Code région,Nom de la région,Code département,Code arrondissement,Code canton,Code commune,Nom de la commune,Population municipale,Population comptée à part,Population totale
82,Rhône-Alpes,01,2,10,001,L' Abergement-Clémenciat,791,16,807
82,Rhône-Alpes,01,1,01,002,L' Abergement-de-Varey,194,6,200
82,Rhône-Alpes,01,1,01,004,Ambérieu-en-Bugey,12792,480,13272
82,Rhône-Alpes,01,2,30,005,Ambérieux-en-Dombes,1567,21,1588
82,Rhône-Alpes,01,1,04,006,Ambléon,123,0,123
82,Rhône-Alpes,01,1,01,007,Ambronay,2296,109,2405
82,Rhône-Alpes,01,1,17,008,Ambutrix,657,13,670
82,Rhône-Alpes,01,1,04,009,Andert-et-Condon,331,17,348
82,Rhône-Alpes,01,1,31,010,Anglefort,926,8,934
82,Rhône-Alpes,01,4,22,011,Apremont,339,19,358
82,Rhône-Alpes,01,1,15,012,Aranc,285,13,298
82,Rhône-Alpes,01,1,28,013,Arandas,164,1,165
82,Rhône-Alpes,01,4,23,014,Arbent,3433,141,3574
82,Rhône-Alpes,01,1,04,015,Arbignieu,473,14,487
82,Rhône-Alpes,01,2,26,016,Arbigny,368,11,379
82,Rhône-Alpes,01,1,28,017,Argis,421,4,425
82,Rhône-Alpes,01,1,36,019,Armix,23,1,24
82,Rhône-Alpes,01,2,42,021,Ars-sur-Formans,1284,19,1303
82,Rhône-Alpes,01,1,09,022,Artemare,1097,27,1124
82,Rhône-Alpes,01,2,02,023,Asnières-sur-Saône,79,1,80
82,Rhône-Alpes,01,2,21,024,Attignat,2662,58,2720
82,Rhône-Alpes,01,2,02,025,Bâgé-la-Ville,2866,86,2952
82,Rhône-Alpes,01,2,02,026,Bâgé-le-Châtel,795,75,870
82,Rhône-Alpes,01,2,20,027,Balan,2362,91,2453
82,Rhône-Alpes,01,2,30,028,Baneins,595,6,601
82,Rhône-Alpes,01,4,22,170,Béard-Géovreissiat,908,35,943
82,Rhône-Alpes,01,2,11,029,Beaupont,560,10,570
82,Rhône-Alpes,01,2,34,030,Beauregard,881,19,900
82,Rhône-Alpes,01,2,20,032,Béligneux,2883,58,2941
82,Rhône-Alpes,01,4,03,033,Bellegarde-sur-Valserine,11404,349,11753
82,Rhône-Alpes,01,1,04,034,Belley,8750,431,9181
82,Rhône-Alpes,01,4,23,035,Belleydoux,298,18,316
82,Rhône-Alpes,01,4,41,031,Bellignat,3464,175,3639
82,Rhône-Alpes,01,1,09,036,Belmont-Luthézieu,489,15,504
82,Rhône-Alpes,01,1,18,037,Bénonces,280,2,282
82,Rhône-Alpes,01,2,11,038,Bény,742,18,760
82,Rhône-Alpes,01,1,09,039,Béon,354,13,367
82,Rhône-Alpes,01,2,21,040,Béréziat,388,9,397
82,Rhône-Alpes,01,1,01,041,Bettant,714,11,725
82,Rhône-Alpes,01,2,27,042,Bey,242,10,252
82,Rhône-Alpes,01,2,40,043,Beynost,4305,98,4403
82,Rhône-Alpes,01,4,03,044,Billiat,448,6,454
82,Rhône-Alpes,01,2,35,045,Birieux,230,2,232
82,Rhône-Alpes,01,2,10,046,Biziat,774,10,784
82,Rhône-Alpes,01,1,17,047,Blyes,880,45,925
82,Rhône-Alpes,01,2,07,245,Bohas-Meyriat-Rignat,815,38,853
82,Rhône-Alpes,01,2,20,049,La Boisse,2880,56,2936
82,Rhône-Alpes,01,2,26,050,Boissey,246,6,252
82,Rhône-Alpes,01,4,16,051,Bolozon,98,3,101
82,Rhône-Alpes,01,2,35,052,Bouligneux,303,10,313
82,Rhône-Alpes,01,2,99,053,Bourg-en-Bresse,40203,2143,42346
82,Rhône-Alpes,01,2,19,054,Bourg-Saint-Christophe,1095,16,1111
82,Rhône-Alpes,01,4,24,056,Boyeux-Saint-Jérôme,306,12,318
82,Rhône-Alpes,01,2,26,057,Boz,485,4,489
82,Rhône-Alpes,01,1,04,058,Brégnier-Cordon,746,25,771
82,Rhône-Alpes,01,1,09,059,Brénaz,92,8,100
82,Rhône-Alpes,01,4,06,060,Brénod,531,15,546
82,Rhône-Alpes,01,1,04,061,Brens,993,29,1022
82,Rhône-Alpes,01,2,20,062,Bressolles,717,18,735
82,Rhône-Alpes,01,4,22,063,Brion,506,20,526
82,Rhône-Alpes,01,1,18,064,Briord,856,14,870
82,Rhône-Alpes,01,2,43,065,Buellas,1617,68,1685
82,Rhône-Alpes,01,1,36,066,La Burbanche,68,1,69
82,Rhône-Alpes,01,4,16,067,Ceignes,271,5,276
82,Rhône-Alpes,01,4,24,068,Cerdon,766,14,780
82,Rhône-Alpes,01,2,25,069,Certines,1450,32,1482
82,Rhône-Alpes,01,3,14,071,Cessy,3660,116,3776
82,Rhône-Alpes,01,2,07,072,Ceyzériat,2620,74,2694
82,Rhône-Alpes,01,1,36,073,Ceyzérieu,893,30,923
82,Rhône-Alpes,01,2,08,074,Chalamont,2236,27,2263
82,Rhône-Alpes,01,2,30,075,Chaleins,1183,30,1213
82,Rhône-Alpes,01,1,28,076,Chaley,120,5,125
82,Rhône-Alpes,01,4,24,077,Challes-la-Montagne,186,1,187
82,Rhône-Alpes,01,3,12,078,Challex,1124,25,1149
82,Rhône-Alpes,01,1,09,079,Champagne-en-Valromey,741,18,759
82,Rhône-Alpes,01,4,06,080,Champdor,450,12,462
82,Rhône-Alpes,01,4,03,081,Champfromier,653,25,678
82,Rhône-Alpes,01,1,31,082,Chanay,610,28,638
82,Rhône-Alpes,01,2,30,083,Chaneins,840,16,856
82,Rhône-Alpes,01,2,10,084,Chanoz-Châtenay,671,9,680
82,Rhône-Alpes,01,2,35,085,La Chapelle-du-Châtelard,309,3,312
82,Rhône-Alpes,01,4,22,087,Charix,297,17,314
82,Rhône-Alpes,01,2,19,088,Charnoz-sur-Ain,912,13,925
82,Rhône-Alpes,01,1,01,089,Château-Gaillard,1732,38,1770
82,Rhône-Alpes,01,2,08,090,Châtenay,337,3,340
82,Rhône-Alpes,01,4,03,091,Châtillon-en-Michaille,3099,95,3194
82,Rhône-Alpes,01,2,08,092,Châtillon-la-Palud,1496,63,1559
82,Rhône-Alpes,01,2,10,093,Châtillon-sur-Chalaronne,4924,209,5133
82,Rhône-Alpes,01,2,26,094,Chavannes-sur-Reyssouze,667,16,683
82,Rhône-Alpes,01,2,33,095,Chavannes-sur-Suran,655,11,666
82,Rhône-Alpes,01,2,10,096,Chaveyriat,907,23,930
82,Rhône-Alpes,01,1,09,097,Chavornay,181,7,188
82,Rhône-Alpes,01,1,04,098,Chazey-Bons,715,15,730
82,Rhône-Alpes,01,1,17,099,Chazey-sur-Ain,1385,28,1413
82,Rhône-Alpes,01,1,36,100,Cheignieu-la-Balme,150,2,152
82,Rhône-Alpes,01,4,06,101,Chevillard,174,7,181
82,Rhône-Alpes,01,2,26,102,Chevroux,871,10,881
82,Rhône-Alpes,01,3,14,103,Chevry,1184,48,1232
82,Rhône-Alpes,01,3,12,104,Chézery-Forens,403,13,416
82,Rhône-Alpes,01,2,42,105,Civrieux,1340,78,1418
82,Rhône-Alpes,01,2,07,106,Cize,158,2,160
82,Rhône-Alpes,01,1,28,107,Cleyzieu,131,1,132
82,Rhône-Alpes,01,2,11,108,Coligny,1150,30,1180
82,Rhône-Alpes,01,3,12,109,Collonges,1621,29,1650
82,Rhône-Alpes,01,1,04,110,Colomieu,116,1,117
82,Rhône-Alpes,01,1,28,111,Conand,103,6,109
82,Rhône-Alpes,01,4,06,112,Condamine,388,41,429
82,Rhône-Alpes,01,2,10,113,Condeissiat,749,17,766
82,Rhône-Alpes,01,3,12,114,Confort,513,21,534
82,Rhône-Alpes,01,2,21,115,Confrançon,1071,26,1097
82,Rhône-Alpes,01,1,36,116,Contrevoz,506,25,531
82,Rhône-Alpes,01,1,04,117,Conzieu,119,5,124
82,Rhône-Alpes,01,1,31,118,Corbonod,1152,21,1173
82,Rhône-Alpes,01,4,06,119,Corcelles,223,6,229
82,Rhône-Alpes,01,1,15,121,Corlier,119,2,121
82,Rhône-Alpes,01,1,15,122,Cormaranche-en-Bugey,857,76,933
82,Rhône-Alpes,01,2,27,123,Cormoranche-sur-Saône,1043,30,1073
82,Rhône-Alpes,01,2,29,124,Cormoz,547,8,555
82,Rhône-Alpes,01,2,33,125,Corveissiat,556,16,572
82,Rhône-Alpes,01,2,33,127,Courmangoux,490,13,503
82,Rhône-Alpes,01,2,29,128,Courtes,251,6,257
82,Rhône-Alpes,01,2,08,129,Crans,273,9,282
82,Rhône-Alpes,01,2,21,130,Cras-sur-Reyssouze,1155,35,1190
82,Rhône-Alpes,01,1,04,133,Cressin-Rochefort,361,7,368
82,Rhône-Alpes,01,2,27,134,Crottet,1723,44,1767
82,Rhône-Alpes,01,3,14,135,Crozet,1766,64,1830
82,Rhône-Alpes,01,2,27,136,Cruzilles-lès-Mépillat,793,15,808
82,Rhône-Alpes,01,1,31,138,Culoz,2931,57,2988
82,Rhône-Alpes,01,2,29,139,Curciat-Dongalon,437,6,443
82,Rhône-Alpes,01,2,21,140,Curtafond,663,13,676
82,Rhône-Alpes,01,1,36,141,Cuzieu,401,10,411
82,Rhône-Alpes,01,2,20,142,Dagneux,3930,78,4008
82,Rhône-Alpes,01,3,14,143,Divonne-les-Bains,7806,210,8016
82,Rhône-Alpes,01,2,02,144,Dommartin,813,17,830
82,Rhône-Alpes,01,2,10,146,Dompierre-sur-Chalaronne,371,7,378
82,Rhône-Alpes,01,2,25,145,Dompierre-sur-Veyle,1198,24,1222
82,Rhône-Alpes,01,2,11,147,Domsure,475,9,484
82,Rhône-Alpes,01,4,23,148,Dortan,2077,75,2152
82,Rhône-Alpes,01,1,01,149,Douvres,934,31,965
82,Rhône-Alpes,01,2,07,150,Drom,192,1,193
82,Rhône-Alpes,01,2,25,151,Druillat,1127,24,1151
82,Rhône-Alpes,01,4,23,152,Échallon,775,29,804
82,Rhône-Alpes,01,3,14,153,Échenevex,1538,53,1591
82,Rhône-Alpes,01,2,21,154,Étrez,786,15,801
82,Rhône-Alpes,01,1,28,155,Évosges,130,3,133
82,Rhône-Alpes,01,2,19,156,Faramans,647,15,662
82,Rhône-Alpes,01,2,30,157,Fareins,2035,56,2091
82,Rhône-Alpes,01,3,12,158,Farges,825,23,848
82,Rhône-Alpes,01,2,02,159,Feillens,3108,112,3220
82,Rhône-Alpes,01,3,13,160,Ferney-Voltaire,7822,223,8045
82,Rhône-Alpes,01,1,36,162,Flaxieu,57,3,60
82,Rhône-Alpes,01,2,21,163,Foissiat,1855,33,1888
82,Rhône-Alpes,01,2,30,165,Francheleins,1218,22,1240
82,Rhône-Alpes,01,2,34,166,Frans,1994,37,2031
82,Rhône-Alpes,01,2,32,167,Garnerans,640,22,662
82,Rhône-Alpes,01,2,32,169,Genouilleux,581,10,591
82,Rhône-Alpes,01,4,41,171,Géovreisset,904,31,935
82,Rhône-Alpes,01,2,33,172,Germagnat,144,4,148
82,Rhône-Alpes,01,3,14,173,Gex,9694,251,9945
82,Rhône-Alpes,01,4,03,174,Giron,147,5,152
82,Rhône-Alpes,01,2,26,175,Gorrevod,737,14,751
82,Rhône-Alpes,01,4,06,176,Le Grand-Abergement,105,6,111
82,Rhône-Alpes,01,2,07,177,Grand-Corent,146,5,151
82,Rhône-Alpes,01,2,27,179,Grièges,1800,57,1857
82,Rhône-Alpes,01,3,14,180,Grilly,709,25,734
82,Rhône-Alpes,01,4,41,181,Groissiat,1116,38,1154
82,Rhône-Alpes,01,1,18,182,Groslée,350,9,359
82,Rhône-Alpes,01,2,32,183,Guéreins,1241,25,1266
82,Rhône-Alpes,01,2,07,184,Hautecourt-Romanèche,748,18,766
82,Rhône-Alpes,01,1,15,185,Hauteville-Lompnes,4193,134,4327
82,Rhône-Alpes,01,1,28,186,Hostiaz,80,2,82
82,Rhône-Alpes,01,4,06,187,Hotonnes,300,18,318
82,Rhône-Alpes,01,2,32,188,Illiat,544,18,562
82,Rhône-Alpes,01,4,03,189,Injoux-Génissiat,1014,22,1036
82,Rhône-Alpes,01,1,18,190,Innimond,111,6,117
82,Rhône-Alpes,01,4,06,191,Izenave,152,3,155
82,Rhône-Alpes,01,4,16,192,Izernore,2247,50,2297
82,Rhône-Alpes,01,1,04,193,Izieu,196,4,200
82,Rhône-Alpes,01,2,34,194,Jassans-Riottier,5934,116,6050
82,Rhône-Alpes,01,2,07,195,Jasseron,1412,41,1453
82,Rhône-Alpes,01,2,21,196,Jayat,994,24,1018
82,Rhône-Alpes,01,2,25,197,Journans,315,17,332
82,Rhône-Alpes,01,2,19,198,Joyeux,233,3,236
82,Rhône-Alpes,01,4,24,199,Jujurieux,2022,36,2058
82,Rhône-Alpes,01,4,24,200,Labalme,172,2,174
82,Rhône-Alpes,01,1,17,202,Lagnieu,6694,149,6843
82,Rhône-Alpes,01,2,27,203,Laiz,1101,34,1135
82,Rhône-Alpes,01,4,22,204,Lalleyriat,222,9,231
82,Rhône-Alpes,01,3,12,205,Lancrans,1025,33,1058
82,Rhône-Alpes,01,4,06,206,Lantenay,254,9,263
82,Rhône-Alpes,01,2,35,207,Lapeyrouse,293,2,295
82,Rhône-Alpes,01,1,04,208,Lavours,130,6,136
82,Rhône-Alpes,01,3,12,209,Léaz,520,15,535
82,Rhône-Alpes,01,3,14,210,Lélex,225,8,233
82,Rhône-Alpes,01,2,39,211,Lent,1266,31,1297
82,Rhône-Alpes,01,2,29,212,Lescheroux,695,7,702
82,Rhône-Alpes,01,1,17,213,Leyment,1260,22,1282
82,Rhône-Alpes,01,4,16,214,Leyssard,160,8,168
82,Rhône-Alpes,01,4,03,215,Lhôpital,58,1,59
82,Rhône-Alpes,01,1,18,216,Lhuis,817,24,841
82,Rhône-Alpes,01,1,09,218,Lochieu,90,5,95
82,Rhône-Alpes,01,1,18,219,Lompnas,157,3,160
82,Rhône-Alpes,01,1,09,221,Lompnieu,111,3,114
82,Rhône-Alpes,01,1,17,224,Loyettes,2437,37,2474
82,Rhône-Alpes,01,2,30,225,Lurcy,395,10,405
82,Rhône-Alpes,01,1,04,227,Magnieu,418,5,423
82,Rhône-Alpes,01,4,22,228,Maillat,655,13,668
82,Rhône-Alpes,01,2,21,229,Malafretaz,888,28,916
82,Rhône-Alpes,01,2,29,230,Mantenay-Montlin,285,5,290
82,Rhône-Alpes,01,2,02,231,Manziat,1892,59,1951
82,Rhône-Alpes,01,2,11,232,Marboz,2176,48,2224
82,Rhône-Alpes,01,1,18,233,Marchamp,115,3,118
82,Rhône-Alpes,01,1,36,234,Marignieu,156,5,161
82,Rhône-Alpes,01,2,35,235,Marlieux,801,53,854
82,Rhône-Alpes,01,2,21,236,Marsonnas,937,16,953
82,Rhône-Alpes,01,4,41,237,Martignat,1586,51,1637
82,Rhône-Alpes,01,2,42,238,Massieux,2391,40,2431
82,Rhône-Alpes,01,1,04,239,Massignieu-de-Rives,573,15,588
82,Rhône-Alpes,01,4,16,240,Matafelon-Granges,653,9,662
82,Rhône-Alpes,01,2,33,241,Meillonnas,1298,27,1325
82,Rhône-Alpes,01,4,24,242,Mérignat,136,4,140
82,Rhône-Alpes,01,2,30,243,Messimy-sur-Saône,1163,18,1181
82,Rhône-Alpes,01,2,19,244,Meximieux,7334,177,7511
82,Rhône-Alpes,01,2,10,246,Mézériat,2034,50,2084
82,Rhône-Alpes,01,3,14,247,Mijoux,380,18,398
82,Rhône-Alpes,01,2,42,248,Mionnay,2115,41,2156
82,Rhône-Alpes,01,2,40,249,Miribel,8997,146,9143
82,Rhône-Alpes,01,2,42,250,Misérieux,1749,222,1971
82,Rhône-Alpes,01,2,32,252,Mogneneins,694,23,717
82,Rhône-Alpes,01,2,39,254,Montagnat,1588,52,1640
82,Rhône-Alpes,01,1,18,255,Montagnieu,484,19,503
82,Rhône-Alpes,01,4,03,257,Montanges,331,12,343
82,Rhône-Alpes,01,2,32,258,Montceaux,1063,34,1097
82,Rhône-Alpes,01,2,43,259,Montcet,663,12,675
82,Rhône-Alpes,01,2,19,260,Le Montellier,224,6,230
82,Rhône-Alpes,01,2,35,261,Monthieux,595,13,608
82,Rhône-Alpes,01,2,20,262,Montluel,6774,181,6955
82,Rhône-Alpes,01,2,32,263,Montmerle-sur-Saône,3806,66,3872
82,Rhône-Alpes,01,2,39,264,Montracol,925,25,950
82,Rhône-Alpes,01,4,22,265,Montréal-la-Cluse,3529,114,3643
82,Rhône-Alpes,01,2,21,266,Montrevel-en-Bresse,2351,37,2388
82,Rhône-Alpes,01,1,04,268,Murs-et-Gélignieux,238,8,246
82,Rhône-Alpes,01,4,22,269,Nantua,3633,162,3795
82,Rhône-Alpes,01,1,04,271,Nattages,549,15,564
82,Rhône-Alpes,01,2,10,272,Neuville-les-Dames,1523,22,1545
82,Rhône-Alpes,01,2,25,273,Neuville-sur-Ain,1516,37,1553
82,Rhône-Alpes,01,4,22,274,Les Neyrolles,656,22,678
82,Rhône-Alpes,01,2,40,275,Neyron,2332,42,2374
82,Rhône-Alpes,01,2,20,276,Niévroz,1511,15,1526
82,Rhône-Alpes,01,1,28,277,Nivollet-Montgriffon,139,2,141
82,Rhône-Alpes,01,4,16,267,Nurieux-Volognat,1089,25,1114
82,Rhône-Alpes,01,1,28,279,Oncieu,92,4,96
82,Rhône-Alpes,01,1,18,280,Ordonnaz,134,2,136
82,Rhône-Alpes,01,3,13,281,Ornex,3163,115,3278
82,Rhône-Alpes,01,4,06,282,Outriaz,266,8,274
82,Rhône-Alpes,01,4,98,283,Oyonnax,23114,652,23766
82,Rhône-Alpes,01,2,26,284,Ozan,539,12,551
82,Rhône-Alpes,01,2,42,285,Parcieux,1057,15,1072
82,Rhône-Alpes,01,1,04,286,Parves,342,4,346
82,Rhône-Alpes,01,3,12,288,Péron,1930,31,1961
82,Rhône-Alpes,01,2,39,289,Péronnas,6135,370,6505
82,Rhône-Alpes,01,2,19,290,Pérouges,1205,29,1234
82,Rhône-Alpes,01,2,27,291,Perrex,836,22,858
82,Rhône-Alpes,01,4,06,292,Le Petit-Abergement,141,9,150
82,Rhône-Alpes,01,4,16,293,Peyriat,166,11,177
82,Rhône-Alpes,01,1,04,294,Peyrieu,791,42,833
82,Rhône-Alpes,01,2,32,295,Peyzieux-sur-Saône,385,6,391
82,Rhône-Alpes,01,2,11,296,Pirajoux,330,12,342
82,Rhône-Alpes,01,2,20,297,Pizay,762,19,781
82,Rhône-Alpes,01,4,03,298,Plagne,109,2,111
82,Rhône-Alpes,01,2,08,299,Le Plantay,535,16,551
82,Rhône-Alpes,01,4,22,300,Le Poizat,424,7,431
82,Rhône-Alpes,01,2,43,301,Polliat,2366,59,2425
82,Rhône-Alpes,01,1,04,302,Pollieu,156,7,163
82,Rhône-Alpes,01,4,24,303,Poncin,1582,36,1618
82,Rhône-Alpes,01,2,25,304,Pont-d'Ain,2514,53,2567
82,Rhône-Alpes,01,2,26,305,Pont-de-Vaux,2159,56,2215
82,Rhône-Alpes,01,2,27,306,Pont-de-Veyle,1496,99,1595
82,Rhône-Alpes,01,4,22,307,Port,868,28,896
82,Rhône-Alpes,01,3,12,308,Pougny,764,6,770
82,Rhône-Alpes,01,2,33,309,Pouillat,83,2,85
82,Rhône-Alpes,01,1,04,310,Prémeyzel,251,5,256
82,Rhône-Alpes,01,1,15,311,Prémillieu,34,2,36
82,Rhône-Alpes,01,2,33,312,Pressiat,216,6,222
82,Rhône-Alpes,01,3,13,313,Prévessin-Moëns,5300,182,5482
82,Rhône-Alpes,01,2,25,314,Priay,1447,22,1469
82,Rhône-Alpes,01,1,36,316,Pugieu,146,2,148
82,Rhône-Alpes,01,2,07,317,Ramasse,255,7,262
82,Rhône-Alpes,01,2,42,318,Rancé,643,12,655
82,Rhône-Alpes,01,2,30,319,Relevant,433,11,444
82,Rhône-Alpes,01,2,02,320,Replonges,3281,63,3344
82,Rhône-Alpes,01,2,07,321,Revonnas,670,10,680
82,Rhône-Alpes,01,2,42,322,Reyrieux,4028,93,4121
82,Rhône-Alpes,01,2,26,323,Reyssouze,905,15,920
82,Rhône-Alpes,01,2,19,325,Rignieux-le-Franc,944,16,960
82,Rhône-Alpes,01,2,10,328,Romans,581,14,595
82,Rhône-Alpes,01,1,36,329,Rossillon,145,2,147
82,Rhône-Alpes,01,1,09,330,Ruffieu,180,13,193
82,Rhône-Alpes,01,4,24,331,Saint-Alban,174,6,180
82,Rhône-Alpes,01,2,27,334,Saint-André-d'Huiriat,536,6,542
82,Rhône-Alpes,01,2,02,332,Saint-André-de-Bâgé,555,14,569
82,Rhône-Alpes,01,2,42,333,Saint-André-de-Corcy,2971,41,3012
82,Rhône-Alpes,01,2,10,335,Saint-André-le-Bouchoux,307,5,312
82,Rhône-Alpes,01,2,39,336,Saint-André-sur-Vieux-Jonc,1030,22,1052
82,Rhône-Alpes,01,2,26,337,Saint-Bénigne,1117,29,1146
82,Rhône-Alpes,01,1,18,338,Saint-Benoît,736,20,756
82,Rhône-Alpes,01,2,34,339,Saint-Bernard,1380,30,1410
82,Rhône-Alpes,01,1,04,340,Saint-Bois,120,3,123
82,Rhône-Alpes,01,1,04,341,Saint-Champ,138,4,142
82,Rhône-Alpes,01,2,27,343,Saint-Cyr-sur-Menthon,1563,32,1595
82,Rhône-Alpes,01,1,01,345,Saint-Denis-en-Bugey,2093,31,2124
82,Rhône-Alpes,01,2,43,344,Saint-Denis-lès-Bourg,5229,175,5404
82,Rhône-Alpes,01,2,21,346,Saint-Didier-d'Aussiat,821,14,835
82,Rhône-Alpes,01,2,34,347,Saint-Didier-de-Formans,1782,67,1849
82,Rhône-Alpes,01,2,32,348,Saint-Didier-sur-Chalaronne,2656,59,2715
82,Rhône-Alpes,01,2,19,349,Saint-Éloi,372,12,384
82,Rhône-Alpes,01,2,33,350,Saint-Étienne-du-Bois,2410,47,2457
82,Rhône-Alpes,01,2,32,351,Saint-Étienne-sur-Chalaronne,1415,36,1451
82,Rhône-Alpes,01,2,26,352,Saint-Étienne-sur-Reyssouze,516,8,524
82,Rhône-Alpes,01,3,13,354,Saint-Genis-Pouilly,8379,165,8544
82,Rhône-Alpes,01,2,27,355,Saint-Genis-sur-Menthon,391,6,397
82,Rhône-Alpes,01,2,10,356,Saint-Georges-sur-Renon,196,5,201
82,Rhône-Alpes,01,4,03,357,Saint-Germain-de-Joux,494,12,506
82,Rhône-Alpes,01,1,04,358,Saint-Germain-les-Paroisses,367,12,379
82,Rhône-Alpes,01,2,35,359,Saint-Germain-sur-Renon,241,5,246
82,Rhône-Alpes,01,3,12,360,Saint-Jean-de-Gonville,1442,41,1483
82,Rhône-Alpes,01,2,19,361,Saint-Jean-de-Niost,1404,42,1446
82,Rhône-Alpes,01,2,42,362,Saint-Jean-de-Thurigneux,615,6,621
82,Rhône-Alpes,01,4,24,363,Saint-Jean-le-Vieux,1578,84,1662
82,Rhône-Alpes,01,2,29,364,Saint-Jean-sur-Reyssouze,713,16,729
82,Rhône-Alpes,01,2,27,365,Saint-Jean-sur-Veyle,1068,35,1103
82,Rhône-Alpes,01,2,29,367,Saint-Julien-sur-Reyssouze,586,14,600
82,Rhône-Alpes,01,2,10,368,Saint-Julien-sur-Veyle,699,8,707
82,Rhône-Alpes,01,2,39,369,Saint-Just,874,38,912
82,Rhône-Alpes,01,2,02,370,Saint-Laurent-sur-Saône,1736,20,1756
82,Rhône-Alpes,01,2,35,371,Saint-Marcel,1223,10,1233
82,Rhône-Alpes,01,1,36,372,Saint-Martin-de-Bavel,457,6,463
82,Rhône-Alpes,01,4,22,373,Saint-Martin-du-Frêne,1069,46,1115
82,Rhône-Alpes,01,2,25,374,Saint-Martin-du-Mont,1565,45,1610
82,Rhône-Alpes,01,2,21,375,Saint-Martin-le-Châtel,774,21,795
82,Rhône-Alpes,01,2,40,376,Saint-Maurice-de-Beynost,3875,37,3912
82,Rhône-Alpes,01,2,19,378,Saint-Maurice-de-Gourdans,2404,45,2449
82,Rhône-Alpes,01,1,01,379,Saint-Maurice-de-Rémens,683,7,690
82,Rhône-Alpes,01,2,29,380,Saint-Nizier-le-Bouchoux,727,18,745
82,Rhône-Alpes,01,2,08,381,Saint-Nizier-le-Désert,858,6,864
82,Rhône-Alpes,01,2,35,383,Saint-Paul-de-Varax,1497,9,1506
82,Rhône-Alpes,01,1,28,384,Saint-Rambert-en-Bugey,2167,39,2206
82,Rhône-Alpes,01,2,39,385,Saint-Rémy,835,25,860
82,Rhône-Alpes,01,1,17,386,Saint-Sorlin-en-Bugey,1066,49,1115
82,Rhône-Alpes,01,2,21,387,Saint-Sulpice,135,0,135
82,Rhône-Alpes,01,2,29,388,Saint-Trivier-de-Courtes,975,30,1005
82,Rhône-Alpes,01,2,30,389,Saint-Trivier-sur-Moignans,1881,24,1905
82,Rhône-Alpes,01,1,17,390,Saint-Vulbas,923,17,940
82,Rhône-Alpes,01,2,20,342,Sainte-Croix,524,10,534
82,Rhône-Alpes,01,2,42,353,Sainte-Euphémie,1392,34,1426
82,Rhône-Alpes,01,1,17,366,Sainte-Julie,846,9,855
82,Rhône-Alpes,01,2,30,382,Sainte-Olive,310,2,312
82,Rhône-Alpes,01,2,11,391,Salavre,282,12,294
82,Rhône-Alpes,01,4,16,392,Samognat,685,20,705
82,Rhône-Alpes,01,2,10,393,Sandrans,530,9,539
82,Rhône-Alpes,01,1,17,396,Sault-Brénaz,1050,15,1065
82,Rhône-Alpes,01,3,13,397,Sauverny,1095,41,1136
82,Rhône-Alpes,01,2,30,398,Savigneux,1189,11,1200
82,Rhône-Alpes,01,3,14,399,Ségny,1581,50,1631
82,Rhône-Alpes,01,1,18,400,Seillonnaz,141,3,144
82,Rhône-Alpes,01,3,13,401,Sergy,1706,39,1745
82,Rhône-Alpes,01,2,26,402,Sermoyer,664,12,676
82,Rhône-Alpes,01,1,18,403,Serrières-de-Briord,1112,17,1129
82,Rhône-Alpes,01,4,16,404,Serrières-sur-Ain,116,3,119
82,Rhône-Alpes,01,2,39,405,Servas,1174,16,1190
82,Rhône-Alpes,01,2,29,406,Servignat,156,4,160
82,Rhône-Alpes,01,1,31,407,Seyssel,933,18,951
82,Rhône-Alpes,01,2,07,408,Simandre-sur-Suran,656,19,675
82,Rhône-Alpes,01,1,09,409,Songieu,121,5,126
82,Rhône-Alpes,01,4,16,410,Sonthonnax-la-Montagne,323,23,346
82,Rhône-Alpes,01,1,17,411,Souclin,256,0,256
82,Rhône-Alpes,01,2,10,412,Sulignat,573,23,596
82,Rhône-Alpes,01,4,03,413,Surjoux,74,1,75
82,Rhône-Alpes,01,1,09,414,Sutrieu,228,9,237
82,Rhône-Alpes,01,1,09,415,Talissieu,452,4,456
82,Rhône-Alpes,01,1,28,416,Tenay,1105,24,1129
82,Rhône-Alpes,01,1,15,417,Thézillieu,313,4,317
82,Rhône-Alpes,01,2,40,418,Thil,1083,6,1089
82,Rhône-Alpes,01,3,13,419,Thoiry,4938,154,5092
82,Rhône-Alpes,01,2,32,420,Thoissey,1498,18,1516
82,Rhône-Alpes,01,1,28,421,Torcieu,685,13,698
82,Rhône-Alpes,01,2,25,422,Tossiat,1388,34,1422
82,Rhône-Alpes,01,2,42,423,Toussieux,745,11,756
82,Rhône-Alpes,01,2,42,424,Tramoyes,1641,33,1674
82,Rhône-Alpes,01,2,25,425,La Tranclière,303,7,310
82,Rhône-Alpes,01,2,33,426,Treffort-Cuisiat,2070,48,2118
82,Rhône-Alpes,01,2,34,427,Trévoux,6768,189,6957
82,Rhône-Alpes,01,2,32,428,Valeins,90,1,91
82,Rhône-Alpes,01,2,43,429,Vandeins,600,10,610
82,Rhône-Alpes,01,2,25,430,Varambon,536,14,550
82,Rhône-Alpes,01,1,17,431,Vaux-en-Bugey,1115,26,1141
82,Rhône-Alpes,01,2,11,432,Verjon,250,9,259
82,Rhône-Alpes,01,2,29,433,Vernoux,227,2,229
82,Rhône-Alpes,01,2,08,434,Versailleux,330,5,335
82,Rhône-Alpes,01,3,13,435,Versonnex,2068,54,2122
82,Rhône-Alpes,01,3,14,436,Vesancy,520,21,541
82,Rhône-Alpes,01,2,29,437,Vescours,199,4,203
82,Rhône-Alpes,01,2,02,439,Vésines,90,3,93
82,Rhône-Alpes,01,1,09,442,Vieu,381,7,388
82,Rhône-Alpes,01,4,06,441,Vieu-d'Izenave,682,16,698
82,Rhône-Alpes,01,2,35,443,Villars-les-Dombes,4330,91,4421
82,Rhône-Alpes,01,1,17,444,Villebois,1111,20,1131
82,Rhône-Alpes,01,2,11,445,Villemotier,597,12,609
82,Rhône-Alpes,01,2,30,446,Villeneuve,1353,23,1376
82,Rhône-Alpes,01,2,07,447,Villereversure,1206,102,1308
82,Rhône-Alpes,01,4,03,448,Villes,361,9,370
82,Rhône-Alpes,01,2,08,449,Villette-sur-Ain,664,18,682
82,Rhône-Alpes,01,2,19,450,Villieu-Loyes-Mollon,2937,71,3008
82,Rhône-Alpes,01,2,43,451,Viriat,5735,171,5906
82,Rhône-Alpes,01,1,36,452,Virieu-le-Grand,1084,23,1107
82,Rhône-Alpes,01,1,09,453,Virieu-le-Petit,313,2,315
82,Rhône-Alpes,01,1,04,454,Virignin,798,26,824
82,Rhône-Alpes,01,1,36,456,Vongnes,69,6,75
82,Rhône-Alpes,01,2,10,457,Vonnas,2681,65,2746
22,Picardie,02,2,09,001,Abbécourt,490,9,499
22,Picardie,02,2,14,002,Achery,546,7,553
22,Picardie,02,4,04,003,Acy,898,33,931
22,Picardie,02,2,19,004,Agnicourt-et-Séchelles,193,7,200
22,Picardie,02,2,21,005,Aguilcourt,334,15,349
22,Picardie,02,5,16,006,Aisonville-et-Bernoville,292,5,297
22,Picardie,02,2,12,007,Aizelles,107,0,107
22,Picardie,02,4,32,008,Aizy-Jouy,260,8,268
22,Picardie,02,3,20,009,Alaincourt,495,7,502
22,Picardie,02,4,32,010,Allemant,177,3,180
22,Picardie,02,4,35,011,Ambleny,1138,95,1233
22,Picardie,02,4,24,012,Ambrief,63,4,67
22,Picardie,02,2,21,013,Amifontaine,413,9,422
22,Picardie,02,2,09,014,Amigny-Rouy,724,13,737
22,Picardie,02,4,36,015,Ancienville,66,2,68
22,Picardie,02,2,14,016,Andelain,179,9,188
22,Picardie,02,2,14,017,Anguilcourt-le-Sart,279,6,285
22,Picardie,02,2,01,018,Anizy-le-Château,1899,31,1930
22,Picardie,02,3,29,019,Annois,378,4,382
22,Picardie,02,5,02,020,Any-Martin-Rieux,499,11,510
22,Picardie,02,2,26,021,Archon,92,2,94
22,Picardie,02,4,24,022,Arcy-Sainte-Restitue,433,14,447
22,Picardie,02,1,22,023,Armentières-sur-Ourcq,100,1,101
22,Picardie,02,2,38,024,Arrancy,45,0,45
22,Picardie,02,3,29,025,Artemps,359,6,365
22,Picardie,02,1,10,026,Artonges,167,3,170
22,Picardie,02,2,13,027,Assis-sur-Serre,266,5,271
22,Picardie,02,2,38,028,Athies-sous-Laon,2385,53,2438
22,Picardie,02,3,33,029,Attilly,394,9,403
22,Picardie,02,3,06,030,Aubencheul-aux-Bois,307,9,316
22,Picardie,02,5,02,031,Aubenton,701,10,711
22,Picardie,02,3,29,032,Aubigny-aux-Kaisnes,243,5,248
22,Picardie,02,2,12,033,Aubigny-en-Laonnois,117,2,119
22,Picardie,02,2,11,034,Audignicourt,101,6,107
22,Picardie,02,5,16,035,Audigny,250,8,258
22,Picardie,02,4,04,036,Augy,82,2,84
22,Picardie,02,2,18,037,Aulnois-sous-Laon,1301,26,1327
22,Picardie,02,2,26,038,Les Autels,75,1,76
22,Picardie,02,2,19,039,Autremencourt,184,3,187
22,Picardie,02,5,34,040,Autreppes,184,4,188
22,Picardie,02,2,09,041,Autreville,837,24,861
22,Picardie,02,1,08,042,Azy-sur-Marne,372,10,382
22,Picardie,02,4,35,043,Bagneux,72,1,73
22,Picardie,02,5,34,044,Bancigny,24,0,24
22,Picardie,02,2,13,046,Barenton-Bugny,580,9,589
22,Picardie,02,2,13,047,Barenton-Cel,147,2,149
22,Picardie,02,2,13,048,Barenton-sur-Serre,110,2,112
22,Picardie,02,2,11,049,Barisis,708,14,722
22,Picardie,02,5,23,050,Barzy-en-Thiérache,298,3,301
22,Picardie,02,1,10,051,Barzy-sur-Marne,384,8,392
22,Picardie,02,2,01,052,Bassoles-Aulers,135,4,139
22,Picardie,02,1,10,053,Baulne-en-Brie,296,4,300
22,Picardie,02,4,04,054,Bazoches-sur-Vesles,443,8,451
22,Picardie,02,5,02,055,Beaumé,98,2,100
22,Picardie,02,2,09,056,Beaumont-en-Beine,154,4,158
22,Picardie,02,3,06,057,Beaurevoir,1528,20,1548
22,Picardie,02,2,12,058,Beaurieux,796,14,810
22,Picardie,02,2,42,059,Beautor,2664,43,2707
22,Picardie,02,3,33,060,Beauvois-en-Vermandois,277,6,283
22,Picardie,02,3,03,061,Becquigny,280,5,285
22,Picardie,02,1,08,062,Belleau,127,0,127
22,Picardie,02,3,06,063,Bellenglise,386,8,394
22,Picardie,02,4,41,064,Belleu,3907,80,3987
22,Picardie,02,3,06,065,Bellicourt,638,12,650
22,Picardie,02,3,20,066,Benay,207,4,211
22,Picardie,02,5,23,067,Bergues-sur-Sambre,207,3,210
22,Picardie,02,5,27,068,Berlancourt,97,2,99
22,Picardie,02,2,26,069,Berlise,123,1,124
22,Picardie,02,5,16,070,Bernot,447,15,462
22,Picardie,02,4,35,071,Berny-Rivière,596,12,608
22,Picardie,02,2,12,072,Berrieux,169,4,173
22,Picardie,02,2,21,073,Berry-au-Bac,548,4,552
22,Picardie,02,2,14,074,Bertaucourt-Epourdon,582,6,588
22,Picardie,02,3,20,075,Berthenicourt,208,2,210
22,Picardie,02,2,21,076,Bertricourt,141,2,143
22,Picardie,02,4,41,077,Berzy-le-Sec,394,7,401
22,Picardie,02,2,11,078,Besmé,158,4,162
22,Picardie,02,5,02,079,Besmont,148,0,148
22,Picardie,02,2,18,080,Besny-et-Loizy,365,17,382
22,Picardie,02,2,09,081,Béthancourt-en-Vaux,383,13,396
22,Picardie,02,4,24,082,Beugneux,126,6,132
22,Picardie,02,1,15,083,Beuvardes,718,8,726
22,Picardie,02,1,07,084,Bézu-le-Guéry,253,11,264
22,Picardie,02,1,08,085,Bézu-Saint-Germain,686,11,697
22,Picardie,02,2,11,086,Bichancourt,999,13,1012
22,Picardie,02,4,35,087,Bieuxy,28,0,28
22,Picardie,02,2,38,088,Bièvres,78,6,84
22,Picardie,02,4,41,089,Billy-sur-Aisne,1099,18,1117
22,Picardie,02,4,24,090,Billy-sur-Ourcq,216,5,221
22,Picardie,02,4,04,091,Blanzy-lès-Fismes,93,3,96
22,Picardie,02,2,11,093,Blérancourt,1276,54,1330
22,Picardie,02,1,08,094,Blesmes,379,13,392
22,Picardie,02,3,03,095,Bohain-en-Vermandois,6117,136,6253
22,Picardie,02,2,13,096,Bois-lès-Pargny,172,9,181
22,Picardie,02,2,30,097,Boncourt,243,9,252
22,Picardie,02,1,08,098,Bonneil,411,10,421
22,Picardie,02,1,22,099,Bonnesvalyn,221,8,229
22,Picardie,02,3,06,100,Bony,128,4,132
22,Picardie,02,2,19,101,Bosmont-sur-Serre,205,2,207
22,Picardie,02,2,12,102,Bouconville-Vauclair,156,4,160
22,Picardie,02,5,23,103,Boué,1244,19,1263
22,Picardie,02,2,21,104,Bouffignereux,107,4,111
22,Picardie,02,1,08,105,Bouresches,205,7,212
22,Picardie,02,2,12,106,Bourg-et-Comin,741,14,755
22,Picardie,02,2,11,107,Bourguignon-sous-Coucy,91,0,91
22,Picardie,02,2,01,108,Bourguignon-sous-Montbavin,129,0,129
22,Picardie,02,5,34,109,La Bouteille,509,11,520
22,Picardie,02,4,04,110,Braine,2106,34,2140
22,Picardie,02,2,01,111,Brancourt-en-Laonnois,641,24,665
22,Picardie,02,3,03,112,Brancourt-le-Grand,616,9,625
22,Picardie,02,1,08,114,Brasles,1276,37,1313
22,Picardie,02,3,29,117,Bray-Saint-Christophe,79,2,81
22,Picardie,02,4,32,118,Braye,117,1,118
22,Picardie,02,2,12,115,Braye-en-Laonnois,216,4,220
22,Picardie,02,5,34,116,Braye-en-Thiérache,154,3,157
22,Picardie,02,1,15,119,Brécy,342,8,350
22,Picardie,02,4,04,120,Brenelle,188,5,193
22,Picardie,02,4,24,121,Breny,274,13,287
22,Picardie,02,2,14,122,Brie,58,2,60
22,Picardie,02,3,20,123,Brissay-Choigny,320,7,327
22,Picardie,02,3,20,124,Brissy-Hamégicourt,640,12,652
22,Picardie,02,1,22,125,Brumetz,209,4,213
22,Picardie,02,2,26,126,Brunehamel,538,7,545
22,Picardie,02,2,38,128,Bruyères-et-Montbérault,1586,40,1626
22,Picardie,02,1,15,127,Bruyères-sur-Fère,208,11,219
22,Picardie,02,4,04,129,Bruys,20,0,20
22,Picardie,02,5,17,130,Bucilly,202,6,208
22,Picardie,02,4,32,131,Bucy-le-Long,1966,45,2011
22,Picardie,02,2,18,132,Bucy-lès-Cerny,182,10,192
22,Picardie,02,2,30,133,Bucy-lès-Pierrepont,420,12,432
22,Picardie,02,5,17,134,Buire,875,23,898
22,Picardie,02,5,05,135,Buironfosse,1195,24,1219
22,Picardie,02,5,34,136,Burelles,144,2,146
22,Picardie,02,1,22,137,Bussiares,116,1,117
22,Picardie,02,4,24,138,Buzancy,186,7,193
22,Picardie,02,2,09,139,Caillouël-Crépigny,404,13,417
22,Picardie,02,2,11,140,Camelin,444,10,454
22,Picardie,02,5,05,141,La Capelle,1877,98,1975
22,Picardie,02,3,29,142,Castres,224,4,228
22,Picardie,02,3,06,143,Le Catelet,196,5,201
22,Picardie,02,3,33,144,Caulaincourt,124,4,128
22,Picardie,02,2,09,145,Caumont,563,19,582
22,Picardie,02,1,10,147,La Celle-sous-Montmirail,111,2,113
22,Picardie,02,1,10,146,Celles-lès-Condé,76,5,81
22,Picardie,02,4,32,148,Celles-sur-Aisne,255,3,258
22,Picardie,02,3,20,149,Cerizy,58,2,60
22,Picardie,02,2,12,150,Cerny-en-Laonnois,72,1,73
22,Picardie,02,2,18,151,Cerny-lès-Bucy,114,8,122
22,Picardie,02,4,04,152,Cerseuil,88,0,88
22,Picardie,02,2,01,153,Cessières,448,13,461
22,Picardie,02,4,24,154,Chacrise,312,14,326
22,Picardie,02,2,01,155,Chaillevois,194,5,199
22,Picardie,02,2,13,156,Chalandry,212,6,218
22,Picardie,02,2,18,157,Chambry,748,25,773
22,Picardie,02,2,12,158,Chamouille,256,6,262
22,Picardie,02,2,11,159,Champs,289,10,299
22,Picardie,02,2,26,160,Chaourse,554,15,569
22,Picardie,02,1,10,161,La Chapelle-Monthodon,183,7,190
22,Picardie,02,1,07,162,La Chapelle-sur-Chézy,269,6,275
22,Picardie,02,1,07,163,Charly-sur-Marne,2700,53,2753
22,Picardie,02,1,15,164,Le Charmel,324,3,327
22,Picardie,02,2,14,165,Charmes,1683,37,1720
22,Picardie,02,1,10,166,Chartèves,367,10,377
22,Picardie,02,4,04,167,Chassemy,791,12,803
22,Picardie,02,1,08,168,Château-Thierry,14831,536,15367
22,Picardie,02,2,19,169,Châtillon-lès-Sons,79,3,82
22,Picardie,02,3,20,170,Châtillon-sur-Oise,137,6,143
22,Picardie,02,2,21,171,Chaudardes,85,3,88
22,Picardie,02,4,24,172,Chaudun,260,6,266
22,Picardie,02,2,09,173,Chauny,12146,446,12592
22,Picardie,02,4,32,174,Chavignon,739,14,753
22,Picardie,02,4,31,175,Chavigny,154,3,157
22,Picardie,02,4,32,176,Chavonne,192,1,193
22,Picardie,02,2,38,177,Chérêt,123,7,130
22,Picardie,02,2,12,178,Chermizy-Ailles,86,2,88
22,Picardie,02,4,04,179,Chéry-Chartreuve,329,5,334
22,Picardie,02,2,13,180,Chéry-lès-Pouilly,665,15,680
22,Picardie,02,2,26,181,Chéry-lès-Rozoy,100,2,102
22,Picardie,02,5,27,182,Chevennes,143,5,148
22,Picardie,02,2,01,183,Chevregny,195,5,200
22,Picardie,02,3,25,184,Chevresis-Monceau,353,10,363
22,Picardie,02,1,22,185,Chézy-en-Orxois,366,8,374
22,Picardie,02,1,07,186,Chézy-sur-Marne,1341,42,1383
22,Picardie,02,1,08,187,Chierry,1069,32,1101
22,Picardie,02,5,05,188,Chigny,174,5,179
22,Picardie,02,2,30,189,Chivres-en-Laonnois,356,2,358
22,Picardie,02,4,32,190,Chivres-Val,587,19,606
22,Picardie,02,2,38,191,Chivy-lès-Étouvelles,502,18,520
22,Picardie,02,1,22,192,Chouy,384,12,396
22,Picardie,02,1,15,193,Cierges,75,0,75
22,Picardie,02,2,19,194,Cilly,222,3,225
22,Picardie,02,4,04,195,Ciry-Salsogne,825,10,835
22,Picardie,02,2,38,196,Clacy-et-Thierret,357,14,371
22,Picardie,02,5,05,197,Clairfontaine,568,111,679
22,Picardie,02,4,32,198,Clamecy,227,7,234
22,Picardie,02,3,29,199,Clastres,575,3,578
22,Picardie,02,2,26,200,Clermont-les-Fermes,126,4,130
22,Picardie,02,4,35,201,Coeuvres-et-Valsery,465,15,480
22,Picardie,02,1,15,203,Coincy,1267,25,1292
22,Picardie,02,5,02,204,Coingt,79,1,80
22,Picardie,02,2,12,205,Colligis-Crandelain,161,2,163
22,Picardie,02,5,27,206,Colonfay,67,6,73
22,Picardie,02,2,09,207,Commenchon,176,5,181
22,Picardie,02,2,21,208,Concevreux,265,10,275
22,Picardie,02,1,10,209,Condé-en-Brie,650,10,660
22,Picardie,02,4,32,210,Condé-sur-Aisne,388,1,389
22,Picardie,02,2,21,211,Condé-sur-Suippe,243,6,249
22,Picardie,02,2,09,212,Condren,712,23,735
22,Picardie,02,1,10,213,Connigis,325,7,332
22,Picardie,02,3,29,214,Contescourt,71,2,73
22,Picardie,02,2,12,215,Corbeny,710,3,713
22,Picardie,02,4,36,216,Corcy,306,5,311
22,Picardie,02,2,11,219,Coucy-la-Ville,196,61,257
22,Picardie,02,2,11,217,Coucy-le-Château-Auffrique,1052,56,1108
22,Picardie,02,2,30,218,Coucy-lès-Eppes,567,5,572
22,Picardie,02,1,15,220,Coulonges-Cohan,428,12,440
22,Picardie,02,1,07,221,Coupru,175,3,178
22,Picardie,02,2,14,222,Courbes,35,3,38
22,Picardie,02,1,10,223,Courboin,286,10,296
22,Picardie,02,4,04,224,Courcelles-sur-Vesle,332,5,337
22,Picardie,02,1,22,225,Courchamps,88,3,91
22,Picardie,02,4,41,226,Courmelles,1696,28,1724
22,Picardie,02,1,15,227,Courmont,111,8,119
22,Picardie,02,1,10,228,Courtemont-Varennes,298,35,333
22,Picardie,02,2,30,229,Courtrizy-et-Fussigny,72,2,74
22,Picardie,02,4,04,230,Couvrelles,189,8,197
22,Picardie,02,2,13,231,Couvron-et-Aumencourt,1404,22,1426
22,Picardie,02,4,36,232,Coyolles,352,24,376
22,Picardie,02,4,24,233,Cramaille,123,2,125
22,Picardie,02,2,12,234,Craonne,68,2,70
22,Picardie,02,2,12,235,Craonnelle,103,0,103
22,Picardie,02,2,11,236,Crécy-au-Mont,305,5,310
22,Picardie,02,2,13,237,Crécy-sur-Serre,1471,50,1521
22,Picardie,02,2,18,238,Crépy,1860,42,1902
22,Picardie,02,1,10,239,Crézancy,1116,95,1211
22,Picardie,02,3,03,240,Croix-Fonsommes,226,3,229
22,Picardie,02,1,22,241,La Croix-sur-Ourcq,107,2,109
22,Picardie,02,1,07,242,Crouttes-sur-Marne,646,22,668
22,Picardie,02,4,31,243,Crouy,2732,50,2782
22,Picardie,02,5,05,244,Crupilly,56,2,58
22,Picardie,02,4,31,245,Cuffies,1667,26,1693
22,Picardie,02,3,29,246,Cugny,557,9,566
22,Picardie,02,2,19,248,Cuirieux,164,4,168
22,Picardie,02,4,24,249,Cuiry-Housse,105,2,107
22,Picardie,02,2,12,250,Cuiry-lès-Chaudardes,84,0,84
22,Picardie,02,2,26,251,Cuiry-lès-Iviers,38,1,39
22,Picardie,02,2,12,252,Cuissy-et-Geny,69,2,71
22,Picardie,02,4,35,253,Cuisy-en-Almont,328,10,338
22,Picardie,02,4,35,254,Cutry,114,1,115
22,Picardie,02,4,04,255,Cys-la-Commune,145,1,146
22,Picardie,02,2,26,256,Dagny-Lambercy,128,6,134
22,Picardie,02,3,29,257,Dallon,376,12,388
22,Picardie,02,1,22,258,Dammard,419,6,425
22,Picardie,02,4,36,259,Dampleux,431,11,442
22,Picardie,02,2,14,260,Danizy,555,10,565
22,Picardie,02,2,13,261,Dercy,377,7,384
22,Picardie,02,2,14,262,Deuillet,210,1,211
22,Picardie,02,4,04,263,Dhuizel,106,0,106
22,Picardie,02,2,26,264,Dizy-le-Gros,783,10,793
22,Picardie,02,2,26,265,Dohis,79,2,81
22,Picardie,02,2,26,266,Dolignon,58,2,60
22,Picardie,02,4,35,267,Dommiers,293,9,302
22,Picardie,02,1,07,268,Domptin,645,19,664
22,Picardie,02,5,23,269,Dorengt,154,0,154
22,Picardie,02,3,33,270,Douchy,142,1,143
22,Picardie,02,1,15,271,Dravegny,144,6,150
22,Picardie,02,4,24,272,Droizy,78,2,80
22,Picardie,02,3,29,273,Dury,188,3,191
22,Picardie,02,2,30,274,Ébouleau,202,8,210
22,Picardie,02,5,17,275,Effry,353,5,358
22,Picardie,02,5,05,276,Englancourt,110,5,115
22,Picardie,02,4,35,277,Épagny,332,5,337
22,Picardie,02,5,17,278,Éparcy,47,3,50
22,Picardie,02,1,08,279,Épaux-Bézu,569,14,583
22,Picardie,02,1,08,280,Épieds,374,12,386
22,Picardie,02,1,07,281,L' Épine-aux-Bois,260,1,261
22,Picardie,02,2,38,282,Eppes,387,5,392
22,Picardie,02,2,19,283,Erlon,290,10,300
22,Picardie,02,5,05,284,Erloy,95,4,99
22,Picardie,02,5,23,286,Esquéhéries,850,13,863
22,Picardie,02,3,20,287,Essigny-le-Grand,1126,37,1163
22,Picardie,02,3,39,288,Essigny-le-Petit,358,9,367
22,Picardie,02,1,07,289,Essises,426,14,440
22,Picardie,02,1,08,290,Essômes-sur-Marne,2612,77,2689
22,Picardie,02,3,06,291,Estrées,407,7,414
22,Picardie,02,1,08,292,Étampes-sur-Marne,1206,29,1235
22,Picardie,02,3,03,293,Étaves-et-Bocquiaux,543,7,550
22,Picardie,02,2,38,294,Étouvelles,228,6,234
22,Picardie,02,5,05,295,Étréaupont,854,27,881
22,Picardie,02,3,33,296,Étreillers,1159,35,1194
22,Picardie,02,1,08,297,Étrépilly,85,2,87
22,Picardie,02,5,37,298,Étreux,1567,35,1602
22,Picardie,02,2,21,299,Évergnicourt,548,5,553
22,Picardie,02,2,01,301,Faucoucourt,318,6,324
22,Picardie,02,4,36,302,Faverolles,346,8,354
22,Picardie,02,3,33,303,Fayet,534,34,568
22,Picardie,02,2,14,304,La Fère,2987,114,3101
22,Picardie,02,1,15,305,Fère-en-Tardenois,3285,57,3342
22,Picardie,02,3,25,306,La Ferté-Chevresis,590,12,602
22,Picardie,02,1,22,307,La Ferté-Milon,2284,153,2437
22,Picardie,02,5,23,308,Fesmy-le-Sart,471,11,482
22,Picardie,02,2,38,309,Festieux,532,12,544
22,Picardie,02,3,39,310,Fieulaine,279,4,283
22,Picardie,02,4,32,311,Filain,133,0,133
22,Picardie,02,5,05,312,La Flamengrie,1031,29,1060
22,Picardie,02,5,16,313,Flavigny-le-Grand-et-Beaurain,452,8,460
22,Picardie,02,3,29,315,Flavy-le-Martel,1628,22,1650
22,Picardie,02,4,36,316,Fleury,135,5,140
22,Picardie,02,3,33,317,Fluquières,212,4,216
22,Picardie,02,2,11,318,Folembray,1538,23,1561
22,Picardie,02,3,39,319,Fonsommes,516,7,523
22,Picardie,02,3,29,320,Fontaine-lès-Clercs,291,14,305
22,Picardie,02,5,34,321,Fontaine-lès-Vervins,951,191,1142
22,Picardie,02,3,39,322,Fontaine-Notre-Dame,389,14,403
22,Picardie,02,3,03,323,Fontaine-Uterte,117,3,120
22,Picardie,02,5,05,324,Fontenelle,282,3,285
22,Picardie,02,1,10,325,Fontenelle-en-Brie,184,8,192
22,Picardie,02,4,35,326,Fontenoy,515,15,530
22,Picardie,02,3,33,327,Foreste,188,4,192
22,Picardie,02,1,08,328,Fossoy,588,26,614
22,Picardie,02,2,14,329,Fourdrain,407,11,418
22,Picardie,02,3,33,330,Francilly-Selency,461,14,475
22,Picardie,02,5,27,331,Franqueville,127,5,132
22,Picardie,02,2,11,333,Fresnes,145,0,145
22,Picardie,02,1,15,332,Fresnes-en-Tardenois,249,5,254
22,Picardie,02,3,03,334,Fresnoy-le-Grand,3045,40,3085
22,Picardie,02,2,14,335,Fressancourt,219,7,226
22,Picardie,02,2,09,336,Frières-Faillouël,926,18,944
22,Picardie,02,5,05,337,Froidestrées,207,3,210
22,Picardie,02,2,19,338,Froidmont-Cohartille,220,6,226
22,Picardie,02,1,22,339,Gandelu,678,8,686
22,Picardie,02,3,40,340,Gauchy,5593,110,5703
22,Picardie,02,5,34,341,Gercy,301,4,305
22,Picardie,02,5,05,342,Gergny,155,4,159
22,Picardie,02,3,33,343,Germaine,67,0,67
22,Picardie,02,2,21,344,Gernicourt,64,3,67
22,Picardie,02,3,20,345,Gibercourt,41,0,41
22,Picardie,02,2,30,346,Gizy,691,14,705
22,Picardie,02,1,08,347,Gland,474,10,484
22,Picardie,02,4,04,348,Glennes,214,4,218
22,Picardie,02,2,12,349,Goudelancourt-lès-Berrieux,69,3,72
22,Picardie,02,2,30,350,Goudelancourt-lès-Pierrepont,121,4,125
22,Picardie,02,1,15,351,Goussancourt,101,0,101
22,Picardie,02,3,06,352,Gouy,601,10,611
22,Picardie,02,4,24,665,Grand-Rozoy,286,10,296
22,Picardie,02,5,37,783,Grand-Verly,142,4,146
22,Picardie,02,2,19,353,Grandlup-et-Fay,320,8,328
22,Picardie,02,2,26,354,Grandrieux,88,4,92
22,Picardie,02,3,33,355,Gricourt,851,24,875
22,Picardie,02,1,22,356,Grisolles,198,2,200
22,Picardie,02,5,34,357,Gronard,73,3,76
22,Picardie,02,5,37,358,Grougis,369,11,380
22,Picardie,02,3,29,359,Grugies,956,21,977
22,Picardie,02,2,21,360,Guignicourt,2134,41,2175
22,Picardie,02,5,16,361,Guise,5365,143,5508
22,Picardie,02,2,09,362,Guivry,259,1,260
22,Picardie,02,2,11,363,Guny,437,6,443
22,Picardie,02,2,21,364,Guyencourt,234,14,248
22,Picardie,02,5,37,366,Hannapes,276,2,278
22,Picardie,02,3,29,367,Happencourt,159,3,162
22,Picardie,02,4,36,368,Haramont,605,8,613
22,Picardie,02,5,34,369,Harcigny,251,8,259
22,Picardie,02,3,06,370,Hargicourt,542,5,547
22,Picardie,02,3,40,371,Harly,1756,35,1791
22,Picardie,02,4,24,372,Hartennes-et-Taux,334,14,348
22,Picardie,02,5,34,373,Hary,223,4,227
22,Picardie,02,1,22,375,Hautevesnes,143,2,145
22,Picardie,02,5,16,376,Hauteville,174,6,180
22,Picardie,02,5,34,377,Haution,146,3,149
22,Picardie,02,5,17,378,La Hérie,159,4,163
22,Picardie,02,5,27,379,Le Hérie-la-Viéville,232,118,350
22,Picardie,02,3,20,380,Hinacourt,34,0,34
22,Picardie,02,5,17,381,Hirson,9393,323,9716
22,Picardie,02,3,33,382,Holnon,1374,37,1411
22,Picardie,02,3,40,383,Homblières,1417,18,1435
22,Picardie,02,5,34,384,Houry,64,0,64
22,Picardie,02,5,27,385,Housset,177,10,187
22,Picardie,02,5,16,386,Iron,222,4,226
22,Picardie,02,3,20,387,Itancourt,1129,21,1150
22,Picardie,02,5,02,388,Iviers,183,1,184
22,Picardie,02,1,10,389,Jaulgonne,653,20,673
22,Picardie,02,3,33,390,Jeancourt,233,1,234
22,Picardie,02,5,02,391,Jeantes,209,5,214
22,Picardie,02,3,06,392,Joncourt,326,7,333
22,Picardie,02,4,04,393,Jouaignes,168,2,170
22,Picardie,02,2,11,395,Jumencourt,155,8,163
22,Picardie,02,2,12,396,Jumigny,70,3,73
22,Picardie,02,3,29,397,Jussy,1244,21,1265
22,Picardie,02,4,31,398,Juvigny,282,2,284
22,Picardie,02,2,21,399,Juvincourt-et-Damary,465,3,468
22,Picardie,02,4,32,400,Laffaux,139,0,139
22,Picardie,02,5,34,401,Laigny,225,1,226
22,Picardie,02,3,33,402,Lanchy,54,1,55
22,Picardie,02,5,27,403,Landifay-et-Bertaignemont,299,6,305
22,Picardie,02,5,34,404,Landouzy-la-Cour,148,0,148
22,Picardie,02,5,02,405,Landouzy-la-Ville,511,15,526
22,Picardie,02,2,11,406,Landricourt,124,2,126
22,Picardie,02,2,01,407,Laniscourt,180,3,183
22,Picardie,02,2,97,408,Laon,26175,1055,27230
22,Picardie,02,2,30,409,Lappion,289,11,300
22,Picardie,02,4,36,410,Largny-sur-Automne,239,7,246
22,Picardie,02,1,22,411,Latilly,219,3,222
22,Picardie,02,4,24,412,Launoy,99,1,100
22,Picardie,02,2,01,413,Laval-en-Laonnois,251,9,260
22,Picardie,02,5,16,414,Lavaqueresse,212,5,217
22,Picardie,02,4,35,415,Laversine,138,0,138
22,Picardie,02,3,06,374,Lehaucourt,841,12,853
22,Picardie,02,5,27,416,Lemé,450,14,464
22,Picardie,02,3,06,417,Lempire,101,2,103
22,Picardie,02,5,05,418,Lerzy,205,0,205
22,Picardie,02,5,23,419,Leschelle,288,2,290
22,Picardie,02,3,39,420,Lesdins,811,16,827
22,Picardie,02,4,04,421,Lesges,84,4,88
22,Picardie,02,5,16,422,Lesquielles-Saint-Germain,864,23,887
22,Picardie,02,2,11,423,Leuilly-sous-Coucy,420,6,426
22,Picardie,02,4,31,424,Leury,105,3,108
22,Picardie,02,5,02,425,Leuze,156,1,157
22,Picardie,02,3,06,426,Levergies,599,13,612
22,Picardie,02,4,04,427,Lhuys,143,1,144
22,Picardie,02,1,22,428,Licy-Clignon,90,1,91
22,Picardie,02,2,12,429,Lierval,118,2,120
22,Picardie,02,2,30,430,Liesse-Notre-Dame,1232,114,1346
22,Picardie,02,2,42,431,Liez,445,4,449
22,Picardie,02,4,04,432,Limé,187,5,192
22,Picardie,02,2,26,433,Lislet,244,0,244
22,Picardie,02,2,01,434,Lizy,246,15,261
22,Picardie,02,5,02,435,Logny-lès-Aubenton,76,1,77
22,Picardie,02,4,36,438,Longpont,287,8,295
22,Picardie,02,4,04,439,Longueval-Barbonval,474,7,481
22,Picardie,02,2,21,440,Lor,142,6,148
22,Picardie,02,4,36,441,Louâtre,211,6,217
22,Picardie,02,1,15,442,Loupeigne,82,2,84
22,Picardie,02,1,07,443,Lucy-le-Bocage,175,2,177
22,Picardie,02,5,34,444,Lugny,130,4,134
22,Picardie,02,5,05,445,Luzoir,285,5,290
22,Picardie,02,3,20,446,Ly-Fontaine,108,0,108
22,Picardie,02,4,24,447,Maast-et-Violaine,161,3,164
22,Picardie,02,2,30,448,Mâchecourt,134,1,135
22,Picardie,02,1,22,449,Macogny,75,1,76
22,Picardie,02,5,16,450,Macquigny,388,5,393
22,Picardie,02,3,06,451,Magny-la-Fosse,129,5,134
22,Picardie,02,3,33,452,Maissemy,239,3,242
22,Picardie,02,2,21,453,Maizy,409,4,413
22,Picardie,02,2,21,454,La Malmaison,412,17,429
22,Picardie,02,5,16,455,Malzy,204,2,206
22,Picardie,02,2,11,456,Manicamp,310,13,323
22,Picardie,02,2,30,457,Marchais,362,4,366
22,Picardie,02,1,10,458,Marchais-en-Brie,266,4,270
22,Picardie,02,3,39,459,Marcy,162,8,170
22,Picardie,02,2,19,460,Marcy-sous-Marle,211,6,217
22,Picardie,02,2,09,461,Marest-Dampcourt,329,3,332
22,Picardie,02,1,15,462,Mareuil-en-Dôle,222,4,226
22,Picardie,02,5,27,463,Marfontaine,91,3,94
22,Picardie,02,4,32,464,Margival,323,8,331
22,Picardie,02,1,08,465,Marigny-en-Orxois,467,13,480
22,Picardie,02,1,22,467,Marizy-Saint-Mard,50,1,51
22,Picardie,02,1,22,466,Marizy-Sainte-Geneviève,127,0,127
22,Picardie,02,2,19,468,Marle,2379,57,2436
22,Picardie,02,5,16,469,Marly-Gomont,418,11,429
22,Picardie,02,5,02,470,Martigny,450,10,460
22,Picardie,02,2,12,471,Martigny-Courpierre,114,4,118
22,Picardie,02,2,30,472,Mauregny-en-Haye,418,10,428
22,Picardie,02,2,14,473,Mayot,174,1,175
22,Picardie,02,2,42,474,Mennessis,398,3,401
22,Picardie,02,2,21,475,Menneville,398,0,398
22,Picardie,02,5,37,476,Mennevret,667,7,674
22,Picardie,02,4,41,477,Mercin-et-Vaux,924,47,971
22,Picardie,02,2,01,478,Merlieux-et-Fouquerolles,260,12,272
22,Picardie,02,4,04,479,Merval,81,0,81
22,Picardie,02,2,13,480,Mesbrecourt-Richecourt,290,6,296
22,Picardie,02,3,40,481,Mesnil-Saint-Laurent,445,11,456
22,Picardie,02,2,21,482,Meurival,56,0,56
22,Picardie,02,3,20,483,Mézières-sur-Oise,532,4,536
22,Picardie,02,1,10,484,Mézy-Moulins,510,6,516
22,Picardie,02,4,41,485,Missy-aux-Bois,102,3,105
22,Picardie,02,2,30,486,Missy-lès-Pierrepont,101,0,101
22,Picardie,02,4,32,487,Missy-sur-Aisne,670,17,687
22,Picardie,02,5,37,488,Molain,149,2,151
22,Picardie,02,2,18,489,Molinchart,300,15,315
22,Picardie,02,2,01,490,Monampteuil,132,2,134
22,Picardie,02,5,27,491,Monceau-le-Neuf-et-Faucouzy,341,11,352
22,Picardie,02,2,19,493,Monceau-le-Waast,239,4,243
22,Picardie,02,2,14,492,Monceau-lès-Leups,472,6,478
22,Picardie,02,5,16,494,Monceau-sur-Oise,123,0,123
22,Picardie,02,5,17,495,Mondrepuis,1012,25,1037
22,Picardie,02,1,22,496,Monnes,101,1,102
22,Picardie,02,2,01,497,Mons-en-Laonnois,1113,28,1141
22,Picardie,02,3,25,503,Mont-d'Origny,883,8,891
22,Picardie,02,4,04,520,Mont-Notre-Dame,649,11,660
22,Picardie,02,5,02,522,Mont-Saint-Jean,69,1,70
22,Picardie,02,4,04,523,Mont-Saint-Martin,70,4,74
22,Picardie,02,1,08,524,Mont-Saint-Père,674,12,686
22,Picardie,02,2,30,498,Montaigu,699,11,710
22,Picardie,02,2,01,499,Montbavin,36,4,40
22,Picardie,02,3,03,500,Montbrehain,800,28,828
22,Picardie,02,2,38,501,Montchâlons,66,1,67
22,Picardie,02,2,26,502,Montcornet,1634,16,1650
22,Picardie,02,3,29,504,Montescourt-Lizerolles,1661,17,1678
22,Picardie,02,1,07,505,Montfaucon,167,5,172
22,Picardie,02,4,36,506,Montgobert,187,1,188
22,Picardie,02,4,24,507,Montgru-Saint-Hilaire,33,0,33
22,Picardie,02,2,12,508,Monthenault,113,1,114
22,Picardie,02,1,22,509,Monthiers,163,2,165
22,Picardie,02,1,10,510,Monthurel,157,4,161
22,Picardie,02,3,03,511,Montigny-en-Arrouaise,292,4,296
22,Picardie,02,1,22,512,Montigny-l'Allier,271,1,272
22,Picardie,02,2,19,513,Montigny-le-Franc,162,2,164
22,Picardie,02,4,35,514,Montigny-Lengrain,663,17,680
22,Picardie,02,1,10,515,Montigny-lès-Condé,67,0,67
22,Picardie,02,2,19,516,Montigny-sous-Marle,71,3,74
22,Picardie,02,2,13,517,Montigny-sur-Crécy,312,2,314
22,Picardie,02,1,10,518,Montlevon,252,8,260
22,Picardie,02,2,26,519,Montloué,162,3,165
22,Picardie,02,1,07,521,Montreuil-aux-Lions,1360,34,1394
22,Picardie,02,3,39,525,Morcourt,590,18,608
22,Picardie,02,2,26,526,Morgny-en-Thiérache,105,2,107
22,Picardie,02,4,35,527,Morsain,431,9,440
22,Picardie,02,4,35,528,Mortefontaine,243,10,253
22,Picardie,02,2,13,529,Mortiers,216,5,221
22,Picardie,02,2,12,530,Moulins,97,0,97
22,Picardie,02,2,12,531,Moussy-Verneuil,130,2,132
22,Picardie,02,3,20,532,Moÿ-de-l'Aisne,995,19,1014
22,Picardie,02,4,24,533,Muret-et-Crouttes,135,3,138
22,Picardie,02,2,21,534,Muscourt,42,0,42
22,Picardie,02,5,34,535,Nampcelles-la-Cour,136,1,137
22,Picardie,02,4,24,536,Nampteuil-sous-Muret,80,0,80
22,Picardie,02,4,32,537,Nanteuil-la-Fosse,139,3,142
22,Picardie,02,1,15,538,Nanteuil-Notre-Dame,70,1,71
22,Picardie,02,3,06,539,Nauroy,679,12,691
22,Picardie,02,1,08,540,Nesles-la-Montagne,1175,29,1204
22,Picardie,02,2,21,541,Neufchâtel-sur-Aisne,438,5,443
22,Picardie,02,2,09,542,Neuflieux,93,2,95
22,Picardie,02,1,22,543,Neuilly-Saint-Front,2171,32,2203
22,Picardie,02,5,17,544,Neuve-Maison,642,11,653
22,Picardie,02,2,19,545,La Neuville-Bosmont,181,3,184
22,Picardie,02,2,09,546,La Neuville-en-Beine,168,8,176
22,Picardie,02,5,27,547,La Neuville-Housset,64,2,66
22,Picardie,02,5,23,548,La Neuville-lès-Dorengt,376,2,378
22,Picardie,02,3,40,549,Neuville-Saint-Amand,858,11,869
22,Picardie,02,2,12,550,Neuville-sur-Ailette,86,4,90
22,Picardie,02,4,32,551,Neuville-sur-Margival,110,1,111
22,Picardie,02,3,25,552,Neuvillette,197,0,197
22,Picardie,02,2,30,553,Nizy-le-Comte,258,10,268
22,Picardie,02,1,07,555,Nogent-l'Artaud,2126,49,2175
22,Picardie,02,1,08,554,Nogentel,1052,22,1074
22,Picardie,02,2,26,556,Noircourt,92,4,96
22,Picardie,02,4,36,557,Noroy-sur-Ourcq,154,4,158
22,Picardie,02,5,23,558,Le Nouvion-en-Thiérache,2829,59,2888
22,Picardie,02,2,13,559,Nouvion-et-Catillon,534,14,548
22,Picardie,02,2,13,560,Nouvion-le-Comte,276,9,285
22,Picardie,02,2,38,561,Nouvion-le-Vineux,163,3,166
22,Picardie,02,4,35,562,Nouvron-Vingré,217,1,218
22,Picardie,02,5,16,563,Noyales,170,4,174
22,Picardie,02,4,41,564,Noyant-et-Aconin,468,20,488
22,Picardie,02,2,12,565,OEuilly,270,6,276
22,Picardie,02,2,09,566,Ognes,1143,30,1173
22,Picardie,02,5,17,567,Ohis,308,2,310
22,Picardie,02,4,36,568,Oigny-en-Valois,152,10,162
22,Picardie,02,5,37,569,Oisy,410,17,427
22,Picardie,02,3,29,570,Ollezy,156,0,156
22,Picardie,02,3,39,571,Omissy,814,116,930
22,Picardie,02,2,21,572,Orainville,474,3,477
22,Picardie,02,2,38,573,Orgeval,70,2,72
22,Picardie,02,5,17,574,Origny-en-Thiérache,1524,39,1563
22,Picardie,02,3,25,575,Origny-Sainte-Benoite,1718,21,1739
22,Picardie,02,4,35,576,Osly-Courtil,295,10,305
22,Picardie,02,4,32,577,Ostel,80,1,81
22,Picardie,02,2,12,578,Oulches-la-Vallée-Foulon,50,1,51
22,Picardie,02,4,24,579,Oulchy-la-Ville,128,4,132
22,Picardie,02,4,24,580,Oulchy-le-Château,848,12,860
22,Picardie,02,4,04,581,Paars,263,3,266
22,Picardie,02,2,12,582,Paissy,70,1,71
22,Picardie,02,2,12,583,Pancy-Courtecon,44,2,46
22,Picardie,02,5,05,584,Papleux,110,2,112
22,Picardie,02,4,24,585,Parcy-et-Tigny,247,6,253
22,Picardie,02,2,26,586,Parfondeval,162,4,166
22,Picardie,02,2,38,587,Parfondru,341,10,351
22,Picardie,02,2,12,588,Pargnan,62,0,62
22,Picardie,02,4,32,589,Pargny-Filain,231,6,237
22,Picardie,02,1,10,590,Pargny-la-Dhuys,164,5,169
22,Picardie,02,2,13,591,Pargny-les-Bois,135,7,142
22,Picardie,02,3,25,592,Parpeville,232,1,233
22,Picardie,02,4,31,593,Pasly,1019,39,1058
22,Picardie,02,1,22,594,Passy-en-Valois,156,1,157
22,Picardie,02,1,10,595,Passy-sur-Marne,153,3,156
22,Picardie,02,1,07,596,Pavant,779,12,791
22,Picardie,02,4,04,597,Perles,83,1,84
22,Picardie,02,4,35,598,Pernant,696,17,713
22,Picardie,02,5,37,784,Petit-Verly,201,3,204
22,Picardie,02,2,11,599,Pierremande,278,3,281
22,Picardie,02,2,19,600,Pierrepont,396,2,398
22,Picardie,02,2,21,601,Pignicourt,141,4,145
22,Picardie,02,2,01,602,Pinon,1755,28,1783
22,Picardie,02,3,29,604,Pithon,82,1,83
22,Picardie,02,3,25,605,Pleine-Selve,174,5,179
22,Picardie,02,4,24,606,Le Plessier-Huleu,78,3,81
22,Picardie,02,4,41,607,Ploisy,85,3,88
22,Picardie,02,5,34,608,Plomion,491,6,497
22,Picardie,02,2,38,609,Ployart-et-Vaurseine,19,0,19
22,Picardie,02,4,31,610,Pommiers,624,18,642
22,Picardie,02,4,32,612,Pont-Arcy,130,1,131
22,Picardie,02,2,11,616,Pont-Saint-Mard,173,4,177
22,Picardie,02,2,21,613,Pontavert,605,7,612
22,Picardie,02,3,33,614,Pontru,298,5,303
22,Picardie,02,3,33,615,Pontruet,345,19,364
22,Picardie,02,2,13,617,Pouilly-sur-Serre,536,46,582
22,Picardie,02,3,03,618,Prémont,736,13,749
22,Picardie,02,2,01,619,Prémontré,764,8,772
22,Picardie,02,4,04,620,Presles-et-Boves,361,9,370
22,Picardie,02,2,38,621,Presles-et-Thierny,361,15,376
22,Picardie,02,1,22,622,Priez,49,2,51
22,Picardie,02,5,34,623,Prisces,115,0,115
22,Picardie,02,5,16,624,Proisy,305,55,360
22,Picardie,02,5,16,625,Proix,145,0,145
22,Picardie,02,2,21,626,Prouvais,379,10,389
22,Picardie,02,2,21,627,Proviseux-et-Plesnoy,109,2,111
22,Picardie,02,4,36,628,Puiseux-en-Retz,224,3,227
22,Picardie,02,5,27,629,Puisieux-et-Clanlieu,299,10,309
22,Picardie,02,2,11,631,Quierzy,437,6,443
22,Picardie,02,2,11,632,Quincy-Basse,53,0,53
22,Picardie,02,4,04,633,Quincy-sous-le-Mont,68,0,68
22,Picardie,02,2,26,634,Raillimont,86,2,88
22,Picardie,02,3,03,635,Ramicourt,177,1,178
22,Picardie,02,3,25,636,Regny,212,3,215
22,Picardie,02,3,39,637,Remaucourt,330,14,344
22,Picardie,02,2,13,638,Remies,239,8,247
22,Picardie,02,3,20,639,Remigny,364,5,369
22,Picardie,02,3,25,640,Renansart,171,0,171
22,Picardie,02,2,26,641,Renneval,131,2,133
22,Picardie,02,2,26,642,Résigny,168,4,172
22,Picardie,02,4,35,643,Ressons-le-Long,762,36,798
22,Picardie,02,4,36,644,Retheuil,377,5,382
22,Picardie,02,1,10,645,Reuilly-Sauvigny,233,6,239
22,Picardie,02,4,04,646,Révillon,65,0,65
22,Picardie,02,5,37,647,Ribeauville,86,0,86
22,Picardie,02,3,25,648,Ribemont,2023,39,2062
22,Picardie,02,1,22,649,Rocourt-Saint-Martin,314,7,321
22,Picardie,02,5,05,650,Rocquigny,398,11,409
22,Picardie,02,2,14,651,Rogécourt,81,2,83
22,Picardie,02,5,34,652,Rogny,102,2,104
22,Picardie,02,1,07,653,Romeny-sur-Marne,487,3,490
22,Picardie,02,5,16,654,Romery,79,0,79
22,Picardie,02,1,15,655,Ronchères,121,5,126
22,Picardie,02,2,21,656,Roucy,404,10,414
22,Picardie,02,5,27,657,Rougeries,230,4,234
22,Picardie,02,3,33,658,Roupy,248,12,260
22,Picardie,02,3,39,659,Rouvroy,380,6,386
22,Picardie,02,2,26,660,Rouvroy-sur-Serre,44,2,46
22,Picardie,02,2,01,661,Royaucourt-et-Chailvet,190,1,191
22,Picardie,02,1,22,662,Rozet-Saint-Albin,300,9,309
22,Picardie,02,4,24,663,Rozières-sur-Crise,233,7,240
22,Picardie,02,1,10,664,Rozoy-Bellevalle,108,1,109
22,Picardie,02,2,26,666,Rozoy-sur-Serre,1034,14,1048
22,Picardie,02,4,35,667,Saconin-et-Breuil,226,13,239
22,Picardie,02,5,27,668,Sains-Richaumont,949,21,970
22,Picardie,02,1,10,669,Saint-Agnan,108,2,110
22,Picardie,02,5,34,670,Saint-Algis,157,7,164
22,Picardie,02,2,11,671,Saint-Aubin,316,5,321
22,Picardie,02,4,35,672,Saint-Bandry,223,4,227
22,Picardie,02,4,35,673,Saint-Christophe-à-Berry,422,3,425
22,Picardie,02,5,02,674,Saint-Clément,53,1,54
22,Picardie,02,2,30,676,Saint-Erme-Outre-et-Ramecourt,1809,38,1847
22,Picardie,02,1,10,677,Saint-Eugène,230,3,233
22,Picardie,02,1,22,679,Saint-Gengoulph,146,2,148
22,Picardie,02,2,14,680,Saint-Gobain,2348,51,2399
22,Picardie,02,5,27,681,Saint-Gobert,308,4,312
22,Picardie,02,4,04,682,Saint-Mard,123,2,125
22,Picardie,02,5,37,683,Saint-Martin-Rivière,122,0,122
22,Picardie,02,5,17,684,Saint-Michel,3522,61,3583
22,Picardie,02,2,14,685,Saint-Nicolas-aux-Bois,107,3,110
22,Picardie,02,2,11,686,Saint-Paul-aux-Bois,394,10,404
22,Picardie,02,4,35,687,Saint-Pierre-Aigle,361,14,375
22,Picardie,02,5,27,688,Saint-Pierre-lès-Franqueville,60,0,60
22,Picardie,02,2,19,689,Saint-Pierremont,58,1,59
22,Picardie,02,3,98,691,Saint-Quentin,56843,1634,58477
22,Picardie,02,4,24,693,Saint-Rémy-Blanzy,233,6,239
22,Picardie,02,3,29,694,Saint-Simon,632,6,638
22,Picardie,02,4,04,695,Saint-Thibaut,61,6,67
22,Picardie,02,2,12,696,Saint-Thomas,82,4,86
22,Picardie,02,2,12,675,Sainte-Croix,134,4,138
22,Picardie,02,2,26,678,Sainte-Geneviève,75,1,76
22,Picardie,02,2,30,690,Sainte-Preuve,87,2,89
22,Picardie,02,2,38,697,Samoussy,358,15,373
22,Picardie,02,4,32,698,Sancy-les-Cheminots,112,3,115
22,Picardie,02,1,15,699,Saponay,259,5,264
22,Picardie,02,1,07,701,Saulchery,669,14,683
22,Picardie,02,3,33,702,Savy,638,25,663
22,Picardie,02,3,03,703,Seboncourt,1064,12,1076
22,Picardie,02,2,11,704,Selens,243,2,245
22,Picardie,02,2,30,705,La Selve,205,2,207
22,Picardie,02,4,41,706,Septmonts,561,21,582
22,Picardie,02,2,11,707,Septvaux,203,4,207
22,Picardie,02,3,06,708,Sequehart,224,5,229
22,Picardie,02,3,03,709,Serain,379,4,383
22,Picardie,02,3,29,710,Seraucourt-le-Grand,785,10,795
22,Picardie,02,4,04,711,Serches,302,8,310
22,Picardie,02,1,15,712,Sergy,160,3,163
22,Picardie,02,1,15,713,Seringes-et-Nesles,290,10,300
22,Picardie,02,4,04,714,Sermoise,313,7,320
22,Picardie,02,2,14,716,Servais,264,1,265
22,Picardie,02,4,04,715,Serval,41,0,41
22,Picardie,02,3,25,717,Séry-lès-Mézières,644,16,660
22,Picardie,02,1,22,718,Silly-la-Poterie,141,2,143
22,Picardie,02,2,09,719,Sinceny,2153,35,2188
22,Picardie,02,2,30,720,Sissonne,2149,100,2249
22,Picardie,02,3,25,721,Sissy,493,12,505
22,Picardie,02,4,99,722,Soissons,28523,1144,29667
22,Picardie,02,2,26,723,Soize,100,4,104
22,Picardie,02,1,22,724,Sommelans,56,2,58
22,Picardie,02,5,05,725,Sommeron,135,6,141
22,Picardie,02,3,29,726,Sommette-Eaucourt,141,2,143
22,Picardie,02,2,19,727,Sons-et-Ronchères,231,1,232
22,Picardie,02,5,05,728,Sorbais,274,6,280
22,Picardie,02,4,36,729,Soucy,81,5,86
22,Picardie,02,4,32,730,Soupir,308,3,311
22,Picardie,02,5,27,731,Le Sourd,164,7,171
22,Picardie,02,3,25,732,Surfontaine,101,0,101
22,Picardie,02,2,01,733,Suzy,298,6,304
22,Picardie,02,4,36,734,Taillefontaine,274,4,278
22,Picardie,02,4,04,735,Tannières,13,0,13
22,Picardie,02,4,35,736,Tartiers,181,1,182
22,Picardie,02,2,19,737,Tavaux-et-Pontséricourt,577,10,587
22,Picardie,02,2,42,738,Tergnier,14458,169,14627
22,Picardie,02,4,32,739,Terny-Sorny,308,7,315
22,Picardie,02,5,34,740,Thenailles,257,6,263
22,Picardie,02,3,25,741,Thenelles,583,2,585
22,Picardie,02,2,19,742,Thiernu,117,7,124
22,Picardie,02,2,26,743,Le Thuel,168,4,172
22,Picardie,02,1,22,744,Torcy-en-Valois,81,1,82
22,Picardie,02,2,19,745,Toulis-et-Attencourt,129,2,131
22,Picardie,02,2,14,746,Travecy,613,12,625
22,Picardie,02,3,33,747,Trefcon,81,3,84
22,Picardie,02,1,10,748,Trélou-sur-Marne,958,21,979
22,Picardie,02,1,22,749,Troësnes,229,10,239
22,Picardie,02,2,11,750,Trosly-Loire,583,9,592
22,Picardie,02,2,12,751,Trucy,138,0,138
22,Picardie,02,3,29,752,Tugny-et-Pont,253,3,256
22,Picardie,02,5,37,753,Tupigny,361,5,366
22,Picardie,02,2,09,754,Ugny-le-Gay,154,2,156
22,Picardie,02,2,01,755,Urcel,569,8,577
22,Picardie,02,3,20,756,Urvillers,595,11,606
22,Picardie,02,5,16,757,Vadencourt,633,8,641
22,Picardie,02,4,32,758,Vailly-sur-Aisne,2087,40,2127
22,Picardie,02,5,34,759,La Vallée-au-Blé,291,4,295
22,Picardie,02,5,37,760,La Vallée-Mulâtre,140,2,142
22,Picardie,02,2,21,761,Variscourt,204,0,204
22,Picardie,02,2,11,762,Vassens,169,2,171
22,Picardie,02,4,04,763,Vasseny,204,1,205
22,Picardie,02,2,12,764,Vassogne,61,1,62
22,Picardie,02,2,01,765,Vaucelles-et-Beffecourt,215,6,221
22,Picardie,02,4,32,766,Vaudesson,268,6,274
22,Picardie,02,5,37,769,Vaux-Andigny,956,24,980
22,Picardie,02,3,33,772,Vaux-en-Vermandois,152,0,152
22,Picardie,02,2,01,768,Vauxaillon,453,5,458
22,Picardie,02,4,41,770,Vauxbuin,778,24,802
22,Picardie,02,4,04,771,Vauxcéré,111,0,111
22,Picardie,02,4,31,767,Vauxrezis,329,7,336
22,Picardie,02,4,04,773,Vauxtin,50,1,51
22,Picardie,02,3,33,774,Vendelles,113,2,115
22,Picardie,02,3,20,775,Vendeuil,908,22,930
22,Picardie,02,3,06,776,Vendhuile,511,10,521
22,Picardie,02,1,07,777,Vendières,144,3,147
22,Picardie,02,2,12,778,Vendresse-Beaulne,117,3,120
22,Picardie,02,5,37,779,Vénérolles,224,4,228
22,Picardie,02,4,31,780,Venizel,1377,29,1406
22,Picardie,02,1,08,781,Verdilly,432,20,452
22,Picardie,02,3,33,782,Le Verguier,230,5,235
22,Picardie,02,3,33,785,Vermand,1036,20,1056
22,Picardie,02,2,11,786,Verneuil-sous-Coucy,128,4,132
22,Picardie,02,2,13,787,Verneuil-sur-Serre,271,4,275
22,Picardie,02,2,14,788,Versigny,460,3,463
22,Picardie,02,5,34,789,Vervins,2690,159,2849
22,Picardie,02,2,19,790,Vesles-et-Caumont,216,6,222
22,Picardie,02,2,38,791,Veslud,257,5,262
22,Picardie,02,1,22,792,Veuilly-la-Poterie,136,3,139
22,Picardie,02,4,35,793,Vézaponin,122,2,124
22,Picardie,02,1,15,794,Vézilly,158,3,161
22,Picardie,02,4,35,795,Vic-sur-Aisne,1733,21,1754
22,Picardie,02,1,22,796,Vichel-Nanteuil,101,4,105
22,Picardie,02,4,04,797,Viel-Arcy,178,0,178
22,Picardie,02,1,07,798,Viels-Maisons,1016,15,1031
22,Picardie,02,4,24,799,Vierzy,425,13,438
22,Picardie,02,1,10,800,Viffort,312,4,316
22,Picardie,02,2,26,801,Vigneux-Hocquet,281,8,289
22,Picardie,02,2,26,802,La Ville-aux-Bois-lès-Dizy,191,0,191
22,Picardie,02,2,21,803,La Ville-aux-Bois-lès-Pontavert,117,3,120
22,Picardie,02,4,04,817,Ville-Savoye,57,1,58
22,Picardie,02,4,24,804,Villemontoire,213,2,215
22,Picardie,02,4,31,805,Villeneuve-Saint-Germain,2425,47,2472
22,Picardie,02,1,15,806,Villeneuve-sur-Fère,289,5,294
22,Picardie,02,2,09,807,Villequier-Aumont,607,19,626
22,Picardie,02,3,06,808,Villeret,314,2,316
22,Picardie,02,1,15,809,Villers-Agron-Aiguizy,97,3,100
22,Picardie,02,4,36,810,Villers-Cotterêts,10168,342,10510
22,Picardie,02,4,04,811,Villers-en-Prayères,118,3,121
22,Picardie,02,4,36,812,Villers-Hélon,216,0,216
22,Picardie,02,3,25,813,Villers-le-Sec,270,8,278
22,Picardie,02,5,16,814,Villers-lès-Guise,172,10,182
22,Picardie,02,3,29,815,Villers-Saint-Christophe,460,7,467
22,Picardie,02,1,15,816,Villers-sur-Fère,458,9,467
22,Picardie,02,1,07,818,Villiers-Saint-Denis,1055,20,1075
22,Picardie,02,2,26,819,Vincy-Reuil-et-Magny,124,1,125
22,Picardie,02,2,09,820,Viry-Noureuil,1879,46,1925
22,Picardie,02,2,18,821,Vivaise,775,22,797
22,Picardie,02,4,36,822,Vivières,386,12,398
22,Picardie,02,5,27,823,Voharies,72,3,75
22,Picardie,02,2,38,824,Vorges,379,16,395
22,Picardie,02,5,34,826,Voulpaix,396,12,408
22,Picardie,02,2,19,827,Voyenne,283,7,290
22,Picardie,02,4,32,828,Vregny,93,1,94
22,Picardie,02,4,32,829,Vuillery,32,0,32
22,Picardie,02,5,37,830,Wassigny,986,15,1001
22,Picardie,02,5,17,831,Watigny,368,18,386
22,Picardie,02,5,27,832,Wiège-Faty,228,4,232
22,Picardie,02,5,17,833,Wimy,502,8,510
22,Picardie,02,2,01,834,Wissignicourt,145,2,147
83,Auvergne,03,3,35,001,Abrest,2659,73,2732
83,Auvergne,03,2,27,002,Agonges,363,16,379
83,Auvergne,03,1,02,003,Ainay-le-Château,1092,18,1110
83,Auvergne,03,3,15,004,Andelaroche,286,9,295
83,Auvergne,03,1,13,005,Archignat,349,6,355
83,Auvergne,03,3,15,006,Arfeuilles,685,9,694
83,Auvergne,03,1,17,007,Arpheuilles-Saint-Priest,330,12,342
83,Auvergne,03,3,18,008,Arronnes,354,9,363
83,Auvergne,03,2,24,009,Aubigny,122,53,175
83,Auvergne,03,1,12,010,Audes,463,4,467
83,Auvergne,03,2,33,011,Aurouër,375,13,388
83,Auvergne,03,2,27,012,Autry-Issards,332,14,346
83,Auvergne,03,2,24,013,Avermes,3814,153,3967
83,Auvergne,03,3,08,014,Avrilly,160,7,167
83,Auvergne,03,2,24,015,Bagneux,288,9,297
83,Auvergne,03,2,03,016,Barberier,126,3,129
83,Auvergne,03,3,15,017,Barrais-Bussolles,214,12,226
83,Auvergne,03,2,26,018,Bayet,668,13,681
83,Auvergne,03,2,04,019,Beaulon,1612,24,1636
83,Auvergne,03,1,22,020,Beaune-d'Allier,290,11,301
83,Auvergne,03,3,11,021,Bègues,230,5,235
83,Auvergne,03,1,09,022,Bellenaves,1032,22,1054
83,Auvergne,03,3,10,023,Bellerive-sur-Allier,8579,375,8954
83,Auvergne,03,3,14,024,Bert,272,3,275
83,Auvergne,03,2,25,025,Bessay-sur-Allier,1417,21,1438
83,Auvergne,03,2,27,026,Besson,797,28,825
83,Auvergne,03,1,22,027,Bézenet,962,29,991
83,Auvergne,03,3,15,028,Billezois,377,8,385
83,Auvergne,03,3,28,029,Billy,840,19,859
83,Auvergne,03,3,11,030,Biozat,723,19,742
83,Auvergne,03,1,12,031,Bizeneuille,292,8,300
83,Auvergne,03,1,22,032,Blomard,204,6,210
83,Auvergne,03,3,06,033,Bost,179,2,181
83,Auvergne,03,3,28,034,Boucé,556,12,568
83,Auvergne,03,3,08,035,Le Bouchaud,213,7,220
83,Auvergne,03,2,01,036,Bourbon-l'Archambault,2593,51,2644
83,Auvergne,03,1,02,037,Braize,286,3,289
83,Auvergne,03,2,26,038,Bransat,513,12,525
83,Auvergne,03,2,27,039,Bresnay,394,8,402
83,Auvergne,03,2,23,040,Bressolles,1042,43,1085
83,Auvergne,03,1,12,041,Le Brethon,337,3,340
83,Auvergne,03,3,15,042,Le Breuil,545,9,554
83,Auvergne,03,3,10,043,Broût-Vernet,1175,69,1244
83,Auvergne,03,3,10,044,Brugheas,1311,68,1379
83,Auvergne,03,3,35,045,Busset,849,22,871
83,Auvergne,03,2,01,046,Buxières-les-Mines,1078,28,1106
83,Auvergne,03,1,17,047,La Celle,413,4,417
83,Auvergne,03,1,02,048,Cérilly,1379,32,1411
83,Auvergne,03,2,26,049,Cesset,370,8,378
83,Auvergne,03,3,18,050,La Chabanne,186,5,191
83,Auvergne,03,1,13,051,Chambérat,312,12,324
83,Auvergne,03,1,20,052,Chamblet,1066,25,1091
83,Auvergne,03,2,03,053,Chantelle,1062,31,1093
83,Auvergne,03,2,25,054,Chapeau,223,3,226
83,Auvergne,03,1,13,055,La Chapelaude,974,17,991
83,Auvergne,03,3,35,056,La Chapelle,381,11,392
83,Auvergne,03,2,04,057,La Chapelle-aux-Chasses,228,2,230
83,Auvergne,03,1,22,058,Chappes,203,6,209
83,Auvergne,03,2,03,059,Chareil-Cintrat,334,8,342
83,Auvergne,03,3,10,060,Charmeil,723,28,751
83,Auvergne,03,3,11,061,Charmes,340,4,344
83,Auvergne,03,2,03,062,Charroux,384,13,397
83,Auvergne,03,3,08,063,Chassenard,935,26,961
83,Auvergne,03,2,16,064,Château-sur-Allier,165,4,169
83,Auvergne,03,2,19,065,Châtel-de-Neuvre,532,12,544
83,Auvergne,03,3,18,066,Châtel-Montagne,419,5,424
83,Auvergne,03,3,14,067,Châtelperron,144,5,149
83,Auvergne,03,3,15,068,Châtelus,135,3,138
83,Auvergne,03,2,19,069,Châtillon,317,3,320
83,Auvergne,03,1,22,070,Chavenon,145,8,153
83,Auvergne,03,3,14,071,Chavroches,283,2,285
83,Auvergne,03,1,13,072,Chazemais,449,4,453
83,Auvergne,03,2,27,073,Chemilly,637,20,657
83,Auvergne,03,2,04,074,Chevagnes,696,19,715
83,Auvergne,03,2,03,075,Chezelle,162,3,165
83,Auvergne,03,2,04,076,Chézy,210,4,214
83,Auvergne,03,1,09,077,Chirat-l'Église,136,1,137
83,Auvergne,03,1,09,078,Chouvigny,239,8,247
83,Auvergne,03,3,14,079,Cindré,313,9,322
83,Auvergne,03,3,10,080,Cognat-Lyonne,636,13,649
83,Auvergne,03,1,05,081,Colombier,311,8,319
83,Auvergne,03,1,05,082,Commentry,6795,216,7011
83,Auvergne,03,2,26,083,Contigny,602,27,629
83,Auvergne,03,1,12,084,Cosne-d'Allier,2196,46,2242
83,Auvergne,03,2,24,085,Coulandon,689,84,773
83,Auvergne,03,2,07,086,Coulanges,312,6,318
83,Auvergne,03,2,16,087,Couleuvre,582,13,595
83,Auvergne,03,1,13,088,Courçais,294,3,297
83,Auvergne,03,1,09,089,Coutansouze,130,1,131
83,Auvergne,03,2,16,090,Couzon,300,11,311
83,Auvergne,03,3,28,091,Créchy,473,8,481
83,Auvergne,03,2,19,092,Cressanges,659,16,675
83,Auvergne,03,3,06,093,Creuzier-le-Neuf,1007,26,1033
83,Auvergne,03,3,06,094,Creuzier-le-Vieux,3202,132,3334
83,Auvergne,03,3,96,095,Cusset,13286,529,13815
83,Auvergne,03,2,03,096,Deneuille-lès-Chantelle,99,2,101
83,Auvergne,03,1,20,097,Deneuille-les-Mines,339,2,341
83,Auvergne,03,1,20,098,Désertines,4441,87,4528
83,Auvergne,03,2,19,099,Deux-Chaises,416,9,425
83,Auvergne,03,2,07,100,Diou,1510,29,1539
83,Auvergne,03,1,34,101,Domérat,9004,186,9190
83,Auvergne,03,2,07,102,Dompierre-sur-Besbre,3216,91,3307
83,Auvergne,03,3,08,103,Le Donjon,1067,18,1085
83,Auvergne,03,1,22,104,Doyet,1234,32,1266
83,Auvergne,03,3,15,105,Droiturier,348,10,358
83,Auvergne,03,1,17,106,Durdat-Larequille,1252,99,1351
83,Auvergne,03,1,09,107,Ébreuil,1270,23,1293
83,Auvergne,03,1,09,108,Échassières,394,4,398
83,Auvergne,03,3,10,109,Escurolles,721,16,737
83,Auvergne,03,3,10,110,Espinasse-Vozelle,850,17,867
83,Auvergne,03,1,12,111,Estivareilles,1046,36,1082
83,Auvergne,03,2,03,112,Étroussat,701,14,715
83,Auvergne,03,3,18,113,Ferrières-sur-Sichon,554,12,566
83,Auvergne,03,2,25,114,La Ferté-Hauterive,278,7,285
83,Auvergne,03,2,03,115,Fleuriel,358,10,368
83,Auvergne,03,2,03,116,Fourilles,207,5,212
83,Auvergne,03,2,01,117,Franchesse,453,10,463
83,Auvergne,03,3,11,118,Gannat,5868,208,6076
83,Auvergne,03,2,04,119,Gannay-sur-Loire,416,5,421
83,Auvergne,03,2,04,120,Garnat-sur-Engièvre,727,17,744
83,Auvergne,03,2,33,121,Gennetines,589,12,601
83,Auvergne,03,2,27,122,Gipcy,218,7,225
83,Auvergne,03,1,12,123,Givarlais,237,9,246
83,Auvergne,03,2,25,124,Gouise,224,10,234
83,Auvergne,03,3,18,125,La Guillermie,151,3,154
83,Auvergne,03,3,10,126,Hauterive,1076,30,1106
83,Auvergne,03,1,12,127,Hérisson,676,15,691
83,Auvergne,03,1,13,128,Huriel,2471,56,2527
83,Auvergne,03,1,05,129,Hyds,308,10,318
83,Auvergne,03,1,02,130,Isle-et-Bardais,280,7,287
83,Auvergne,03,3,15,131,Isserpent,494,26,520
83,Auvergne,03,3,14,132,Jaligny-sur-Besbre,641,21,662
83,Auvergne,03,3,11,133,Jenzat,508,22,530
83,Auvergne,03,2,26,134,Laféline,193,12,205
83,Auvergne,03,1,09,135,Lalizolle,375,9,384
83,Auvergne,03,1,21,136,Lamaids,141,3,144
83,Auvergne,03,3,28,137,Langy,237,3,240
83,Auvergne,03,3,15,138,Lapalisse,3175,139,3314
83,Auvergne,03,3,18,139,Laprugne,360,7,367
83,Auvergne,03,1,32,140,Lavault-Sainte-Anne,1188,54,1242
83,Auvergne,03,3,18,141,Lavoine,151,4,155
83,Auvergne,03,3,08,142,Lenax,243,5,248
83,Auvergne,03,1,02,143,Lételon,128,3,131
83,Auvergne,03,3,14,144,Liernolles,258,4,262
83,Auvergne,03,1,32,145,Lignerolles,625,17,642
83,Auvergne,03,2,16,146,Limoise,169,85,254
83,Auvergne,03,3,08,147,Loddes,153,3,156
83,Auvergne,03,2,26,148,Loriges,311,5,316
83,Auvergne,03,2,26,149,Louchy-Montfand,453,15,468
83,Auvergne,03,1,12,150,Louroux-Bourbonnais,223,8,231
83,Auvergne,03,1,22,151,Louroux-de-Beaune,183,5,188
83,Auvergne,03,1,09,152,Louroux-de-Bouble,293,2,295
83,Auvergne,03,1,12,153,Louroux-Hodement,351,2,353
83,Auvergne,03,3,08,154,Luneau,284,7,291
83,Auvergne,03,2,16,155,Lurcy-Lévis,2139,28,2167
83,Auvergne,03,2,04,156,Lusigny,1581,42,1623
83,Auvergne,03,3,28,157,Magnet,794,14,808
83,Auvergne,03,1,12,158,Maillet,368,2,370
83,Auvergne,03,1,05,159,Malicorne,848,19,867
83,Auvergne,03,2,26,160,Marcenat,362,13,375
83,Auvergne,03,1,17,161,Marcillat-en-Combraille,907,28,935
83,Auvergne,03,2,27,162,Marigny,188,7,195
83,Auvergne,03,3,35,163,Mariol,769,9,778
83,Auvergne,03,3,11,164,Le Mayet-d'École,271,6,277
83,Auvergne,03,3,18,165,Le Mayet-de-Montagne,1537,148,1685
83,Auvergne,03,3,11,166,Mazerier,278,7,285
83,Auvergne,03,1,17,167,Mazirat,289,5,294
83,Auvergne,03,1,02,168,Meaulne,775,17,792
83,Auvergne,03,2,19,169,Meillard,244,8,252
83,Auvergne,03,2,27,170,Meillers,157,12,169
83,Auvergne,03,2,25,171,Mercy,282,8,290
83,Auvergne,03,1,13,172,Mesples,133,2,135
83,Auvergne,03,2,07,173,Molinet,1176,21,1197
83,Auvergne,03,3,35,174,Molles,802,28,830
83,Auvergne,03,2,03,175,Monestier,268,4,272
83,Auvergne,03,2,26,176,Monétay-sur-Allier,548,17,565
83,Auvergne,03,2,07,177,Monétay-sur-Loire,293,8,301
83,Auvergne,03,3,28,179,Montaigu-le-Blin,306,11,317
83,Auvergne,03,3,08,178,Montaiguët-en-Forez,312,6,318
83,Auvergne,03,2,25,180,Montbeugny,639,10,649
83,Auvergne,03,3,08,181,Montcombroux-les-Mines,416,14,430
83,Auvergne,03,3,11,182,Monteignet-sur-l'Andelot,233,3,236
83,Auvergne,03,2,19,183,Le Montet,511,9,520
83,Auvergne,03,2,24,184,Montilly,547,15,562
83,Auvergne,03,1,98,185,Montluçon,39492,1336,40828
83,Auvergne,03,1,22,186,Montmarault,1571,26,1597
83,Auvergne,03,3,28,187,Montoldre,643,18,661
83,Auvergne,03,2,26,188,Montord,250,5,255
83,Auvergne,03,1,22,189,Montvicq,736,8,744
83,Auvergne,03,2,99,190,Moulins,19760,710,20470
83,Auvergne,03,1,22,191,Murat,280,3,283
83,Auvergne,03,1,09,192,Nades,123,2,125
83,Auvergne,03,1,12,193,Nassigny,186,1,187
83,Auvergne,03,1,09,194,Naves,116,2,118
83,Auvergne,03,1,32,195,Néris-les-Bains,2704,122,2826
83,Auvergne,03,3,08,196,Neuilly-en-Donjon,235,10,245
83,Auvergne,03,2,25,197,Neuilly-le-Réal,1362,36,1398
83,Auvergne,03,2,16,198,Neure,174,2,176
83,Auvergne,03,2,24,200,Neuvy,1578,200,1778
83,Auvergne,03,3,18,201,Nizerolles,330,8,338
83,Auvergne,03,2,27,202,Noyant-d'Allier,702,17,719
83,Auvergne,03,2,04,203,Paray-le-Frésil,430,6,436
83,Auvergne,03,2,26,204,Paray-sous-Briailles,623,19,642
83,Auvergne,03,3,15,205,Périgny,442,6,448
83,Auvergne,03,1,17,206,La Petite-Marche,186,9,195
83,Auvergne,03,2,07,207,Pierrefitte-sur-Loire,517,6,523
83,Auvergne,03,3,08,208,Le Pin,381,4,385
83,Auvergne,03,3,11,209,Poëzat,118,1,119
83,Auvergne,03,2,16,210,Pouzy-Mésangy,422,15,437
83,Auvergne,03,1,21,211,Prémilhat,2241,62,2303
83,Auvergne,03,1,21,212,Quinssaines,1245,30,1275
83,Auvergne,03,1,12,213,Reugny,263,3,266
83,Auvergne,03,2,19,214,Rocles,350,5,355
83,Auvergne,03,3,28,215,Rongères,551,13,564
83,Auvergne,03,1,17,216,Ronnet,190,6,196
83,Auvergne,03,1,20,217,Saint-Angel,736,45,781
83,Auvergne,03,2,01,218,Saint-Aubin-le-Monial,289,10,299
83,Auvergne,03,1,22,219,Saint-Bonnet-de-Four,200,8,208
83,Auvergne,03,3,11,220,Saint-Bonnet-de-Rochefort,647,10,657
83,Auvergne,03,1,02,221,Saint-Bonnet-Tronçais,755,11,766
83,Auvergne,03,1,12,222,Saint-Caprais,95,2,97
83,Auvergne,03,3,15,223,Saint-Christophe,472,6,478
83,Auvergne,03,3,18,224,Saint-Clément,355,7,362
83,Auvergne,03,1,13,225,Saint-Désiré,470,14,484
83,Auvergne,03,3,08,226,Saint-Didier-en-Donjon,268,9,277
83,Auvergne,03,3,10,227,Saint-Didier-la-Forêt,379,15,394
83,Auvergne,03,1,13,228,Saint-Éloy-d'Allier,62,0,62
83,Auvergne,03,2,33,229,Saint-Ennemond,655,10,665
83,Auvergne,03,3,15,230,Saint-Étienne-de-Vicq,495,14,509
83,Auvergne,03,1,17,231,Saint-Fargeol,214,4,218
83,Auvergne,03,3,28,232,Saint-Félix,334,5,339
83,Auvergne,03,1,17,233,Saint-Genest,357,12,369
83,Auvergne,03,2,25,234,Saint-Gérand-de-Vaux,436,8,444
83,Auvergne,03,3,28,235,Saint-Gérand-le-Puy,993,18,1011
83,Auvergne,03,2,03,237,Saint-Germain-de-Salles,437,5,442
83,Auvergne,03,3,28,236,Saint-Germain-des-Fossés,3667,71,3738
83,Auvergne,03,2,01,238,Saint-Hilaire,524,6,530
83,Auvergne,03,3,08,239,Saint-Léger-sur-Vouzance,290,7,297
83,Auvergne,03,3,14,240,Saint-Léon,601,17,618
83,Auvergne,03,2,16,241,Saint-Léopardin-d'Augy,361,29,390
83,Auvergne,03,3,28,242,Saint-Loup,595,7,602
83,Auvergne,03,1,17,244,Saint-Marcel-en-Marcillat,145,5,150
83,Auvergne,03,1,22,243,Saint-Marcel-en-Murat,132,8,140
83,Auvergne,03,2,04,245,Saint-Martin-des-Lais,141,4,145
83,Auvergne,03,1,13,246,Saint-Martinien,618,14,632
83,Auvergne,03,2,27,247,Saint-Menoux,979,29,1008
83,Auvergne,03,3,18,248,Saint-Nicolas-des-Biefs,181,2,183
83,Auvergne,03,1,13,249,Saint-Palais,191,1,192
83,Auvergne,03,3,15,250,Saint-Pierre-Laval,367,8,375
83,Auvergne,03,2,01,251,Saint-Plaisir,408,16,424
83,Auvergne,03,3,10,252,Saint-Pont,550,7,557
83,Auvergne,03,2,07,253,Saint-Pourçain-sur-Besbre,417,5,422
83,Auvergne,03,2,26,254,Saint-Pourçain-sur-Sioule,5065,158,5223
83,Auvergne,03,3,11,255,Saint-Priest-d'Andelot,134,4,138
83,Auvergne,03,1,22,256,Saint-Priest-en-Murat,243,12,255
83,Auvergne,03,3,15,257,Saint-Prix,811,12,823
83,Auvergne,03,3,10,258,Saint-Rémy-en-Rollat,1601,54,1655
83,Auvergne,03,1,13,259,Saint-Sauvier,339,5,344
83,Auvergne,03,2,19,260,Saint-Sornin,220,3,223
83,Auvergne,03,1,31,262,Saint-Victor,2014,52,2066
83,Auvergne,03,2,25,263,Saint-Voir,197,6,203
83,Auvergne,03,3,35,264,Saint-Yorre,2745,70,2815
83,Auvergne,03,1,17,261,Sainte-Thérence,203,4,207
83,Auvergne,03,2,07,265,Saligny-sur-Roudon,813,91,904
83,Auvergne,03,3,28,266,Sanssat,272,35,307
83,Auvergne,03,2,26,267,Saulcet,652,24,676
83,Auvergne,03,3,11,268,Saulzet,336,8,344
83,Auvergne,03,1,12,269,Sauvagny,93,4,97
83,Auvergne,03,1,22,270,Sazeret,155,5,160
83,Auvergne,03,3,10,271,Serbannes,723,24,747
83,Auvergne,03,3,15,272,Servilly,265,4,269
83,Auvergne,03,3,28,273,Seuillet,478,12,490
83,Auvergne,03,3,14,274,Sorbier,290,6,296
83,Auvergne,03,2,27,275,Souvigny,1943,70,2013
83,Auvergne,03,1,09,276,Sussat,103,1,104
83,Auvergne,03,2,03,277,Target,260,12,272
83,Auvergne,03,2,03,278,Taxat-Senat,227,5,232
83,Auvergne,03,1,32,279,Teillet-Argenty,517,10,527
83,Auvergne,03,1,17,280,Terjat,218,4,222
83,Auvergne,03,2,19,281,Le Theil,408,15,423
83,Auvergne,03,1,02,282,Theneuille,396,15,411
83,Auvergne,03,2,04,283,Thiel-sur-Acolin,973,21,994
83,Auvergne,03,3,14,284,Thionne,317,8,325
83,Auvergne,03,1,12,285,Tortezais,172,6,178
83,Auvergne,03,2,23,286,Toulon-sur-Allier,1112,24,1136
83,Auvergne,03,2,19,287,Treban,396,6,402
83,Auvergne,03,1,13,288,Treignat,452,18,470
83,Auvergne,03,3,14,289,Treteau,551,4,555
83,Auvergne,03,2,33,290,Trévol,1599,75,1674
83,Auvergne,03,3,14,291,Trézelles,382,10,392
83,Auvergne,03,2,19,292,Tronget,933,26,959
83,Auvergne,03,1,02,293,Urçay,287,10,297
83,Auvergne,03,2,03,294,Ussel-d'Allier,150,5,155
83,Auvergne,03,1,09,295,Valignat,70,1,71
83,Auvergne,03,1,02,296,Valigny,397,4,401
83,Auvergne,03,1,12,297,Vallon-en-Sully,1711,31,1742
83,Auvergne,03,3,28,298,Varennes-sur-Allier,3750,82,3832
83,Auvergne,03,3,14,299,Varennes-sur-Tèche,253,3,256
83,Auvergne,03,2,07,300,Vaumas,544,15,559
83,Auvergne,03,1,31,301,Vaux,1011,26,1037
83,Auvergne,03,1,09,302,Veauce,41,0,41
83,Auvergne,03,1,12,303,Venas,233,5,238
83,Auvergne,03,3,10,304,Vendat,2192,50,2242
83,Auvergne,03,1,20,305,Verneix,570,8,578
83,Auvergne,03,3,35,306,Le Vernet,1808,64,1872
83,Auvergne,03,2,26,307,Verneuil-en-Bourbonnais,245,6,251
83,Auvergne,03,1,22,308,Vernusse,161,5,166
83,Auvergne,03,2,16,309,Le Veurdre,544,43,587
83,Auvergne,03,3,97,310,Vichy,25221,470,25691
83,Auvergne,03,1,09,311,Vicq,324,6,330
83,Auvergne,03,2,01,312,Vieure,256,6,262
83,Auvergne,03,1,02,313,Le Vilhain,268,7,275
83,Auvergne,03,1,17,314,Villebret,1258,25,1283
83,Auvergne,03,1,22,315,Villefranche-d'Allier,1325,58,1383
83,Auvergne,03,2,33,316,Villeneuve-sur-Allier,966,32,998
83,Auvergne,03,1,13,317,Viplaix,280,7,287
83,Auvergne,03,1,02,318,Vitray,122,2,124
83,Auvergne,03,2,03,319,Voussac,465,10,475
83,Auvergne,03,2,01,320,Ygrande,759,24,783
83,Auvergne,03,2,33,321,Yzeure,12515,518,13033
93,Provence-Alpes-Côte d'Azur,04,3,31,001,Aiglun,1212,57,1269
93,Provence-Alpes-Côte d'Azur,04,3,21,004,Allemagne-en-Provence,497,15,512
93,Provence-Alpes-Côte d'Azur,04,2,22,005,Allons,131,1,132
93,Provence-Alpes-Côte d'Azur,04,2,07,006,Allos,695,20,715
93,Provence-Alpes-Côte d'Azur,04,2,22,007,Angles,72,2,74
93,Provence-Alpes-Côte d'Azur,04,2,02,008,Annot,1028,35,1063
93,Provence-Alpes-Côte d'Azur,04,3,11,009,Archail,11,0,11
93,Provence-Alpes-Côte d'Azur,04,4,20,012,Aubenas-les-Alpes,108,1,109
93,Provence-Alpes-Côte d'Azur,04,4,30,013,Aubignosc,552,14,566
93,Provence-Alpes-Côte d'Azur,04,4,27,016,Authon,40,1,41
93,Provence-Alpes-Côte d'Azur,04,3,26,017,Auzet,81,3,84
93,Provence-Alpes-Côte d'Azur,04,4,03,018,Banon,1074,30,1104
93,Provence-Alpes-Côte d'Azur,04,1,04,019,Barcelonnette,2735,176,2911
93,Provence-Alpes-Côte d'Azur,04,3,26,020,Barles,152,4,156
93,Provence-Alpes-Côte d'Azur,04,3,31,021,Barras,156,4,160
93,Provence-Alpes-Côte d'Azur,04,3,05,022,Barrême,481,5,486
93,Provence-Alpes-Côte d'Azur,04,4,28,023,Bayons,253,8,261
93,Provence-Alpes-Côte d'Azur,04,3,11,024,Beaujeu,153,2,155
93,Provence-Alpes-Côte d'Azur,04,2,07,025,Beauvezer,346,5,351
93,Provence-Alpes-Côte d'Azur,04,4,28,026,Bellaffaire,135,3,138
93,Provence-Alpes-Côte d'Azur,04,4,18,027,Bevons,164,49,213
93,Provence-Alpes-Côte d'Azur,04,3,15,028,Beynes,121,1,122
93,Provence-Alpes-Côte d'Azur,04,3,05,030,Blieux,57,1,58
93,Provence-Alpes-Côte d'Azur,04,3,15,031,Bras-d'Asse,498,4,502
93,Provence-Alpes-Côte d'Azur,04,2,02,032,Braux,131,2,133
93,Provence-Alpes-Côte d'Azur,04,1,12,033,La Bréole,346,5,351
93,Provence-Alpes-Côte d'Azur,04,4,19,034,La Brillanne,894,19,913
93,Provence-Alpes-Côte d'Azur,04,3,29,035,Brunet,258,2,260
93,Provence-Alpes-Côte d'Azur,04,3,11,036,Le Brusquet,976,38,1014
93,Provence-Alpes-Côte d'Azur,04,4,16,037,Le Caire,68,2,70
93,Provence-Alpes-Côte d'Azur,04,2,06,039,Castellane,1579,59,1638
93,Provence-Alpes-Côte d'Azur,04,3,31,040,Le Castellard-Mélan,55,4,59
93,Provence-Alpes-Côte d'Azur,04,3,14,041,Le Castellet,257,7,264
93,Provence-Alpes-Côte d'Azur,04,2,09,042,Castellet-lès-Sausses,113,3,116
93,Provence-Alpes-Côte d'Azur,04,4,20,045,Céreste,1208,17,1225
93,Provence-Alpes-Côte d'Azur,04,3,31,046,Le Chaffaut-Saint-Jurson,721,105,826
93,Provence-Alpes-Côte d'Azur,04,3,31,047,Champtercier,799,22,821
93,Provence-Alpes-Côte d'Azur,04,4,30,049,Château-Arnoux-Saint-Auban,5270,129,5399
93,Provence-Alpes-Côte d'Azur,04,4,16,050,Châteaufort,25,1,26
93,Provence-Alpes-Côte d'Azur,04,4,18,051,Châteauneuf-Miravail,75,0,75
93,Provence-Alpes-Côte d'Azur,04,4,30,053,Châteauneuf-Val-Saint-Donat,516,10,526
93,Provence-Alpes-Côte d'Azur,04,3,15,054,Châteauredon,97,0,97
93,Provence-Alpes-Côte d'Azur,04,3,05,055,Chaudon-Norante,144,2,146
93,Provence-Alpes-Côte d'Azur,04,4,16,057,Clamensane,160,6,166
93,Provence-Alpes-Côte d'Azur,04,4,16,058,Claret,218,9,227
93,Provence-Alpes-Côte d'Azur,04,3,05,059,Clumanc,169,2,171
93,Provence-Alpes-Côte d'Azur,04,2,07,061,Colmars,384,8,392
93,Provence-Alpes-Côte d'Azur,04,1,04,062,La Condamine-Châtelard,147,7,154
93,Provence-Alpes-Côte d'Azur,04,4,32,063,Corbières,957,16,973
93,Provence-Alpes-Côte d'Azur,04,4,23,065,Cruis,590,6,596
93,Provence-Alpes-Côte d'Azur,04,4,16,066,Curbans,390,9,399
93,Provence-Alpes-Côte d'Azur,04,4,18,067,Curel,51,4,55
93,Provence-Alpes-Côte d'Azur,04,4,10,068,Dauphin,787,19,806
93,Provence-Alpes-Côte d'Azur,04,2,06,069,Demandolx,135,2,137
93,Provence-Alpes-Côte d'Azur,04,3,97,070,Digne-les-Bains,17268,1262,18530
93,Provence-Alpes-Côte d'Azur,04,3,11,072,Draix,76,5,81
93,Provence-Alpes-Côte d'Azur,04,1,04,073,Enchastrayes,427,10,437
93,Provence-Alpes-Côte d'Azur,04,3,08,074,Entrages,114,0,114
93,Provence-Alpes-Côte d'Azur,04,4,27,075,Entrepierres,389,4,393
93,Provence-Alpes-Côte d'Azur,04,2,09,076,Entrevaux,925,10,935
93,Provence-Alpes-Côte d'Azur,04,3,14,077,Entrevennes,167,4,171
93,Provence-Alpes-Côte d'Azur,04,4,30,079,L' Escale,1255,29,1284
93,Provence-Alpes-Côte d'Azur,04,3,21,081,Esparron-de-Verdon,430,2,432
93,Provence-Alpes-Côte d'Azur,04,3,15,084,Estoublon,434,5,439
93,Provence-Alpes-Côte d'Azur,04,1,04,086,Faucon-de-Barcelonnette,305,16,321
93,Provence-Alpes-Côte d'Azur,04,4,28,085,Faucon-du-Caire,55,1,56
93,Provence-Alpes-Côte d'Azur,04,4,23,087,Fontienne,133,3,136
93,Provence-Alpes-Côte d'Azur,04,4,10,088,Forcalquier,4645,77,4722
93,Provence-Alpes-Côte d'Azur,04,2,02,090,Le Fugeret,224,2,226
93,Provence-Alpes-Côte d'Azur,04,4,19,091,Ganagobie,108,3,111
93,Provence-Alpes-Côte d'Azur,04,2,06,092,La Garde,89,0,89
93,Provence-Alpes-Côte d'Azur,04,4,28,093,Gigors,58,1,59
93,Provence-Alpes-Côte d'Azur,04,3,29,094,Gréoux-les-Bains,2476,43,2519
93,Provence-Alpes-Côte d'Azur,04,3,31,177,Hautes-Duyes,32,0,32
93,Provence-Alpes-Côte d'Azur,04,4,03,095,L' Hospitalet,89,3,92
93,Provence-Alpes-Côte d'Azur,04,1,04,096,Jausiers,1068,46,1114
93,Provence-Alpes-Côte d'Azur,04,3,11,097,La Javie,391,9,400
93,Provence-Alpes-Côte d'Azur,04,2,22,099,Lambruisse,85,0,85
93,Provence-Alpes-Côte d'Azur,04,1,04,100,Larche,72,2,74
93,Provence-Alpes-Côte d'Azur,04,4,23,101,Lardiers,114,1,115
93,Provence-Alpes-Côte d'Azur,04,1,12,102,Le Lauzet-Ubaye,230,5,235
93,Provence-Alpes-Côte d'Azur,04,4,10,104,Limans,334,5,339
93,Provence-Alpes-Côte d'Azur,04,4,19,106,Lurs,376,4,380
93,Provence-Alpes-Côte d'Azur,04,3,15,107,Majastres,2,0,2
93,Provence-Alpes-Côte d'Azur,04,3,14,108,Malijai,1958,32,1990
93,Provence-Alpes-Côte d'Azur,04,4,23,109,Mallefougasse-Augès,219,8,227
93,Provence-Alpes-Côte d'Azur,04,3,31,110,Mallemoisson,1032,33,1065
93,Provence-Alpes-Côte d'Azur,04,4,10,111,Mane,1355,39,1394
93,Provence-Alpes-Côte d'Azur,04,4,98,112,Manosque,22270,648,22918
93,Provence-Alpes-Côte d'Azur,04,3,08,113,Marcoux,492,6,498
93,Provence-Alpes-Côte d'Azur,04,2,02,115,Méailles,110,3,113
93,Provence-Alpes-Côte d'Azur,04,3,14,116,Les Mées,3591,40,3631
93,Provence-Alpes-Côte d'Azur,04,4,16,118,Melve,106,2,108
93,Provence-Alpes-Côte d'Azur,04,1,12,161,Méolans-Revel,330,12,342
93,Provence-Alpes-Côte d'Azur,04,1,04,120,Meyronnes,77,0,77
93,Provence-Alpes-Côte d'Azur,04,3,15,121,Mézel,660,15,675
93,Provence-Alpes-Côte d'Azur,04,3,31,122,Mirabeau,461,5,466
93,Provence-Alpes-Côte d'Azur,04,4,27,123,Mison,985,40,1025
93,Provence-Alpes-Côte d'Azur,04,3,21,124,Montagnac-Montpezat,413,9,422
93,Provence-Alpes-Côte d'Azur,04,3,26,126,Montclar,458,15,473
93,Provence-Alpes-Côte d'Azur,04,4,30,127,Montfort,388,3,391
93,Provence-Alpes-Côte d'Azur,04,4,33,128,Montfuron,198,0,198
93,Provence-Alpes-Côte d'Azur,04,4,20,129,Montjustin,50,1,51
93,Provence-Alpes-Côte d'Azur,04,4,23,130,Montlaux,133,2,135
93,Provence-Alpes-Côte d'Azur,04,4,03,132,Montsalier,104,3,107
93,Provence-Alpes-Côte d'Azur,04,2,22,133,Moriez,183,7,190
93,Provence-Alpes-Côte d'Azur,04,4,16,134,La Motte-du-Caire,507,9,516
93,Provence-Alpes-Côte d'Azur,04,3,17,135,Moustiers-Sainte-Marie,710,9,719
93,Provence-Alpes-Côte d'Azur,04,2,22,136,La Mure-Argens,321,5,326
93,Provence-Alpes-Côte d'Azur,04,4,16,137,Nibles,45,0,45
93,Provence-Alpes-Côte d'Azur,04,4,10,138,Niozelles,233,10,243
93,Provence-Alpes-Côte d'Azur,04,4,18,139,Noyers-sur-Jabron,398,16,414
93,Provence-Alpes-Côte d'Azur,04,4,18,140,Les Omergues,123,2,125
93,Provence-Alpes-Côte d'Azur,04,4,23,141,Ongles,331,7,338
93,Provence-Alpes-Côte d'Azur,04,4,20,142,Oppedette,63,0,63
93,Provence-Alpes-Côte d'Azur,04,3,14,143,Oraison,5208,97,5305
93,Provence-Alpes-Côte d'Azur,04,3,17,144,La Palud-sur-Verdon,313,3,316
93,Provence-Alpes-Côte d'Azur,04,4,30,145,Peipin,1229,41,1270
93,Provence-Alpes-Côte d'Azur,04,2,06,148,Peyroules,222,6,228
93,Provence-Alpes-Côte d'Azur,04,4,19,149,Peyruis,2542,51,2593
93,Provence-Alpes-Côte d'Azur,04,4,28,150,Piégut,138,3,141
93,Provence-Alpes-Côte d'Azur,04,4,10,151,Pierrerue,521,14,535
93,Provence-Alpes-Côte d'Azur,04,4,33,152,Pierrevert,3614,151,3765
93,Provence-Alpes-Côte d'Azur,04,1,12,154,Pontis,70,4,74
93,Provence-Alpes-Côte d'Azur,04,3,11,155,Prads-Haute-Bléone,172,1,173
93,Provence-Alpes-Côte d'Azur,04,3,14,156,Puimichel,255,0,255
93,Provence-Alpes-Côte d'Azur,04,3,21,157,Puimoisson,698,16,714
93,Provence-Alpes-Côte d'Azur,04,3,21,158,Quinson,440,13,453
93,Provence-Alpes-Côte d'Azur,04,4,03,159,Redortiers,86,3,89
93,Provence-Alpes-Côte d'Azur,04,4,20,160,Reillanne,1479,32,1511
93,Provence-Alpes-Côte d'Azur,04,4,03,162,Revest-des-Brousses,248,8,256
93,Provence-Alpes-Côte d'Azur,04,4,03,163,Revest-du-Bion,550,6,556
93,Provence-Alpes-Côte d'Azur,04,4,23,164,Revest-Saint-Martin,92,5,97
93,Provence-Alpes-Côte d'Azur,04,3,21,166,Riez,1760,28,1788
93,Provence-Alpes-Côte d'Azur,04,3,08,167,La Robine-sur-Galabre,324,7,331
93,Provence-Alpes-Côte d'Azur,04,4,03,169,La Rochegiron,108,3,111
93,Provence-Alpes-Côte d'Azur,04,2,09,170,La Rochette,57,0,57
93,Provence-Alpes-Côte d'Azur,04,2,06,171,Rougon,114,1,115
93,Provence-Alpes-Côte d'Azur,04,3,21,172,Roumoules,722,18,740
93,Provence-Alpes-Côte d'Azur,04,2,22,173,Saint-André-les-Alpes,937,5,942
93,Provence-Alpes-Côte d'Azur,04,2,02,174,Saint-Benoît,122,7,129
93,Provence-Alpes-Côte d'Azur,04,4,23,178,Saint-Étienne-les-Orgues,1222,25,1247
93,Provence-Alpes-Côte d'Azur,04,4,27,179,Saint-Geniez,96,4,100
93,Provence-Alpes-Côte d'Azur,04,3,05,180,Saint-Jacques,57,1,58
93,Provence-Alpes-Côte d'Azur,04,3,15,181,Saint-Jeannet,53,3,56
93,Provence-Alpes-Côte d'Azur,04,3,15,182,Saint-Julien-d'Asse,155,4,159
93,Provence-Alpes-Côte d'Azur,04,2,06,183,Saint-Julien-du-Verdon,139,3,142
93,Provence-Alpes-Côte d'Azur,04,3,17,184,Saint-Jurs,156,2,158
93,Provence-Alpes-Côte d'Azur,04,3,21,186,Saint-Laurent-du-Verdon,93,1,94
93,Provence-Alpes-Côte d'Azur,04,3,05,187,Saint-Lions,38,1,39
93,Provence-Alpes-Côte d'Azur,04,4,10,188,Saint-Maime,844,19,863
93,Provence-Alpes-Côte d'Azur,04,3,29,189,Saint-Martin-de-Brômes,512,10,522
93,Provence-Alpes-Côte d'Azur,04,4,13,190,Saint-Martin-les-Eaux,99,3,102
93,Provence-Alpes-Côte d'Azur,04,3,26,191,Saint-Martin-lès-Seyne,20,0,20
93,Provence-Alpes-Côte d'Azur,04,4,10,192,Saint-Michel-l'Observatoire,1113,21,1134
93,Provence-Alpes-Côte d'Azur,04,1,04,193,Saint-Paul-sur-Ubaye,228,4,232
93,Provence-Alpes-Côte d'Azur,04,2,09,194,Saint-Pierre,111,4,115
93,Provence-Alpes-Côte d'Azur,04,1,04,195,Saint-Pons,720,27,747
93,Provence-Alpes-Côte d'Azur,04,1,12,198,Saint-Vincent-les-Forts,264,3,267
93,Provence-Alpes-Côte d'Azur,04,4,18,199,Saint-Vincent-sur-Jabron,194,6,200
93,Provence-Alpes-Côte d'Azur,04,4,20,175,Sainte-Croix-à-Lauze,82,3,85
93,Provence-Alpes-Côte d'Azur,04,3,21,176,Sainte-Croix-du-Verdon,132,2,134
93,Provence-Alpes-Côte d'Azur,04,4,32,197,Sainte-Tulle,3265,55,3320
93,Provence-Alpes-Côte d'Azur,04,4,30,200,Salignac,518,17,535
93,Provence-Alpes-Côte d'Azur,04,4,03,201,Saumane,106,4,110
93,Provence-Alpes-Côte d'Azur,04,2,09,202,Sausses,108,1,109
93,Provence-Alpes-Côte d'Azur,04,3,26,203,Selonnet,430,13,443
93,Provence-Alpes-Côte d'Azur,04,3,05,204,Senez,186,3,189
93,Provence-Alpes-Côte d'Azur,04,3,26,205,Seyne,1431,32,1463
93,Provence-Alpes-Côte d'Azur,04,4,10,206,Sigonce,399,12,411
93,Provence-Alpes-Côte d'Azur,04,4,16,207,Sigoyer,86,5,91
93,Provence-Alpes-Côte d'Azur,04,4,03,208,Simiane-la-Rotonde,568,12,580
93,Provence-Alpes-Côte d'Azur,04,4,27,209,Sisteron,7326,298,7624
93,Provence-Alpes-Côte d'Azur,04,2,06,210,Soleilhas,111,0,111
93,Provence-Alpes-Côte d'Azur,04,4,30,211,Sourribes,174,2,176
93,Provence-Alpes-Côte d'Azur,04,3,05,214,Tartonne,140,3,143
93,Provence-Alpes-Côte d'Azur,04,4,16,216,Thèze,205,2,207
93,Provence-Alpes-Côte d'Azur,04,3,31,217,Thoard,723,16,739
93,Provence-Alpes-Côte d'Azur,04,2,07,218,Thorame-Basse,202,7,209
93,Provence-Alpes-Côte d'Azur,04,2,07,219,Thorame-Haute,228,5,233
93,Provence-Alpes-Côte d'Azur,04,1,04,220,Les Thuiles,380,10,390
93,Provence-Alpes-Côte d'Azur,04,4,28,222,Turriers,397,11,408
93,Provence-Alpes-Côte d'Azur,04,2,02,224,Ubraye,105,3,108
93,Provence-Alpes-Côte d'Azur,04,1,04,226,Uvernet-Fours,637,25,662
93,Provence-Alpes-Côte d'Azur,04,4,20,227,Vachères,305,10,315
93,Provence-Alpes-Côte d'Azur,04,2,09,043,Val-de-Chalvagne,65,2,67
93,Provence-Alpes-Côte d'Azur,04,4,16,228,Valavoire,36,2,38
93,Provence-Alpes-Côte d'Azur,04,4,18,229,Valbelle,235,8,243
93,Provence-Alpes-Côte d'Azur,04,3,29,230,Valensole,2875,39,2914
93,Provence-Alpes-Côte d'Azur,04,4,16,231,Valernes,241,4,245
93,Provence-Alpes-Côte d'Azur,04,4,16,233,Vaumeilh,272,8,280
93,Provence-Alpes-Côte d'Azur,04,4,28,234,Venterol,229,4,233
93,Provence-Alpes-Côte d'Azur,04,3,26,235,Verdaches,61,1,62
93,Provence-Alpes-Côte d'Azur,04,2,02,236,Vergons,125,0,125
93,Provence-Alpes-Côte d'Azur,04,3,26,237,Le Vernet,126,2,128
93,Provence-Alpes-Côte d'Azur,04,2,07,240,Villars-Colmars,238,5,243
93,Provence-Alpes-Côte d'Azur,04,4,20,241,Villemus,157,3,160
93,Provence-Alpes-Côte d'Azur,04,4,10,242,Villeneuve,3444,49,3493
93,Provence-Alpes-Côte d'Azur,04,4,30,244,Volonne,1648,46,1694
93,Provence-Alpes-Côte d'Azur,04,4,13,245,Volx,2887,69,2956
93,Provence-Alpes-Côte d'Azur,05,1,01,001,Abriès,372,12,384
93,Provence-Alpes-Côte d'Azur,05,2,19,002,Agnières-en-Dévoluy,266,7,273
93,Provence-Alpes-Côte d'Azur,05,1,01,003,Aiguilles,419,8,427
93,Provence-Alpes-Côte d'Azur,05,2,18,004,Ancelle,831,14,845
93,Provence-Alpes-Côte d'Azur,05,2,16,005,Antonaves,179,4,183
93,Provence-Alpes-Côte d'Azur,05,1,02,006,L' Argentière-la-Bessée,2330,77,2407
93,Provence-Alpes-Côte d'Azur,05,1,01,007,Arvieux,360,15,375
93,Provence-Alpes-Côte d'Azur,05,2,03,008,Aspremont,306,2,308
93,Provence-Alpes-Côte d'Azur,05,2,20,009,Aspres-lès-Corps,134,3,137
93,Provence-Alpes-Côte d'Azur,05,2,03,010,Aspres-sur-Buëch,778,19,797
93,Provence-Alpes-Côte d'Azur,05,2,05,011,Avançon,352,4,356
93,Provence-Alpes-Côte d'Azur,05,2,08,012,Baratier,511,18,529
93,Provence-Alpes-Côte d'Azur,05,2,04,013,Barcillonnette,126,3,129
93,Provence-Alpes-Côte d'Azur,05,2,16,014,Barret-sur-Méouge,214,7,221
93,Provence-Alpes-Côte d'Azur,05,2,22,016,La Bâtie-Montsaléon,200,5,205
93,Provence-Alpes-Côte d'Azur,05,2,05,017,La Bâtie-Neuve,2116,79,2195
93,Provence-Alpes-Côte d'Azur,05,2,05,018,La Bâtie-Vieille,268,19,287
93,Provence-Alpes-Côte d'Azur,05,2,03,019,La Beaume,161,4,165
93,Provence-Alpes-Côte d'Azur,05,2,18,020,Bénévent-et-Charbillac,280,9,289
93,Provence-Alpes-Côte d'Azur,05,2,22,021,Le Bersac,153,3,156
93,Provence-Alpes-Côte d'Azur,05,2,07,022,Bréziers,143,7,150
93,Provence-Alpes-Côte d'Azur,05,1,98,023,Briançon,11645,458,12103
93,Provence-Alpes-Côte d'Azur,05,2,17,024,Bruis,65,1,66
93,Provence-Alpes-Côte d'Azur,05,2,18,025,Buissard,172,2,174
93,Provence-Alpes-Côte d'Azur,05,1,11,026,Ceillac,304,7,311
93,Provence-Alpes-Côte d'Azur,05,1,25,027,Cervières,156,4,160
93,Provence-Alpes-Côte d'Azur,05,2,24,028,Chabestan,131,5,136
93,Provence-Alpes-Côte d'Azur,05,2,18,029,Chabottes,750,25,775
93,Provence-Alpes-Côte d'Azur,05,1,02,031,Champcella,170,6,176
93,Provence-Alpes-Côte d'Azur,05,2,14,032,Champoléon,125,3,128
93,Provence-Alpes-Côte d'Azur,05,2,17,033,Chanousse,48,0,48
93,Provence-Alpes-Côte d'Azur,05,2,20,064,La Chapelle-en-Valgaudémar,120,4,124
93,Provence-Alpes-Côte d'Azur,05,1,01,038,Château-Ville-Vieille,328,11,339
93,Provence-Alpes-Côte d'Azur,05,2,24,035,Châteauneuf-d'Oze,29,0,29
93,Provence-Alpes-Côte d'Azur,05,2,16,034,Châteauneuf-de-Chabre,305,8,313
93,Provence-Alpes-Côte d'Azur,05,2,08,036,Châteauroux-les-Alpes,1110,33,1143
93,Provence-Alpes-Côte d'Azur,05,2,23,037,Châteauvieux,438,22,460
93,Provence-Alpes-Côte d'Azur,05,2,20,039,Chauffayer,385,7,392
93,Provence-Alpes-Côte d'Azur,05,2,07,040,Chorges,2485,57,2542
93,Provence-Alpes-Côte d'Azur,05,2,19,042,La Cluse,53,1,54
93,Provence-Alpes-Côte d'Azur,05,2,18,043,Les Costes,147,3,150
93,Provence-Alpes-Côte d'Azur,05,2,08,044,Crévoux,129,4,133
93,Provence-Alpes-Côte d'Azur,05,2,08,045,Crots,928,29,957
93,Provence-Alpes-Côte d'Azur,05,2,08,046,Embrun,6267,392,6659
93,Provence-Alpes-Côte d'Azur,05,2,16,047,Éourres,143,4,147
93,Provence-Alpes-Côte d'Azur,05,2,22,048,L' Épine,180,14,194
93,Provence-Alpes-Côte d'Azur,05,2,04,049,Esparron,36,1,37
93,Provence-Alpes-Côte d'Azur,05,2,07,050,Espinasses,660,23,683
93,Provence-Alpes-Côte d'Azur,05,2,15,051,Étoile-Saint-Cyrice,35,4,39
93,Provence-Alpes-Côte d'Azur,05,1,11,052,Eygliers,749,9,758
93,Provence-Alpes-Côte d'Azur,05,2,12,053,Eyguians,243,2,245
93,Provence-Alpes-Côte d'Azur,05,2,18,054,La Fare-en-Champsaur,418,4,422
93,Provence-Alpes-Côte d'Azur,05,2,03,055,La Faurie,322,11,333
93,Provence-Alpes-Côte d'Azur,05,2,18,056,Forest-Saint-Julien,276,1,277
93,Provence-Alpes-Côte d'Azur,05,2,23,057,Fouillouse,188,5,193
93,Provence-Alpes-Côte d'Azur,05,1,02,058,Freissinières,187,7,194
93,Provence-Alpes-Côte d'Azur,05,2,09,059,La Freissinouse,499,10,509
93,Provence-Alpes-Côte d'Azur,05,2,24,060,Furmeyer,146,5,151
93,Provence-Alpes-Côte d'Azur,05,2,99,061,Gap,38584,1891,40475
93,Provence-Alpes-Côte d'Azur,05,2,20,062,Le Glaizil,170,7,177
93,Provence-Alpes-Côte d'Azur,05,1,10,063,La Grave,497,13,510
93,Provence-Alpes-Côte d'Azur,05,1,11,065,Guillestre,2290,93,2383
93,Provence-Alpes-Côte d'Azur,05,2,03,066,La Haute-Beaume,10,0,10
93,Provence-Alpes-Côte d'Azur,05,2,18,067,Les Infournas,26,1,27
93,Provence-Alpes-Côte d'Azur,05,2,23,068,Jarjayes,418,12,430
93,Provence-Alpes-Côte d'Azur,05,2,15,069,Lagrand,280,13,293
93,Provence-Alpes-Côte d'Azur,05,2,12,070,Laragne-Montéglin,3532,104,3636
93,Provence-Alpes-Côte d'Azur,05,2,23,071,Lardier-et-Valença,269,5,274
93,Provence-Alpes-Côte d'Azur,05,2,18,072,Laye,231,7,238
93,Provence-Alpes-Côte d'Azur,05,2,12,073,Lazer,329,13,342
93,Provence-Alpes-Côte d'Azur,05,2,23,074,Lettret,165,1,166
93,Provence-Alpes-Côte d'Azur,05,2,09,075,Manteyer,414,15,429
93,Provence-Alpes-Côte d'Azur,05,2,22,076,Méreuil,85,0,85
93,Provence-Alpes-Côte d'Azur,05,1,01,077,Molines-en-Queyras,334,12,346
93,Provence-Alpes-Côte d'Azur,05,2,12,078,Monêtier-Allemont,321,15,336
93,Provence-Alpes-Côte d'Azur,05,1,13,079,Le Monêtier-les-Bains,1057,30,1087
93,Provence-Alpes-Côte d'Azur,05,1,11,082,Mont-Dauphin,142,5,147
93,Provence-Alpes-Côte d'Azur,05,2,03,080,Montbrand,50,1,51
93,Provence-Alpes-Côte d'Azur,05,2,22,081,Montclus,50,2,52
93,Provence-Alpes-Côte d'Azur,05,2,05,084,Montgardin,436,6,442
93,Provence-Alpes-Côte d'Azur,05,1,06,085,Montgenèvre,486,16,502
93,Provence-Alpes-Côte d'Azur,05,2,17,086,Montjay,100,1,101
93,Provence-Alpes-Côte d'Azur,05,2,24,087,Montmaur,510,14,524
93,Provence-Alpes-Côte d'Azur,05,2,22,088,Montmorin,89,1,90
93,Provence-Alpes-Côte d'Azur,05,2,22,089,Montrond,51,1,52
93,Provence-Alpes-Côte d'Azur,05,2,18,090,La Motte-en-Champsaur,185,6,191
93,Provence-Alpes-Côte d'Azur,05,2,17,091,Moydans,50,2,52
93,Provence-Alpes-Côte d'Azur,05,2,23,092,Neffes,726,16,742
93,Provence-Alpes-Côte d'Azur,05,1,06,093,Névache,334,10,344
93,Provence-Alpes-Côte d'Azur,05,2,15,094,Nossage-et-Bénévent,13,0,13
93,Provence-Alpes-Côte d'Azur,05,2,18,095,Le Noyer,257,5,262
93,Provence-Alpes-Côte d'Azur,05,2,14,096,Orcières,700,9,709
93,Provence-Alpes-Côte d'Azur,05,2,15,097,Orpierre,324,50,374
93,Provence-Alpes-Côte d'Azur,05,2,08,098,Les Orres,516,9,525
93,Provence-Alpes-Côte d'Azur,05,2,24,099,Oze,93,2,95
93,Provence-Alpes-Côte d'Azur,05,2,09,100,Pelleautier,557,19,576
93,Provence-Alpes-Côte d'Azur,05,1,02,101,Pelvoux,449,9,458
93,Provence-Alpes-Côte d'Azur,05,2,22,102,La Piarre,96,0,96
93,Provence-Alpes-Côte d'Azur,05,2,12,103,Le Poët,734,25,759
93,Provence-Alpes-Côte d'Azur,05,2,18,104,Poligny,305,4,309
93,Provence-Alpes-Côte d'Azur,05,2,07,106,Prunières,289,9,298
93,Provence-Alpes-Côte d'Azur,05,1,25,107,Puy-Saint-André,471,20,491
93,Provence-Alpes-Côte d'Azur,05,2,21,108,Puy-Saint-Eusèbe,123,4,127
93,Provence-Alpes-Côte d'Azur,05,1,25,109,Puy-Saint-Pierre,500,24,524
93,Provence-Alpes-Côte d'Azur,05,1,02,110,Puy-Saint-Vincent,314,5,319
93,Provence-Alpes-Côte d'Azur,05,2,21,111,Puy-Sanières,220,10,230
93,Provence-Alpes-Côte d'Azur,05,2,09,112,Rabou,77,6,83
93,Provence-Alpes-Côte d'Azur,05,2,05,113,Rambaud,361,11,372
93,Provence-Alpes-Côte d'Azur,05,2,21,114,Réallon,237,1,238
93,Provence-Alpes-Côte d'Azur,05,2,07,115,Remollon,425,16,441
93,Provence-Alpes-Côte d'Azur,05,1,11,116,Réotier,193,6,199
93,Provence-Alpes-Côte d'Azur,05,2,17,117,Ribeyret,105,5,110
93,Provence-Alpes-Côte d'Azur,05,2,16,118,Ribiers,777,30,807
93,Provence-Alpes-Côte d'Azur,05,1,11,119,Risoul,649,32,681
93,Provence-Alpes-Côte d'Azur,05,1,01,120,Ristolas,96,3,99
93,Provence-Alpes-Côte d'Azur,05,1,02,122,La Roche-de-Rame,823,20,843
93,Provence-Alpes-Côte d'Azur,05,2,09,123,La Roche-des-Arnauds,1347,38,1385
93,Provence-Alpes-Côte d'Azur,05,2,07,121,Rochebrune,148,2,150
93,Provence-Alpes-Côte d'Azur,05,2,05,124,La Rochette,380,3,383
93,Provence-Alpes-Côte d'Azur,05,2,17,126,Rosans,522,17,539
93,Provence-Alpes-Côte d'Azur,05,2,07,127,Rousset,172,3,175
93,Provence-Alpes-Côte d'Azur,05,2,08,128,Saint-André-d'Embrun,637,26,663
93,Provence-Alpes-Côte d'Azur,05,2,17,129,Saint-André-de-Rosans,150,4,154
93,Provence-Alpes-Côte d'Azur,05,2,21,130,Saint-Apollinaire,113,3,116
93,Provence-Alpes-Côte d'Azur,05,2,24,131,Saint-Auban-d'Oze,68,3,71
93,Provence-Alpes-Côte d'Azur,05,2,18,132,Saint-Bonnet-en-Champsaur,1683,56,1739
93,Provence-Alpes-Côte d'Azur,05,1,13,133,Saint-Chaffrey,1662,69,1731
93,Provence-Alpes-Côte d'Azur,05,1,11,134,Saint-Clément-sur-Durance,276,11,287
93,Provence-Alpes-Côte d'Azur,05,1,11,136,Saint-Crépin,592,22,614
93,Provence-Alpes-Côte d'Azur,05,2,19,138,Saint-Disdier,133,6,139
93,Provence-Alpes-Côte d'Azur,05,2,19,139,Saint-Étienne-en-Dévoluy,573,20,593
93,Provence-Alpes-Côte d'Azur,05,2,05,140,Saint-Étienne-le-Laus,297,3,300
93,Provence-Alpes-Côte d'Azur,05,2,18,141,Saint-Eusèbe-en-Champsaur,138,1,139
93,Provence-Alpes-Côte d'Azur,05,2,20,142,Saint-Firmin,464,11,475
93,Provence-Alpes-Côte d'Azur,05,2,22,143,Saint-Genis,56,2,58
93,Provence-Alpes-Côte d'Azur,05,2,20,144,Saint-Jacques-en-Valgodemard,161,2,163
93,Provence-Alpes-Côte d'Azur,05,2,14,145,Saint-Jean-Saint-Nicolas,941,95,1036
93,Provence-Alpes-Côte d'Azur,05,2,03,146,Saint-Julien-en-Beauchêne,124,2,126
93,Provence-Alpes-Côte d'Azur,05,2,18,147,Saint-Julien-en-Champsaur,302,8,310
93,Provence-Alpes-Côte d'Azur,05,2,18,148,Saint-Laurent-du-Cros,528,10,538
93,Provence-Alpes-Côte d'Azur,05,2,18,149,Saint-Léger-les-Mélèzes,318,3,321
93,Provence-Alpes-Côte d'Azur,05,1,02,151,Saint-Martin-de-Queyrières,1102,31,1133
93,Provence-Alpes-Côte d'Azur,05,2,20,152,Saint-Maurice-en-Valgodemard,134,3,137
93,Provence-Alpes-Côte d'Azur,05,2,18,153,Saint-Michel-de-Chaillol,334,8,342
93,Provence-Alpes-Côte d'Azur,05,2,16,155,Saint-Pierre-Avez,23,0,23
93,Provence-Alpes-Côte d'Azur,05,2,03,154,Saint-Pierre-d'Argençon,163,0,163
93,Provence-Alpes-Côte d'Azur,05,2,08,156,Saint-Sauveur,442,12,454
93,Provence-Alpes-Côte d'Azur,05,1,01,157,Saint-Véran,282,5,287
93,Provence-Alpes-Côte d'Azur,05,2,15,135,Sainte-Colombe,53,1,54
93,Provence-Alpes-Côte d'Azur,05,2,17,150,Sainte-Marie,42,0,42
93,Provence-Alpes-Côte d'Azur,05,2,24,158,Le Saix,92,2,94
93,Provence-Alpes-Côte d'Azur,05,2,15,159,Saléon,81,4,85
93,Provence-Alpes-Côte d'Azur,05,2,16,160,Salérans,78,0,78
93,Provence-Alpes-Côte d'Azur,05,1,13,161,La Salle-les-Alpes,909,43,952
93,Provence-Alpes-Côte d'Azur,05,2,23,162,La Saulce,1274,37,1311
93,Provence-Alpes-Côte d'Azur,05,2,21,163,Le Sauze-du-Lac,124,7,131
93,Provence-Alpes-Côte d'Azur,05,2,21,164,Savines-le-Lac,1136,58,1194
93,Provence-Alpes-Côte d'Azur,05,2,22,165,Savournon,249,10,259
93,Provence-Alpes-Côte d'Azur,05,2,22,166,Serres,1334,30,1364
93,Provence-Alpes-Côte d'Azur,05,2,22,167,Sigottier,69,4,73
93,Provence-Alpes-Côte d'Azur,05,2,23,168,Sigoyer,650,21,671
93,Provence-Alpes-Côte d'Azur,05,2,17,169,Sorbiers,36,1,37
93,Provence-Alpes-Côte d'Azur,05,2,23,170,Tallard,1909,53,1962
93,Provence-Alpes-Côte d'Azur,05,2,07,171,Théus,189,3,192
93,Provence-Alpes-Côte d'Azur,05,2,15,172,Trescléoux,314,8,322
93,Provence-Alpes-Côte d'Azur,05,2,12,173,Upaix,412,11,423
93,Provence-Alpes-Côte d'Azur,05,1,06,174,Val-des-Prés,502,29,531
93,Provence-Alpes-Côte d'Azur,05,1,02,175,Vallouise,728,28,756
93,Provence-Alpes-Côte d'Azur,05,2,05,176,Valserres,217,7,224
93,Provence-Alpes-Côte d'Azur,05,1,11,177,Vars,606,8,614
93,Provence-Alpes-Côte d'Azur,05,2,12,178,Ventavon,517,60,577
93,Provence-Alpes-Côte d'Azur,05,2,24,179,Veynes,3168,163,3331
93,Provence-Alpes-Côte d'Azur,05,1,02,180,Les Vigneaux,464,14,478
93,Provence-Alpes-Côte d'Azur,05,1,10,181,Villar-d'Arêne,284,3,287
93,Provence-Alpes-Côte d'Azur,05,2,20,182,Villar-Loubière,49,0,49
93,Provence-Alpes-Côte d'Azur,05,1,25,183,Villar-Saint-Pancrace,1452,57,1509
93,Provence-Alpes-Côte d'Azur,05,2,04,184,Vitrolles,206,3,209
93,Provence-Alpes-Côte d'Azur,06,1,21,001,Aiglun,90,1,91
93,Provence-Alpes-Côte d'Azur,06,1,21,002,Amirat,44,0,44
93,Provence-Alpes-Côte d'Azur,06,1,21,003,Andon,550,8,558
93,Provence-Alpes-Côte d'Azur,06,1,97,004,Antibes,76994,1023,78017
93,Provence-Alpes-Côte d'Azur,06,2,18,005,Ascros,148,4,152
93,Provence-Alpes-Côte d'Azur,06,2,12,006,Aspremont,2139,26,2165
93,Provence-Alpes-Côte d'Azur,06,1,10,007,Auribeau-sur-Siagne,2847,54,2901
93,Provence-Alpes-Côte d'Azur,06,2,18,008,Auvare,55,1,56
93,Provence-Alpes-Côte d'Azur,06,2,29,009,Bairols,105,1,106
93,Provence-Alpes-Côte d'Azur,06,1,02,010,Le Bar-sur-Loup,2778,47,2825
93,Provence-Alpes-Côte d'Azur,06,2,30,011,Beaulieu-sur-Mer,3742,21,3763
93,Provence-Alpes-Côte d'Azur,06,2,03,012,Beausoleil,14078,142,14220
93,Provence-Alpes-Côte d'Azur,06,2,19,013,Belvédère,685,11,696
93,Provence-Alpes-Côte d'Azur,06,2,07,014,Bendejun,917,16,933
93,Provence-Alpes-Côte d'Azur,06,2,07,015,Berre-les-Alpes,1264,14,1278
93,Provence-Alpes-Côte d'Azur,06,2,11,016,Beuil,493,6,499
93,Provence-Alpes-Côte d'Azur,06,1,08,017,Bézaudun-les-Alpes,165,2,167
93,Provence-Alpes-Côte d'Azur,06,1,01,018,Biot,9160,234,9394
93,Provence-Alpes-Côte d'Azur,06,2,09,019,Blausasc,1408,13,1421
93,Provence-Alpes-Côte d'Azur,06,2,19,020,La Bollène-Vésubie,574,12,586
93,Provence-Alpes-Côte d'Azur,06,2,20,021,Bonson,677,14,691
93,Provence-Alpes-Côte d'Azur,06,1,08,022,Bouyon,460,5,465
93,Provence-Alpes-Côte d'Azur,06,2,04,023,Breil-sur-Roya,2117,60,2177
93,Provence-Alpes-Côte d'Azur,06,1,21,024,Briançonnet,191,1,192
93,Provence-Alpes-Côte d'Azur,06,2,31,162,La Brigue,633,8,641
93,Provence-Alpes-Côte d'Azur,06,1,50,025,Le Broc,1301,14,1315
93,Provence-Alpes-Côte d'Azur,06,1,25,026,Cabris,1456,52,1508
93,Provence-Alpes-Côte d'Azur,06,1,96,027,Cagnes-sur-Mer,48926,622,49548
93,Provence-Alpes-Côte d'Azur,06,1,21,028,Caille,330,6,336
93,Provence-Alpes-Côte d'Azur,06,1,98,029,Cannes,72939,964,73903
93,Provence-Alpes-Côte d'Azur,06,1,95,030,Le Cannet,40940,398,41338
93,Provence-Alpes-Côte d'Azur,06,2,07,031,Cantaron,1192,18,1210
93,Provence-Alpes-Côte d'Azur,06,2,30,032,Cap-d'Ail,4997,64,5061
93,Provence-Alpes-Côte d'Azur,06,1,50,033,Carros,11515,151,11666
93,Provence-Alpes-Côte d'Azur,06,2,12,034,Castagniers,1511,24,1535
93,Provence-Alpes-Côte d'Azur,06,2,13,035,Castellar,968,16,984
93,Provence-Alpes-Côte d'Azur,06,2,26,036,Castillon,342,3,345
93,Provence-Alpes-Côte d'Azur,06,1,02,037,Caussols,231,2,233
93,Provence-Alpes-Côte d'Azur,06,2,11,040,Châteauneuf-d'Entraunes,68,0,68
93,Provence-Alpes-Côte d'Azur,06,1,02,038,Châteauneuf-Grasse,3160,82,3242
93,Provence-Alpes-Côte d'Azur,06,2,07,039,Châteauneuf-Villevieille,835,8,843
93,Provence-Alpes-Côte d'Azur,06,1,08,041,Cipières,361,11,372
93,Provence-Alpes-Côte d'Azur,06,2,24,042,Clans,557,9,566
93,Provence-Alpes-Côte d'Azur,06,2,07,043,Coaraze,729,10,739
93,Provence-Alpes-Côte d'Azur,06,1,45,044,La Colle-sur-Loup,7633,129,7762
93,Provence-Alpes-Côte d'Azur,06,1,21,045,Collongues,100,1,101
93,Provence-Alpes-Côte d'Azur,06,2,12,046,Colomars,3226,37,3263
93,Provence-Alpes-Côte d'Azur,06,1,08,047,Conségudes,81,0,81
93,Provence-Alpes-Côte d'Azur,06,2,07,048,Contes,6909,89,6998
93,Provence-Alpes-Côte d'Azur,06,1,02,049,Courmes,96,1,97
93,Provence-Alpes-Côte d'Azur,06,1,08,050,Coursegoules,455,11,466
93,Provence-Alpes-Côte d'Azur,06,2,18,051,La Croix-sur-Roudoule,83,1,84
93,Provence-Alpes-Côte d'Azur,06,2,20,052,Cuébris,197,4,201
93,Provence-Alpes-Côte d'Azur,06,2,11,053,Daluis,126,3,129
93,Provence-Alpes-Côte d'Azur,06,2,07,054,Drap,4561,42,4603
93,Provence-Alpes-Côte d'Azur,06,2,12,055,Duranus,170,1,171
93,Provence-Alpes-Côte d'Azur,06,2,11,056,Entraunes,129,3,132
93,Provence-Alpes-Côte d'Azur,06,2,09,057,L' Escarène,2342,18,2360
93,Provence-Alpes-Côte d'Azur,06,1,25,058,Escragnolles,545,4,549
93,Provence-Alpes-Côte d'Azur,06,2,30,059,Èze,2961,32,2993
93,Provence-Alpes-Côte d'Azur,06,2,43,060,Falicon,1926,30,1956
93,Provence-Alpes-Côte d'Azur,06,1,08,061,Les Ferres,92,0,92
93,Provence-Alpes-Côte d'Azur,06,2,04,062,Fontan,269,5,274
93,Provence-Alpes-Côte d'Azur,06,1,21,063,Gars,60,0,60
93,Provence-Alpes-Côte d'Azur,06,1,50,064,Gattières,4093,37,4130
93,Provence-Alpes-Côte d'Azur,06,1,28,065,La Gaude,6716,132,6848
93,Provence-Alpes-Côte d'Azur,06,2,20,066,Gilette,1472,19,1491
93,Provence-Alpes-Côte d'Azur,06,2,52,067,Gorbio,1280,22,1302
93,Provence-Alpes-Côte d'Azur,06,1,02,068,Gourdon,453,8,461
93,Provence-Alpes-Côte d'Azur,06,1,94,069,Grasse,51580,1045,52625
93,Provence-Alpes-Côte d'Azur,06,1,08,070,Gréolières,540,8,548
93,Provence-Alpes-Côte d'Azur,06,2,11,071,Guillaumes,694,15,709
93,Provence-Alpes-Côte d'Azur,06,2,24,072,Ilonse,153,3,156
93,Provence-Alpes-Côte d'Azur,06,2,22,073,Isola,689,15,704
93,Provence-Alpes-Côte d'Azur,06,2,27,074,Lantosque,1262,15,1277
93,Provence-Alpes-Côte d'Azur,06,2,12,075,Levens,4632,45,4677
93,Provence-Alpes-Côte d'Azur,06,2,29,076,Lieuche,40,1,41
93,Provence-Alpes-Côte d'Azur,06,2,09,077,Lucéram,1259,15,1274
93,Provence-Alpes-Côte d'Azur,06,2,29,078,Malaussène,236,1,237
93,Provence-Alpes-Côte d'Azur,06,1,36,079,Mandelieu-la-Napoule,21192,276,21468
93,Provence-Alpes-Côte d'Azur,06,2,24,080,Marie,84,1,85
93,Provence-Alpes-Côte d'Azur,06,1,21,081,Le Mas,142,0,142
93,Provence-Alpes-Côte d'Azur,06,2,29,082,Massoins,130,3,133
93,Provence-Alpes-Côte d'Azur,06,2,93,083,Menton,28833,494,29327
93,Provence-Alpes-Côte d'Azur,06,1,46,084,Mouans-Sartoux,10290,248,10538
93,Provence-Alpes-Côte d'Azur,06,1,46,085,Mougins,19703,314,20017
93,Provence-Alpes-Côte d'Azur,06,2,26,086,Moulinet,216,6,222
93,Provence-Alpes-Côte d'Azur,06,1,21,087,Les Mujouls,54,0,54
93,Provence-Alpes-Côte d'Azur,06,2,99,088,Nice,344875,3681,348556
93,Provence-Alpes-Côte d'Azur,06,1,02,089,Opio,2123,72,2195
93,Provence-Alpes-Côte d'Azur,06,1,10,090,Pégomas,6438,103,6541
93,Provence-Alpes-Côte d'Azur,06,2,09,091,Peille,2289,12,2301
93,Provence-Alpes-Côte d'Azur,06,2,09,092,Peillon,1346,8,1354
93,Provence-Alpes-Côte d'Azur,06,2,18,093,La Penne,302,1,303
93,Provence-Alpes-Côte d'Azur,06,2,11,094,Péone,812,6,818
93,Provence-Alpes-Côte d'Azur,06,1,25,095,Peymeinade,7844,197,8041
93,Provence-Alpes-Côte d'Azur,06,2,29,096,Pierlas,111,5,116
93,Provence-Alpes-Côte d'Azur,06,2,20,097,Pierrefeu,255,8,263
93,Provence-Alpes-Côte d'Azur,06,2,18,098,Puget-Rostang,106,2,108
93,Provence-Alpes-Côte d'Azur,06,2,18,099,Puget-Théniers,1818,91,1909
93,Provence-Alpes-Côte d'Azur,06,2,20,100,Revest-les-Roches,203,3,206
93,Provence-Alpes-Côte d'Azur,06,2,18,101,Rigaud,210,1,211
93,Provence-Alpes-Côte d'Azur,06,2,24,102,Rimplas,113,1,114
93,Provence-Alpes-Côte d'Azur,06,2,19,103,Roquebillière,1636,82,1718
93,Provence-Alpes-Côte d'Azur,06,2,52,104,Roquebrune-Cap-Martin,13515,148,13663
93,Provence-Alpes-Côte d'Azur,06,1,02,105,Roquefort-les-Pins,6346,171,6517
93,Provence-Alpes-Côte d'Azur,06,2,20,106,Roquesteron,539,1,540
93,Provence-Alpes-Côte d'Azur,06,1,08,107,Roquestéron-Grasse,68,2,70
93,Provence-Alpes-Côte d'Azur,06,1,46,108,La Roquette-sur-Siagne,4976,96,5072
93,Provence-Alpes-Côte d'Azur,06,2,12,109,La Roquette-sur-Var,949,2,951
93,Provence-Alpes-Côte d'Azur,06,2,24,110,Roubion,114,0,114
93,Provence-Alpes-Côte d'Azur,06,2,24,111,Roure,210,3,213
93,Provence-Alpes-Côte d'Azur,06,1,02,112,Le Rouret,3796,101,3897
93,Provence-Alpes-Côte d'Azur,06,2,43,114,Saint-André-de-la-Roche,4841,48,4889
93,Provence-Alpes-Côte d'Azur,06,2,18,115,Saint-Antonin,102,1,103
93,Provence-Alpes-Côte d'Azur,06,1,21,116,Saint-Auban,221,4,225
93,Provence-Alpes-Côte d'Azur,06,2,12,117,Saint-Blaise,936,15,951
93,Provence-Alpes-Côte d'Azur,06,1,25,118,Saint-Cézaire-sur-Siagne,3575,65,3640
93,Provence-Alpes-Côte d'Azur,06,2,22,119,Saint-Dalmas-le-Selvage,132,10,142
93,Provence-Alpes-Côte d'Azur,06,2,22,120,Saint-Étienne-de-Tinée,1324,156,1480
93,Provence-Alpes-Côte d'Azur,06,2,30,121,Saint-Jean-Cap-Ferrat,2085,12,2097
93,Provence-Alpes-Côte d'Azur,06,1,28,122,Saint-Jeannet,3656,67,3723
93,Provence-Alpes-Côte d'Azur,06,1,05,123,Saint-Laurent-du-Var,30276,315,30591
93,Provence-Alpes-Côte d'Azur,06,2,18,124,Saint-Léger,69,1,70
93,Provence-Alpes-Côte d'Azur,06,2,11,125,Saint-Martin-d'Entraunes,84,0,84
93,Provence-Alpes-Côte d'Azur,06,2,12,126,Saint-Martin-du-Var,2541,23,2564
93,Provence-Alpes-Côte d'Azur,06,2,23,127,Saint-Martin-Vésubie,1327,7,1334
93,Provence-Alpes-Côte d'Azur,06,1,45,128,Saint-Paul,3477,58,3535
93,Provence-Alpes-Côte d'Azur,06,2,24,129,Saint-Sauveur-sur-Tinée,339,97,436
93,Provence-Alpes-Côte d'Azur,06,1,25,130,Saint-Vallier-de-Thiey,3214,101,3315
93,Provence-Alpes-Côte d'Azur,06,2,52,113,Sainte-Agnès,1189,10,1199
93,Provence-Alpes-Côte d'Azur,06,1,21,131,Sallagriffon,52,0,52
93,Provence-Alpes-Côte d'Azur,06,2,04,132,Saorge,434,13,447
93,Provence-Alpes-Côte d'Azur,06,2,11,133,Sauze,106,4,110
93,Provence-Alpes-Côte d'Azur,06,1,21,134,Séranon,462,0,462
93,Provence-Alpes-Côte d'Azur,06,2,20,135,Sigale,210,5,215
93,Provence-Alpes-Côte d'Azur,06,2,26,136,Sospel,3520,81,3601
93,Provence-Alpes-Côte d'Azur,06,1,25,137,Spéracèdes,1191,28,1219
93,Provence-Alpes-Côte d'Azur,06,2,31,163,Tende,2025,52,2077
93,Provence-Alpes-Côte d'Azur,06,1,36,138,Théoule-sur-Mer,1556,24,1580
93,Provence-Alpes-Côte d'Azur,06,2,29,139,Thiéry,101,0,101
93,Provence-Alpes-Côte d'Azur,06,1,25,140,Le Tignet,3099,82,3181
93,Provence-Alpes-Côte d'Azur,06,2,20,141,Toudon,268,4,272
93,Provence-Alpes-Côte d'Azur,06,2,09,142,Touët-de-l'Escarène,300,1,301
93,Provence-Alpes-Côte d'Azur,06,2,29,143,Touët-sur-Var,620,8,628
93,Provence-Alpes-Côte d'Azur,06,2,29,144,La Tour,439,4,443
93,Provence-Alpes-Côte d'Azur,06,2,20,145,Tourette-du-Château,119,2,121
93,Provence-Alpes-Côte d'Azur,06,2,29,146,Tournefort,149,0,149
93,Provence-Alpes-Côte d'Azur,06,2,12,147,Tourrette-Levens,4728,51,4779
93,Provence-Alpes-Côte d'Azur,06,1,02,148,Tourrettes-sur-Loup,4213,97,4310
93,Provence-Alpes-Côte d'Azur,06,2,43,149,La Trinité,10608,118,10726
93,Provence-Alpes-Côte d'Azur,06,2,30,150,La Turbie,3165,42,3207
93,Provence-Alpes-Côte d'Azur,06,2,27,151,Utelle,693,10,703
93,Provence-Alpes-Côte d'Azur,06,1,02,152,Valbonne,12500,497,12997
93,Provence-Alpes-Côte d'Azur,06,2,24,153,Valdeblore,831,94,925
93,Provence-Alpes-Côte d'Azur,06,1,21,154,Valderoure,386,4,390
93,Provence-Alpes-Côte d'Azur,06,1,35,155,Vallauris,29111,208,29319
93,Provence-Alpes-Côte d'Azur,06,2,23,156,Venanson,138,2,140
93,Provence-Alpes-Côte d'Azur,06,1,28,157,Vence,19247,151,19398
93,Provence-Alpes-Côte d'Azur,06,2,29,158,Villars-sur-Var,646,39,685
93,Provence-Alpes-Côte d'Azur,06,2,30,159,Villefranche-sur-Mer,6244,63,6307
93,Provence-Alpes-Côte d'Azur,06,2,11,160,Villeneuve-d'Entraunes,82,2,84
93,Provence-Alpes-Côte d'Azur,06,1,45,161,Villeneuve-Loubet,14427,203,14630
82,Rhône-Alpes,07,3,06,001,Accons,430,24,454
82,Rhône-Alpes,07,1,03,002,Ailhon,471,23,494
82,Rhône-Alpes,07,1,02,003,Aizac,159,3,162
82,Rhône-Alpes,07,2,13,004,Ajoux,94,2,96
82,Rhône-Alpes,07,2,30,005,Alba-la-Romaine,1421,46,1467
82,Rhône-Alpes,07,2,20,006,Albon-d'Ardèche,158,3,161
82,Rhône-Alpes,07,3,19,007,Alboussière,907,26,933
82,Rhône-Alpes,07,2,13,008,Alissas,1277,52,1329
82,Rhône-Alpes,07,3,22,009,Andance,1123,18,1141
82,Rhône-Alpes,07,3,99,010,Annonay,17156,554,17710
82,Rhône-Alpes,07,1,02,011,Antraigues-sur-Volane,577,15,592
82,Rhône-Alpes,07,3,18,012,Arcens,414,13,427
82,Rhône-Alpes,07,3,21,013,Ardoix,1017,20,1037
82,Rhône-Alpes,07,3,17,014,Arlebosc,350,2,352
82,Rhône-Alpes,07,3,24,015,Arras-sur-Rhône,506,20,526
82,Rhône-Alpes,07,1,02,016,Asperjoc,339,14,353
82,Rhône-Alpes,07,1,27,017,Les Assions,630,15,645
82,Rhône-Alpes,07,1,23,018,Astet,44,1,45
82,Rhône-Alpes,07,1,03,019,Aubenas,11496,906,12402
82,Rhône-Alpes,07,2,30,020,Aubignas,390,9,399
82,Rhône-Alpes,07,2,07,022,Baix,1025,30,1055
82,Rhône-Alpes,07,1,26,023,Balazuc,331,9,340
82,Rhône-Alpes,07,1,27,024,Banne,657,17,674
82,Rhône-Alpes,07,1,23,025,Barnas,226,5,231
82,Rhône-Alpes,07,1,12,026,Le Béage,335,1,336
82,Rhône-Alpes,07,2,31,027,Beauchastel,1678,27,1705
82,Rhône-Alpes,07,1,09,028,Beaulieu,437,13,450
82,Rhône-Alpes,07,1,25,029,Beaumont,208,8,216
82,Rhône-Alpes,07,2,20,030,Beauvène,231,5,236
82,Rhône-Alpes,07,1,27,031,Berrias-et-Casteljau,640,20,660
82,Rhône-Alpes,07,1,29,032,Berzème,142,6,148
82,Rhône-Alpes,07,1,26,033,Bessas,212,4,216
82,Rhône-Alpes,07,2,04,034,Bidon,159,2,161
82,Rhône-Alpes,07,3,28,035,Boffres,629,18,647
82,Rhône-Alpes,07,3,22,036,Bogy,336,5,341
82,Rhône-Alpes,07,3,18,037,Borée,167,1,168
82,Rhône-Alpes,07,1,16,038,Borne,41,0,41
82,Rhône-Alpes,07,3,24,040,Boucieu-le-Roi,277,3,280
82,Rhône-Alpes,07,3,01,041,Boulieu-lès-Annonay,2070,64,2134
82,Rhône-Alpes,07,2,04,042,Bourg-Saint-Andéol,7324,243,7567
82,Rhône-Alpes,07,3,17,039,Bozas,245,10,255
82,Rhône-Alpes,07,3,22,044,Brossainc,188,6,194
82,Rhône-Alpes,07,1,05,045,Burzet,475,10,485
82,Rhône-Alpes,07,1,16,047,Cellier-du-Luc,107,1,108
82,Rhône-Alpes,07,3,28,048,Chalencon,313,5,318
82,Rhône-Alpes,07,3,06,049,Le Chambon,55,2,57
82,Rhône-Alpes,07,1,27,050,Chambonas,612,14,626
82,Rhône-Alpes,07,3,22,051,Champagne,589,14,603
82,Rhône-Alpes,07,3,19,052,Champis,567,13,580
82,Rhône-Alpes,07,1,09,053,Chandolas,450,19,469
82,Rhône-Alpes,07,3,18,054,Chanéac,266,10,276
82,Rhône-Alpes,07,2,31,055,Charmes-sur-Rhône,2384,57,2441
82,Rhône-Alpes,07,3,22,056,Charnas,715,7,722
82,Rhône-Alpes,07,1,11,058,Chassiers,994,84,1078
82,Rhône-Alpes,07,3,19,059,Châteaubourg,211,9,220
82,Rhône-Alpes,07,3,28,060,Châteauneuf-de-Vernoux,194,7,201
82,Rhône-Alpes,07,1,11,061,Chauzon,329,8,337
82,Rhône-Alpes,07,1,11,062,Chazeaux,108,10,118
82,Rhône-Alpes,07,3,24,063,Cheminas,264,5,269
82,Rhône-Alpes,07,3,06,064,Le Cheylard,3285,153,3438
82,Rhône-Alpes,07,1,23,065,Chirols,256,11,267
82,Rhône-Alpes,07,2,07,066,Chomérac,2689,198,2887
82,Rhône-Alpes,07,3,22,067,Colombier-le-Cardinal,263,5,268
82,Rhône-Alpes,07,3,24,068,Colombier-le-Jeune,552,15,567
82,Rhône-Alpes,07,3,17,069,Colombier-le-Vieux,630,23,653
82,Rhône-Alpes,07,3,19,070,Cornas,2255,51,2306
82,Rhône-Alpes,07,1,08,071,Coucouron,827,4,831
82,Rhône-Alpes,07,2,13,072,Coux,1631,53,1684
82,Rhône-Alpes,07,3,10,073,Le Crestet,535,13,548
82,Rhône-Alpes,07,2,13,074,Creysseilles,132,2,134
82,Rhône-Alpes,07,1,12,075,Cros-de-Géorand,180,3,183
82,Rhône-Alpes,07,2,14,076,Cruas,2709,71,2780
82,Rhône-Alpes,07,1,29,077,Darbres,250,7,257
82,Rhône-Alpes,07,3,01,078,Davézieux,2809,87,2896
82,Rhône-Alpes,07,3,10,079,Désaignes,1173,14,1187
82,Rhône-Alpes,07,3,15,080,Devesset,292,9,301
82,Rhône-Alpes,07,1,25,081,Dompnac,96,1,97
82,Rhône-Alpes,07,3,06,082,Dornas,277,13,290
82,Rhône-Alpes,07,2,13,083,Dunière-sur-Eyrieux,392,9,401
82,Rhône-Alpes,07,3,24,084,Eclassan,864,27,891
82,Rhône-Alpes,07,3,10,085,Empurany,543,4,547
82,Rhône-Alpes,07,3,24,086,Étables,765,4,769
82,Rhône-Alpes,07,1,23,087,Fabras,360,4,364
82,Rhône-Alpes,07,1,09,088,Faugères,89,1,90
82,Rhône-Alpes,07,3,22,089,Félines,1462,45,1507
82,Rhône-Alpes,07,2,13,090,Flaviac,1109,33,1142
82,Rhône-Alpes,07,1,03,091,Fons,305,12,317
82,Rhône-Alpes,07,2,13,092,Freyssenet,53,2,55
82,Rhône-Alpes,07,1,02,093,Genestelle,276,7,283
82,Rhône-Alpes,07,2,31,094,Gilhac-et-Bruzac,150,3,153
82,Rhône-Alpes,07,3,10,095,Gilhoc-sur-Ormèze,362,3,365
82,Rhône-Alpes,07,2,20,096,Gluiras,393,8,401
82,Rhône-Alpes,07,3,24,097,Glun,664,11,675
82,Rhône-Alpes,07,2,13,098,Gourdon,89,2,91
82,Rhône-Alpes,07,2,04,099,Gras,512,13,525
82,Rhône-Alpes,07,1,27,100,Gravières,372,10,382
82,Rhône-Alpes,07,1,09,101,Grospierres,846,19,865
82,Rhône-Alpes,07,3,19,102,Guilherand-Granges,10791,282,11073
82,Rhône-Alpes,07,3,18,103,Intres,116,1,117
82,Rhône-Alpes,07,2,20,104,Issamoulenc,105,2,107
82,Rhône-Alpes,07,1,08,105,Issanlas,123,5,128
82,Rhône-Alpes,07,1,08,106,Issarlès,165,6,171
82,Rhône-Alpes,07,1,23,107,Jaujac,1191,25,1216
82,Rhône-Alpes,07,3,06,108,Jaunac,143,11,154
82,Rhône-Alpes,07,1,11,109,Joannas,340,7,347
82,Rhône-Alpes,07,1,09,110,Joyeuse,1626,42,1668
82,Rhône-Alpes,07,1,02,111,Juvinas,161,4,165
82,Rhône-Alpes,07,1,26,113,Labastide-de-Virac,218,5,223
82,Rhône-Alpes,07,1,02,112,Labastide-sur-Bésorgues,222,8,230
82,Rhône-Alpes,07,3,15,114,Labatie-d'Andaure,197,1,198
82,Rhône-Alpes,07,1,09,115,Labeaume,572,29,601
82,Rhône-Alpes,07,1,33,116,Labégude,1366,33,1399
82,Rhône-Alpes,07,1,09,117,Lablachère,1815,43,1858
82,Rhône-Alpes,07,1,25,118,Laboule,141,8,149
82,Rhône-Alpes,07,1,08,119,Le Lac-d'Issarlès,270,2,272
82,Rhône-Alpes,07,1,02,120,Lachamp-Raphaël,86,1,87
82,Rhône-Alpes,07,1,08,121,Lachapelle-Graillouse,240,1,241
82,Rhône-Alpes,07,1,03,122,Lachapelle-sous-Aubenas,1430,52,1482
82,Rhône-Alpes,07,3,18,123,Lachapelle-sous-Chanéac,204,4,208
82,Rhône-Alpes,07,3,17,124,Lafarre,42,2,44
82,Rhône-Alpes,07,1,26,126,Lagorce,934,22,956
82,Rhône-Alpes,07,1,23,127,Lalevade-d'Ardèche,1167,17,1184
82,Rhône-Alpes,07,3,21,128,Lalouvesc,498,10,508
82,Rhône-Alpes,07,3,10,129,Lamastre,2523,102,2625
82,Rhône-Alpes,07,1,08,130,Lanarce,170,10,180
82,Rhône-Alpes,07,1,29,131,Lanas,381,22,403
82,Rhône-Alpes,07,1,11,132,Largentière,1805,124,1929
82,Rhône-Alpes,07,2,04,133,Larnas,90,0,90
82,Rhône-Alpes,07,1,11,134,Laurac-en-Vivarais,887,23,910
82,Rhône-Alpes,07,1,16,135,Laval-d'Aurelle,61,0,61
82,Rhône-Alpes,07,1,16,136,Laveyrune,133,2,135
82,Rhône-Alpes,07,1,08,137,Lavillatte,77,1,78
82,Rhône-Alpes,07,1,29,138,Lavilledieu,1885,31,1916
82,Rhône-Alpes,07,1,02,139,Laviolle,124,5,129
82,Rhône-Alpes,07,3,24,140,Lemps,754,16,770
82,Rhône-Alpes,07,1,03,141,Lentillères,210,6,216
82,Rhône-Alpes,07,1,08,142,Lespéron,320,12,332
82,Rhône-Alpes,07,3,22,143,Limony,776,11,787
82,Rhône-Alpes,07,1,25,144,Loubaresse,32,0,32
82,Rhône-Alpes,07,1,29,145,Lussas,956,32,988
82,Rhône-Alpes,07,2,13,146,Lyas,568,12,580
82,Rhône-Alpes,07,1,27,147,Malarce-sur-la-Thines,241,13,254
82,Rhône-Alpes,07,1,27,148,Malbosc,154,1,155
82,Rhône-Alpes,07,2,20,149,Marcols-les-Eaux,334,2,336
82,Rhône-Alpes,07,3,06,150,Mariac,692,32,724
82,Rhône-Alpes,07,3,15,151,Mars,281,5,286
82,Rhône-Alpes,07,3,24,152,Mauves,1151,26,1177
82,Rhône-Alpes,07,1,23,153,Mayres,262,7,269
82,Rhône-Alpes,07,1,12,154,Mazan-l'Abbaye,136,14,150
82,Rhône-Alpes,07,1,03,155,Mercuer,1186,40,1226
82,Rhône-Alpes,07,1,23,156,Meyras,832,25,857
82,Rhône-Alpes,07,2,14,157,Meysse,1333,39,1372
82,Rhône-Alpes,07,1,02,158,Mézilhac,105,2,107
82,Rhône-Alpes,07,1,29,159,Mirabel,402,15,417
82,Rhône-Alpes,07,3,32,160,Monestier,55,2,57
82,Rhône-Alpes,07,1,12,161,Montpezat-sous-Bauzon,780,37,817
82,Rhône-Alpes,07,1,11,162,Montréal,529,9,538
82,Rhône-Alpes,07,1,25,163,Montselgues,92,4,96
82,Rhône-Alpes,07,3,06,165,Nonières,206,2,208
82,Rhône-Alpes,07,3,10,166,Nozières,254,4,258
82,Rhône-Alpes,07,2,13,167,Les Ollières-sur-Eyrieux,921,21,942
82,Rhône-Alpes,07,1,26,168,Orgnac-l'Aven,537,4,541
82,Rhône-Alpes,07,3,24,169,Ozon,348,12,360
82,Rhône-Alpes,07,3,17,170,Pailharès,289,5,294
82,Rhône-Alpes,07,1,09,171,Payzac,489,12,501
82,Rhône-Alpes,07,3,22,172,Peaugres,1978,69,2047
82,Rhône-Alpes,07,1,05,173,Péreyres,53,0,53
82,Rhône-Alpes,07,3,22,174,Peyraud,519,8,527
82,Rhône-Alpes,07,1,16,175,Le Plagnal,72,2,74
82,Rhône-Alpes,07,1,09,176,Planzolles,136,1,137
82,Rhône-Alpes,07,3,24,177,Plats,753,12,765
82,Rhône-Alpes,07,1,23,178,Pont-de-Labeaume,577,4,581
82,Rhône-Alpes,07,2,13,179,Pourchères,133,14,147
82,Rhône-Alpes,07,2,07,181,Le Pouzin,2877,41,2918
82,Rhône-Alpes,07,1,23,182,Prades,1128,20,1148
82,Rhône-Alpes,07,1,26,183,Pradons,415,7,422
82,Rhône-Alpes,07,2,13,184,Pranles,448,11,459
82,Rhône-Alpes,07,3,21,185,Préaux,585,10,595
82,Rhône-Alpes,07,2,13,186,Privas,8552,379,8931
82,Rhône-Alpes,07,1,11,187,Prunet,133,1,134
82,Rhône-Alpes,07,3,21,188,Quintenas,1389,33,1422
82,Rhône-Alpes,07,1,09,189,Ribes,259,5,264
82,Rhône-Alpes,07,1,29,190,Rochecolombe,222,3,225
82,Rhône-Alpes,07,2,14,191,Rochemaure,1991,65,2056
82,Rhône-Alpes,07,3,15,192,Rochepaule,296,11,307
82,Rhône-Alpes,07,1,11,193,Rocher,275,1,276
82,Rhône-Alpes,07,2,07,194,Rochessauve,392,13,405
82,Rhône-Alpes,07,3,18,195,La Rochette,60,1,61
82,Rhône-Alpes,07,1,11,196,Rocles,220,8,228
82,Rhône-Alpes,07,3,32,197,Roiffieux,2703,93,2796
82,Rhône-Alpes,07,2,31,198,Rompon,959,12,971
82,Rhône-Alpes,07,1,09,199,Rosières,1097,34,1131
82,Rhône-Alpes,07,1,12,200,Le Roux,41,1,42
82,Rhône-Alpes,07,1,26,201,Ruoms,2245,39,2284
82,Rhône-Alpes,07,1,09,202,Sablières,145,6,151
82,Rhône-Alpes,07,1,05,203,Sagnes-et-Goudoulet,134,2,136
82,Rhône-Alpes,07,3,15,204,Saint-Agrève,2506,51,2557
82,Rhône-Alpes,07,1,09,207,Saint-Alban-Auriolles,952,32,984
82,Rhône-Alpes,07,3,21,205,Saint-Alban-d'Ay,1305,34,1339
82,Rhône-Alpes,07,1,16,206,Saint-Alban-en-Montagne,73,3,76
82,Rhône-Alpes,07,1,29,208,Saint-Andéol-de-Berg,129,4,133
82,Rhône-Alpes,07,3,06,209,Saint-Andéol-de-Fourchades,54,2,56
82,Rhône-Alpes,07,1,02,210,Saint-Andéol-de-Vals,540,23,563
82,Rhône-Alpes,07,1,27,211,Saint-André-de-Cruzières,507,13,520
82,Rhône-Alpes,07,3,15,212,Saint-André-en-Vivarais,230,4,234
82,Rhône-Alpes,07,1,09,213,Saint-André-Lachamp,120,8,128
82,Rhône-Alpes,07,3,28,214,Saint-Apollinaire-de-Rias,153,4,157
82,Rhône-Alpes,07,3,10,216,Saint-Barthélemy-Grozon,506,31,537
82,Rhône-Alpes,07,3,06,215,Saint-Barthélemy-le-Meil,211,7,218
82,Rhône-Alpes,07,3,24,217,Saint-Barthélemy-le-Plain,762,20,782
82,Rhône-Alpes,07,3,10,218,Saint-Basile,324,9,333
82,Rhône-Alpes,07,2,07,219,Saint-Bauzile,265,17,282
82,Rhône-Alpes,07,3,06,220,Saint-Christol,107,5,112
82,Rhône-Alpes,07,2,31,221,Saint-Cierge-la-Serre,233,1,234
82,Rhône-Alpes,07,3,06,222,Saint-Cierge-sous-le-Cheylard,196,12,208
82,Rhône-Alpes,07,1,23,223,Saint-Cirgues-de-Prades,130,3,133
82,Rhône-Alpes,07,1,12,224,Saint-Cirgues-en-Montagne,249,11,260
82,Rhône-Alpes,07,3,01,225,Saint-Clair,1022,37,1059
82,Rhône-Alpes,07,3,18,226,Saint-Clément,104,3,107
82,Rhône-Alpes,07,3,01,227,Saint-Cyr,1262,24,1286
82,Rhône-Alpes,07,3,22,228,Saint-Désirat,769,26,795
82,Rhône-Alpes,07,1,03,229,Saint-Didier-sous-Aubenas,773,11,784
82,Rhône-Alpes,07,1,33,230,Saint-Étienne-de-Boulogne,342,5,347
82,Rhône-Alpes,07,1,03,231,Saint-Étienne-de-Fontbellon,2490,70,2560
82,Rhône-Alpes,07,1,16,232,Saint-Étienne-de-Lugdarès,466,6,472
82,Rhône-Alpes,07,2,20,233,Saint-Étienne-de-Serre,209,9,218
82,Rhône-Alpes,07,3,22,234,Saint-Étienne-de-Valoux,293,2,295
82,Rhône-Alpes,07,3,17,236,Saint-Félicien,1212,40,1252
82,Rhône-Alpes,07,2,31,237,Saint-Fortunat-sur-Eyrieux,714,10,724
82,Rhône-Alpes,07,1,09,238,Saint-Genest-de-Beauzon,245,5,250
82,Rhône-Alpes,07,3,06,239,Saint-Genest-Lachamp,101,2,103
82,Rhône-Alpes,07,2,31,240,Saint-Georges-les-Bains,2008,52,2060
82,Rhône-Alpes,07,1,29,241,Saint-Germain,619,17,636
82,Rhône-Alpes,07,1,29,242,Saint-Gineis-en-Coiron,97,3,100
82,Rhône-Alpes,07,3,22,243,Saint-Jacques-d'Atticieux,244,0,244
82,Rhône-Alpes,07,3,28,244,Saint-Jean-Chambre,252,10,262
82,Rhône-Alpes,07,3,24,245,Saint-Jean-de-Muzols,2452,69,2521
82,Rhône-Alpes,07,1,29,247,Saint-Jean-le-Centenier,643,7,650
82,Rhône-Alpes,07,3,18,248,Saint-Jean-Roure,258,5,263
82,Rhône-Alpes,07,3,15,249,Saint-Jeure-d'Andaure,92,2,94
82,Rhône-Alpes,07,3,21,250,Saint-Jeure-d'Ay,444,3,447
82,Rhône-Alpes,07,1,02,251,Saint-Joseph-des-Bancs,187,4,191
82,Rhône-Alpes,07,3,18,252,Saint-Julien-Boutières,214,3,217
82,Rhône-Alpes,07,2,20,253,Saint-Julien-du-Gua,177,4,181
82,Rhône-Alpes,07,1,33,254,Saint-Julien-du-Serre,828,29,857
82,Rhône-Alpes,07,2,07,255,Saint-Julien-en-Saint-Alban,1278,16,1294
82,Rhône-Alpes,07,3,06,256,Saint-Julien-Labrousse,336,8,344
82,Rhône-Alpes,07,3,28,257,Saint-Julien-le-Roux,89,4,93
82,Rhône-Alpes,07,3,32,258,Saint-Julien-Vocance,259,2,261
82,Rhône-Alpes,07,2,04,259,Saint-Just,1498,37,1535
82,Rhône-Alpes,07,2,07,260,Saint-Lager-Bressac,848,33,881
82,Rhône-Alpes,07,2,31,261,Saint-Laurent-du-Pape,1527,44,1571
82,Rhône-Alpes,07,1,16,262,Saint-Laurent-les-Bains,156,4,160
82,Rhône-Alpes,07,1,29,263,Saint-Laurent-sous-Coiron,127,3,130
82,Rhône-Alpes,07,2,04,264,Saint-Marcel-d'Ardèche,2401,90,2491
82,Rhône-Alpes,07,3,01,265,Saint-Marcel-lès-Annonay,1309,32,1341
82,Rhône-Alpes,07,3,18,267,Saint-Martial,256,6,262
82,Rhône-Alpes,07,2,04,268,Saint-Martin-d'Ardèche,860,19,879
82,Rhône-Alpes,07,3,18,269,Saint-Martin-de-Valamas,1279,21,1300
82,Rhône-Alpes,07,2,14,270,Saint-Martin-sur-Lavezon,440,8,448
82,Rhône-Alpes,07,1,29,272,Saint-Maurice-d'Ardèche,302,6,308
82,Rhône-Alpes,07,1,29,273,Saint-Maurice-d'Ibie,201,3,204
82,Rhône-Alpes,07,3,28,274,Saint-Maurice-en-Chalencon,183,5,188
82,Rhône-Alpes,07,1,25,275,Saint-Mélany,126,1,127
82,Rhône-Alpes,07,3,06,276,Saint-Michel-d'Aurance,240,10,250
82,Rhône-Alpes,07,1,33,277,Saint-Michel-de-Boulogne,145,11,156
82,Rhône-Alpes,07,2,31,278,Saint-Michel-de-Chabrillanoux,354,7,361
82,Rhône-Alpes,07,2,04,279,Saint-Montan,1764,52,1816
82,Rhône-Alpes,07,1,27,280,Saint-Paul-le-Jeune,852,18,870
82,Rhône-Alpes,07,3,19,281,Saint-Péray,7268,216,7484
82,Rhône-Alpes,07,1,05,282,Saint-Pierre-de-Colombier,390,39,429
82,Rhône-Alpes,07,2,14,283,Saint-Pierre-la-Roche,52,2,54
82,Rhône-Alpes,07,1,27,284,Saint-Pierre-Saint-Jean,153,3,156
82,Rhône-Alpes,07,3,21,285,Saint-Pierre-sur-Doux,101,2,103
82,Rhône-Alpes,07,2,20,286,Saint-Pierreville,519,10,529
82,Rhône-Alpes,07,1,29,287,Saint-Pons,262,14,276
82,Rhône-Alpes,07,2,13,288,Saint-Priest,1231,57,1288
82,Rhône-Alpes,07,1,33,289,Saint-Privat,1579,32,1611
82,Rhône-Alpes,07,3,10,290,Saint-Prix,253,12,265
82,Rhône-Alpes,07,2,04,291,Saint-Remèze,845,12,857
82,Rhône-Alpes,07,3,21,292,Saint-Romain-d'Ay,973,19,992
82,Rhône-Alpes,07,3,19,293,Saint-Romain-de-Lerps,708,20,728
82,Rhône-Alpes,07,1,27,294,Saint-Sauveur-de-Cruzières,542,9,551
82,Rhône-Alpes,07,2,20,295,Saint-Sauveur-de-Montagut,1149,43,1192
82,Rhône-Alpes,07,1,03,296,Saint-Sernin,1475,39,1514
82,Rhône-Alpes,07,3,19,297,Saint-Sylvestre,475,12,487
82,Rhône-Alpes,07,3,21,299,Saint-Symphorien-de-Mahun,126,8,134
82,Rhône-Alpes,07,2,07,298,Saint-Symphorien-sous-Chomérac,710,26,736
82,Rhône-Alpes,07,2,30,300,Saint-Thomé,383,10,393
82,Rhône-Alpes,07,3,17,301,Saint-Victor,932,22,954
82,Rhône-Alpes,07,2,14,302,Saint-Vincent-de-Barrès,781,40,821
82,Rhône-Alpes,07,2,13,303,Saint-Vincent-de-Durfort,222,3,225
82,Rhône-Alpes,07,1,05,235,Sainte-Eulalie,232,6,238
82,Rhône-Alpes,07,1,27,266,Sainte-Marguerite-Lafigère,80,1,81
82,Rhône-Alpes,07,1,26,304,Salavas,532,12,544
82,Rhône-Alpes,07,1,27,305,Les Salelles,295,9,304
82,Rhône-Alpes,07,1,26,306,Sampzon,217,3,220
82,Rhône-Alpes,07,1,11,307,Sanilhac,382,11,393
82,Rhône-Alpes,07,3,24,308,Sarras,2065,40,2105
82,Rhône-Alpes,07,3,21,309,Satillieu,1611,32,1643
82,Rhône-Alpes,07,3,22,310,Savas,802,36,838
82,Rhône-Alpes,07,2,14,311,Sceautres,141,3,144
82,Rhône-Alpes,07,3,24,312,Sécheras,481,9,490
82,Rhône-Alpes,07,3,22,313,Serrières,1145,13,1158
82,Rhône-Alpes,07,3,28,314,Silhac,340,13,353
82,Rhône-Alpes,07,1,23,315,La Souche,336,9,345
82,Rhône-Alpes,07,3,19,316,Soyons,1947,67,2014
82,Rhône-Alpes,07,3,32,317,Talencieux,922,24,946
82,Rhône-Alpes,07,1,11,318,Tauriers,179,9,188
82,Rhône-Alpes,07,2,30,319,Le Teil,7929,258,8187
82,Rhône-Alpes,07,3,22,321,Thorrenc,232,8,240
82,Rhône-Alpes,07,1,23,322,Thueyts,1168,20,1188
82,Rhône-Alpes,07,3,19,323,Toulaud,1671,30,1701
82,Rhône-Alpes,07,3,24,324,Tournon-sur-Rhône,10607,620,11227
82,Rhône-Alpes,07,1,33,325,Ucel,1894,78,1972
82,Rhône-Alpes,07,1,12,326,Usclades-et-Rieutord,122,4,126
82,Rhône-Alpes,07,1,11,327,Uzer,419,5,424
82,Rhône-Alpes,07,1,26,328,Vagnas,518,16,534
82,Rhône-Alpes,07,1,25,329,Valgorge,454,6,460
82,Rhône-Alpes,07,1,26,330,Vallon-Pont-d'Arc,2380,87,2467
82,Rhône-Alpes,07,1,33,331,Vals-les-Bains,3737,119,3856
82,Rhône-Alpes,07,2,30,332,Valvignères,421,15,436
82,Rhône-Alpes,07,3,32,333,Vanosc,873,18,891
82,Rhône-Alpes,07,1,27,334,Les Vans,2812,60,2872
82,Rhône-Alpes,07,3,17,335,Vaudevant,211,7,218
82,Rhône-Alpes,07,1,09,336,Vernon,218,3,221
82,Rhône-Alpes,07,3,32,337,Vernosc-lès-Annonay,2199,53,2252
82,Rhône-Alpes,07,3,28,338,Vernoux-en-Vivarais,1916,133,2049
82,Rhône-Alpes,07,1,33,339,Vesseaux,1577,54,1631
82,Rhône-Alpes,07,2,13,340,Veyras,1553,91,1644
82,Rhône-Alpes,07,1,29,341,Villeneuve-de-Berg,2845,107,2952
82,Rhône-Alpes,07,3,32,342,Villevocance,1195,22,1217
82,Rhône-Alpes,07,1,11,343,Vinezac,1195,43,1238
82,Rhône-Alpes,07,3,22,344,Vinzieux,368,4,372
82,Rhône-Alpes,07,3,24,345,Vion,885,35,920
82,Rhône-Alpes,07,2,30,346,Viviers,3867,98,3965
82,Rhône-Alpes,07,3,32,347,Vocance,620,11,631
82,Rhône-Alpes,07,1,29,348,Vogüé,906,20,926
82,Rhône-Alpes,07,2,31,349,La Voulte-sur-Rhône,5017,78,5095
21,Champagne-Ardenne,08,2,23,001,Acy-Romance,446,5,451
21,Champagne-Ardenne,08,1,05,003,Aiglemont,1571,48,1619
21,Champagne-Ardenne,08,2,01,004,Aire,224,12,236
21,Champagne-Ardenne,08,2,13,005,Alincourt,126,2,128
21,Champagne-Ardenne,08,4,02,006,Alland'Huy-et-Sausseuil,241,3,244
21,Champagne-Ardenne,08,4,08,007,Les Alleux,81,0,81
21,Champagne-Ardenne,08,2,23,008,Amagne,695,38,733
21,Champagne-Ardenne,08,3,18,009,Amblimont,144,3,147
21,Champagne-Ardenne,08,2,23,010,Ambly-Fleury,137,13,150
21,Champagne-Ardenne,08,1,35,011,Anchamps,234,5,239
21,Champagne-Ardenne,08,3,21,013,Angecourt,332,7,339
21,Champagne-Ardenne,08,2,13,014,Annelles,136,10,146
21,Champagne-Ardenne,08,1,25,015,Antheny,102,3,105
21,Champagne-Ardenne,08,1,25,016,Aouste,202,15,217
21,Champagne-Ardenne,08,4,12,017,Apremont,128,3,131
21,Champagne-Ardenne,08,4,17,018,Ardeuil-et-Montfauxelles,88,0,88
21,Champagne-Ardenne,08,2,23,021,Arnicourt,164,3,167
21,Champagne-Ardenne,08,1,22,022,Arreux,364,10,374
21,Champagne-Ardenne,08,3,21,023,Artaise-le-Vivier,60,0,60
21,Champagne-Ardenne,08,2,01,024,Asfeld,1008,15,1023
21,Champagne-Ardenne,08,4,02,025,Attigny,1195,11,1206
21,Champagne-Ardenne,08,1,25,026,Aubigny-les-Pothées,343,10,353
21,Champagne-Ardenne,08,2,19,027,Auboncourt-Vauzelles,104,1,105
21,Champagne-Ardenne,08,1,11,028,Aubrives,895,22,917
21,Champagne-Ardenne,08,3,04,029,Auflance,89,1,90
21,Champagne-Ardenne,08,1,29,030,Auge,57,4,61
21,Champagne-Ardenne,08,4,17,031,Aure,56,0,56
21,Champagne-Ardenne,08,2,13,032,Aussonce,173,2,175
21,Champagne-Ardenne,08,4,08,033,Authe,91,4,95
21,Champagne-Ardenne,08,3,18,034,Autrecourt-et-Pourron,347,6,353
21,Champagne-Ardenne,08,4,08,035,Autruche,56,3,59
21,Champagne-Ardenne,08,4,17,036,Autry,147,2,149
21,Champagne-Ardenne,08,1,29,037,Auvillers-les-Forges,903,10,913
21,Champagne-Ardenne,08,2,06,038,Avançon,320,9,329
21,Champagne-Ardenne,08,2,01,039,Avaux,471,16,487
21,Champagne-Ardenne,08,1,09,040,Les Ayvelles,886,23,909
21,Champagne-Ardenne,08,1,20,041,Baâlons,196,10,206
21,Champagne-Ardenne,08,1,09,042,Balaives-et-Butz,235,3,238
21,Champagne-Ardenne,08,3,27,043,Balan,1637,50,1687
21,Champagne-Ardenne,08,2,01,044,Balham,142,1,143
21,Champagne-Ardenne,08,4,31,045,Ballay,244,2,246
21,Champagne-Ardenne,08,2,06,046,Banogne-Recouvrance,153,8,161
21,Champagne-Ardenne,08,4,03,049,Bar-lès-Buzancy,111,3,114
21,Champagne-Ardenne,08,1,28,047,Barbaise,105,1,106
21,Champagne-Ardenne,08,2,23,048,Barby,371,16,387
21,Champagne-Ardenne,08,4,03,052,Bayonville,112,2,114
21,Champagne-Ardenne,08,3,27,053,Bazeilles,1995,211,2206
21,Champagne-Ardenne,08,3,18,055,Beaumont-en-Argonne,454,8,462
21,Champagne-Ardenne,08,4,12,056,Beffu-et-le-Morthomme,72,0,72
21,Champagne-Ardenne,08,4,08,057,Belleville-et-Châtillon-sur-Bar,322,39,361
21,Champagne-Ardenne,08,1,15,058,Belval,225,6,231
21,Champagne-Ardenne,08,4,03,059,Belval-Bois-des-Dames,40,3,43
21,Champagne-Ardenne,08,2,01,060,Bergnicourt,172,4,176
21,Champagne-Ardenne,08,4,03,061,La Berlière,47,0,47
21,Champagne-Ardenne,08,2,23,062,Bertoncourt,139,6,145
21,Champagne-Ardenne,08,3,21,063,La Besace,122,9,131
21,Champagne-Ardenne,08,2,23,064,Biermes,256,12,268
21,Champagne-Ardenne,08,3,04,065,Bièvres,63,1,64
21,Champagne-Ardenne,08,2,13,066,Bignicourt,63,2,65
21,Champagne-Ardenne,08,3,04,067,Blagny,1211,27,1238
21,Champagne-Ardenne,08,1,25,069,Blanchefosse-et-Bay,154,1,155
21,Champagne-Ardenne,08,2,01,070,Blanzy-la-Salonnaise,326,3,329
21,Champagne-Ardenne,08,1,24,071,Blombay,116,3,119
21,Champagne-Ardenne,08,1,16,081,Bogny-sur-Meuse,5531,78,5609
21,Champagne-Ardenne,08,3,36,072,Bosseval-et-Briancourt,423,13,436
21,Champagne-Ardenne,08,1,25,073,Bossus-lès-Rumigny,93,0,93
21,Champagne-Ardenne,08,4,17,074,Bouconville,51,2,53
21,Champagne-Ardenne,08,4,08,075,Boult-aux-Bois,146,6,152
21,Champagne-Ardenne,08,1,09,076,Boulzicourt,941,35,976
21,Champagne-Ardenne,08,4,31,077,Bourcq,59,6,65
21,Champagne-Ardenne,08,1,24,078,Bourg-Fidèle,811,15,826
21,Champagne-Ardenne,08,1,09,079,Boutancourt,254,11,265
21,Champagne-Ardenne,08,1,20,080,Bouvellemont,96,4,100
21,Champagne-Ardenne,08,4,17,082,Brécy-Brières,91,1,92
21,Champagne-Ardenne,08,3,18,083,Brévilly,398,3,401
21,Champagne-Ardenne,08,2,01,084,Brienne-sur-Aisne,179,2,181
21,Champagne-Ardenne,08,4,08,085,Brieulles-sur-Bar,225,4,229
21,Champagne-Ardenne,08,4,03,086,Briquenay,128,2,130
21,Champagne-Ardenne,08,1,29,087,Brognon,137,8,145
21,Champagne-Ardenne,08,3,21,088,Bulson,140,1,141
21,Champagne-Ardenne,08,4,03,089,Buzancy,371,10,381
21,Champagne-Ardenne,08,3,04,090,Carignan,3156,62,3218
21,Champagne-Ardenne,08,4,14,092,Cauroy,191,2,193
21,Champagne-Ardenne,08,1,25,094,Cernion,54,0,54
21,Champagne-Ardenne,08,1,20,095,Chagny,172,3,175
21,Champagne-Ardenne,08,1,09,096,Chalandry-Elaire,581,22,603
21,Champagne-Ardenne,08,4,17,097,Challerange,431,11,442
21,Champagne-Ardenne,08,1,09,099,Champigneul-sur-Vence,130,1,131
21,Champagne-Ardenne,08,4,12,098,Champigneulle,68,3,71
21,Champagne-Ardenne,08,1,25,100,Champlin,75,1,76
21,Champagne-Ardenne,08,3,26,101,La Chapelle,164,6,170
21,Champagne-Ardenne,08,2,07,102,Chappes,93,5,98
21,Champagne-Ardenne,08,4,02,103,Charbogne,210,4,214
21,Champagne-Ardenne,08,4,14,104,Chardeny,41,0,41
21,Champagne-Ardenne,08,1,98,105,Charleville-Mézières,50876,1835,52711
21,Champagne-Ardenne,08,1,11,106,Charnois,82,0,82
21,Champagne-Ardenne,08,2,06,107,Château-Porcien,1414,20,1434
21,Champagne-Ardenne,08,4,12,109,Chatel-Chéhéry,163,2,165
21,Champagne-Ardenne,08,2,13,111,Le Châtelet-sur-Retourne,576,10,586
21,Champagne-Ardenne,08,1,24,110,Le Châtelet-sur-Sormonne,166,2,168
21,Champagne-Ardenne,08,2,07,113,Chaumont-Porcien,453,6,459
21,Champagne-Ardenne,08,3,36,114,Chéhéry,137,6,143
21,Champagne-Ardenne,08,3,21,115,Chémery-sur-Bar,446,12,458
21,Champagne-Ardenne,08,4,08,116,Le Chesne,981,57,1038
21,Champagne-Ardenne,08,2,19,117,Chesnois-Auboncourt,162,1,163
21,Champagne-Ardenne,08,3,36,119,Cheveuges,426,18,444
21,Champagne-Ardenne,08,4,12,120,Chevières,50,1,51
21,Champagne-Ardenne,08,1,24,121,Chilly,153,2,155
21,Champagne-Ardenne,08,1,11,122,Chooz,766,23,789
21,Champagne-Ardenne,08,4,02,123,Chuffilly-Roche,89,0,89
21,Champagne-Ardenne,08,1,28,124,Clavy-Warby,351,6,357
21,Champagne-Ardenne,08,1,22,125,Cliron,293,10,303
21,Champagne-Ardenne,08,4,17,128,Condé-lès-Autry,72,2,74
21,Champagne-Ardenne,08,2,06,126,Condé-lès-Herpy,194,1,195
21,Champagne-Ardenne,08,4,31,130,Contreuve,71,5,76
21,Champagne-Ardenne,08,4,12,131,Cornay,80,3,83
21,Champagne-Ardenne,08,2,19,132,Corny-Machéroménil,154,2,156
21,Champagne-Ardenne,08,2,23,133,Coucy,514,6,520
21,Champagne-Ardenne,08,4,02,134,Coulommes-et-Marqueny,94,2,96
21,Champagne-Ardenne,08,4,31,135,La Croix-aux-Bois,116,2,118
21,Champagne-Ardenne,08,3,27,136,Daigny,355,7,362
21,Champagne-Ardenne,08,1,32,137,Damouzy,413,40,453
21,Champagne-Ardenne,08,3,04,138,Les Deux-Villes,257,1,258
21,Champagne-Ardenne,08,1,16,139,Deville,1149,13,1162
21,Champagne-Ardenne,08,1,09,140,Dom-le-Mesnil,1112,22,1134
21,Champagne-Ardenne,08,1,28,141,Dommery,194,6,200
21,Champagne-Ardenne,08,3,36,142,Donchery,2409,36,2445
21,Champagne-Ardenne,08,2,07,143,Doumely-Bégny,96,1,97
21,Champagne-Ardenne,08,2,23,144,Doux,69,0,69
21,Champagne-Ardenne,08,3,18,145,Douzy,1852,39,1891
21,Champagne-Ardenne,08,2,07,146,Draize,102,0,102
21,Champagne-Ardenne,08,4,14,147,Dricourt,87,11,98
21,Champagne-Ardenne,08,2,01,148,L' Écaille,191,0,191
21,Champagne-Ardenne,08,1,25,149,L' Échelle,145,3,148
21,Champagne-Ardenne,08,2,06,150,Écly,187,11,198
21,Champagne-Ardenne,08,4,30,151,Écordal,299,2,301
21,Champagne-Ardenne,08,1,09,152,Élan,79,2,81
21,Champagne-Ardenne,08,3,27,153,Escombres-et-le-Chesnois,337,2,339
21,Champagne-Ardenne,08,1,25,154,Estrebay,80,2,82
21,Champagne-Ardenne,08,1,24,155,Étalle,91,0,91
21,Champagne-Ardenne,08,1,29,156,Éteignières,456,12,468
21,Champagne-Ardenne,08,1,09,158,Étrépigny,258,6,264
21,Champagne-Ardenne,08,3,18,159,Euilly-et-Lombut,110,2,112
21,Champagne-Ardenne,08,1,15,160,Évigny,195,12,207
21,Champagne-Ardenne,08,4,12,161,Exermont,34,1,35
21,Champagne-Ardenne,08,1,15,162,Fagnon,359,10,369
21,Champagne-Ardenne,08,2,19,163,Faissault,201,9,210
21,Champagne-Ardenne,08,4,31,164,Falaise,346,8,354
21,Champagne-Ardenne,08,2,19,165,Faux,55,1,56
21,Champagne-Ardenne,08,1,10,166,Fépin,271,4,275
21,Champagne-Ardenne,08,1,25,167,La Férée,82,0,82
21,Champagne-Ardenne,08,3,04,168,La Ferté-sur-Chiers,187,3,190
21,Champagne-Ardenne,08,1,25,169,Flaignes-Havys,119,7,126
21,Champagne-Ardenne,08,3,26,170,Fleigneux,220,13,233
21,Champagne-Ardenne,08,4,12,171,Fléville,95,6,101
21,Champagne-Ardenne,08,1,29,172,Fligny,190,4,194
21,Champagne-Ardenne,08,1,09,173,Flize,1156,31,1187
21,Champagne-Ardenne,08,3,26,174,Floing,2487,66,2553
21,Champagne-Ardenne,08,1,11,175,Foisches,233,8,241
21,Champagne-Ardenne,08,4,03,176,Fossé,54,5,59
21,Champagne-Ardenne,08,2,07,178,Fraillicourt,217,7,224
21,Champagne-Ardenne,08,3,27,179,Francheval,628,13,641
21,Champagne-Ardenne,08,1,33,180,La Francheville,1591,37,1628
21,Champagne-Ardenne,08,1,25,182,Le Fréty,68,1,69
21,Champagne-Ardenne,08,1,11,183,Fromelennes,1065,29,1094
21,Champagne-Ardenne,08,3,04,184,Fromy,81,3,84
21,Champagne-Ardenne,08,1,10,185,Fumay,3884,75,3959
21,Champagne-Ardenne,08,4,08,186,Germont,43,0,43
21,Champagne-Ardenne,08,1,37,187,Gernelle,343,11,354
21,Champagne-Ardenne,08,1,34,188,Gespunsart,1133,18,1151
21,Champagne-Ardenne,08,1,25,189,Girondelle,150,5,155
21,Champagne-Ardenne,08,1,11,190,Givet,6736,179,6915
21,Champagne-Ardenne,08,3,26,191,Givonne,1128,22,1150
21,Champagne-Ardenne,08,2,07,192,Givron,76,5,81
21,Champagne-Ardenne,08,4,02,193,Givry,236,9,245
21,Champagne-Ardenne,08,3,26,194,Glaire,922,37,959
21,Champagne-Ardenne,08,2,01,195,Gomont,325,4,329
21,Champagne-Ardenne,08,2,19,196,Grandchamp,107,5,112
21,Champagne-Ardenne,08,4,08,019,Les Grandes-Armoises,46,2,48
21,Champagne-Ardenne,08,4,12,197,Grandham,55,2,57
21,Champagne-Ardenne,08,4,12,198,Grandpré,465,22,487
21,Champagne-Ardenne,08,1,37,199,La Grandville,796,15,811
21,Champagne-Ardenne,08,4,31,200,Grivy-Loisy,177,2,179
21,Champagne-Ardenne,08,1,28,201,Gruyères,65,1,66
21,Champagne-Ardenne,08,1,24,202,Gué-d'Hossus,512,1,513
21,Champagne-Ardenne,08,1,09,203,Guignicourt-sur-Vence,299,9,308
21,Champagne-Ardenne,08,4,30,204,Guincourt,96,1,97
21,Champagne-Ardenne,08,2,19,205,Hagnicourt,63,2,65
21,Champagne-Ardenne,08,1,22,206,Ham-les-Moines,357,7,364
21,Champagne-Ardenne,08,1,11,207,Ham-sur-Meuse,250,4,254
21,Champagne-Ardenne,08,1,25,208,Hannappes,159,0,159
21,Champagne-Ardenne,08,1,09,209,Hannogne-Saint-Martin,473,13,486
21,Champagne-Ardenne,08,2,06,210,Hannogne-Saint-Rémy,116,2,118
21,Champagne-Ardenne,08,3,21,211,Haraucourt,773,20,793
21,Champagne-Ardenne,08,1,22,212,Harcy,503,4,507
21,Champagne-Ardenne,08,1,10,214,Hargnies,492,16,508
21,Champagne-Ardenne,08,4,03,215,Harricourt,50,1,51
21,Champagne-Ardenne,08,1,22,216,Haudrecy,306,7,313
21,Champagne-Ardenne,08,1,16,217,Haulmé,82,1,83
21,Champagne-Ardenne,08,1,16,218,Les Hautes-Rivières,1725,39,1764
21,Champagne-Ardenne,08,2,06,219,Hauteville,114,3,117
21,Champagne-Ardenne,08,4,14,220,Hauviné,290,9,299
21,Champagne-Ardenne,08,1,10,222,Haybes,2057,61,2118
21,Champagne-Ardenne,08,3,04,223,Herbeuval,84,3,87
21,Champagne-Ardenne,08,2,06,225,Herpy-l'Arlésienne,192,5,197
21,Champagne-Ardenne,08,1,11,226,Hierges,212,6,218
21,Champagne-Ardenne,08,1,20,228,La Horgne,185,5,190
21,Champagne-Ardenne,08,2,01,229,Houdilcourt,148,2,150
21,Champagne-Ardenne,08,1,32,230,Houldizy,343,14,357
21,Champagne-Ardenne,08,3,26,232,Illy,404,11,415
21,Champagne-Ardenne,08,4,03,233,Imécourt,62,1,63
21,Champagne-Ardenne,08,2,06,234,Inaumont,68,1,69
21,Champagne-Ardenne,08,1,37,235,Issancourt-et-Rumel,404,15,419
21,Champagne-Ardenne,08,1,28,236,Jandun,276,7,283
21,Champagne-Ardenne,08,1,34,237,Joigny-sur-Meuse,704,20,724
21,Champagne-Ardenne,08,4,30,238,Jonval,82,7,89
21,Champagne-Ardenne,08,2,13,239,Juniville,1116,42,1158
21,Champagne-Ardenne,08,2,19,240,Justine-Herbigny,167,5,172
21,Champagne-Ardenne,08,1,16,242,Laifour,515,5,520
21,Champagne-Ardenne,08,1,28,243,Lalobbe,192,9,201
21,Champagne-Ardenne,08,4,30,244,Lametz,80,1,81
21,Champagne-Ardenne,08,4,03,246,Landres-et-Saint-Georges,101,5,106
21,Champagne-Ardenne,08,1,11,247,Landrichamps,141,1,142
21,Champagne-Ardenne,08,4,12,245,Lançon,40,5,45
21,Champagne-Ardenne,08,1,28,248,Launois-sur-Vence,611,48,659
21,Champagne-Ardenne,08,1,24,249,Laval-Morency,244,4,248
21,Champagne-Ardenne,08,4,14,250,Leffincourt,172,1,173
21,Champagne-Ardenne,08,1,25,251,Lépron-les-Vallées,86,0,86
21,Champagne-Ardenne,08,3,18,252,Létanne,126,3,129
21,Champagne-Ardenne,08,1,25,254,Liart,532,18,550
21,Champagne-Ardenne,08,3,04,255,Linay,241,2,243
21,Champagne-Ardenne,08,4,17,256,Liry,107,3,110
21,Champagne-Ardenne,08,1,25,257,Logny-Bogny,183,0,183
21,Champagne-Ardenne,08,4,31,259,Longwé,91,0,91
21,Champagne-Ardenne,08,1,22,260,Lonny,491,12,503
21,Champagne-Ardenne,08,4,08,261,Louvergny,77,4,81
21,Champagne-Ardenne,08,2,19,262,Lucquy,538,26,564
21,Champagne-Ardenne,08,1,37,263,Lumes,1121,41,1162
21,Champagne-Ardenne,08,4,14,264,Machault,497,13,510
21,Champagne-Ardenne,08,3,18,267,Mairy,214,2,216
21,Champagne-Ardenne,08,3,21,268,Maisoncelle-et-Villers,74,2,76
21,Champagne-Ardenne,08,3,04,269,Malandry,65,1,66
21,Champagne-Ardenne,08,4,17,271,Manre,129,2,131
21,Champagne-Ardenne,08,1,28,272,Maranwez,52,2,54
21,Champagne-Ardenne,08,1,25,273,Marby,65,3,68
21,Champagne-Ardenne,08,4,12,274,Marcq,112,3,115
21,Champagne-Ardenne,08,3,04,275,Margny,177,6,183
21,Champagne-Ardenne,08,3,04,276,Margut,790,19,809
21,Champagne-Ardenne,08,1,25,277,Marlemont,143,0,143
21,Champagne-Ardenne,08,4,30,278,Marquigny,66,2,68
21,Champagne-Ardenne,08,4,31,279,Mars-sous-Bourcq,49,1,50
21,Champagne-Ardenne,08,4,17,280,Marvaux-Vieux,65,0,65
21,Champagne-Ardenne,08,3,04,281,Matton-et-Clémency,465,5,470
21,Champagne-Ardenne,08,1,24,282,Maubert-Fontaine,1073,57,1130
21,Champagne-Ardenne,08,1,20,283,Mazerny,118,1,119
21,Champagne-Ardenne,08,1,22,284,Les Mazures,948,23,971
21,Champagne-Ardenne,08,2,13,286,Ménil-Annelles,94,5,99
21,Champagne-Ardenne,08,2,13,287,Ménil-Lépinois,106,2,108
21,Champagne-Ardenne,08,2,19,288,Mesmont,93,8,101
21,Champagne-Ardenne,08,3,04,289,Messincourt,593,13,606
21,Champagne-Ardenne,08,3,04,291,Mogues,147,3,150
21,Champagne-Ardenne,08,3,04,293,Moiry,187,2,189
21,Champagne-Ardenne,08,3,27,294,La Moncelle,132,1,133
21,Champagne-Ardenne,08,1,09,295,Mondigny,181,8,189
21,Champagne-Ardenne,08,3,21,300,Le Mont-Dieu,27,1,28
21,Champagne-Ardenne,08,2,23,306,Mont-Laurent,70,0,70
21,Champagne-Ardenne,08,4,17,308,Mont-Saint-Martin,86,5,91
21,Champagne-Ardenne,08,4,14,309,Mont-Saint-Remy,54,0,54
21,Champagne-Ardenne,08,4,17,296,Montcheutin,143,2,145
21,Champagne-Ardenne,08,1,22,297,Montcornet,267,8,275
21,Champagne-Ardenne,08,1,05,298,Montcy-Notre-Dame,1535,61,1596
21,Champagne-Ardenne,08,4,08,301,Montgon,74,3,77
21,Champagne-Ardenne,08,1,16,302,Monthermé,2498,81,2579
21,Champagne-Ardenne,08,4,17,303,Monthois,382,13,395
21,Champagne-Ardenne,08,1,10,304,Montigny-sur-Meuse,90,3,93
21,Champagne-Ardenne,08,1,20,305,Montigny-sur-Vence,224,4,228
21,Champagne-Ardenne,08,2,07,307,Montmeillant,98,8,106
21,Champagne-Ardenne,08,4,12,310,Mouron,79,6,85
21,Champagne-Ardenne,08,3,18,311,Mouzon,2392,81,2473
21,Champagne-Ardenne,08,1,22,312,Murtin-et-Bogny,180,6,186
21,Champagne-Ardenne,08,2,23,313,Nanteuil-sur-Aisne,121,5,126
21,Champagne-Ardenne,08,2,13,314,Neuflize,724,13,737
21,Champagne-Ardenne,08,1,28,315,Neufmaison,57,2,59
21,Champagne-Ardenne,08,1,34,316,Neufmanil,1191,29,1220
21,Champagne-Ardenne,08,3,21,317,La Neuville-à-Maire,104,3,107
21,Champagne-Ardenne,08,1,29,318,La Neuville-aux-Joûtes,352,12,364
21,Champagne-Ardenne,08,4,30,321,Neuville-Day,163,15,178
21,Champagne-Ardenne,08,2,13,320,La Neuville-en-Tourne-à-Fuy,469,8,477
21,Champagne-Ardenne,08,1,15,322,Neuville-lès-This,402,14,416
21,Champagne-Ardenne,08,2,19,323,La Neuville-lès-Wasigny,158,4,162
21,Champagne-Ardenne,08,1,29,319,Neuville-lez-Beaulieu,324,4,328
21,Champagne-Ardenne,08,2,19,324,Neuvizy,108,3,111
21,Champagne-Ardenne,08,4,08,325,Noirval,34,0,34
21,Champagne-Ardenne,08,4,03,326,Nouart,144,1,145
21,Champagne-Ardenne,08,1,09,327,Nouvion-sur-Meuse,2225,62,2287
21,Champagne-Ardenne,08,1,34,328,Nouzonville,6334,135,6469
21,Champagne-Ardenne,08,2,19,329,Novion-Porcien,492,14,506
21,Champagne-Ardenne,08,2,23,330,Novy-Chevrières,651,23,674
21,Champagne-Ardenne,08,3,36,331,Noyers-Pont-Maugis,718,17,735
21,Champagne-Ardenne,08,4,03,332,Oches,30,1,31
21,Champagne-Ardenne,08,4,12,333,Olizy-Primat,223,1,224
21,Champagne-Ardenne,08,1,09,334,Omicourt,51,0,51
21,Champagne-Ardenne,08,1,20,335,Omont,88,4,92
21,Champagne-Ardenne,08,3,04,336,Osnes,229,2,231
21,Champagne-Ardenne,08,4,14,338,Pauvres,182,4,186
21,Champagne-Ardenne,08,2,13,339,Perthes,292,17,309
21,Champagne-Ardenne,08,4,08,020,Les Petites-Armoises,63,1,64
21,Champagne-Ardenne,08,2,01,340,Poilcourt-Sydney,169,2,171
21,Champagne-Ardenne,08,1,20,341,Poix-Terron,832,23,855
21,Champagne-Ardenne,08,3,27,342,Pouru-aux-Bois,289,5,294
21,Champagne-Ardenne,08,3,27,343,Pouru-Saint-Remy,1232,28,1260
21,Champagne-Ardenne,08,1,25,344,Prez,143,5,148
21,Champagne-Ardenne,08,1,15,346,Prix-lès-Mézières,1328,32,1360
21,Champagne-Ardenne,08,3,04,347,Puilly-et-Charbeaux,257,4,261
21,Champagne-Ardenne,08,2,19,348,Puiseux,103,3,106
21,Champagne-Ardenne,08,3,04,349,Pure,630,6,636
21,Champagne-Ardenne,08,4,31,350,Quatre-Champs,194,8,202
21,Champagne-Ardenne,08,4,14,351,Quilly,85,0,85
21,Champagne-Ardenne,08,1,28,352,Raillicourt,221,6,227
21,Champagne-Ardenne,08,1,11,353,Rancennes,710,26,736
21,Champagne-Ardenne,08,3,21,354,Raucourt-et-Flaba,869,13,882
21,Champagne-Ardenne,08,1,24,355,Regniowez,386,16,402
21,Champagne-Ardenne,08,2,07,356,Remaucourt,155,2,157
21,Champagne-Ardenne,08,3,21,357,Remilly-Aillicourt,830,35,865
21,Champagne-Ardenne,08,1,22,358,Remilly-les-Pothées,268,3,271
21,Champagne-Ardenne,08,2,07,360,Renneville,206,5,211
21,Champagne-Ardenne,08,1,22,361,Renwez,1699,36,1735
21,Champagne-Ardenne,08,2,23,362,Rethel,7740,430,8170
21,Champagne-Ardenne,08,1,35,363,Revin,7462,192,7654
21,Champagne-Ardenne,08,4,02,364,Rilly-sur-Aisne,109,4,113
21,Champagne-Ardenne,08,1,24,365,Rimogne,1427,27,1454
21,Champagne-Ardenne,08,2,07,366,Rocquigny,754,19,773
21,Champagne-Ardenne,08,1,24,367,Rocroi,2386,45,2431
21,Champagne-Ardenne,08,2,01,368,Roizy,247,7,254
21,Champagne-Ardenne,08,2,07,369,La Romagne,125,1,126
21,Champagne-Ardenne,08,1,25,370,Rouvroy-sur-Audry,564,10,574
21,Champagne-Ardenne,08,3,27,371,Rubécourt-et-Lamécourt,162,4,166
21,Champagne-Ardenne,08,2,07,372,Rubigny,75,0,75
21,Champagne-Ardenne,08,1,25,373,Rumigny,377,4,381
21,Champagne-Ardenne,08,4,30,374,La Sabotterie,85,1,86
21,Champagne-Ardenne,08,3,04,375,Sachy,166,6,172
21,Champagne-Ardenne,08,3,04,376,Sailly,220,4,224
21,Champagne-Ardenne,08,3,36,377,Saint-Aignan,141,4,145
21,Champagne-Ardenne,08,4,14,378,Saint-Clément-à-Arnes,105,3,108
21,Champagne-Ardenne,08,4,14,379,Saint-Étienne-à-Arnes,208,4,212
21,Champagne-Ardenne,08,2,06,380,Saint-Fergeux,202,7,209
21,Champagne-Ardenne,08,2,01,381,Saint-Germainmont,800,10,810
21,Champagne-Ardenne,08,2,07,382,Saint-Jean-aux-Bois,142,2,144
21,Champagne-Ardenne,08,4,12,383,Saint-Juvin,111,6,117
21,Champagne-Ardenne,08,4,02,384,Saint-Lambert-et-Mont-de-Jeux,186,1,187
21,Champagne-Ardenne,08,1,37,385,Saint-Laurent,1201,157,1358
21,Champagne-Ardenne,08,2,06,386,Saint-Loup-en-Champagne,247,8,255
21,Champagne-Ardenne,08,4,30,387,Saint-Loup-Terrier,162,7,169
21,Champagne-Ardenne,08,1,09,388,Saint-Marceau,375,16,391
21,Champagne-Ardenne,08,1,22,389,Saint-Marcel,330,9,339
21,Champagne-Ardenne,08,3,36,391,Saint-Menges,1049,16,1065
21,Champagne-Ardenne,08,4,17,392,Saint-Morel,238,6,244
21,Champagne-Ardenne,08,4,14,393,Saint-Pierre-à-Arnes,66,4,70
21,Champagne-Ardenne,08,1,09,395,Saint-Pierre-sur-Vence,158,5,163
21,Champagne-Ardenne,08,4,03,394,Saint-Pierremont,95,7,102
21,Champagne-Ardenne,08,2,06,396,Saint-Quentin-le-Petit,150,9,159
21,Champagne-Ardenne,08,2,01,397,Saint-Remy-le-Petit,40,1,41
21,Champagne-Ardenne,08,4,31,390,Sainte-Marie,79,0,79
21,Champagne-Ardenne,08,4,02,398,Sainte-Vaubourg,97,1,98
21,Champagne-Ardenne,08,1,09,400,Sapogne-et-Feuchères,502,13,515
21,Champagne-Ardenne,08,3,04,399,Sapogne-sur-Marche,147,2,149
21,Champagne-Ardenne,08,4,02,401,Saulces-Champenoises,192,1,193
21,Champagne-Ardenne,08,2,19,402,Saulces-Monclin,646,16,662
21,Champagne-Ardenne,08,2,23,403,Sault-lès-Rethel,1879,29,1908
21,Champagne-Ardenne,08,2,01,404,Sault-Saint-Remy,158,0,158
21,Champagne-Ardenne,08,4,08,405,Sauville,255,0,255
21,Champagne-Ardenne,08,4,17,406,Savigny-sur-Aisne,368,20,388
21,Champagne-Ardenne,08,4,17,407,Séchault,71,3,74
21,Champagne-Ardenne,08,1,22,408,Sécheval,499,11,510
21,Champagne-Ardenne,08,3,99,409,Sedan,19219,519,19738
21,Champagne-Ardenne,08,4,14,410,Semide,213,17,230
21,Champagne-Ardenne,08,4,02,411,Semuy,94,1,95
21,Champagne-Ardenne,08,4,12,412,Senuc,153,5,158
21,Champagne-Ardenne,08,2,06,413,Seraincourt,241,8,249
21,Champagne-Ardenne,08,2,19,415,Sery,340,3,343
21,Champagne-Ardenne,08,2,23,416,Seuil,164,6,170
21,Champagne-Ardenne,08,1,24,417,Sévigny-la-Forêt,249,7,256
21,Champagne-Ardenne,08,2,06,418,Sévigny-Waleppe,253,3,256
21,Champagne-Ardenne,08,1,28,419,Signy-l'Abbaye,1362,38,1400
21,Champagne-Ardenne,08,1,29,420,Signy-le-Petit,1299,31,1330
21,Champagne-Ardenne,08,3,04,421,Signy-Montlibert,77,4,81
21,Champagne-Ardenne,08,1,20,422,Singly,124,6,130
21,Champagne-Ardenne,08,4,03,424,Sommauthe,117,4,121
21,Champagne-Ardenne,08,4,12,425,Sommerance,47,2,49
21,Champagne-Ardenne,08,2,06,426,Son,94,4,98
21,Champagne-Ardenne,08,2,23,427,Sorbon,206,9,215
21,Champagne-Ardenne,08,2,19,428,Sorcy-Bauthémont,141,4,145
21,Champagne-Ardenne,08,1,22,429,Sormonne,568,15,583
21,Champagne-Ardenne,08,3,21,430,Stonne,45,1,46
21,Champagne-Ardenne,08,4,17,431,Sugny,93,3,96
21,Champagne-Ardenne,08,1,15,432,Sury,95,2,97
21,Champagne-Ardenne,08,4,30,433,Suzanne,62,1,63
21,Champagne-Ardenne,08,4,08,434,Sy,43,4,47
21,Champagne-Ardenne,08,2,13,435,Tagnon,951,19,970
21,Champagne-Ardenne,08,1,24,436,Taillette,367,14,381
21,Champagne-Ardenne,08,4,03,437,Tailly,181,4,185
21,Champagne-Ardenne,08,2,06,438,Taizy,107,3,110
21,Champagne-Ardenne,08,4,08,439,Tannay,151,5,156
21,Champagne-Ardenne,08,1,29,440,Tarzy,142,2,144
21,Champagne-Ardenne,08,4,12,441,Termes,135,1,136
21,Champagne-Ardenne,08,4,31,443,Terron-sur-Aisne,116,2,118
21,Champagne-Ardenne,08,3,18,444,Tétaigne,82,7,89
21,Champagne-Ardenne,08,3,36,445,Thelonne,356,4,360
21,Champagne-Ardenne,08,4,03,446,Thénorgues,98,4,102
21,Champagne-Ardenne,08,1,16,448,Thilay,1058,21,1079
21,Champagne-Ardenne,08,1,28,449,Thin-le-Moutier,572,16,588
21,Champagne-Ardenne,08,1,15,450,This,202,7,209
21,Champagne-Ardenne,08,2,01,451,Le Thour,325,3,328
21,Champagne-Ardenne,08,2,23,452,Thugny-Trugny,215,0,215
21,Champagne-Ardenne,08,4,31,453,Toges,92,2,94
21,Champagne-Ardenne,08,1,20,454,Touligny,66,1,67
21,Champagne-Ardenne,08,4,14,455,Tourcelles-Chaumont,96,1,97
21,Champagne-Ardenne,08,1,16,456,Tournavaux,166,5,171
21,Champagne-Ardenne,08,1,22,457,Tournes,1058,44,1102
21,Champagne-Ardenne,08,4,30,458,Tourteron,172,7,179
21,Champagne-Ardenne,08,3,04,459,Tremblois-lès-Carignan,112,0,112
21,Champagne-Ardenne,08,1,24,460,Tremblois-lès-Rocroi,152,1,153
21,Champagne-Ardenne,08,4,31,461,Vandy,176,7,183
21,Champagne-Ardenne,08,4,02,462,Vaux-Champagne,125,5,130
21,Champagne-Ardenne,08,4,03,463,Vaux-en-Dieulet,70,0,70
21,Champagne-Ardenne,08,4,17,464,Vaux-lès-Mouron,81,0,81
21,Champagne-Ardenne,08,3,18,466,Vaux-lès-Mouzon,84,5,89
21,Champagne-Ardenne,08,2,07,465,Vaux-lès-Rubigny,48,1,49
21,Champagne-Ardenne,08,2,19,467,Vaux-Montreuil,106,4,110
21,Champagne-Ardenne,08,1,25,468,Vaux-Villaine,182,3,185
21,Champagne-Ardenne,08,1,20,469,Vendresse,483,7,490
21,Champagne-Ardenne,08,4,03,470,Verpel,89,3,92
21,Champagne-Ardenne,08,4,08,471,Verrières,35,1,36
21,Champagne-Ardenne,08,2,19,472,Viel-Saint-Remy,245,4,249
21,Champagne-Ardenne,08,2,01,473,Vieux-lès-Asfeld,259,8,267
21,Champagne-Ardenne,08,1,37,483,Ville-sur-Lumes,470,18,488
21,Champagne-Ardenne,08,2,13,484,Ville-sur-Retourne,73,7,80
21,Champagne-Ardenne,08,3,27,475,Villers-Cernay,318,0,318
21,Champagne-Ardenne,08,2,01,476,Villers-devant-le-Thour,356,4,360
21,Champagne-Ardenne,08,3,18,477,Villers-devant-Mouzon,112,1,113
21,Champagne-Ardenne,08,1,09,478,Villers-le-Tilleul,258,3,261
21,Champagne-Ardenne,08,2,19,479,Villers-le-Tourneur,185,3,188
21,Champagne-Ardenne,08,1,37,480,Villers-Semeuse,3166,110,3276
21,Champagne-Ardenne,08,3,36,481,Villers-sur-Bar,253,6,259
21,Champagne-Ardenne,08,1,09,482,Villers-sur-le-Mont,99,3,102
21,Champagne-Ardenne,08,3,04,485,Villy,183,7,190
21,Champagne-Ardenne,08,1,11,486,Vireux-Molhain,1674,37,1711
21,Champagne-Ardenne,08,1,11,487,Vireux-Wallerand,1901,74,1975
21,Champagne-Ardenne,08,1,37,488,Vivier-au-Court,3392,146,3538
21,Champagne-Ardenne,08,4,02,489,Voncq,226,7,233
21,Champagne-Ardenne,08,4,31,490,Vouziers,4183,216,4399
21,Champagne-Ardenne,08,3,36,491,Vrigne-aux-Bois,3497,65,3562
21,Champagne-Ardenne,08,1,09,492,Vrigne-Meuse,232,4,236
21,Champagne-Ardenne,08,4,31,493,Vrizy,355,12,367
21,Champagne-Ardenne,08,3,36,494,Wadelincourt,536,14,550
21,Champagne-Ardenne,08,2,19,496,Wagnon,105,3,108
21,Champagne-Ardenne,08,1,15,497,Warcq,1316,49,1365
21,Champagne-Ardenne,08,1,15,498,Warnécourt,372,13,385
21,Champagne-Ardenne,08,2,19,499,Wasigny,348,4,352
21,Champagne-Ardenne,08,2,19,500,Wignicourt,69,1,70
21,Champagne-Ardenne,08,3,04,501,Williers,42,1,43
21,Champagne-Ardenne,08,3,18,502,Yoncq,95,0,95
21,Champagne-Ardenne,08,1,09,503,Yvernaumont,140,2,142
73,Midi-Pyrénées,09,1,02,001,Aigues-Juntes,41,0,41
73,Midi-Pyrénées,09,2,10,002,Aigues-Vives,541,11,552
73,Midi-Pyrénées,09,1,07,003,L' Aiguillon,391,3,394
73,Midi-Pyrénées,09,1,03,004,Albiès,139,0,139
73,Midi-Pyrénées,09,3,09,005,Aleu,146,0,146
73,Midi-Pyrénées,09,1,18,006,Alliat,64,0,64
73,Midi-Pyrénées,09,1,02,007,Allières,63,4,67
73,Midi-Pyrénées,09,3,15,008,Alos,123,2,125
73,Midi-Pyrénées,09,1,02,009,Alzen,210,9,219
73,Midi-Pyrénées,09,3,04,011,Antras,71,0,71
73,Midi-Pyrénées,09,1,03,012,Appy,24,0,24
73,Midi-Pyrénées,09,1,21,013,Arabaux,66,2,68
73,Midi-Pyrénées,09,3,04,014,Argein,169,3,172
73,Midi-Pyrénées,09,1,18,015,Arignac,700,5,705
73,Midi-Pyrénées,09,1,18,016,Arnave,211,4,215
73,Midi-Pyrénées,09,3,04,017,Arrien-en-Bethmale,101,1,102
73,Midi-Pyrénées,09,3,04,018,Arrout,69,3,72
73,Midi-Pyrénées,09,2,06,019,Artigat,540,12,552
73,Midi-Pyrénées,09,1,13,020,Artigues,62,4,66
73,Midi-Pyrénées,09,2,19,021,Artix,106,1,107
73,Midi-Pyrénées,09,2,22,022,Arvigna,196,4,200
73,Midi-Pyrénées,09,1,01,023,Ascou,129,2,131
73,Midi-Pyrénées,09,1,03,024,Aston,228,9,237
73,Midi-Pyrénées,09,3,04,025,Aucazein,63,0,63
73,Midi-Pyrénées,09,3,04,026,Audressein,116,2,118
73,Midi-Pyrénées,09,3,04,027,Augirein,63,0,63
73,Midi-Pyrénées,09,1,03,028,Aulos,54,1,55
73,Midi-Pyrénées,09,3,11,029,Aulus-les-Bains,207,0,207
73,Midi-Pyrénées,09,1,20,030,Auzat,599,10,609
73,Midi-Pyrénées,09,1,01,032,Ax-les-Thermes,1426,78,1504
73,Midi-Pyrénées,09,1,03,031,Axiat,26,1,27
73,Midi-Pyrénées,09,3,14,033,Bagert,58,2,60
73,Midi-Pyrénées,09,3,04,034,Balacet,19,0,19
73,Midi-Pyrénées,09,3,04,035,Balaguères,195,7,202
73,Midi-Pyrénées,09,3,14,037,Barjac,38,3,41
73,Midi-Pyrénées,09,2,08,038,La Bastide-de-Besplas,372,6,378
73,Midi-Pyrénées,09,2,10,039,La Bastide-de-Bousignac,333,8,341
73,Midi-Pyrénées,09,2,17,040,La Bastide-de-Lordat,261,5,266
73,Midi-Pyrénées,09,1,02,042,La Bastide-de-Sérou,959,20,979
73,Midi-Pyrénées,09,3,16,041,La Bastide-du-Salat,197,4,201
73,Midi-Pyrénées,09,2,10,043,La Bastide-sur-l'Hers,718,15,733
73,Midi-Pyrénées,09,1,21,044,Baulou,161,1,162
73,Midi-Pyrénées,09,1,18,045,Bédeilhac-et-Aynat,187,1,188
73,Midi-Pyrénées,09,3,14,046,Bédeille,83,1,84
73,Midi-Pyrénées,09,1,07,047,Bélesta,1106,29,1135
73,Midi-Pyrénées,09,2,10,048,Belloc,66,4,70
73,Midi-Pyrénées,09,1,21,049,Bénac,182,4,186
73,Midi-Pyrénées,09,2,12,050,Benagues,467,9,476
73,Midi-Pyrénées,09,1,07,051,Bénaix,154,6,160
73,Midi-Pyrénées,09,2,10,052,Besset,144,1,145
73,Midi-Pyrénées,09,1,03,053,Bestiac,18,0,18
73,Midi-Pyrénées,09,3,16,054,Betchat,364,9,373
73,Midi-Pyrénées,09,3,04,055,Bethmale,96,1,97
73,Midi-Pyrénées,09,2,12,056,Bézac,281,7,288
73,Midi-Pyrénées,09,3,09,057,Biert,295,10,305
73,Midi-Pyrénées,09,1,18,058,Bompas,203,9,212
73,Midi-Pyrénées,09,3,04,059,Bonac-Irazein,138,6,144
73,Midi-Pyrénées,09,2,22,060,Bonnac,717,28,745
73,Midi-Pyrénées,09,2,08,061,Les Bordes-sur-Arize,528,12,540
73,Midi-Pyrénées,09,3,04,062,Les Bordes-sur-Lez,165,6,171
73,Midi-Pyrénées,09,1,21,063,Le Bosc,108,13,121
73,Midi-Pyrénées,09,1,03,064,Bouan,35,1,36
73,Midi-Pyrénées,09,3,09,065,Boussenac,188,12,200
73,Midi-Pyrénées,09,1,21,066,Brassac,626,57,683
73,Midi-Pyrénées,09,2,17,067,Brie,175,3,178
73,Midi-Pyrénées,09,1,21,068,Burret,38,0,38
73,Midi-Pyrénées,09,3,04,069,Buzan,24,2,26
73,Midi-Pyrénées,09,1,03,070,Les Cabannes,347,3,350
73,Midi-Pyrénées,09,1,02,071,Cadarcet,231,8,239
73,Midi-Pyrénées,09,2,19,072,Calzan,28,0,28
73,Midi-Pyrénées,09,2,08,073,Camarade,156,3,159
73,Midi-Pyrénées,09,2,10,074,Camon,164,3,167
73,Midi-Pyrénées,09,2,08,075,Campagne-sur-Arize,265,4,269
73,Midi-Pyrénées,09,2,17,076,Canté,203,2,205
73,Midi-Pyrénées,09,1,18,077,Capoulet-et-Junac,179,6,185
73,Midi-Pyrénées,09,1,13,078,Carcanières,53,0,53
73,Midi-Pyrénées,09,2,06,079,Carla-Bayle,745,20,765
73,Midi-Pyrénées,09,1,07,080,Carla-de-Roquefort,158,1,159
73,Midi-Pyrénées,09,2,22,081,Le Carlaret,209,3,212
73,Midi-Pyrénées,09,3,15,082,Castelnau-Durban,413,14,427
73,Midi-Pyrénées,09,2,06,083,Castéras,31,1,32
73,Midi-Pyrénées,09,2,08,084,Castex,95,3,98
73,Midi-Pyrénées,09,3,04,085,Castillon-en-Couserans,402,6,408
73,Midi-Pyrénées,09,3,16,086,Caumont,309,5,314
73,Midi-Pyrénées,09,1,03,087,Caussou,66,2,68
73,Midi-Pyrénées,09,1,03,088,Caychax,11,0,11
73,Midi-Pyrénées,09,2,10,089,Cazals-des-Baylès,39,1,40
73,Midi-Pyrénées,09,2,19,090,Cazaux,44,1,45
73,Midi-Pyrénées,09,3,16,091,Cazavet,201,3,204
73,Midi-Pyrénées,09,1,18,092,Cazenave-Serres-et-Allens,48,3,51
73,Midi-Pyrénées,09,1,21,093,Celles,116,2,118
73,Midi-Pyrénées,09,3,14,094,Cérizols,153,5,158
73,Midi-Pyrénées,09,3,04,095,Cescau,138,7,145
73,Midi-Pyrénées,09,1,03,096,Château-Verdun,54,1,55
73,Midi-Pyrénées,09,3,15,097,Clermont,86,2,88
73,Midi-Pyrénées,09,3,14,098,Contrazy,64,0,64
73,Midi-Pyrénées,09,1,21,099,Cos,364,17,381
73,Midi-Pyrénées,09,3,11,100,Couflens,84,2,86
73,Midi-Pyrénées,09,2,19,101,Coussa,217,3,220
73,Midi-Pyrénées,09,2,10,102,Coutens,151,7,158
73,Midi-Pyrénées,09,2,19,103,Crampagna,604,15,619
73,Midi-Pyrénées,09,2,19,104,Dalou,831,28,859
73,Midi-Pyrénées,09,2,08,105,Daumazan-sur-Arize,715,19,734
73,Midi-Pyrénées,09,1,07,106,Dreuilhe,375,5,380
73,Midi-Pyrénées,09,2,10,107,Dun,575,16,591
73,Midi-Pyrénées,09,1,02,108,Durban-sur-Arize,152,4,156
73,Midi-Pyrénées,09,2,06,109,Durfort,173,1,174
73,Midi-Pyrénées,09,3,15,110,Encourtiech,106,2,108
73,Midi-Pyrénées,09,3,04,111,Engomer,275,4,279
73,Midi-Pyrénées,09,3,11,113,Ercé,550,3,553
73,Midi-Pyrénées,09,3,15,114,Erp,130,1,131
73,Midi-Pyrénées,09,2,10,115,Esclagne,111,3,114
73,Midi-Pyrénées,09,2,12,116,Escosse,400,4,404
73,Midi-Pyrénées,09,2,17,117,Esplas,92,5,97
73,Midi-Pyrénées,09,3,15,118,Esplas-de-Sérou,157,6,163
73,Midi-Pyrénées,09,3,15,119,Eycheil,526,12,538
73,Midi-Pyrénées,09,3,14,120,Fabas,319,2,321
73,Midi-Pyrénées,09,1,21,121,Ferrières-sur-Ariège,804,96,900
73,Midi-Pyrénées,09,1,05,122,Foix,9712,455,10167
73,Midi-Pyrénées,09,2,08,123,Fornex,109,3,112
73,Midi-Pyrénées,09,2,06,124,Le Fossat,1010,19,1029
73,Midi-Pyrénées,09,1,07,125,Fougax-et-Barrineuf,513,4,517
73,Midi-Pyrénées,09,1,21,126,Freychenet,98,0,98
73,Midi-Pyrénées,09,2,08,127,Gabre,93,2,95
73,Midi-Pyrénées,09,3,16,128,Gajan,297,18,315
73,Midi-Pyrénées,09,3,04,129,Galey,113,0,113
73,Midi-Pyrénées,09,1,21,130,Ganac,672,22,694
73,Midi-Pyrénées,09,1,03,131,Garanou,167,6,173
73,Midi-Pyrénées,09,2,17,132,Gaudiès,230,6,236
73,Midi-Pyrénées,09,1,18,133,Génat,34,1,35
73,Midi-Pyrénées,09,1,20,134,Gestiès,9,0,9
73,Midi-Pyrénées,09,1,20,135,Goulier,47,2,49
73,Midi-Pyrénées,09,1,18,136,Gourbit,92,1,93
73,Midi-Pyrénées,09,2,19,137,Gudas,138,3,141
73,Midi-Pyrénées,09,1,21,138,L' Herm,188,38,226
73,Midi-Pyrénées,09,1,01,139,L' Hospitalet-près-l'Andorre,89,2,91
73,Midi-Pyrénées,09,1,01,140,Ignaux,82,1,83
73,Midi-Pyrénées,09,1,07,142,Ilhat,123,3,126
73,Midi-Pyrénées,09,3,04,141,Illartein,77,0,77
73,Midi-Pyrénées,09,1,20,143,Illier-et-Laramade,21,0,21
73,Midi-Pyrénées,09,2,22,145,Les Issards,242,4,246
73,Midi-Pyrénées,09,2,17,146,Justiniac,50,3,53
73,Midi-Pyrénées,09,2,17,147,Labatut,128,6,134
73,Midi-Pyrénées,09,3,16,148,Lacave,120,5,125
73,Midi-Pyrénées,09,3,15,149,Lacourt,201,7,208
73,Midi-Pyrénées,09,2,10,150,Lagarde,180,4,184
73,Midi-Pyrénées,09,2,06,151,Lanoux,48,5,53
73,Midi-Pyrénées,09,1,18,152,Lapège,28,2,30
73,Midi-Pyrénées,09,2,10,153,Lapenne,116,1,117
73,Midi-Pyrénées,09,1,02,154,Larbont,39,2,41
73,Midi-Pyrénées,09,1,03,155,Larcat,39,3,42
73,Midi-Pyrénées,09,1,03,156,Larnat,18,1,19
73,Midi-Pyrénées,09,2,10,157,Laroque-d'Olmes,2712,61,2773
73,Midi-Pyrénées,09,3,14,158,Lasserre,191,2,193
73,Midi-Pyrénées,09,1,03,159,Lassur,67,1,68
73,Midi-Pyrénées,09,1,07,160,Lavelanet,6747,293,7040
73,Midi-Pyrénées,09,2,10,161,Léran,545,23,568
73,Midi-Pyrénées,09,1,20,162,Lercoul,27,0,27
73,Midi-Pyrénées,09,2,12,163,Lescousse,88,1,89
73,Midi-Pyrénées,09,3,15,164,Lescure,503,9,512
73,Midi-Pyrénées,09,1,07,165,Lesparrou,243,8,251
73,Midi-Pyrénées,09,1,07,166,Leychert,107,2,109
73,Midi-Pyrénées,09,2,06,167,Lézat-sur-Lèze,2282,34,2316
73,Midi-Pyrénées,09,1,07,168,Lieurac,153,9,162
73,Midi-Pyrénées,09,2,10,169,Limbrassac,113,2,115
73,Midi-Pyrénées,09,2,17,170,Lissac,208,2,210
73,Midi-Pyrénées,09,1,03,171,Lordat,35,0,35
73,Midi-Pyrénées,09,3,16,289,Lorp-Sentaraille,1251,50,1301
73,Midi-Pyrénées,09,2,08,172,Loubaut,31,0,31
73,Midi-Pyrénées,09,2,19,173,Loubens,254,9,263
73,Midi-Pyrénées,09,1,21,174,Loubières,207,4,211
73,Midi-Pyrénées,09,2,22,175,Ludiès,77,8,85
73,Midi-Pyrénées,09,1,03,176,Luzenac,607,12,619
73,Midi-Pyrénées,09,2,12,177,Madière,203,9,212
73,Midi-Pyrénées,09,2,10,178,Malegoude,61,2,63
73,Midi-Pyrénées,09,2,19,179,Malléon,49,1,50
73,Midi-Pyrénées,09,2,10,180,Manses,122,7,129
73,Midi-Pyrénées,09,2,08,181,Le Mas-d'Azil,1226,15,1241
73,Midi-Pyrénées,09,3,09,182,Massat,710,11,721
73,Midi-Pyrénées,09,3,16,183,Mauvezin-de-Prat,81,2,83
73,Midi-Pyrénées,09,3,14,184,Mauvezin-de-Sainte-Croix,43,0,43
73,Midi-Pyrénées,09,2,17,185,Mazères,3413,104,3517
73,Midi-Pyrénées,09,2,08,186,Méras,83,2,85
73,Midi-Pyrénées,09,3,16,187,Mercenac,338,7,345
73,Midi-Pyrénées,09,1,18,188,Mercus-Garrabet,1143,18,1161
73,Midi-Pyrénées,09,1,01,189,Mérens-les-Vals,186,3,189
73,Midi-Pyrénées,09,3,14,190,Mérigon,124,3,127
73,Midi-Pyrénées,09,1,18,192,Miglos,107,2,109
73,Midi-Pyrénées,09,1,13,193,Mijanès,92,1,93
73,Midi-Pyrénées,09,2,10,194,Mirepoix,3123,154,3277
73,Midi-Pyrénées,09,2,06,195,Monesple,26,0,26
73,Midi-Pyrénées,09,1,02,196,Montagagne,43,0,43
73,Midi-Pyrénées,09,1,01,197,Montaillou,25,1,26
73,Midi-Pyrénées,09,3,14,198,Montardit,188,3,191
73,Midi-Pyrénées,09,2,17,199,Montaut,674,13,687
73,Midi-Pyrénées,09,2,10,200,Montbel,109,4,113
73,Midi-Pyrénées,09,3,15,201,Montégut-en-Couserans,69,6,75
73,Midi-Pyrénées,09,2,19,202,Montégut-Plantaurel,320,6,326
73,Midi-Pyrénées,09,1,02,203,Montels,154,5,159
73,Midi-Pyrénées,09,3,16,204,Montesquieu-Avantès,239,2,241
73,Midi-Pyrénées,09,2,08,205,Montfa,80,0,80
73,Midi-Pyrénées,09,1,07,206,Montferrier,647,22,669
73,Midi-Pyrénées,09,1,21,207,Montgaillard,1341,38,1379
73,Midi-Pyrénées,09,3,16,208,Montgauch,115,3,118
73,Midi-Pyrénées,09,3,16,209,Montjoie-en-Couserans,1045,34,1079
73,Midi-Pyrénées,09,1,21,210,Montoulieu,364,5,369
73,Midi-Pyrénées,09,1,07,211,Montségur,108,4,112
73,Midi-Pyrénées,09,1,02,212,Montseron,83,0,83
73,Midi-Pyrénées,09,2,10,213,Moulin-Neuf,197,2,199
73,Midi-Pyrénées,09,3,15,214,Moulis,793,17,810
73,Midi-Pyrénées,09,1,07,215,Nalzen,127,1,128
73,Midi-Pyrénées,09,1,02,216,Nescus,70,3,73
73,Midi-Pyrénées,09,1,18,217,Niaux,193,5,198
73,Midi-Pyrénées,09,1,01,218,Orgeix,101,3,104
73,Midi-Pyrénées,09,3,04,219,Orgibet,171,4,175
73,Midi-Pyrénées,09,1,01,220,Orlu,194,4,198
73,Midi-Pyrénées,09,1,18,221,Ornolac-Ussat-les-Bains,230,0,230
73,Midi-Pyrénées,09,1,20,222,Orus,22,0,22
73,Midi-Pyrénées,09,3,11,223,Oust,533,15,548
73,Midi-Pyrénées,09,2,06,224,Pailhès,383,12,395
73,Midi-Pyrénées,09,2,99,225,Pamiers,15857,943,16800
73,Midi-Pyrénées,09,1,03,226,Pech,34,1,35
73,Midi-Pyrénées,09,1,07,227,Péreille,185,5,190
73,Midi-Pyrénées,09,1,01,228,Perles-et-Castelet,187,6,193
73,Midi-Pyrénées,09,2,10,229,Le Peyrat,476,9,485
73,Midi-Pyrénées,09,1,13,230,Le Pla,67,3,70
73,Midi-Pyrénées,09,3,09,231,Le Port,204,3,207
73,Midi-Pyrénées,09,1,01,232,Prades,50,0,50
73,Midi-Pyrénées,09,2,10,233,Pradettes,38,0,38
73,Midi-Pyrénées,09,1,21,234,Pradières,107,2,109
73,Midi-Pyrénées,09,3,16,235,Prat-Bonrepaux,851,22,873
73,Midi-Pyrénées,09,1,21,236,Prayols,359,19,378
73,Midi-Pyrénées,09,1,13,237,Le Puch,30,0,30
73,Midi-Pyrénées,09,2,22,238,Les Pujols,656,9,665
73,Midi-Pyrénées,09,1,13,239,Quérigut,139,2,141
73,Midi-Pyrénées,09,1,18,240,Quié,325,4,329
73,Midi-Pyrénées,09,1,18,241,Rabat-les-Trois-Seigneurs,307,8,315
73,Midi-Pyrénées,09,1,07,242,Raissac,42,2,44
73,Midi-Pyrénées,09,2,10,243,Régat,81,6,87
73,Midi-Pyrénées,09,2,10,244,Rieucros,573,21,594
73,Midi-Pyrénées,09,2,19,245,Rieux-de-Pelleport,1170,48,1218
73,Midi-Pyrénées,09,3,15,246,Rimont,555,14,569
73,Midi-Pyrénées,09,3,15,247,Rivèrenert,182,3,185
73,Midi-Pyrénées,09,1,07,249,Roquefixade,147,2,149
73,Midi-Pyrénées,09,1,07,250,Roquefort-les-Cascades,100,2,102
73,Midi-Pyrénées,09,2,10,251,Roumengoux,147,4,151
73,Midi-Pyrénées,09,1,13,252,Rouze,91,8,99
73,Midi-Pyrénées,09,2,08,253,Sabarat,351,5,356
73,Midi-Pyrénées,09,2,22,254,Saint-Amadou,227,5,232
73,Midi-Pyrénées,09,2,12,255,Saint-Amans,48,0,48
73,Midi-Pyrénées,09,2,19,256,Saint-Bauzeil,56,0,56
73,Midi-Pyrénées,09,2,19,258,Saint-Félix-de-Rieutord,413,12,425
73,Midi-Pyrénées,09,2,10,259,Saint-Félix-de-Tournegat,136,4,140
73,Midi-Pyrénées,09,3,15,261,Saint-Girons,6579,498,7077
73,Midi-Pyrénées,09,1,07,262,Saint-Jean-d'Aigues-Vives,404,8,412
73,Midi-Pyrénées,09,1,21,264,Saint-Jean-de-Verges,1100,39,1139
73,Midi-Pyrénées,09,3,04,263,Saint-Jean-du-Castillonnais,26,0,26
73,Midi-Pyrénées,09,2,12,265,Saint-Jean-du-Falga,2627,77,2704
73,Midi-Pyrénées,09,2,10,266,Saint-Julien-de-Gras-Capou,67,1,68
73,Midi-Pyrénées,09,3,04,267,Saint-Lary,155,3,158
73,Midi-Pyrénées,09,3,16,268,Saint-Lizier,1466,49,1515
73,Midi-Pyrénées,09,2,12,270,Saint-Martin-d'Oydes,253,3,256
73,Midi-Pyrénées,09,1,21,269,Saint-Martin-de-Caralp,349,9,358
73,Midi-Pyrénées,09,2,12,271,Saint-Michel,80,0,80
73,Midi-Pyrénées,09,1,21,272,Saint-Paul-de-Jarrat,1246,30,1276
73,Midi-Pyrénées,09,1,21,273,Saint-Pierre-de-Rivière,665,37,702
73,Midi-Pyrénées,09,2,10,274,Saint-Quentin-la-Tour,326,14,340
73,Midi-Pyrénées,09,2,17,275,Saint-Quirc,357,5,362
73,Midi-Pyrénées,09,2,12,276,Saint-Victor-Rouzaud,224,2,226
73,Midi-Pyrénées,09,2,06,277,Saint-Ybars,649,15,664
73,Midi-Pyrénées,09,3,14,257,Sainte-Croix-Volvestre,666,14,680
73,Midi-Pyrénées,09,2,10,260,Sainte-Foi,28,1,29
73,Midi-Pyrénées,09,2,06,342,Sainte-Suzanne,242,8,250
73,Midi-Pyrénées,09,3,04,279,Salsein,46,1,47
73,Midi-Pyrénées,09,1,18,280,Saurat,596,16,612
73,Midi-Pyrénées,09,1,07,281,Sautel,123,3,126
73,Midi-Pyrénées,09,2,17,282,Saverdun,4435,132,4567
73,Midi-Pyrénées,09,1,01,283,Savignac-les-Ormeaux,395,8,403
73,Midi-Pyrénées,09,2,19,284,Ségura,165,4,169
73,Midi-Pyrénées,09,3,11,285,Seix,816,28,844
73,Midi-Pyrénées,09,1,20,286,Sem,29,1,30
73,Midi-Pyrénées,09,1,03,287,Senconac,5,0,5
73,Midi-Pyrénées,09,3,04,290,Sentein,146,3,149
73,Midi-Pyrénées,09,3,11,291,Sentenac-d'Oust,88,8,96
73,Midi-Pyrénées,09,1,02,292,Sentenac-de-Sérou,35,2,37
73,Midi-Pyrénées,09,1,21,293,Serres-sur-Arget,779,25,804
73,Midi-Pyrénées,09,2,06,294,Sieuras,80,4,84
73,Midi-Pyrénées,09,1,20,295,Siguer,86,1,87
73,Midi-Pyrénées,09,1,03,296,Sinsat,110,1,111
73,Midi-Pyrénées,09,3,04,297,Sor,31,1,32
73,Midi-Pyrénées,09,1,01,298,Sorgeat,96,5,101
73,Midi-Pyrénées,09,3,11,299,Soueix-Rogalle,375,11,386
73,Midi-Pyrénées,09,1,21,300,Soula,210,0,210
73,Midi-Pyrénées,09,3,09,301,Soulan,345,16,361
73,Midi-Pyrénées,09,1,20,302,Suc-et-Sentenac,60,1,61
73,Midi-Pyrénées,09,1,18,303,Surba,347,6,353
73,Midi-Pyrénées,09,1,02,304,Suzan,22,0,22
73,Midi-Pyrénées,09,2,10,305,Tabre,351,12,363
73,Midi-Pyrénées,09,1,18,306,Tarascon-sur-Ariège,3495,61,3556
73,Midi-Pyrénées,09,3,16,307,Taurignan-Castet,157,2,159
73,Midi-Pyrénées,09,3,16,308,Taurignan-Vieux,215,6,221
73,Midi-Pyrénées,09,2,10,309,Teilhet,184,1,185
73,Midi-Pyrénées,09,2,08,310,Thouars-sur-Arize,49,0,49
73,Midi-Pyrénées,09,1,01,311,Tignac,25,1,26
73,Midi-Pyrénées,09,2,22,312,La Tour-du-Crieu,2457,83,2540
73,Midi-Pyrénées,09,3,14,313,Tourtouse,160,8,168
73,Midi-Pyrénées,09,2,10,314,Tourtrol,242,4,246
73,Midi-Pyrénées,09,2,17,315,Trémoulet,85,1,86
73,Midi-Pyrénées,09,2,10,316,Troye-d'Ariège,86,3,89
73,Midi-Pyrénées,09,3,04,317,Uchentein,35,0,35
73,Midi-Pyrénées,09,1,03,318,Unac,122,2,124
73,Midi-Pyrénées,09,2,12,319,Unzent,123,1,124
73,Midi-Pyrénées,09,1,03,320,Urs,42,0,42
73,Midi-Pyrénées,09,1,18,321,Ussat,320,5,325
73,Midi-Pyrénées,09,3,11,322,Ustou,346,6,352
73,Midi-Pyrénées,09,2,10,323,Vals,86,1,87
73,Midi-Pyrénées,09,2,19,324,Varilhes,2867,83,2950
73,Midi-Pyrénées,09,1,01,325,Vaychis,30,0,30
73,Midi-Pyrénées,09,1,03,326,Vèbre,141,3,144
73,Midi-Pyrénées,09,2,19,327,Ventenac,226,9,235
73,Midi-Pyrénées,09,1,03,328,Verdun,233,8,241
73,Midi-Pyrénées,09,1,21,329,Vernajoul,688,33,721
73,Midi-Pyrénées,09,1,03,330,Vernaux,33,0,33
73,Midi-Pyrénées,09,2,17,331,Le Vernet,632,22,654
73,Midi-Pyrénées,09,2,19,332,Verniolle,2242,71,2313
73,Midi-Pyrénées,09,1,20,334,Vicdessos,511,51,562
73,Midi-Pyrénées,09,3,04,335,Villeneuve,38,0,38
73,Midi-Pyrénées,09,1,07,336,Villeneuve-d'Olmes,1164,19,1183
73,Midi-Pyrénées,09,2,06,338,Villeneuve-du-Latou,115,2,117
73,Midi-Pyrénées,09,2,22,339,Villeneuve-du-Paréage,630,14,644
73,Midi-Pyrénées,09,2,19,340,Vira,158,2,160
73,Midi-Pyrénées,09,2,10,341,Viviès,112,4,116
21,Champagne-Ardenne,10,1,03,002,Ailleville,272,6,278
21,Champagne-Ardenne,10,3,01,003,Aix-en-Othe,2400,37,2437
21,Champagne-Ardenne,10,3,02,004,Allibaudières,258,32,290
21,Champagne-Ardenne,10,1,25,005,Amance,260,5,265
21,Champagne-Ardenne,10,3,02,006,Arcis-sur-Aube,3019,84,3103
21,Champagne-Ardenne,10,1,03,007,Arconville,118,3,121
21,Champagne-Ardenne,10,1,25,008,Argançon,104,5,109
21,Champagne-Ardenne,10,3,19,009,Arrelles,83,2,85
21,Champagne-Ardenne,10,1,08,010,Arrembécourt,45,1,46
21,Champagne-Ardenne,10,1,03,011,Arrentières,204,7,211
21,Champagne-Ardenne,10,1,03,012,Arsonval,338,8,346
21,Champagne-Ardenne,10,3,05,013,Assenay,151,2,153
21,Champagne-Ardenne,10,3,17,014,Assencières,181,4,185
21,Champagne-Ardenne,10,3,02,015,Aubeterre,225,14,239
21,Champagne-Ardenne,10,1,08,017,Aulnay,111,4,115
21,Champagne-Ardenne,10,3,09,018,Auxon,971,18,989
21,Champagne-Ardenne,10,2,13,020,Avant-lès-Marcilly,484,5,489
21,Champagne-Ardenne,10,3,18,021,Avant-lès-Ramerupt,147,2,149
21,Champagne-Ardenne,10,3,19,022,Avirey-Lingey,223,3,226
21,Champagne-Ardenne,10,2,13,023,Avon-la-Pèze,171,5,176
21,Champagne-Ardenne,10,3,07,024,Avreuil,167,3,170
21,Champagne-Ardenne,10,3,19,025,Bagneux-la-Fosse,179,4,183
21,Champagne-Ardenne,10,1,08,026,Bailly-le-Franc,31,0,31
21,Champagne-Ardenne,10,1,08,027,Balignicourt,84,2,86
21,Champagne-Ardenne,10,3,07,028,Balnot-la-Grange,156,7,163
21,Champagne-Ardenne,10,3,19,029,Balnot-sur-Laignes,157,2,159
21,Champagne-Ardenne,10,1,03,033,Bar-sur-Aube,5403,220,5623
21,Champagne-Ardenne,10,3,04,034,Bar-sur-Seine,3374,192,3566
21,Champagne-Ardenne,10,3,29,030,Barberey-Saint-Sulpice,1193,28,1221
21,Champagne-Ardenne,10,2,26,031,Barbuise,404,8,412
21,Champagne-Ardenne,10,1,03,032,Baroville,353,13,366
21,Champagne-Ardenne,10,1,03,035,Bayel,860,14,874
21,Champagne-Ardenne,10,3,11,037,Bercenay-en-Othe,389,11,400
21,Champagne-Ardenne,10,2,13,038,Bercenay-le-Hayer,137,9,146
21,Champagne-Ardenne,10,1,03,039,Bergères,121,3,124
21,Champagne-Ardenne,10,3,07,040,Bernon,200,2,202
21,Champagne-Ardenne,10,3,10,041,Bertignolles,68,1,69
21,Champagne-Ardenne,10,3,01,042,Bérulle,252,4,256
21,Champagne-Ardenne,10,2,14,043,Bessy,131,1,132
21,Champagne-Ardenne,10,1,06,044,Bétignicourt,31,1,32
21,Champagne-Ardenne,10,3,10,045,Beurey,186,6,192
21,Champagne-Ardenne,10,1,06,046,Blaincourt-sur-Aube,96,2,98
21,Champagne-Ardenne,10,1,06,047,Blignicourt,46,4,50
21,Champagne-Ardenne,10,1,25,048,Bligny,203,4,207
21,Champagne-Ardenne,10,3,05,049,Les Bordes-Aumont,431,5,436
21,Champagne-Ardenne,10,1,25,050,Bossancourt,206,9,215
21,Champagne-Ardenne,10,3,05,051,Bouilly,1039,47,1086
21,Champagne-Ardenne,10,2,14,052,Boulages,229,9,238
21,Champagne-Ardenne,10,3,12,053,Bouranton,504,11,515
21,Champagne-Ardenne,10,2,13,054,Bourdenay,103,2,105
21,Champagne-Ardenne,10,3,04,055,Bourguignons,279,5,284
21,Champagne-Ardenne,10,3,17,056,Bouy-Luxembourg,190,2,192
21,Champagne-Ardenne,10,2,16,057,Bouy-sur-Orvin,62,1,63
21,Champagne-Ardenne,10,3,19,058,Bragelogne-Beauvoir,278,6,284
21,Champagne-Ardenne,10,1,08,059,Braux,108,11,119
21,Champagne-Ardenne,10,3,32,060,Bréviandes,2212,49,2261
21,Champagne-Ardenne,10,3,17,061,Brévonnes,687,15,702
21,Champagne-Ardenne,10,3,04,062,Briel-sur-Barse,192,4,196
21,Champagne-Ardenne,10,1,06,063,Brienne-la-Vieille,450,14,464
21,Champagne-Ardenne,10,1,06,064,Brienne-le-Château,3142,83,3225
21,Champagne-Ardenne,10,3,18,065,Brillecourt,88,1,89
21,Champagne-Ardenne,10,3,11,066,Bucey-en-Othe,426,4,430
21,Champagne-Ardenne,10,3,05,067,Buchères,1414,34,1448
21,Champagne-Ardenne,10,3,04,068,Buxeuil,139,4,143
21,Champagne-Ardenne,10,3,10,069,Buxières-sur-Arce,156,4,160
21,Champagne-Ardenne,10,3,15,070,Celles-sur-Ource,459,12,471
21,Champagne-Ardenne,10,3,10,071,Chacenay,62,4,66
21,Champagne-Ardenne,10,1,21,072,La Chaise,35,1,36
21,Champagne-Ardenne,10,1,08,073,Chalette-sur-Voire,141,7,148
21,Champagne-Ardenne,10,3,09,074,Chamoy,474,3,477
21,Champagne-Ardenne,10,1,25,078,Champ-sur-Barse,32,0,32
21,Champagne-Ardenne,10,2,14,075,Champfleury,163,3,166
21,Champagne-Ardenne,10,1,03,076,Champignol-lez-Mondeville,338,5,343
21,Champagne-Ardenne,10,3,02,077,Champigny-sur-Aube,84,3,87
21,Champagne-Ardenne,10,3,19,079,Channes,127,5,132
21,Champagne-Ardenne,10,3,07,080,Chaource,1104,12,1116
21,Champagne-Ardenne,10,3,96,081,La Chapelle-Saint-Luc,13203,211,13414
21,Champagne-Ardenne,10,2,14,082,Chapelle-Vallon,201,3,204
21,Champagne-Ardenne,10,3,04,083,Chappes,308,7,315
21,Champagne-Ardenne,10,3,02,084,Charmont-sous-Barbuise,983,13,996
21,Champagne-Ardenne,10,2,13,085,Charmoy,58,0,58
21,Champagne-Ardenne,10,2,14,086,Charny-le-Bachot,185,4,189
21,Champagne-Ardenne,10,3,07,087,Chaserey,48,2,50
21,Champagne-Ardenne,10,2,14,089,Châtres,597,12,609
21,Champagne-Ardenne,10,2,14,090,Chauchigny,252,4,256
21,Champagne-Ardenne,10,3,18,091,Chaudrey,153,5,158
21,Champagne-Ardenne,10,3,04,092,Chauffour-lès-Bailly,114,0,114
21,Champagne-Ardenne,10,1,21,093,Chaumesnil,84,1,85
21,Champagne-Ardenne,10,1,08,094,Chavanges,661,20,681
21,Champagne-Ardenne,10,3,02,095,Le Chêne,246,3,249
21,Champagne-Ardenne,10,3,11,096,Chennegy,470,13,483
21,Champagne-Ardenne,10,3,10,097,Chervey,191,2,193
21,Champagne-Ardenne,10,3,07,098,Chesley,339,13,352
21,Champagne-Ardenne,10,3,09,099,Chessy-les-Prés,525,13,538
21,Champagne-Ardenne,10,3,12,100,Clérey,1124,26,1150
21,Champagne-Ardenne,10,3,18,101,Coclois,192,3,195
21,Champagne-Ardenne,10,1,21,102,Colombé-la-Fosse,218,5,223
21,Champagne-Ardenne,10,1,03,103,Colombé-le-Sec,137,3,140
21,Champagne-Ardenne,10,3,05,104,Cormost,283,4,287
21,Champagne-Ardenne,10,1,06,105,Courcelles-sur-Voire,37,0,37
21,Champagne-Ardenne,10,2,16,106,Courceroy,108,3,111
21,Champagne-Ardenne,10,3,09,107,Coursan-en-Othe,99,6,105
21,Champagne-Ardenne,10,3,09,108,Courtaoult,76,4,80
21,Champagne-Ardenne,10,3,04,109,Courtenot,213,9,222
21,Champagne-Ardenne,10,3,12,110,Courteranges,594,2,596
21,Champagne-Ardenne,10,3,15,111,Courteron,121,3,124
21,Champagne-Ardenne,10,3,07,112,Coussegrey,162,7,169
21,Champagne-Ardenne,10,1,03,113,Couvignon,245,2,247
21,Champagne-Ardenne,10,2,20,114,Crancey,811,16,827
21,Champagne-Ardenne,10,3,23,115,Creney-près-Troyes,1566,36,1602
21,Champagne-Ardenne,10,3,05,116,Crésantignes,273,6,279
21,Champagne-Ardenne,10,1,21,117,Crespy-le-Neuf,149,8,157
21,Champagne-Ardenne,10,3,09,118,Les Croûtes,103,0,103
21,Champagne-Ardenne,10,3,10,119,Cunfin,212,8,220
21,Champagne-Ardenne,10,3,07,120,Cussangy,205,1,206
21,Champagne-Ardenne,10,3,18,121,Dampierre,298,7,305
21,Champagne-Ardenne,10,3,09,122,Davrey,251,6,257
21,Champagne-Ardenne,10,1,06,123,Dienville,809,15,824
21,Champagne-Ardenne,10,2,13,124,Dierrey-Saint-Julien,262,2,264
21,Champagne-Ardenne,10,2,13,125,Dierrey-Saint-Pierre,196,2,198
21,Champagne-Ardenne,10,1,25,126,Dolancourt,141,8,149
21,Champagne-Ardenne,10,3,18,127,Dommartin-le-Coq,65,1,66
21,Champagne-Ardenne,10,1,08,128,Donnement,87,6,93
21,Champagne-Ardenne,10,3,17,129,Dosches,288,7,295
21,Champagne-Ardenne,10,3,18,130,Dosnon,107,2,109
21,Champagne-Ardenne,10,2,14,131,Droupt-Saint-Basle,306,7,313
21,Champagne-Ardenne,10,2,14,132,Droupt-Sainte-Marie,237,5,242
21,Champagne-Ardenne,10,3,09,133,Eaux-Puiseaux,234,1,235
21,Champagne-Ardenne,10,2,13,134,Échemines,82,0,82
21,Champagne-Ardenne,10,1,21,135,Éclance,124,2,126
21,Champagne-Ardenne,10,3,10,136,Éguilly-sous-Bois,117,1,118
21,Champagne-Ardenne,10,1,03,137,Engente,44,1,45
21,Champagne-Ardenne,10,1,06,138,Épagne,109,4,113
21,Champagne-Ardenne,10,1,21,139,Épothémont,168,3,171
21,Champagne-Ardenne,10,3,09,140,Ervy-le-Châtel,1207,17,1224
21,Champagne-Ardenne,10,3,10,141,Essoyes,696,22,718
21,Champagne-Ardenne,10,3,11,142,Estissac,1796,28,1824
21,Champagne-Ardenne,10,3,07,143,Étourvy,222,6,228
21,Champagne-Ardenne,10,2,14,144,Étrelles-sur-Aube,132,6,138
21,Champagne-Ardenne,10,2,13,145,Faux-Villecerf,223,7,230
21,Champagne-Ardenne,10,2,13,146,Fay-lès-Marcilly,106,0,106
21,Champagne-Ardenne,10,3,05,147,Fays-la-Chapelle,152,4,156
21,Champagne-Ardenne,10,2,16,148,Ferreux-Quincey,340,5,345
21,Champagne-Ardenne,10,3,02,149,Feuges,228,2,230
21,Champagne-Ardenne,10,1,03,150,Fontaine,296,8,304
21,Champagne-Ardenne,10,2,14,151,Fontaine-les-Grès,866,13,879
21,Champagne-Ardenne,10,2,16,153,Fontaine-Mâcon,527,12,539
21,Champagne-Ardenne,10,2,16,154,Fontenay-de-Bossery,81,3,84
21,Champagne-Ardenne,10,3,10,155,Fontette,179,8,187
21,Champagne-Ardenne,10,3,11,156,Fontvannes,566,7,573
21,Champagne-Ardenne,10,2,20,157,La Fosse-Corduan,214,3,217
21,Champagne-Ardenne,10,3,04,158,Fouchères,494,22,516
21,Champagne-Ardenne,10,3,04,159,Fralignes,73,1,74
21,Champagne-Ardenne,10,1,25,160,Fravaux,50,1,51
21,Champagne-Ardenne,10,1,21,161,Fresnay,45,3,48
21,Champagne-Ardenne,10,3,12,162,Fresnoy-le-Château,244,3,247
21,Champagne-Ardenne,10,1,21,163,Fuligny,51,1,52
21,Champagne-Ardenne,10,2,20,164,Gélannes,720,19,739
21,Champagne-Ardenne,10,3,17,165,Géraudot,292,6,298
21,Champagne-Ardenne,10,2,14,166,Les Grandes-Chapelles,364,6,370
21,Champagne-Ardenne,10,3,18,167,Grandville,88,0,88
21,Champagne-Ardenne,10,3,07,168,Les Granges,79,1,80
21,Champagne-Ardenne,10,2,16,169,Gumery,226,8,234
21,Champagne-Ardenne,10,3,15,170,Gyé-sur-Seine,521,10,531
21,Champagne-Ardenne,10,1,06,171,Hampigny,259,9,268
21,Champagne-Ardenne,10,3,02,172,Herbisse,180,12,192
21,Champagne-Ardenne,10,3,18,174,Isle-Aubigny,151,5,156
21,Champagne-Ardenne,10,3,05,173,Isle-Aumont,510,9,519
21,Champagne-Ardenne,10,1,08,175,Jasseines,153,6,159
21,Champagne-Ardenne,10,1,03,176,Jaucourt,181,12,193
21,Champagne-Ardenne,10,3,05,177,Javernant,158,1,159
21,Champagne-Ardenne,10,1,25,178,Jessains,264,16,280
21,Champagne-Ardenne,10,3,05,179,Jeugny,451,4,455
21,Champagne-Ardenne,10,1,08,180,Joncreuil,92,1,93
21,Champagne-Ardenne,10,3,04,181,Jully-sur-Sarce,298,8,306
21,Champagne-Ardenne,10,1,03,182,Juvancourt,160,6,166
21,Champagne-Ardenne,10,1,25,183,Juvanzé,31,2,33
21,Champagne-Ardenne,10,1,21,184,Juzanvigny,124,0,124
21,Champagne-Ardenne,10,3,07,185,Lagesse,184,4,188
21,Champagne-Ardenne,10,3,31,186,Laines-aux-Bois,510,16,526
21,Champagne-Ardenne,10,3,10,187,Landreville,533,11,544
21,Champagne-Ardenne,10,3,07,188,Lantages,244,6,250
21,Champagne-Ardenne,10,1,06,189,Lassicourt,60,1,61
21,Champagne-Ardenne,10,3,12,190,Laubressel,443,9,452
21,Champagne-Ardenne,10,3,23,191,Lavau,799,19,818
21,Champagne-Ardenne,10,1,08,192,Lentilles,95,1,96
21,Champagne-Ardenne,10,1,06,193,Lesmont,356,8,364
21,Champagne-Ardenne,10,1,21,194,Lévigny,108,4,112
21,Champagne-Ardenne,10,3,18,195,Lhuître,266,8,274
21,Champagne-Ardenne,10,3,07,196,Lignières,226,8,234
21,Champagne-Ardenne,10,1,03,197,Lignol-le-Château,203,6,209
21,Champagne-Ardenne,10,3,05,198,Lirey,89,3,92
21,Champagne-Ardenne,10,3,10,199,Loches-sur-Ource,363,13,376
21,Champagne-Ardenne,10,1,25,200,La Loge-aux-Chèvres,79,2,81
21,Champagne-Ardenne,10,3,07,201,La Loge-Pomblin,68,1,69
21,Champagne-Ardenne,10,3,07,202,Les Loges-Margueron,226,47,273
21,Champagne-Ardenne,10,1,03,203,Longchamp-sur-Aujon,416,9,425
21,Champagne-Ardenne,10,3,05,204,Longeville-sur-Mogne,106,5,111
21,Champagne-Ardenne,10,3,10,205,Longpré-le-Sec,85,0,85
21,Champagne-Ardenne,10,3,18,206,Longsols,127,3,130
21,Champagne-Ardenne,10,2,14,207,Longueville-sur-Aube,131,2,133
21,Champagne-Ardenne,10,2,16,208,La Louptière-Thénard,261,10,271
21,Champagne-Ardenne,10,3,12,209,Lusigny-sur-Barse,1699,55,1754
21,Champagne-Ardenne,10,3,17,210,Luyères,437,8,445
21,Champagne-Ardenne,10,3,28,211,Macey,856,22,878
21,Champagne-Ardenne,10,3,05,212,Machy,103,4,107
21,Champagne-Ardenne,10,3,10,213,Magnant,178,10,188
21,Champagne-Ardenne,10,1,08,214,Magnicourt,67,2,69
21,Champagne-Ardenne,10,1,25,215,Magny-Fouchard,246,9,255
21,Champagne-Ardenne,10,3,02,216,Mailly-le-Camp,1675,23,1698
21,Champagne-Ardenne,10,1,25,217,Maison-des-Champs,41,0,41
21,Champagne-Ardenne,10,3,07,218,Maisons-lès-Chaource,181,4,185
21,Champagne-Ardenne,10,1,21,219,Maisons-lès-Soulaines,78,2,80
21,Champagne-Ardenne,10,2,20,220,Maizières-la-Grande-Paroisse,1402,40,1442
21,Champagne-Ardenne,10,1,06,221,Maizières-lès-Brienne,171,6,177
21,Champagne-Ardenne,10,3,01,222,Maraye-en-Othe,501,8,509
21,Champagne-Ardenne,10,2,13,223,Marcilly-le-Hayer,667,17,684
21,Champagne-Ardenne,10,2,13,224,Marigny-le-Châtel,1558,31,1589
21,Champagne-Ardenne,10,2,16,225,Marnay-sur-Seine,246,4,250
21,Champagne-Ardenne,10,3,04,226,Marolles-lès-Bailly,106,2,108
21,Champagne-Ardenne,10,3,09,227,Marolles-sous-Lignières,315,7,322
21,Champagne-Ardenne,10,1,06,228,Mathaux,234,4,238
21,Champagne-Ardenne,10,3,05,229,Maupas,97,1,98
21,Champagne-Ardenne,10,3,23,230,Mergey,668,17,685
21,Champagne-Ardenne,10,2,16,231,Le Mériot,566,13,579
21,Champagne-Ardenne,10,3,04,232,Merrey-sur-Arce,331,9,340
21,Champagne-Ardenne,10,2,14,233,Méry-sur-Seine,1365,64,1429
21,Champagne-Ardenne,10,2,14,234,Mesgrigny,233,4,237
21,Champagne-Ardenne,10,3,18,235,Mesnil-la-Comtesse,36,0,36
21,Champagne-Ardenne,10,3,18,236,Mesnil-Lettre,60,4,64
21,Champagne-Ardenne,10,2,13,237,Mesnil-Saint-Loup,540,37,577
21,Champagne-Ardenne,10,3,12,238,Mesnil-Saint-Père,400,8,408
21,Champagne-Ardenne,10,3,17,239,Mesnil-Sellières,545,12,557
21,Champagne-Ardenne,10,3,11,240,Messon,430,8,438
21,Champagne-Ardenne,10,3,07,241,Metz-Robert,55,1,56
21,Champagne-Ardenne,10,1,25,242,Meurville,179,3,182
21,Champagne-Ardenne,10,1,06,243,Molins-sur-Aube,114,3,117
21,Champagne-Ardenne,10,3,12,245,Montaulin,722,8,730
21,Champagne-Ardenne,10,3,05,246,Montceaux-lès-Vaudes,249,41,290
21,Champagne-Ardenne,10,3,09,247,Montfey,135,2,137
21,Champagne-Ardenne,10,3,28,248,Montgueux,404,11,415
21,Champagne-Ardenne,10,1,03,250,Montier-en-l'Isle,204,10,214
21,Champagne-Ardenne,10,3,12,249,Montiéramey,455,8,463
21,Champagne-Ardenne,10,3,09,251,Montigny-les-Monts,263,2,265
21,Champagne-Ardenne,10,3,10,252,Montmartin-le-Haut,58,0,58
21,Champagne-Ardenne,10,1,08,253,Montmorency-Beaufort,123,7,130
21,Champagne-Ardenne,10,2,26,254,Montpothier,319,5,324
21,Champagne-Ardenne,10,3,12,255,Montreuil-sur-Barse,289,7,296
21,Champagne-Ardenne,10,3,02,256,Montsuzain,342,14,356
21,Champagne-Ardenne,10,3,18,257,Morembert,48,0,48
21,Champagne-Ardenne,10,1,21,258,Morvilliers,288,8,296
21,Champagne-Ardenne,10,2,16,259,La Motte-Tilly,367,4,371
21,Champagne-Ardenne,10,3,05,260,Moussey,520,6,526
21,Champagne-Ardenne,10,3,15,261,Mussy-sur-Seine,1176,36,1212
21,Champagne-Ardenne,10,3,15,262,Neuville-sur-Seine,377,9,386
21,Champagne-Ardenne,10,3,11,263,Neuville-sur-Vanne,433,6,439
21,Champagne-Ardenne,10,3,10,264,Noë-les-Mallets,117,6,123
21,Champagne-Ardenne,10,3,33,265,Les Noës-près-Troyes,3168,39,3207
21,Champagne-Ardenne,10,3,01,266,Nogent-en-Othe,35,1,36
21,Champagne-Ardenne,10,3,18,267,Nogent-sur-Aube,347,5,352
21,Champagne-Ardenne,10,2,16,268,Nogent-sur-Seine,6060,139,6199
21,Champagne-Ardenne,10,3,02,269,Nozay,134,9,143
21,Champagne-Ardenne,10,3,17,270,Onjon,243,5,248
21,Champagne-Ardenne,10,2,20,271,Origny-le-Sec,620,20,640
21,Champagne-Ardenne,10,3,02,272,Ormes,200,7,207
21,Champagne-Ardenne,10,3,18,273,Ortillon,35,0,35
21,Champagne-Ardenne,10,2,20,274,Orvilliers-Saint-Julien,290,4,294
21,Champagne-Ardenne,10,2,20,275,Ossey-les-Trois-Maisons,573,8,581
21,Champagne-Ardenne,10,3,01,276,Paisy-Cosdon,318,9,327
21,Champagne-Ardenne,10,2,13,277,Palis,603,11,614
21,Champagne-Ardenne,10,3,07,278,Pargues,121,2,123
21,Champagne-Ardenne,10,1,08,279,Pars-lès-Chavanges,70,5,75
21,Champagne-Ardenne,10,2,20,280,Pars-lès-Romilly,764,13,777
21,Champagne-Ardenne,10,3,29,281,Le Pavillon-Sainte-Julie,317,7,324
21,Champagne-Ardenne,10,3,29,282,Payns,1170,49,1219
21,Champagne-Ardenne,10,1,06,283,Pel-et-Der,146,3,149
21,Champagne-Ardenne,10,2,26,284,Périgny-la-Rose,107,3,110
21,Champagne-Ardenne,10,1,06,285,Perthes-lès-Brienne,76,6,82
21,Champagne-Ardenne,10,1,21,286,Petit-Mesnil,236,9,245
21,Champagne-Ardenne,10,3,17,287,Piney,1255,17,1272
21,Champagne-Ardenne,10,3,15,288,Plaines-Saint-Lange,313,2,315
21,Champagne-Ardenne,10,2,14,289,Plancy-l'Abbaye,941,24,965
21,Champagne-Ardenne,10,2,13,290,Planty,189,3,192
21,Champagne-Ardenne,10,2,26,291,Plessis-Barbuise,153,2,155
21,Champagne-Ardenne,10,3,02,293,Poivres,168,2,170
21,Champagne-Ardenne,10,3,04,294,Poligny,65,0,65
21,Champagne-Ardenne,10,3,15,295,Polisot,341,5,346
21,Champagne-Ardenne,10,3,15,296,Polisy,182,12,194
21,Champagne-Ardenne,10,3,23,297,Pont-Sainte-Marie,4797,157,4954
21,Champagne-Ardenne,10,2,16,298,Pont-sur-Seine,990,14,1004
21,Champagne-Ardenne,10,3,02,299,Pouan-les-Vallées,489,11,500
21,Champagne-Ardenne,10,3,18,300,Pougy,274,7,281
21,Champagne-Ardenne,10,2,13,301,Pouy-sur-Vannes,144,1,145
21,Champagne-Ardenne,10,3,07,302,Praslin,66,3,69
21,Champagne-Ardenne,10,1,06,303,Précy-Notre-Dame,77,4,81
21,Champagne-Ardenne,10,1,06,304,Précy-Saint-Martin,209,5,214
21,Champagne-Ardenne,10,2,14,305,Prémierfait,104,5,109
21,Champagne-Ardenne,10,1,03,306,Proverville,266,13,279
21,Champagne-Ardenne,10,3,11,307,Prugny,421,5,426
21,Champagne-Ardenne,10,2,13,308,Prunay-Belleville,220,7,227
21,Champagne-Ardenne,10,3,07,309,Prusy,106,3,109
21,Champagne-Ardenne,10,3,10,310,Puits-et-Nuisement,198,6,204
21,Champagne-Ardenne,10,3,09,312,Racines,191,3,194
21,Champagne-Ardenne,10,1,06,313,Radonvilliers,375,8,383
21,Champagne-Ardenne,10,3,18,314,Ramerupt,385,10,395
21,Champagne-Ardenne,10,1,06,315,Rances,42,0,42
21,Champagne-Ardenne,10,2,14,316,Rhèges,220,4,224
21,Champagne-Ardenne,10,3,19,317,Les Riceys,1354,61,1415
21,Champagne-Ardenne,10,2,13,318,Rigny-la-Nonneuse,140,0,140
21,Champagne-Ardenne,10,3,01,319,Rigny-le-Ferron,374,9,383
21,Champagne-Ardenne,10,2,14,320,Rilly-Sainte-Syre,250,2,252
21,Champagne-Ardenne,10,3,28,321,La Rivière-de-Corps,2924,173,3097
21,Champagne-Ardenne,10,2,97,323,Romilly-sur-Seine,13803,249,14052
21,Champagne-Ardenne,10,3,05,324,Roncenay,134,5,139
21,Champagne-Ardenne,10,3,32,325,Rosières-près-Troyes,2987,314,3301
21,Champagne-Ardenne,10,1,06,326,Rosnay-l'Hôpital,221,8,229
21,Champagne-Ardenne,10,1,21,327,La Rothière,106,1,107
21,Champagne-Ardenne,10,3,17,328,Rouilly-Sacey,328,3,331
21,Champagne-Ardenne,10,3,12,329,Rouilly-Saint-Loup,535,54,589
21,Champagne-Ardenne,10,1,03,330,Rouvres-les-Vignes,123,7,130
21,Champagne-Ardenne,10,3,04,331,Rumilly-lès-Vaudes,465,9,474
21,Champagne-Ardenne,10,3,12,332,Ruvigny,427,12,439
21,Champagne-Ardenne,10,3,31,333,Saint-André-les-Vergers,11154,258,11412
21,Champagne-Ardenne,10,2,16,334,Saint-Aubin,580,11,591
21,Champagne-Ardenne,10,3,01,335,Saint-Benoist-sur-Vanne,234,5,239
21,Champagne-Ardenne,10,3,23,336,Saint-Benoît-sur-Seine,398,18,416
21,Champagne-Ardenne,10,1,06,337,Saint-Christophe-Dodinicourt,37,2,39
21,Champagne-Ardenne,10,3,02,338,Saint-Étienne-sous-Barbuise,134,5,139
21,Champagne-Ardenne,10,2,13,339,Saint-Flavy,262,5,267
21,Champagne-Ardenne,10,3,31,340,Saint-Germain,2315,46,2361
21,Champagne-Ardenne,10,2,20,341,Saint-Hilaire-sous-Romilly,381,23,404
21,Champagne-Ardenne,10,3,05,342,Saint-Jean-de-Bonneval,396,7,403
21,Champagne-Ardenne,10,3,32,343,Saint-Julien-les-Villas,6782,161,6943
21,Champagne-Ardenne,10,3,05,344,Saint-Léger-près-Troyes,700,14,714
21,Champagne-Ardenne,10,1,06,345,Saint-Léger-sous-Brienne,391,8,399
21,Champagne-Ardenne,10,1,08,346,Saint-Léger-sous-Margerie,59,4,63
21,Champagne-Ardenne,10,2,20,347,Saint-Loup-de-Buffigny,181,5,186
21,Champagne-Ardenne,10,2,13,348,Saint-Lupien,235,7,242
21,Champagne-Ardenne,10,3,29,349,Saint-Lyé,2873,64,2937
21,Champagne-Ardenne,10,3,01,350,Saint-Mards-en-Othe,648,4,652
21,Champagne-Ardenne,10,2,20,351,Saint-Martin-de-Bossenay,385,9,394
21,Champagne-Ardenne,10,2,14,353,Saint-Mesmin,868,8,876
21,Champagne-Ardenne,10,3,18,354,Saint-Nabord-sur-Aube,129,2,131
21,Champagne-Ardenne,10,2,16,355,Saint-Nicolas-la-Chapelle,77,2,79
21,Champagne-Ardenne,10,2,14,356,Saint-Oulph,209,2,211
21,Champagne-Ardenne,10,3,22,357,Saint-Parres-aux-Tertres,2854,80,2934
21,Champagne-Ardenne,10,3,04,358,Saint-Parres-lès-Vaudes,984,26,1010
21,Champagne-Ardenne,10,3,09,359,Saint-Phal,533,10,543
21,Champagne-Ardenne,10,3,05,360,Saint-Pouange,886,210,1096
21,Champagne-Ardenne,10,3,02,361,Saint-Remy-sous-Barbuise,173,1,174
21,Champagne-Ardenne,10,3,05,363,Saint-Thibault,466,9,475
21,Champagne-Ardenne,10,3,10,364,Saint-Usage,88,3,91
21,Champagne-Ardenne,10,3,23,352,Sainte-Maure,1421,262,1683
21,Champagne-Ardenne,10,3,28,362,Sainte-Savine,10097,395,10492
21,Champagne-Ardenne,10,2,14,365,Salon,150,5,155
21,Champagne-Ardenne,10,1,21,366,Saulcy,86,1,87
21,Champagne-Ardenne,10,2,26,367,La Saulsotte,620,5,625
21,Champagne-Ardenne,10,2,14,368,Savières,915,16,931
21,Champagne-Ardenne,10,3,02,369,Semoine,219,2,221
21,Champagne-Ardenne,10,2,16,370,Soligny-les-Étangs,220,6,226
21,Champagne-Ardenne,10,3,05,371,Sommeval,321,6,327
21,Champagne-Ardenne,10,1,21,372,Soulaines-Dhuys,303,11,314
21,Champagne-Ardenne,10,3,05,373,Souligny,412,15,427
21,Champagne-Ardenne,10,1,25,374,Spoy,149,8,157
21,Champagne-Ardenne,10,3,12,375,Thennelières,336,6,342
21,Champagne-Ardenne,10,3,10,376,Thieffrain,158,1,159
21,Champagne-Ardenne,10,1,21,377,Thil,158,3,161
21,Champagne-Ardenne,10,1,21,378,Thors,77,4,81
21,Champagne-Ardenne,10,3,02,379,Torcy-le-Grand,420,15,435
21,Champagne-Ardenne,10,3,02,380,Torcy-le-Petit,80,0,80
21,Champagne-Ardenne,10,3,28,381,Torvilliers,852,21,873
21,Champagne-Ardenne,10,2,16,382,Traînel,1036,25,1061
21,Champagne-Ardenne,10,2,13,383,Trancault,206,4,210
21,Champagne-Ardenne,10,1,25,384,Trannes,263,8,271
21,Champagne-Ardenne,10,3,18,386,Trouans,225,3,228
21,Champagne-Ardenne,10,3,99,387,Troyes,61544,1611,63155
21,Champagne-Ardenne,10,3,07,388,Turgy,40,1,41
21,Champagne-Ardenne,10,1,25,389,Unienville,111,2,113
21,Champagne-Ardenne,10,1,03,390,Urville,151,5,156
21,Champagne-Ardenne,10,3,23,391,Vailly,280,3,283
21,Champagne-Ardenne,10,3,17,019,Val-d'Auzon,399,2,401
21,Champagne-Ardenne,10,2,14,392,Vallant-Saint-Georges,384,1,385
21,Champagne-Ardenne,10,1,06,393,Vallentigny,210,7,217
21,Champagne-Ardenne,10,3,07,394,Vallières,138,1,139
21,Champagne-Ardenne,10,3,07,395,Vanlay,310,5,315
21,Champagne-Ardenne,10,3,11,396,Vauchassis,518,11,529
21,Champagne-Ardenne,10,1,25,397,Vauchonvilliers,134,0,134
21,Champagne-Ardenne,10,3,18,398,Vaucogne,82,2,84
21,Champagne-Ardenne,10,3,04,399,Vaudes,606,7,613
21,Champagne-Ardenne,10,3,18,400,Vaupoisson,144,5,149
21,Champagne-Ardenne,10,1,25,401,Vendeuvre-sur-Barse,2385,66,2451
21,Champagne-Ardenne,10,3,05,402,La Vendue-Mignot,236,7,243
21,Champagne-Ardenne,10,1,21,403,Vernonvilliers,83,3,86
21,Champagne-Ardenne,10,3,10,404,Verpillières-sur-Ource,117,7,124
21,Champagne-Ardenne,10,3,18,405,Verricourt,43,1,44
21,Champagne-Ardenne,10,3,12,406,Verrières,1685,41,1726
21,Champagne-Ardenne,10,2,14,408,Viâpres-le-Petit,125,2,127
21,Champagne-Ardenne,10,3,23,409,Villacerf,487,13,500
21,Champagne-Ardenne,10,2,13,410,Villadin,132,4,136
21,Champagne-Ardenne,10,1,21,411,La Ville-aux-Bois,19,1,20
21,Champagne-Ardenne,10,1,03,426,Ville-sous-la-Ferté,1258,27,1285
21,Champagne-Ardenne,10,3,04,427,Ville-sur-Arce,245,10,255
21,Champagne-Ardenne,10,1,21,428,Ville-sur-Terre,129,3,132
21,Champagne-Ardenne,10,3,22,412,Villechétif,831,19,850
21,Champagne-Ardenne,10,3,29,414,Villeloup,130,0,130
21,Champagne-Ardenne,10,3,11,415,Villemaur-sur-Vanne,490,15,505
21,Champagne-Ardenne,10,3,05,416,Villemereuil,239,8,247
21,Champagne-Ardenne,10,3,01,417,Villemoiron-en-Othe,222,8,230
21,Champagne-Ardenne,10,3,04,418,Villemorien,199,2,201
21,Champagne-Ardenne,10,3,04,419,Villemoyenne,691,2,693
21,Champagne-Ardenne,10,2,26,420,Villenauxe-la-Grande,2748,64,2812
21,Champagne-Ardenne,10,2,26,421,La Villeneuve-au-Châtelot,135,0,135
21,Champagne-Ardenne,10,3,09,422,Villeneuve-au-Chemin,187,6,193
21,Champagne-Ardenne,10,1,25,423,La Villeneuve-au-Chêne,431,6,437
21,Champagne-Ardenne,10,1,08,424,Villeret,67,1,68
21,Champagne-Ardenne,10,3,05,425,Villery,276,7,283
21,Champagne-Ardenne,10,3,02,429,Villette-sur-Aube,223,6,229
21,Champagne-Ardenne,10,3,02,430,Villiers-Herbisse,95,2,97
21,Champagne-Ardenne,10,3,07,431,Villiers-le-Bois,98,2,100
21,Champagne-Ardenne,10,3,04,432,Villiers-sous-Praslin,73,3,76
21,Champagne-Ardenne,10,3,04,433,Villy-en-Trodes,250,3,253
21,Champagne-Ardenne,10,3,05,434,Villy-le-Bois,62,0,62
21,Champagne-Ardenne,10,3,05,435,Villy-le-Maréchal,150,2,152
21,Champagne-Ardenne,10,3,18,436,Vinets,170,13,183
21,Champagne-Ardenne,10,3,04,437,Virey-sous-Bar,645,11,656
21,Champagne-Ardenne,10,3,10,438,Vitry-le-Croisé,265,7,272
21,Champagne-Ardenne,10,3,10,439,Viviers-sur-Artaut,112,6,118
21,Champagne-Ardenne,10,1,03,440,Voigny,183,6,189
21,Champagne-Ardenne,10,3,09,441,Vosnon,195,5,200
21,Champagne-Ardenne,10,3,02,442,Voué,548,6,554
21,Champagne-Ardenne,10,3,07,443,Vougrey,52,1,53
21,Champagne-Ardenne,10,3,01,444,Vulaines,222,5,227
21,Champagne-Ardenne,10,1,06,445,Yèvres-le-Petit,74,1,75
91,Languedoc-Roussillon,11,1,25,001,Aigues-Vives,514,9,523
91,Languedoc-Roussillon,11,1,09,002,Airoux,126,1,127
91,Languedoc-Roussillon,11,2,20,003,Ajac,229,6,235
91,Languedoc-Roussillon,11,2,01,004,Alaigne,338,9,347
91,Languedoc-Roussillon,11,1,22,005,Alairac,1246,18,1264
91,Languedoc-Roussillon,11,3,15,006,Albas,77,1,78
91,Languedoc-Roussillon,11,1,23,007,Albières,93,7,100
91,Languedoc-Roussillon,11,2,20,008,Alet-les-Bains,435,8,443
91,Languedoc-Roussillon,11,1,02,009,Alzonne,1240,33,1273
91,Languedoc-Roussillon,11,2,13,010,Antugnac,324,9,333
91,Languedoc-Roussillon,11,1,02,011,Aragon,430,13,443
91,Languedoc-Roussillon,11,3,17,012,Argeliers,1566,24,1590
91,Languedoc-Roussillon,11,3,19,013,Argens-Minervois,380,8,388
91,Languedoc-Roussillon,11,3,14,014,Armissan,1543,31,1574
91,Languedoc-Roussillon,11,2,13,015,Arques,268,6,274
91,Languedoc-Roussillon,11,1,18,016,Arquettes-en-Val,94,2,96
91,Languedoc-Roussillon,11,2,03,017,Artigues,86,5,91
91,Languedoc-Roussillon,11,1,22,018,Arzens,1133,24,1157
91,Languedoc-Roussillon,11,2,04,019,Aunat,46,0,46
91,Languedoc-Roussillon,11,1,23,020,Auriac,36,3,39
91,Languedoc-Roussillon,11,2,03,021,Axat,696,11,707
91,Languedoc-Roussillon,11,1,25,022,Azille,1140,18,1158
91,Languedoc-Roussillon,11,1,06,023,Badens,752,13,765
91,Languedoc-Roussillon,11,3,34,024,Bages,835,29,864
91,Languedoc-Roussillon,11,1,12,025,Bagnoles,200,3,203
91,Languedoc-Roussillon,11,1,29,026,Baraigne,132,5,137
91,Languedoc-Roussillon,11,1,06,027,Barbaira,685,9,694
91,Languedoc-Roussillon,11,2,04,028,Belcaire,425,3,428
91,Languedoc-Roussillon,11,2,27,029,Belcastel-et-Buc,68,3,71
91,Languedoc-Roussillon,11,1,29,030,Belflou,106,1,107
91,Languedoc-Roussillon,11,2,04,031,Belfort-sur-Rebenty,40,1,41
91,Languedoc-Roussillon,11,2,01,032,Bellegarde-du-Razès,212,3,215
91,Languedoc-Roussillon,11,1,05,033,Belpech,1294,29,1323
91,Languedoc-Roussillon,11,2,01,034,Belvèze-du-Razès,827,13,840
91,Languedoc-Roussillon,11,2,26,035,Belvianes-et-Cavirac,288,4,292
91,Languedoc-Roussillon,11,2,04,036,Belvis,179,4,183
91,Languedoc-Roussillon,11,1,07,037,Berriac,863,28,891
91,Languedoc-Roussillon,11,2,03,038,Bessède-de-Sault,53,0,53
91,Languedoc-Roussillon,11,2,20,039,La Bezole,46,1,47
91,Languedoc-Roussillon,11,3,33,040,Bizanet,1275,30,1305
91,Languedoc-Roussillon,11,3,17,041,Bize-Minervois,1061,23,1084
91,Languedoc-Roussillon,11,1,06,042,Blomac,200,4,204
91,Languedoc-Roussillon,11,1,06,043,Bouilhonnac,227,3,230
91,Languedoc-Roussillon,11,1,23,044,Bouisse,94,1,95
91,Languedoc-Roussillon,11,2,20,045,Bouriège,139,5,144
91,Languedoc-Roussillon,11,2,20,046,Bourigeole,49,2,51
91,Languedoc-Roussillon,11,2,03,047,Le Bousquet,47,4,51
91,Languedoc-Roussillon,11,3,19,048,Boutenac,697,8,705
91,Languedoc-Roussillon,11,1,16,049,Bram,3190,91,3281
91,Languedoc-Roussillon,11,2,26,050,Brenac,194,11,205
91,Languedoc-Roussillon,11,2,01,051,Brézilhac,159,5,164
91,Languedoc-Roussillon,11,1,28,052,Brousses-et-Villaret,315,4,319
91,Languedoc-Roussillon,11,2,01,053,Brugairolles,248,3,251
91,Languedoc-Roussillon,11,1,09,054,Les Brunels,220,2,222
91,Languedoc-Roussillon,11,2,13,055,Bugarach,193,2,195
91,Languedoc-Roussillon,11,1,25,056,Cabrespine,184,7,191
91,Languedoc-Roussillon,11,1,05,057,Cahuzac,33,0,33
91,Languedoc-Roussillon,11,2,01,058,Cailhau,250,9,259
91,Languedoc-Roussillon,11,2,01,059,Cailhavel,101,1,102
91,Languedoc-Roussillon,11,2,03,060,Cailla,52,0,52
91,Languedoc-Roussillon,11,2,01,061,Cambieure,240,6,246
91,Languedoc-Roussillon,11,2,04,062,Campagna-de-Sault,15,1,16
91,Languedoc-Roussillon,11,2,26,063,Campagne-sur-Aude,647,17,664
91,Languedoc-Roussillon,11,3,19,064,Camplong-d'Aude,284,6,290
91,Languedoc-Roussillon,11,2,13,065,Camps-sur-l'Agly,84,1,85
91,Languedoc-Roussillon,11,2,04,066,Camurac,123,2,125
91,Languedoc-Roussillon,11,3,33,067,Canet,1244,9,1253
91,Languedoc-Roussillon,11,1,06,068,Capendu,1525,60,1585
91,Languedoc-Roussillon,11,1,98,069,Carcassonne,47634,1508,49142
91,Languedoc-Roussillon,11,1,09,070,Carlipa,311,13,324
91,Languedoc-Roussillon,11,3,15,071,Cascastel-des-Corbières,208,1,209
91,Languedoc-Roussillon,11,1,16,072,La Cassaigne,189,3,192
91,Languedoc-Roussillon,11,2,13,073,Cassaignes,64,2,66
91,Languedoc-Roussillon,11,1,09,074,Les Cassés,223,5,228
91,Languedoc-Roussillon,11,1,25,075,Castans,120,2,122
91,Languedoc-Roussillon,11,3,19,077,Castelnau-d'Aude,443,5,448
91,Languedoc-Roussillon,11,1,99,076,Castelnaudary,11544,484,12028
91,Languedoc-Roussillon,11,2,20,078,Castelreng,201,12,213
91,Languedoc-Roussillon,11,1,21,079,Caudebronde,166,3,169
91,Languedoc-Roussillon,11,2,11,080,Caudeval,172,9,181
91,Languedoc-Roussillon,11,1,25,081,Caunes-Minervois,1598,21,1619
91,Languedoc-Roussillon,11,2,27,082,Caunette-sur-Lauquet,5,0,5
91,Languedoc-Roussillon,11,1,18,083,Caunettes-en-Val,54,0,54
91,Languedoc-Roussillon,11,1,02,084,Caux-et-Sauzens,774,30,804
91,Languedoc-Roussillon,11,1,07,085,Cavanac,880,19,899
91,Languedoc-Roussillon,11,3,30,086,Caves,623,9,632
91,Languedoc-Roussillon,11,1,16,087,Cazalrenoux,76,1,77
91,Languedoc-Roussillon,11,1,07,088,Cazilhac,1602,43,1645
91,Languedoc-Roussillon,11,1,09,089,Cenne-Monestiés,324,8,332
91,Languedoc-Roussillon,11,2,20,090,Cépie,645,3,648
91,Languedoc-Roussillon,11,2,11,091,Chalabre,1141,24,1165
91,Languedoc-Roussillon,11,1,25,092,Citou,83,0,83
91,Languedoc-Roussillon,11,2,03,093,Le Clat,36,0,36
91,Languedoc-Roussillon,11,2,27,094,Clermont-sur-Lauquet,22,1,23
91,Languedoc-Roussillon,11,1,06,095,Comigne,241,2,243
91,Languedoc-Roussillon,11,2,04,096,Comus,40,1,41
91,Languedoc-Roussillon,11,3,19,098,Conilhac-Corbières,819,21,840
91,Languedoc-Roussillon,11,2,13,097,Conilhac-de-la-Montagne,55,3,58
91,Languedoc-Roussillon,11,1,12,099,Conques-sur-Orbiel,2294,57,2351
91,Languedoc-Roussillon,11,2,11,100,Corbières,39,1,40
91,Languedoc-Roussillon,11,2,26,101,Coudons,51,1,52
91,Languedoc-Roussillon,11,1,07,102,Couffoulens,581,4,585
91,Languedoc-Roussillon,11,2,13,103,Couiza,1209,26,1235
91,Languedoc-Roussillon,11,2,03,104,Counozouls,46,0,46
91,Languedoc-Roussillon,11,2,20,105,Cournanel,644,19,663
91,Languedoc-Roussillon,11,3,14,106,Coursan,6124,131,6255
91,Languedoc-Roussillon,11,2,11,107,Courtauly,74,2,76
91,Languedoc-Roussillon,11,2,01,108,La Courtète,45,0,45
91,Languedoc-Roussillon,11,2,13,109,Coustaussa,55,1,56
91,Languedoc-Roussillon,11,3,15,110,Coustouge,87,3,90
91,Languedoc-Roussillon,11,3,19,111,Cruscades,489,2,491
91,Languedoc-Roussillon,11,2,13,112,Cubières-sur-Cinoble,94,0,94
91,Languedoc-Roussillon,11,3,31,113,Cucugnan,135,2,137
91,Languedoc-Roussillon,11,1,29,114,Cumiès,38,2,40
91,Languedoc-Roussillon,11,1,28,115,Cuxac-Cabardès,923,63,986
91,Languedoc-Roussillon,11,3,14,116,Cuxac-d'Aude,4375,80,4455
91,Languedoc-Roussillon,11,1,23,117,Davejean,109,2,111
91,Languedoc-Roussillon,11,1,23,118,Dernacueillette,41,2,43
91,Languedoc-Roussillon,11,2,20,119,La Digne-d'Amont,279,14,293
91,Languedoc-Roussillon,11,2,20,120,La Digne-d'Aval,562,2,564
91,Languedoc-Roussillon,11,2,01,121,Donazac,96,2,98
91,Languedoc-Roussillon,11,1,06,122,Douzens,703,10,713
91,Languedoc-Roussillon,11,3,31,123,Duilhac-sous-Peyrepertuse,124,1,125
91,Languedoc-Roussillon,11,3,15,124,Durban-Corbières,684,11,695
91,Languedoc-Roussillon,11,3,15,125,Embres-et-Castelmaure,150,5,155
91,Languedoc-Roussillon,11,3,19,126,Escales,360,4,364
91,Languedoc-Roussillon,11,2,03,127,Escouloubre,96,0,96
91,Languedoc-Roussillon,11,2,01,128,Escueillens-et-Saint-Just-de-Bélengard,182,2,184
91,Languedoc-Roussillon,11,2,26,129,Espéraza,2101,33,2134
91,Languedoc-Roussillon,11,2,04,130,Espezel,209,7,216
91,Languedoc-Roussillon,11,2,26,131,Fa,337,5,342
91,Languedoc-Roussillon,11,3,19,132,Fabrezan,1242,15,1257
91,Languedoc-Roussillon,11,1,18,133,Fajac-en-Val,29,2,31
91,Languedoc-Roussillon,11,1,29,134,Fajac-la-Relenque,45,0,45
91,Languedoc-Roussillon,11,2,04,135,La Fajolle,14,0,14
91,Languedoc-Roussillon,11,1,16,136,Fanjeaux,776,52,828
91,Languedoc-Roussillon,11,1,23,137,Félines-Termenès,132,1,133
91,Languedoc-Roussillon,11,1,10,138,Fendeille,555,12,567
91,Languedoc-Roussillon,11,2,01,139,Fenouillet-du-Razès,88,2,90
91,Languedoc-Roussillon,11,3,19,140,Ferrals-les-Corbières,1076,16,1092
91,Languedoc-Roussillon,11,2,01,141,Ferran,98,3,101
91,Languedoc-Roussillon,11,2,20,142,Festes-et-Saint-André,206,14,220
91,Languedoc-Roussillon,11,3,30,143,Feuilla,99,1,100
91,Languedoc-Roussillon,11,3,30,144,Fitou,868,16,884
91,Languedoc-Roussillon,11,3,14,145,Fleury,3162,30,3192
91,Languedoc-Roussillon,11,1,06,146,Floure,361,9,370
91,Languedoc-Roussillon,11,2,04,147,Fontanès-de-Sault,9,0,9
91,Languedoc-Roussillon,11,3,19,148,Fontcouverte,563,6,569
91,Languedoc-Roussillon,11,1,16,149,Fonters-du-Razès,91,4,95
91,Languedoc-Roussillon,11,1,28,150,Fontiers-Cabardès,426,55,481
91,Languedoc-Roussillon,11,1,06,151,Fontiès-d'Aude,402,6,408
91,Languedoc-Roussillon,11,3,15,152,Fontjoncouse,131,3,134
91,Languedoc-Roussillon,11,1,16,153,La Force,186,5,191
91,Languedoc-Roussillon,11,1,21,154,Fournes-Cabardès,66,1,67
91,Languedoc-Roussillon,11,2,13,155,Fourtou,57,2,59
91,Languedoc-Roussillon,11,1,28,156,Fraisse-Cabardès,109,3,112
91,Languedoc-Roussillon,11,3,15,157,Fraissé-des-Corbières,237,3,240
91,Languedoc-Roussillon,11,2,20,158,Gaja-et-Villedieu,296,8,304
91,Languedoc-Roussillon,11,1,16,159,Gaja-la-Selve,166,0,166
91,Languedoc-Roussillon,11,2,04,160,Galinagues,43,2,45
91,Languedoc-Roussillon,11,2,27,161,Gardie,104,1,105
91,Languedoc-Roussillon,11,1,16,162,Generville,60,0,60
91,Languedoc-Roussillon,11,2,03,163,Gincla,44,0,44
91,Languedoc-Roussillon,11,3,17,164,Ginestas,1337,27,1364
91,Languedoc-Roussillon,11,2,26,165,Ginoles,365,14,379
91,Languedoc-Roussillon,11,1,29,166,Gourvieille,56,0,56
91,Languedoc-Roussillon,11,2,01,167,Gramazie,101,1,102
91,Languedoc-Roussillon,11,2,26,168,Granès,126,2,128
91,Languedoc-Roussillon,11,2,27,169,Greffeil,77,4,81
91,Languedoc-Roussillon,11,3,14,170,Gruissan,4410,75,4485
91,Languedoc-Roussillon,11,2,11,171,Gueytes-et-Labastide,36,0,36
91,Languedoc-Roussillon,11,3,19,172,Homps,662,6,668
91,Languedoc-Roussillon,11,2,01,173,Hounoux,130,5,135
91,Languedoc-Roussillon,11,1,21,174,Les Ilhes,54,0,54
91,Languedoc-Roussillon,11,1,09,175,Issel,458,4,462
91,Languedoc-Roussillon,11,3,15,176,Jonquières,70,1,71
91,Languedoc-Roussillon,11,2,04,177,Joucou,35,2,37
91,Languedoc-Roussillon,11,1,10,178,Labastide-d'Anjou,926,14,940
91,Languedoc-Roussillon,11,1,18,179,Labastide-en-Val,74,3,77
91,Languedoc-Roussillon,11,1,21,180,Labastide-Esparbairenque,83,4,87
91,Languedoc-Roussillon,11,1,09,181,Labécède-Lauragais,381,6,387
91,Languedoc-Roussillon,11,1,28,182,Lacombe,166,1,167
91,Languedoc-Roussillon,11,2,27,183,Ladern-sur-Lauquet,260,6,266
91,Languedoc-Roussillon,11,1,05,184,Lafage,94,2,96
91,Languedoc-Roussillon,11,1,18,185,Lagrasse,599,26,625
91,Languedoc-Roussillon,11,1,23,186,Lairière,47,1,48
91,Languedoc-Roussillon,11,1,23,187,Lanet,45,1,46
91,Languedoc-Roussillon,11,1,28,189,Laprade,91,1,92
91,Languedoc-Roussillon,11,1,23,191,Laroque-de-Fa,153,3,156
91,Languedoc-Roussillon,11,1,10,192,Lasbordes,829,20,849
91,Languedoc-Roussillon,11,2,01,193,Lasserre-de-Prouille,237,6,243
91,Languedoc-Roussillon,11,1,21,194,Lastours,165,2,167
91,Languedoc-Roussillon,11,1,10,195,Laurabuc,388,1,389
91,Languedoc-Roussillon,11,1,16,196,Laurac,167,4,171
91,Languedoc-Roussillon,11,2,01,197,Lauraguel,552,10,562
91,Languedoc-Roussillon,11,1,25,198,Laure-Minervois,1048,32,1080
91,Languedoc-Roussillon,11,1,22,199,Lavalette,1244,36,1280
91,Languedoc-Roussillon,11,1,25,200,Lespinassière,101,2,103
91,Languedoc-Roussillon,11,1,07,201,Leuc,648,24,672
91,Languedoc-Roussillon,11,3,30,202,Leucate,3858,60,3918
91,Languedoc-Roussillon,11,3,19,203,Lézignan-Corbières,9968,149,10117
91,Languedoc-Roussillon,11,2,01,204,Lignairolles,37,0,37
91,Languedoc-Roussillon,11,1,12,205,Limousis,106,0,106
91,Languedoc-Roussillon,11,2,20,206,Limoux,9781,584,10365
91,Languedoc-Roussillon,11,2,20,207,Loupia,219,14,233
91,Languedoc-Roussillon,11,1,29,208,La Louvière-Lauragais,87,1,88
91,Languedoc-Roussillon,11,2,13,209,Luc-sur-Aude,192,8,200
91,Languedoc-Roussillon,11,3,19,210,Luc-sur-Orbieu,962,23,985
91,Languedoc-Roussillon,11,2,20,211,Magrie,514,10,524
91,Languedoc-Roussillon,11,3,17,212,Mailhac,436,5,441
91,Languedoc-Roussillon,11,3,31,213,Maisons,41,1,42
91,Languedoc-Roussillon,11,2,20,214,Malras,349,10,359
91,Languedoc-Roussillon,11,1,12,215,Malves-en-Minervois,752,26,778
91,Languedoc-Roussillon,11,2,01,216,Malviès,368,6,374
91,Languedoc-Roussillon,11,3,33,217,Marcorignan,1106,31,1137
91,Languedoc-Roussillon,11,1,29,218,Marquein,75,2,77
91,Languedoc-Roussillon,11,2,26,219,Marsa,27,0,27
91,Languedoc-Roussillon,11,1,06,220,Marseillette,694,13,707
91,Languedoc-Roussillon,11,1,21,221,Les Martys,274,3,277
91,Languedoc-Roussillon,11,1,21,222,Mas-Cabardès,201,3,204
91,Languedoc-Roussillon,11,1,07,223,Mas-des-Cours,19,2,21
91,Languedoc-Roussillon,11,1,10,225,Mas-Saintes-Puelles,890,24,914
91,Languedoc-Roussillon,11,1,23,224,Massac,28,0,28
91,Languedoc-Roussillon,11,1,05,226,Mayreville,69,5,74
91,Languedoc-Roussillon,11,1,18,227,Mayronnes,36,0,36
91,Languedoc-Roussillon,11,2,01,228,Mazerolles-du-Razès,173,5,178
91,Languedoc-Roussillon,11,2,04,229,Mazuby,25,0,25
91,Languedoc-Roussillon,11,2,04,230,Mérial,26,0,26
91,Languedoc-Roussillon,11,1,29,231,Mézerville,95,0,95
91,Languedoc-Roussillon,11,1,21,232,Miraval-Cabardes,45,2,47
91,Languedoc-Roussillon,11,3,17,233,Mirepeisset,741,9,750
91,Languedoc-Roussillon,11,1,10,234,Mireval-Lauragais,160,9,169
91,Languedoc-Roussillon,11,2,13,235,Missègre,66,1,67
91,Languedoc-Roussillon,11,1,05,236,Molandier,221,4,225
91,Languedoc-Roussillon,11,1,29,238,Molleville,87,5,92
91,Languedoc-Roussillon,11,1,29,239,Montauriol,78,3,81
91,Languedoc-Roussillon,11,2,13,240,Montazels,492,18,510
91,Languedoc-Roussillon,11,3,19,241,Montbrun-des-Corbières,319,6,325
91,Languedoc-Roussillon,11,1,22,242,Montclar,186,6,192
91,Languedoc-Roussillon,11,1,10,243,Montferrand,486,8,494
91,Languedoc-Roussillon,11,2,03,244,Montfort-sur-Boulzane,102,3,105
91,Languedoc-Roussillon,11,3,31,245,Montgaillard,58,1,59
91,Languedoc-Roussillon,11,2,01,246,Montgradail,59,2,61
91,Languedoc-Roussillon,11,2,01,247,Monthaut,46,0,46
91,Languedoc-Roussillon,11,1,06,248,Montirat,70,4,74
91,Languedoc-Roussillon,11,2,11,249,Montjardin,102,1,103
91,Languedoc-Roussillon,11,1,23,250,Montjoi,42,2,44
91,Languedoc-Roussillon,11,1,18,251,Montlaur,537,10,547
91,Languedoc-Roussillon,11,1,09,252,Montmaur,325,1,326
91,Languedoc-Roussillon,11,1,02,253,Montolieu,757,18,775
91,Languedoc-Roussillon,11,1,22,254,Montréal,1957,157,2114
91,Languedoc-Roussillon,11,3,33,255,Montredon-des-Corbières,1104,23,1127
91,Languedoc-Roussillon,11,3,19,256,Montséret,483,9,492
91,Languedoc-Roussillon,11,1,06,257,Monze,178,2,180
91,Languedoc-Roussillon,11,3,33,258,Moussan,1776,25,1801
91,Languedoc-Roussillon,11,1,02,259,Moussoulens,898,20,918
91,Languedoc-Roussillon,11,1,23,260,Mouthoumet,106,4,110
91,Languedoc-Roussillon,11,1,06,261,Moux,561,13,574
91,Languedoc-Roussillon,11,3,97,262,Narbonne,51005,1247,52252
91,Languedoc-Roussillon,11,2,26,263,Nébias,264,5,269
91,Languedoc-Roussillon,11,3,33,264,Névian,1329,23,1352
91,Languedoc-Roussillon,11,2,04,265,Niort-de-Sault,34,0,34
91,Languedoc-Roussillon,11,3,19,267,Ornaisons,1203,26,1229
91,Languedoc-Roussillon,11,1,16,268,Orsans,90,6,96
91,Languedoc-Roussillon,11,3,17,269,Ouveillan,2167,31,2198
91,Languedoc-Roussillon,11,3,31,270,Padern,125,0,125
91,Languedoc-Roussillon,11,1,23,271,Palairac,30,1,31
91,Languedoc-Roussillon,11,1,07,272,Palaja,2150,77,2227
91,Languedoc-Roussillon,11,3,30,188,La Palme,1508,33,1541
91,Languedoc-Roussillon,11,3,17,273,Paraza,586,6,592
91,Languedoc-Roussillon,11,2,20,274,Pauligne,329,23,352
91,Languedoc-Roussillon,11,1,29,275,Payra-sur-l'Hers,155,5,160
91,Languedoc-Roussillon,11,3,31,276,Paziols,517,8,525
91,Languedoc-Roussillon,11,1,05,278,Pech-Luna,95,2,97
91,Languedoc-Roussillon,11,1,05,277,Pécharic-et-le-Py,29,0,29
91,Languedoc-Roussillon,11,1,08,279,Pennautier,2511,59,2570
91,Languedoc-Roussillon,11,1,25,280,Pépieux,977,35,1012
91,Languedoc-Roussillon,11,1,10,281,Pexiora,1091,17,1108
91,Languedoc-Roussillon,11,2,11,282,Peyrefitte-du-Razès,53,2,55
91,Languedoc-Roussillon,11,1,05,283,Peyrefitte-sur-l'Hers,74,2,76
91,Languedoc-Roussillon,11,1,09,284,Peyrens,409,5,414
91,Languedoc-Roussillon,11,3,30,285,Peyriac-de-Mer,1011,30,1041
91,Languedoc-Roussillon,11,1,25,286,Peyriac-Minervois,1061,23,1084
91,Languedoc-Roussillon,11,2,13,287,Peyrolles,72,1,73
91,Languedoc-Roussillon,11,1,02,288,Pezens,1251,121,1372
91,Languedoc-Roussillon,11,2,20,289,Pieusse,933,24,957
91,Languedoc-Roussillon,11,1,05,290,Plaigne,121,3,124
91,Languedoc-Roussillon,11,1,16,291,Plavilla,113,2,115
91,Languedoc-Roussillon,11,1,09,292,La Pomarède,164,5,169
91,Languedoc-Roussillon,11,2,27,293,Pomas,743,22,765
91,Languedoc-Roussillon,11,2,01,294,Pomy,47,3,50
91,Languedoc-Roussillon,11,3,30,266,Port-la-Nouvelle,5603,65,5668
91,Languedoc-Roussillon,11,3,30,295,Portel-des-Corbières,1135,17,1152
91,Languedoc-Roussillon,11,3,17,296,Pouzols-Minervois,369,1,370
91,Languedoc-Roussillon,11,1,21,297,Pradelles-Cabardès,152,0,152
91,Languedoc-Roussillon,11,1,18,298,Pradelles-en-Val,195,3,198
91,Languedoc-Roussillon,11,1,22,299,Preixan,517,9,526
91,Languedoc-Roussillon,11,1,09,300,Puginier,143,1,144
91,Languedoc-Roussillon,11,1,25,301,Puichéric,1072,25,1097
91,Languedoc-Roussillon,11,2,03,302,Puilaurens,257,5,262
91,Languedoc-Roussillon,11,2,11,303,Puivert,508,9,517
91,Languedoc-Roussillon,11,2,26,304,Quillan,3405,146,3551
91,Languedoc-Roussillon,11,3,15,305,Quintillan,63,0,63
91,Languedoc-Roussillon,11,2,26,306,Quirbajou,36,3,39
91,Languedoc-Roussillon,11,3,33,307,Raissac-d'Aude,247,6,253
91,Languedoc-Roussillon,11,1,02,308,Raissac-sur-Lampy,332,5,337
91,Languedoc-Roussillon,11,1,25,190,La Redorte,1124,19,1143
91,Languedoc-Roussillon,11,2,13,309,Rennes-le-Château,91,1,92
91,Languedoc-Roussillon,11,2,13,310,Rennes-les-Bains,171,1,172
91,Languedoc-Roussillon,11,1,18,311,Ribaute,240,4,244
91,Languedoc-Roussillon,11,1,16,312,Ribouisse,103,2,105
91,Languedoc-Roussillon,11,1,10,313,Ricaud,283,7,290
91,Languedoc-Roussillon,11,1,18,314,Rieux-en-Val,82,0,82
91,Languedoc-Roussillon,11,1,25,315,Rieux-Minervois,2041,57,2098
91,Languedoc-Roussillon,11,2,11,316,Rivel,221,4,225
91,Languedoc-Roussillon,11,2,04,317,Rodome,125,3,128
91,Languedoc-Roussillon,11,1,06,318,Roquecourbe-Minervois,122,1,123
91,Languedoc-Roussillon,11,1,21,319,Roquefère,78,3,81
91,Languedoc-Roussillon,11,2,04,320,Roquefeuil,274,7,281
91,Languedoc-Roussillon,11,2,03,321,Roquefort-de-Sault,92,5,97
91,Languedoc-Roussillon,11,3,30,322,Roquefort-des-Corbières,929,26,955
91,Languedoc-Roussillon,11,2,13,323,Roquetaillade,215,1,216
91,Languedoc-Roussillon,11,3,17,324,Roubia,450,8,458
91,Languedoc-Roussillon,11,1,22,325,Rouffiac-d'Aude,338,7,345
91,Languedoc-Roussillon,11,3,31,326,Rouffiac-des-Corbières,82,3,85
91,Languedoc-Roussillon,11,1,22,327,Roullens,476,14,490
91,Languedoc-Roussillon,11,2,01,328,Routier,257,10,267
91,Languedoc-Roussillon,11,2,26,329,Rouvenac,199,3,202
91,Languedoc-Roussillon,11,1,06,330,Rustiques,448,6,454
91,Languedoc-Roussillon,11,1,05,331,Saint-Amans,62,0,62
91,Languedoc-Roussillon,11,3,19,332,Saint-André-de-Roquelongue,1062,22,1084
91,Languedoc-Roussillon,11,2,11,333,Saint-Benoît,112,3,115
91,Languedoc-Roussillon,11,1,06,337,Saint-Couat-d'Aude,372,7,379
91,Languedoc-Roussillon,11,2,20,338,Saint-Couat-du-Razès,55,3,58
91,Languedoc-Roussillon,11,1,28,339,Saint-Denis,465,7,472
91,Languedoc-Roussillon,11,2,26,341,Saint-Ferriol,141,6,147
91,Languedoc-Roussillon,11,1,25,342,Saint-Frichoux,221,5,226
91,Languedoc-Roussillon,11,1,16,343,Saint-Gaudéric,69,2,71
91,Languedoc-Roussillon,11,2,27,344,Saint-Hilaire,729,9,738
91,Languedoc-Roussillon,11,3,15,345,Saint-Jean-de-Barrou,259,3,262
91,Languedoc-Roussillon,11,2,11,346,Saint-Jean-de-Paracol,114,2,116
91,Languedoc-Roussillon,11,2,26,347,Saint-Julia-de-Bec,113,2,115
91,Languedoc-Roussillon,11,1,16,348,Saint-Julien-de-Briola,84,3,87
91,Languedoc-Roussillon,11,2,26,350,Saint-Just-et-le-Bézu,67,3,70
91,Languedoc-Roussillon,11,3,15,351,Saint-Laurent-de-la-Cabrerisse,747,36,783
91,Languedoc-Roussillon,11,2,26,352,Saint-Louis-et-Parahou,60,0,60
91,Languedoc-Roussillon,11,3,17,353,Saint-Marcel-sur-Aude,1570,25,1595
91,Languedoc-Roussillon,11,2,20,355,Saint-Martin-de-Villereglan,334,5,339
91,Languedoc-Roussillon,11,1,18,354,Saint-Martin-des-Puits,18,0,18
91,Languedoc-Roussillon,11,1,10,356,Saint-Martin-Lalande,1086,28,1114
91,Languedoc-Roussillon,11,1,02,357,Saint-Martin-le-Vieil,221,6,227
91,Languedoc-Roussillon,11,2,26,358,Saint-Martin-Lys,50,2,52
91,Languedoc-Roussillon,11,1,29,359,Saint-Michel-de-Lanès,349,11,360
91,Languedoc-Roussillon,11,3,17,360,Saint-Nazaire-d'Aude,1783,43,1826
91,Languedoc-Roussillon,11,1,09,361,Saint-Papoul,778,15,793
91,Languedoc-Roussillon,11,1,09,362,Saint-Paulet,178,2,180
91,Languedoc-Roussillon,11,1,18,363,Saint-Pierre-des-Champs,164,7,171
91,Languedoc-Roussillon,11,2,27,364,Saint-Polycarpe,167,5,172
91,Languedoc-Roussillon,11,1,05,365,Saint-Sernin,33,0,33
91,Languedoc-Roussillon,11,1,29,334,Sainte-Camelle,115,0,115
91,Languedoc-Roussillon,11,2,03,335,Sainte-Colombe-sur-Guette,47,1,48
91,Languedoc-Roussillon,11,2,11,336,Sainte-Colombe-sur-l'Hers,509,16,525
91,Languedoc-Roussillon,11,1,02,340,Sainte-Eulalie,514,11,525
91,Languedoc-Roussillon,11,3,17,366,Sainte-Valière,544,12,556
91,Languedoc-Roussillon,11,1,28,367,Saissac,981,15,996
91,Languedoc-Roussillon,11,1,12,368,Sallèles-Cabardès,115,1,116
91,Languedoc-Roussillon,11,3,17,369,Sallèles-d'Aude,2375,35,2410
91,Languedoc-Roussillon,11,3,14,370,Salles-d'Aude,2630,54,2684
91,Languedoc-Roussillon,11,1,29,371,Salles-sur-l'Hers,576,8,584
91,Languedoc-Roussillon,11,1,21,372,Salsigne,372,4,376
91,Languedoc-Roussillon,11,2,03,373,Salvezines,90,1,91
91,Languedoc-Roussillon,11,1,23,374,Salza,18,1,19
91,Languedoc-Roussillon,11,2,01,375,Seignalens,31,1,32
91,Languedoc-Roussillon,11,2,13,376,La Serpent,77,1,78
91,Languedoc-Roussillon,11,2,13,377,Serres,50,3,53
91,Languedoc-Roussillon,11,1,18,378,Serviès-en-Val,225,12,237
91,Languedoc-Roussillon,11,3,30,379,Sigean,5163,121,5284
91,Languedoc-Roussillon,11,2,11,380,Sonnac-sur-l'Hers,156,4,160
91,Languedoc-Roussillon,11,2,13,381,Sougraigne,84,3,87
91,Languedoc-Roussillon,11,1,09,382,Souilhanels,383,68,451
91,Languedoc-Roussillon,11,1,09,383,Souilhe,318,8,326
91,Languedoc-Roussillon,11,1,23,384,Soulatgé,107,5,112
91,Languedoc-Roussillon,11,1,09,385,Soupex,261,2,263
91,Languedoc-Roussillon,11,1,18,386,Talairan,362,6,368
91,Languedoc-Roussillon,11,1,18,387,Taurize,71,1,72
91,Languedoc-Roussillon,11,1,23,388,Termes,53,3,56
91,Languedoc-Roussillon,11,2,13,389,Terroles,16,0,16
91,Languedoc-Roussillon,11,3,15,390,Thézan-des-Corbières,525,6,531
91,Languedoc-Roussillon,11,1,21,391,La Tourette-Cabardès,23,0,23
91,Languedoc-Roussillon,11,1,18,392,Tournissan,260,9,269
91,Languedoc-Roussillon,11,3,19,393,Tourouzelle,486,7,493
91,Languedoc-Roussillon,11,2,20,394,Tourreilles,119,3,122
91,Languedoc-Roussillon,11,1,21,395,Trassanel,27,1,28
91,Languedoc-Roussillon,11,1,25,396,Trausse,511,6,517
91,Languedoc-Roussillon,11,1,06,397,Trèbes,5524,127,5651
91,Languedoc-Roussillon,11,3,30,398,Treilles,182,1,183
91,Languedoc-Roussillon,11,1,09,399,Tréville,111,8,119
91,Languedoc-Roussillon,11,2,11,400,Tréziers,110,3,113
91,Languedoc-Roussillon,11,3,31,401,Tuchan,817,23,840
91,Languedoc-Roussillon,11,2,13,402,Valmigère,21,1,22
91,Languedoc-Roussillon,11,1,02,404,Ventenac-Cabardès,861,33,894
91,Languedoc-Roussillon,11,3,17,405,Ventenac-en-Minervois,512,4,516
91,Languedoc-Roussillon,11,2,20,406,Véraza,39,0,39
91,Languedoc-Roussillon,11,1,09,407,Verdun-en-Lauragais,251,14,265
91,Languedoc-Roussillon,11,2,27,408,Verzeille,418,3,421
91,Languedoc-Roussillon,11,1,23,409,Vignevieille,99,3,102
91,Languedoc-Roussillon,11,1,12,410,Villalier,806,13,819
91,Languedoc-Roussillon,11,1,21,411,Villanière,125,3,128
91,Languedoc-Roussillon,11,1,18,414,Villar-en-Val,34,0,34
91,Languedoc-Roussillon,11,2,27,415,Villar-Saint-Anselme,93,2,95
91,Languedoc-Roussillon,11,2,27,412,Villardebelle,70,1,71
91,Languedoc-Roussillon,11,1,21,413,Villardonnel,538,7,545
91,Languedoc-Roussillon,11,1,12,416,Villarzel-Cabardès,175,3,178
91,Languedoc-Roussillon,11,2,01,417,Villarzel-du-Razès,89,6,95
91,Languedoc-Roussillon,11,1,16,418,Villasavary,1147,16,1163
91,Languedoc-Roussillon,11,1,05,419,Villautou,52,2,54
91,Languedoc-Roussillon,11,2,27,420,Villebazy,104,2,106
91,Languedoc-Roussillon,11,3,33,421,Villedaigne,466,7,473
91,Languedoc-Roussillon,11,1,06,422,Villedubert,346,11,357
91,Languedoc-Roussillon,11,2,27,423,Villefloure,133,3,136
91,Languedoc-Roussillon,11,2,11,424,Villefort,103,1,104
91,Languedoc-Roussillon,11,1,12,425,Villegailhenc,1624,32,1656
91,Languedoc-Roussillon,11,1,12,426,Villegly,874,19,893
91,Languedoc-Roussillon,11,2,20,427,Villelongue-d'Aude,325,17,342
91,Languedoc-Roussillon,11,1,09,428,Villemagne,275,3,278
91,Languedoc-Roussillon,11,1,12,429,Villemoustaussou,3132,94,3226
91,Languedoc-Roussillon,11,1,10,430,Villeneuve-la-Comptal,1208,38,1246
91,Languedoc-Roussillon,11,3,15,431,Villeneuve-les-Corbières,272,4,276
91,Languedoc-Roussillon,11,1,22,432,Villeneuve-lès-Montréal,226,4,230
91,Languedoc-Roussillon,11,1,25,433,Villeneuve-Minervois,906,11,917
91,Languedoc-Roussillon,11,1,10,434,Villepinte,1223,22,1245
91,Languedoc-Roussillon,11,1,23,435,Villerouge-Termenès,158,8,166
91,Languedoc-Roussillon,11,3,15,436,Villesèque-des-Corbières,388,12,400
91,Languedoc-Roussillon,11,1,02,437,Villesèquelande,811,6,817
91,Languedoc-Roussillon,11,1,16,438,Villesiscle,326,4,330
91,Languedoc-Roussillon,11,1,09,439,Villespy,360,8,368
91,Languedoc-Roussillon,11,1,18,440,Villetritouls,42,0,42
91,Languedoc-Roussillon,11,3,14,441,Vinassan,2312,44,2356
73,Midi-Pyrénées,12,2,24,001,Agen-d'Aveyron,1054,38,1092
73,Midi-Pyrénées,12,1,17,002,Aguessac,837,16,853
73,Midi-Pyrénées,12,3,06,003,Les Albres,348,7,355
73,Midi-Pyrénées,12,3,10,004,Almont-les-Junies,487,9,496
73,Midi-Pyrénées,12,2,33,005,Alpuech,81,1,82
73,Midi-Pyrénées,12,1,37,006,Alrance,393,7,400
73,Midi-Pyrénées,12,3,43,007,Ambeyrac,179,4,183
73,Midi-Pyrénées,12,2,27,008,Anglars-Saint-Félix,633,12,645
73,Midi-Pyrénées,12,1,04,009,Arnac-sur-Dourdou,23,0,23
73,Midi-Pyrénées,12,2,24,010,Arques,123,1,124
73,Midi-Pyrénées,12,2,07,011,Arvieu,861,19,880
73,Midi-Pyrénées,12,3,06,012,Asprières,692,13,705
73,Midi-Pyrénées,12,3,01,013,Aubin,4215,225,4440
73,Midi-Pyrénées,12,2,34,014,Aurelle-Verlac,173,2,175
73,Midi-Pyrénées,12,2,07,015,Auriac-Lagast,256,7,263
73,Midi-Pyrénées,12,2,27,016,Auzits,878,31,909
73,Midi-Pyrénées,12,1,35,017,Ayssènes,217,3,220
73,Midi-Pyrénées,12,3,06,018,Balaguier-d'Olt,135,5,140
73,Midi-Pyrénées,12,1,36,019,Balaguier-sur-Rance,95,2,97
73,Midi-Pyrénées,12,2,16,020,Balsac,586,17,603
73,Midi-Pyrénées,12,2,39,056,Baraqueville,2989,172,3161
73,Midi-Pyrénées,12,3,26,021,La Bastide-l'Évêque,817,30,847
73,Midi-Pyrénées,12,1,29,022,La Bastide-Pradines,109,2,111
73,Midi-Pyrénées,12,1,36,023,La Bastide-Solages,116,1,117
73,Midi-Pyrénées,12,2,27,024,Belcastel,228,7,235
73,Midi-Pyrénées,12,1,02,025,Belmont-sur-Rance,1017,31,1048
73,Midi-Pyrénées,12,2,15,026,Bertholène,999,30,1029
73,Midi-Pyrénées,12,2,12,027,Bessuéjouls,238,11,249
73,Midi-Pyrénées,12,3,10,028,Boisse-Penchot,540,2,542
73,Midi-Pyrénées,12,3,20,029,Bor-et-Bar,184,5,189
73,Midi-Pyrénées,12,3,06,030,Bouillac,427,6,433
73,Midi-Pyrénées,12,2,27,031,Bournazel,343,12,355
73,Midi-Pyrénées,12,2,39,032,Boussac,531,19,550
73,Midi-Pyrénées,12,2,03,033,Bozouls,2772,62,2834
73,Midi-Pyrénées,12,3,18,034,Brandonnet,306,10,316
73,Midi-Pyrénées,12,1,36,035,Brasc,203,2,205
73,Midi-Pyrénées,12,2,19,036,Brommat,710,18,728
73,Midi-Pyrénées,12,1,35,037,Broquiès,644,25,669
73,Midi-Pyrénées,12,1,35,038,Brousse-le-Château,165,6,171
73,Midi-Pyrénées,12,1,04,039,Brusque,314,5,319
73,Midi-Pyrénées,12,1,40,040,Buzeins,184,9,193
73,Midi-Pyrénées,12,2,22,041,Cabanès,228,9,237
73,Midi-Pyrénées,12,1,29,042,Calmels-et-le-Viala,240,7,247
73,Midi-Pyrénées,12,2,07,043,Calmont,1942,62,2004
73,Midi-Pyrénées,12,1,04,044,Camarès,975,34,1009
73,Midi-Pyrénées,12,2,39,045,Camboulazet,349,9,358
73,Midi-Pyrénées,12,2,22,046,Camjac,536,11,547
73,Midi-Pyrénées,12,1,05,047,Campagnac,456,14,470
73,Midi-Pyrénées,12,2,30,048,Campouriez,400,16,416
73,Midi-Pyrénées,12,2,13,049,Campuac,450,4,454
73,Midi-Pyrénées,12,2,24,050,Canet-de-Salars,410,9,419
73,Midi-Pyrénées,12,2,33,051,Cantoin,320,10,330
73,Midi-Pyrénées,12,3,06,052,Capdenac-Gare,4553,167,4720
73,Midi-Pyrénées,12,3,43,053,La Capelle-Balaguier,279,8,287
73,Midi-Pyrénées,12,3,26,054,La Capelle-Bleys,387,7,394
73,Midi-Pyrénées,12,1,05,055,La Capelle-Bonance,89,4,93
73,Midi-Pyrénées,12,2,07,057,Cassagnes-Bégonhès,934,46,980
73,Midi-Pyrénées,12,2,14,058,Cassuéjouls,137,3,140
73,Midi-Pyrénées,12,2,39,059,Castanet,549,28,577
73,Midi-Pyrénées,12,2,38,060,Castelmary,135,3,138
73,Midi-Pyrénées,12,2,12,061,Castelnau-de-Mandailles,546,9,555
73,Midi-Pyrénées,12,1,31,062,Castelnau-Pégayrols,321,6,327
73,Midi-Pyrénées,12,3,06,257,Causse-et-Diège,711,19,730
73,Midi-Pyrénées,12,1,21,063,La Cavalerie,1021,32,1053
73,Midi-Pyrénées,12,2,12,064,Le Cayrol,285,4,289
73,Midi-Pyrénées,12,2,22,065,Centrès,549,16,565
73,Midi-Pyrénées,12,2,16,066,Clairvaux-d'Aveyron,1135,16,1151
73,Midi-Pyrénées,12,1,09,067,Le Clapier,76,9,85
73,Midi-Pyrénées,12,2,39,068,Colombiès,952,24,976
73,Midi-Pyrénées,12,1,36,069,Combret,297,5,302
73,Midi-Pyrénées,12,1,17,070,Compeyre,527,18,545
73,Midi-Pyrénées,12,3,18,071,Compolibat,402,16,418
73,Midi-Pyrénées,12,1,44,072,Comprégnac,236,15,251
73,Midi-Pyrénées,12,2,07,073,Comps-la-Grand-Ville,512,7,519
73,Midi-Pyrénées,12,2,32,074,Condom-d'Aubrac,319,8,327
73,Midi-Pyrénées,12,2,25,075,Connac,113,3,116
73,Midi-Pyrénées,12,2,08,076,Conques,281,7,288
73,Midi-Pyrénées,12,1,09,077,Cornus,514,11,525
73,Midi-Pyrénées,12,1,35,078,Les Costes-Gozon,177,0,177
73,Midi-Pyrénées,12,2,13,079,Coubisou,535,13,548
73,Midi-Pyrénées,12,1,36,080,Coupiac,473,11,484
73,Midi-Pyrénées,12,2,15,081,Coussergues,229,6,235
73,Midi-Pyrénées,12,1,21,082,La Couvertoirade,179,10,189
73,Midi-Pyrénées,12,3,01,083,Cransac,1681,57,1738
73,Midi-Pyrénées,12,1,44,084,Creissels,1486,48,1534
73,Midi-Pyrénées,12,2,38,085,Crespin,268,7,275
73,Midi-Pyrénées,12,1,23,086,La Cresse,318,8,326
73,Midi-Pyrénées,12,2,15,087,Cruéjouls,414,9,423
73,Midi-Pyrénées,12,1,37,307,Curan,302,5,307
73,Midi-Pyrénées,12,2,14,088,Curières,255,8,263
73,Midi-Pyrénées,12,3,10,089,Decazeville,6164,200,6364
73,Midi-Pyrénées,12,2,45,090,Druelle,1941,68,2009
73,Midi-Pyrénées,12,3,18,091,Drulhe,401,12,413
73,Midi-Pyrénées,12,2,25,092,Durenque,552,12,564
73,Midi-Pyrénées,12,2,11,094,Entraygues-sur-Truyère,1171,50,1221
73,Midi-Pyrénées,12,2,27,095,Escandolières,200,4,204
73,Midi-Pyrénées,12,2,12,096,Espalion,4477,154,4631
73,Midi-Pyrénées,12,2,11,097,Espeyrac,242,6,248
73,Midi-Pyrénées,12,2,13,098,Estaing,607,14,621
73,Midi-Pyrénées,12,1,04,099,Fayet,273,7,280
73,Midi-Pyrénées,12,2,11,093,Le Fel,171,6,177
73,Midi-Pyrénées,12,3,01,100,Firmi,2557,60,2617
73,Midi-Pyrénées,12,3,10,101,Flagnac,942,19,961
73,Midi-Pyrénées,12,2,24,102,Flavin,2186,64,2250
73,Midi-Pyrénées,12,2,30,103,Florentin-la-Capelle,328,12,340
73,Midi-Pyrénées,12,3,06,104,Foissac,423,10,433
73,Midi-Pyrénées,12,1,09,155,Fondamente,298,4,302
73,Midi-Pyrénées,12,3,20,105,La Fouillade,1115,52,1167
73,Midi-Pyrénées,12,2,03,106,Gabriac,450,12,462
73,Midi-Pyrénées,12,2,15,107,Gaillac-d'Aveyron,311,7,318
73,Midi-Pyrénées,12,3,18,108,Galgan,349,12,361
73,Midi-Pyrénées,12,1,04,109,Gissac,114,9,123
73,Midi-Pyrénées,12,2,11,110,Golinhac,441,5,446
73,Midi-Pyrénées,12,2,27,111,Goutrens,445,16,461
73,Midi-Pyrénées,12,2,33,112,Graissac,213,8,221
73,Midi-Pyrénées,12,2,39,113,Gramond,385,7,392
73,Midi-Pyrénées,12,2,08,114,Grand-Vabre,410,15,425
73,Midi-Pyrénées,12,1,21,115,L' Hospitalet-du-Larzac,331,2,333
73,Midi-Pyrénées,12,2,30,116,Huparlac,243,8,251
73,Midi-Pyrénées,12,2,33,117,Lacalm,211,8,219
73,Midi-Pyrénées,12,2,19,118,Lacroix-Barrez,517,8,525
73,Midi-Pyrénées,12,2,14,119,Laguiole,1269,54,1323
73,Midi-Pyrénées,12,2,15,120,Laissac,1556,42,1598
73,Midi-Pyrénées,12,3,18,121,Lanuéjouls,726,16,742
73,Midi-Pyrénées,12,1,40,123,Lapanouse,750,57,807
73,Midi-Pyrénées,12,1,09,122,Lapanouse-de-Cernon,118,2,120
73,Midi-Pyrénées,12,2,12,124,Lassouts,316,8,324
73,Midi-Pyrénées,12,1,36,125,Laval-Roquecezière,309,6,315
73,Midi-Pyrénées,12,1,40,126,Lavernhe,245,4,249
73,Midi-Pyrénées,12,2,25,127,Lédergues,708,18,726
73,Midi-Pyrénées,12,2,38,128,Lescure-Jaoul,258,8,266
73,Midi-Pyrénées,12,1,35,129,Lestrade-et-Thouels,438,10,448
73,Midi-Pyrénées,12,3,10,130,Livinhac-le-Haut,1071,33,1104
73,Midi-Pyrénées,12,2,03,131,La Loubière,1345,47,1392
73,Midi-Pyrénées,12,2,45,133,Luc-la-Primaube,5544,172,5716
73,Midi-Pyrénées,12,3,18,134,Lugan,330,6,336
73,Midi-Pyrénées,12,3,20,135,Lunac,450,19,469
73,Midi-Pyrénées,12,3,18,136,Maleville,934,19,953
73,Midi-Pyrénées,12,2,39,137,Manhac,663,12,675
73,Midi-Pyrénées,12,2,16,138,Marcillac-Vallon,1680,50,1730
73,Midi-Pyrénées,12,1,09,139,Marnhagues-et-Latour,146,1,147
73,Midi-Pyrénées,12,3,42,140,Martiel,903,38,941
73,Midi-Pyrénées,12,1,36,141,Martrin,215,8,223
73,Midi-Pyrénées,12,2,27,142,Mayran,521,11,532
73,Midi-Pyrénées,12,1,04,143,Mélagues,66,1,67
73,Midi-Pyrénées,12,2,22,144,Meljac,140,5,145
73,Midi-Pyrénées,12,1,97,145,Millau,21943,888,22831
73,Midi-Pyrénées,12,2,28,146,Le Monastère,2100,82,2182
73,Midi-Pyrénées,12,1,04,147,Montagnol,155,3,158
73,Midi-Pyrénées,12,3,18,148,Montbazens,1343,34,1377
73,Midi-Pyrénées,12,1,36,149,Montclar,149,3,152
73,Midi-Pyrénées,12,3,20,150,Monteils,530,103,633
73,Midi-Pyrénées,12,2,30,151,Montézic,254,8,262
73,Midi-Pyrénées,12,1,36,152,Montfranc,133,3,136
73,Midi-Pyrénées,12,1,31,153,Montjaux,393,11,404
73,Midi-Pyrénées,12,1,02,154,Montlaur,680,26,706
73,Midi-Pyrénées,12,2,14,156,Montpeyroux,568,14,582
73,Midi-Pyrénées,12,2,03,157,Montrozier,1415,45,1460
73,Midi-Pyrénées,12,3,43,158,Montsalès,239,5,244
73,Midi-Pyrénées,12,3,42,159,Morlhon-le-Haut,553,20,573
73,Midi-Pyrénées,12,1,23,160,Mostuéjouls,282,7,289
73,Midi-Pyrénées,12,1,02,192,Mounes-Prohencoux,192,10,202
73,Midi-Pyrénées,12,2,16,161,Mouret,538,14,552
73,Midi-Pyrénées,12,2,39,162,Moyrazès,1097,20,1117
73,Midi-Pyrénées,12,2,19,164,Mur-de-Barrez,821,29,850
73,Midi-Pyrénées,12,1,02,163,Murasson,202,13,215
73,Midi-Pyrénées,12,2,16,165,Muret-le-Château,316,16,332
73,Midi-Pyrénées,12,2,19,166,Murols,102,4,106
73,Midi-Pyrénées,12,3,20,167,Najac,752,22,774
73,Midi-Pyrénées,12,1,21,168,Nant,920,21,941
73,Midi-Pyrénées,12,2,22,169,Naucelle,2017,274,2291
73,Midi-Pyrénées,12,3,06,170,Naussac,320,10,330
73,Midi-Pyrénées,12,2,16,171,Nauviale,552,18,570
73,Midi-Pyrénées,12,2,13,172,Le Nayrac,571,8,579
73,Midi-Pyrénées,12,2,08,173,Noailhac,177,4,181
73,Midi-Pyrénées,12,2,45,174,Olemps,3165,119,3284
73,Midi-Pyrénées,12,3,43,175,Ols-et-Rinhodes,145,10,155
73,Midi-Pyrénées,12,2,46,176,Onet-le-Château,10643,543,11186
73,Midi-Pyrénées,12,2,15,177,Palmas,287,7,294
73,Midi-Pyrénées,12,1,17,178,Paulhe,346,17,363
73,Midi-Pyrénées,12,1,04,179,Peux-et-Couffouleux,108,5,113
73,Midi-Pyrénées,12,1,23,180,Peyreleau,73,6,79
73,Midi-Pyrénées,12,3,18,181,Peyrusse-le-Roc,213,7,220
73,Midi-Pyrénées,12,2,34,182,Pierrefiche,262,12,274
73,Midi-Pyrénées,12,1,36,183,Plaisance,224,7,231
73,Midi-Pyrénées,12,2,34,184,Pomayrols,148,3,151
73,Midi-Pyrénées,12,2,24,185,Pont-de-Salars,1577,43,1620
73,Midi-Pyrénées,12,1,36,186,Pousthomy,216,7,223
73,Midi-Pyrénées,12,2,34,187,Prades-d'Aubrac,419,9,428
73,Midi-Pyrénées,12,2,24,188,Prades-Salars,283,11,294
73,Midi-Pyrénées,12,2,39,189,Pradinas,367,13,380
73,Midi-Pyrénées,12,3,26,190,Prévinquières,285,12,297
73,Midi-Pyrénées,12,3,18,191,Privezac,325,4,329
73,Midi-Pyrénées,12,2,16,193,Pruines,273,5,278
73,Midi-Pyrénées,12,2,22,194,Quins,798,15,813
73,Midi-Pyrénées,12,1,02,195,Rebourguil,270,7,277
73,Midi-Pyrénées,12,1,40,196,Recoules-Prévinquières,465,12,477
73,Midi-Pyrénées,12,2,25,197,Réquista,2065,100,2165
73,Midi-Pyrénées,12,3,26,198,Rieupeyroux,2078,75,2153
73,Midi-Pyrénées,12,2,27,199,Rignac,1889,169,2058
73,Midi-Pyrénées,12,1,23,200,Rivière-sur-Tarn,1027,21,1048
73,Midi-Pyrénées,12,2,03,201,Rodelle,959,37,996
73,Midi-Pyrénées,12,2,98,202,Rodez,24540,2046,26586
73,Midi-Pyrénées,12,1,23,204,La Roque-Sainte-Marguerite,198,7,205
73,Midi-Pyrénées,12,1,29,203,Roquefort-sur-Soulzon,685,26,711
73,Midi-Pyrénées,12,3,42,205,La Rouquette,719,29,748
73,Midi-Pyrénées,12,3,18,206,Roussennac,496,13,509
73,Midi-Pyrénées,12,2,25,207,Rullac-Saint-Cirq,366,11,377
73,Midi-Pyrénées,12,1,29,208,Saint-Affrique,8112,656,8768
73,Midi-Pyrénées,12,2,30,209,Saint-Amans-des-Cots,773,20,793
73,Midi-Pyrénées,12,3,20,210,Saint-André-de-Najac,418,13,431
73,Midi-Pyrénées,12,1,23,211,Saint-André-de-Vézines,123,4,127
73,Midi-Pyrénées,12,1,09,212,Saint-Beaulize,98,2,100
73,Midi-Pyrénées,12,1,31,213,Saint-Beauzély,520,17,537
73,Midi-Pyrénées,12,2,32,214,Saint-Chély-d'Aubrac,549,18,567
73,Midi-Pyrénées,12,2,16,215,Saint-Christophe-Vallon,1085,55,1140
73,Midi-Pyrénées,12,2,12,216,Saint-Côme-d'Olt,1387,40,1427
73,Midi-Pyrénées,12,2,08,218,Saint-Cyprien-sur-Dourdou,813,25,838
73,Midi-Pyrénées,12,2,08,221,Saint-Félix-de-Lunel,386,5,391
73,Midi-Pyrénées,12,1,29,222,Saint-Félix-de-Sorgues,199,3,202
73,Midi-Pyrénées,12,2,34,224,Saint-Geniez-d'Olt,2034,45,2079
73,Midi-Pyrénées,12,1,44,225,Saint-Georges-de-Luzençon,1673,38,1711
73,Midi-Pyrénées,12,2,11,226,Saint-Hippolyte,453,21,474
73,Midi-Pyrénées,12,3,43,227,Saint-Igest,173,4,177
73,Midi-Pyrénées,12,1,29,228,Saint-Izaire,325,13,338
73,Midi-Pyrénées,12,1,29,229,Saint-Jean-d'Alcapiès,260,15,275
73,Midi-Pyrénées,12,2,25,230,Saint-Jean-Delnous,446,9,455
73,Midi-Pyrénées,12,1,21,231,Saint-Jean-du-Bruel,693,11,704
73,Midi-Pyrénées,12,1,09,232,Saint-Jean-et-Saint-Paul,263,1,264
73,Midi-Pyrénées,12,1,36,233,Saint-Juéry,224,8,232
73,Midi-Pyrénées,12,2,22,235,Saint-Just-sur-Viaur,204,0,204
73,Midi-Pyrénées,12,1,05,237,Saint-Laurent-d'Olt,661,82,743
73,Midi-Pyrénées,12,1,41,236,Saint-Laurent-de-Lévézou,156,5,161
73,Midi-Pyrénées,12,1,41,238,Saint-Léons,347,10,357
73,Midi-Pyrénées,12,1,05,239,Saint-Martin-de-Lenne,268,7,275
73,Midi-Pyrénées,12,3,10,240,Saint-Parthem,415,10,425
73,Midi-Pyrénées,12,3,43,242,Saint-Rémy,320,4,324
73,Midi-Pyrénées,12,1,29,243,Saint-Rome-de-Cernon,757,22,779
73,Midi-Pyrénées,12,1,35,244,Saint-Rome-de-Tarn,845,11,856
73,Midi-Pyrénées,12,3,26,245,Saint-Salvadou,402,16,418
73,Midi-Pyrénées,12,3,10,246,Saint-Santin,561,9,570
73,Midi-Pyrénées,12,1,05,247,Saint-Saturnin-de-Lenne,359,9,368
73,Midi-Pyrénées,12,1,36,248,Saint-Sernin-sur-Rance,674,127,801
73,Midi-Pyrénées,12,1,02,249,Saint-Sever-du-Moustier,226,5,231
73,Midi-Pyrénées,12,2,30,250,Saint-Symphorien-de-Thénières,246,3,249
73,Midi-Pyrénées,12,1,35,251,Saint-Victor-et-Melvieu,374,5,379
73,Midi-Pyrénées,12,3,43,217,Sainte-Croix,719,27,746
73,Midi-Pyrénées,12,2,34,219,Sainte-Eulalie-d'Olt,344,17,361
73,Midi-Pyrénées,12,1,09,220,Sainte-Eulalie-de-Cernon,248,8,256
73,Midi-Pyrénées,12,2,33,223,Sainte-Geneviève-sur-Argence,1011,28,1039
73,Midi-Pyrénées,12,2,07,234,Sainte-Juliette-sur-Viaur,514,11,525
73,Midi-Pyrénées,12,2,28,241,Sainte-Radegonde,1587,54,1641
73,Midi-Pyrénées,12,3,06,252,Salles-Courbatiès,396,17,413
73,Midi-Pyrénées,12,1,37,253,Salles-Curan,1064,31,1095
73,Midi-Pyrénées,12,2,16,254,Salles-la-Source,2028,70,2098
73,Midi-Pyrénées,12,2,07,255,Salmiech,711,11,722
73,Midi-Pyrénées,12,3,43,256,Salvagnac-Cajarc,371,9,380
73,Midi-Pyrénées,12,2,38,258,La Salvetat-Peyralès,1068,23,1091
73,Midi-Pyrénées,12,3,20,259,Sanvensa,634,6,640
73,Midi-Pyrénées,12,1,21,260,Sauclières,189,10,199
73,Midi-Pyrénées,12,3,43,261,Saujac,133,3,136
73,Midi-Pyrénées,12,2,39,262,Sauveterre-de-Rouergue,803,24,827
73,Midi-Pyrénées,12,3,42,263,Savignac,609,23,632
73,Midi-Pyrénées,12,2,46,264,Sébazac-Concourès,3060,101,3161
73,Midi-Pyrénées,12,2,13,265,Sébrazac,516,12,528
73,Midi-Pyrénées,12,1,41,266,Ségur,587,14,601
73,Midi-Pyrénées,12,2,25,267,La Selve,665,16,681
73,Midi-Pyrénées,12,2,08,268,Sénergues,487,17,504
73,Midi-Pyrénées,12,1,36,269,La Serre,132,4,136
73,Midi-Pyrénées,12,2,15,271,Sévérac-l'Église,412,93,505
73,Midi-Pyrénées,12,1,40,270,Sévérac-le-Château,2395,97,2492
73,Midi-Pyrénées,12,3,06,272,Sonnac,411,10,421
73,Midi-Pyrénées,12,2,14,273,Soulages-Bonneval,273,5,278
73,Midi-Pyrénées,12,1,04,274,Sylvanès,93,5,98
73,Midi-Pyrénées,12,1,04,275,Tauriac-de-Camarès,58,2,60
73,Midi-Pyrénées,12,2,22,276,Tauriac-de-Naucelle,382,10,392
73,Midi-Pyrénées,12,2,19,277,Taussac,456,14,470
73,Midi-Pyrénées,12,2,38,278,Tayrac,172,8,180
73,Midi-Pyrénées,12,2,33,279,La Terrisse,166,7,173
73,Midi-Pyrénées,12,2,19,280,Thérondels,478,16,494
73,Midi-Pyrénées,12,3,42,281,Toulonjac,705,21,726
73,Midi-Pyrénées,12,1,29,282,Tournemire,437,12,449
73,Midi-Pyrénées,12,2,24,283,Trémouilles,521,12,533
73,Midi-Pyrénées,12,1,35,284,Le Truel,345,10,355
73,Midi-Pyrénées,12,3,26,285,Vabre-Tizac,433,6,439
73,Midi-Pyrénées,12,1,29,286,Vabres-l'Abbaye,1106,38,1144
73,Midi-Pyrénées,12,3,42,287,Vailhourles,611,17,628
73,Midi-Pyrénées,12,2,16,288,Valady,1467,30,1497
73,Midi-Pyrénées,12,3,18,289,Valzergues,202,13,215
73,Midi-Pyrénées,12,3,18,290,Vaureilles,499,14,513
73,Midi-Pyrénées,12,1,31,291,Verrières,393,15,408
73,Midi-Pyrénées,12,1,29,292,Versols-et-Lapeyre,435,8,443
73,Midi-Pyrénées,12,1,23,293,Veyreau,126,0,126
73,Midi-Pyrénées,12,1,41,294,Vézins-de-Lévézou,645,11,656
73,Midi-Pyrénées,12,1,09,295,Viala-du-Pas-de-Jaux,104,5,109
73,Midi-Pyrénées,12,1,31,296,Viala-du-Tarn,541,19,560
73,Midi-Pyrénées,12,2,24,297,Le Vibal,482,9,491
73,Midi-Pyrénées,12,2,13,298,Villecomtal,442,8,450
73,Midi-Pyrénées,12,1,37,299,Villefranche-de-Panat,778,25,803
73,Midi-Pyrénées,12,3,42,300,Villefranche-de-Rouergue,11926,716,12642
73,Midi-Pyrénées,12,3,43,301,Villeneuve,1952,56,2008
73,Midi-Pyrénées,12,2,15,303,Vimenet,254,7,261
73,Midi-Pyrénées,12,2,33,304,Vitrac-en-Viadène,113,1,114
73,Midi-Pyrénées,12,3,01,305,Viviez,1396,59,1455
93,Provence-Alpes-Côte d'Azur,13,1,97,001,Aix-en-Provence,142743,3307,146050
93,Provence-Alpes-Côte d'Azur,13,3,35,002,Allauch,18728,265,18993
93,Provence-Alpes-Côte d'Azur,13,2,09,003,Alleins,2437,49,2486
93,Provence-Alpes-Côte d'Azur,13,2,98,004,Arles,52729,1088,53817
93,Provence-Alpes-Côte d'Azur,13,3,94,005,Aubagne,46093,434,46527
93,Provence-Alpes-Côte d'Azur,13,2,09,006,Aureille,1462,41,1503
93,Provence-Alpes-Côte d'Azur,13,3,29,007,Auriol,11969,91,12060
93,Provence-Alpes-Côte d'Azur,13,1,51,008,Aurons,531,13,544
93,Provence-Alpes-Côte d'Azur,13,1,51,009,La Barben,703,20,723
93,Provence-Alpes-Côte d'Azur,13,2,07,010,Barbentane,3763,173,3936
93,Provence-Alpes-Côte d'Azur,13,2,31,011,Les Baux-de-Provence,406,11,417
93,Provence-Alpes-Côte d'Azur,13,1,34,012,Beaurecueil,610,24,634
93,Provence-Alpes-Côte d'Azur,13,3,29,013,Belcodène,1743,45,1788
93,Provence-Alpes-Côte d'Azur,13,4,06,014,Berre-l'Étang,13881,127,14008
93,Provence-Alpes-Côte d'Azur,13,1,10,015,Bouc-Bel-Air,13437,317,13754
93,Provence-Alpes-Côte d'Azur,13,3,29,016,La Bouilladisse,5743,53,5796
93,Provence-Alpes-Côte d'Azur,13,2,33,017,Boulbon,1538,21,1559
93,Provence-Alpes-Côte d'Azur,13,2,26,018,Cabannes,4314,73,4387
93,Provence-Alpes-Côte d'Azur,13,1,52,019,Cabriès,8182,253,8435
93,Provence-Alpes-Côte d'Azur,13,3,29,020,Cadolive,2136,28,2164
93,Provence-Alpes-Côte d'Azur,13,3,54,119,Carnoux-en-Provence,6999,97,7096
93,Provence-Alpes-Côte d'Azur,13,4,48,021,Carry-le-Rouet,6331,126,6457
93,Provence-Alpes-Côte d'Azur,13,3,54,022,Cassis,7793,112,7905
93,Provence-Alpes-Côte d'Azur,13,3,08,023,Ceyreste,4130,72,4202
93,Provence-Alpes-Côte d'Azur,13,1,12,024,Charleval,2397,47,2444
93,Provence-Alpes-Côte d'Azur,13,1,34,025,Châteauneuf-le-Rouge,2104,48,2152
93,Provence-Alpes-Côte d'Azur,13,4,48,026,Châteauneuf-les-Martigues,11564,105,11669
93,Provence-Alpes-Côte d'Azur,13,2,07,027,Châteaurenard,14817,144,14961
93,Provence-Alpes-Côte d'Azur,13,3,08,028,La Ciotat,33790,481,34271
93,Provence-Alpes-Côte d'Azur,13,1,51,029,Cornillon-Confoux,1345,30,1375
93,Provence-Alpes-Côte d'Azur,13,1,51,118,Coudoux,3392,57,3449
93,Provence-Alpes-Côte d'Azur,13,3,54,030,Cuges-les-Pins,4743,46,4789
93,Provence-Alpes-Côte d'Azur,13,3,29,031,La Destrousse,2758,25,2783
93,Provence-Alpes-Côte d'Azur,13,1,02,032,Éguilles,7604,216,7820
93,Provence-Alpes-Côte d'Azur,13,4,48,033,Ensuès-la-Redonne,5224,71,5295
93,Provence-Alpes-Côte d'Azur,13,2,26,034,Eygalières,1830,42,1872
93,Provence-Alpes-Côte d'Azur,13,2,09,035,Eyguières,6378,105,6483
93,Provence-Alpes-Côte d'Azur,13,2,07,036,Eyragues,4338,128,4466
93,Provence-Alpes-Côte d'Azur,13,1,51,037,La Fare-les-Oliviers,6526,92,6618
93,Provence-Alpes-Côte d'Azur,13,2,03,038,Fontvieille,3533,97,3630
93,Provence-Alpes-Côte d'Azur,13,4,49,039,Fos-sur-Mer,15448,172,15620
93,Provence-Alpes-Côte d'Azur,13,1,34,040,Fuveau,8894,178,9072
93,Provence-Alpes-Côte d'Azur,13,1,10,041,Gardanne,21121,295,21416
93,Provence-Alpes-Côte d'Azur,13,3,54,042,Gémenos,6007,106,6113
93,Provence-Alpes-Côte d'Azur,13,4,48,043,Gignac-la-Nerthe,9186,96,9282
93,Provence-Alpes-Côte d'Azur,13,1,32,044,Grans,4153,94,4247
93,Provence-Alpes-Côte d'Azur,13,2,07,045,Graveson,3836,63,3899
93,Provence-Alpes-Côte d'Azur,13,3,29,046,Gréasque,3948,57,4005
93,Provence-Alpes-Côte d'Azur,13,4,95,047,Istres,42603,897,43500
93,Provence-Alpes-Côte d'Azur,13,1,27,048,Jouques,4089,53,4142
93,Provence-Alpes-Côte d'Azur,13,2,09,049,Lamanon,1740,39,1779
93,Provence-Alpes-Côte d'Azur,13,1,12,050,Lambesc,8743,247,8990
93,Provence-Alpes-Côte d'Azur,13,1,51,051,Lançon-Provence,8010,112,8122
93,Provence-Alpes-Côte d'Azur,13,2,31,052,Maillane,2219,36,2255
93,Provence-Alpes-Côte d'Azur,13,2,09,053,Mallemort,5809,103,5912
93,Provence-Alpes-Côte d'Azur,13,4,36,054,Marignane,33909,365,34274
93,Provence-Alpes-Côte d'Azur,13,3,99,201,Marseille 1er Arrondissement,40606,343,40949
93,Provence-Alpes-Côte d'Azur,13,3,16,202,Marseille 2e  Arrondissement,25227,193,25420
93,Provence-Alpes-Côte d'Azur,13,3,99,203,Marseille 3e  Arrondissement,45515,281,45796
93,Provence-Alpes-Côte d'Azur,13,3,99,204,Marseille 4e  Arrondissement,47243,450,47693
93,Provence-Alpes-Côte d'Azur,13,3,99,205,Marseille 5e  Arrondissement,44918,373,45291
93,Provence-Alpes-Côte d'Azur,13,3,99,206,Marseille 6e  Arrondissement,42728,553,43281
93,Provence-Alpes-Côte d'Azur,13,3,99,207,Marseille 7e  Arrondissement,35910,391,36301
93,Provence-Alpes-Côte d'Azur,13,3,99,208,Marseille 8e  Arrondissement,78916,1430,80346
93,Provence-Alpes-Côte d'Azur,13,3,99,209,Marseille 9e  Arrondissement,76819,754,77573
93,Provence-Alpes-Côte d'Azur,13,3,99,210,Marseille 10e  Arrondissement,51545,474,52019
93,Provence-Alpes-Côte d'Azur,13,3,99,211,Marseille 11e  Arrondissement,57183,520,57703
93,Provence-Alpes-Côte d'Azur,13,3,99,212,Marseille 12e  Arrondissement,58775,740,59515
93,Provence-Alpes-Côte d'Azur,13,3,99,213,Marseille 13e  Arrondissement,89014,840,89854
93,Provence-Alpes-Côte d'Azur,13,3,99,214,Marseille 14e  Arrondissement,61168,305,61473
93,Provence-Alpes-Côte d'Azur,13,3,99,215,Marseille 15e  Arrondissement,78396,354,78750
93,Provence-Alpes-Côte d'Azur,13,3,39,216,Marseille 16e  Arrondissement,17457,122,17579
93,Provence-Alpes-Côte d'Azur,13,4,96,056,Martigues,46471,675,47146
93,Provence-Alpes-Côte d'Azur,13,2,33,057,Mas-Blanc-des-Alpilles,506,5,511
93,Provence-Alpes-Côte d'Azur,13,2,31,058,Maussane-les-Alpilles,2102,41,2143
93,Provence-Alpes-Côte d'Azur,13,1,27,059,Meyrargues,3473,62,3535
93,Provence-Alpes-Côte d'Azur,13,1,02,060,Meyreuil,5084,104,5188
93,Provence-Alpes-Côte d'Azur,13,1,10,062,Mimet,4479,78,4557
93,Provence-Alpes-Côte d'Azur,13,4,11,063,Miramas,25632,398,26030
93,Provence-Alpes-Côte d'Azur,13,2,26,064,Mollégès,2453,35,2488
93,Provence-Alpes-Côte d'Azur,13,2,09,065,Mouriès,3085,79,3164
93,Provence-Alpes-Côte d'Azur,13,2,07,066,Noves,5106,73,5179
93,Provence-Alpes-Côte d'Azur,13,2,26,067,Orgon,3030,53,3083
93,Provence-Alpes-Côte d'Azur,13,2,31,068,Paradou,1290,35,1325
93,Provence-Alpes-Côte d'Azur,13,1,51,069,Pélissanne,9221,252,9473
93,Provence-Alpes-Côte d'Azur,13,3,05,070,La Penne-sur-Huveaune,6314,50,6364
93,Provence-Alpes-Côte d'Azur,13,1,52,071,Les Pennes-Mirabeau,20187,178,20365
93,Provence-Alpes-Côte d'Azur,13,1,34,072,Peynier,3007,198,3205
93,Provence-Alpes-Côte d'Azur,13,3,29,073,Peypin,5336,54,5390
93,Provence-Alpes-Côte d'Azur,13,1,27,074,Peyrolles-en-Provence,4477,71,4548
93,Provence-Alpes-Côte d'Azur,13,2,26,076,Plan-d'Orgon,2774,36,2810
93,Provence-Alpes-Côte d'Azur,13,3,35,075,Plan-de-Cuques,11096,59,11155
93,Provence-Alpes-Côte d'Azur,13,4,50,077,Port-de-Bouc,17207,177,17384
93,Provence-Alpes-Côte d'Azur,13,2,28,078,Port-Saint-Louis-du-Rhône,8535,150,8685
93,Provence-Alpes-Côte d'Azur,13,1,27,080,Le Puy-Sainte-Réparade,5276,91,5367
93,Provence-Alpes-Côte d'Azur,13,1,34,079,Puyloubier,1755,112,1867
93,Provence-Alpes-Côte d'Azur,13,4,06,081,Rognac,12195,173,12368
93,Provence-Alpes-Côte d'Azur,13,1,12,082,Rognes,4606,79,4685
93,Provence-Alpes-Côte d'Azur,13,2,07,083,Rognonas,4122,62,4184
93,Provence-Alpes-Côte d'Azur,13,1,12,084,La Roque-d'Anthéron,5078,72,5150
93,Provence-Alpes-Côte d'Azur,13,3,54,085,Roquefort-la-Bédoule,5038,59,5097
93,Provence-Alpes-Côte d'Azur,13,3,29,086,Roquevaire,8429,126,8555
93,Provence-Alpes-Côte d'Azur,13,1,34,087,Rousset,4290,106,4396
93,Provence-Alpes-Côte d'Azur,13,4,48,088,Le Rove,4174,40,4214
93,Provence-Alpes-Côte d'Azur,13,2,26,089,Saint-Andiol,3198,48,3246
93,Provence-Alpes-Côte d'Azur,13,1,34,090,Saint-Antonin-sur-Bayon,138,4,142
93,Provence-Alpes-Côte d'Azur,13,1,12,091,Saint-Cannat,5347,115,5462
93,Provence-Alpes-Côte d'Azur,13,4,06,092,Saint-Chamas,7790,127,7917
93,Provence-Alpes-Côte d'Azur,13,1,12,093,Saint-Estève-Janson,339,5,344
93,Provence-Alpes-Côte d'Azur,13,2,33,094,Saint-Étienne-du-Grès,2152,77,2229
93,Provence-Alpes-Côte d'Azur,13,1,01,095,Saint-Marc-Jaumegarde,1101,67,1168
93,Provence-Alpes-Côte d'Azur,13,2,03,097,Saint-Martin-de-Crau,10979,179,11158
93,Provence-Alpes-Côte d'Azur,13,4,49,098,Saint-Mitre-les-Remparts,5372,107,5479
93,Provence-Alpes-Côte d'Azur,13,1,27,099,Saint-Paul-lès-Durance,973,6,979
93,Provence-Alpes-Côte d'Azur,13,2,33,061,Saint-Pierre-de-Mézoargues,256,0,256
93,Provence-Alpes-Côte d'Azur,13,2,31,100,Saint-Rémy-de-Provence,10662,211,10873
93,Provence-Alpes-Côte d'Azur,13,3,29,101,Saint-Savournin,3095,36,3131
93,Provence-Alpes-Côte d'Azur,13,4,36,102,Saint-Victoret,6536,53,6589
93,Provence-Alpes-Côte d'Azur,13,2,30,096,Saintes-Maries-de-la-Mer,2294,33,2327
93,Provence-Alpes-Côte d'Azur,13,1,32,103,Salon-de-Provence,41411,635,42046
93,Provence-Alpes-Côte d'Azur,13,4,48,104,Sausset-les-Pins,7333,128,7461
93,Provence-Alpes-Côte d'Azur,13,2,26,105,Sénas,6317,89,6406
93,Provence-Alpes-Côte d'Azur,13,1,52,106,Septèmes-les-Vallons,10481,58,10539
93,Provence-Alpes-Côte d'Azur,13,1,10,107,Simiane-Collongue,5774,104,5878
93,Provence-Alpes-Côte d'Azur,13,2,33,108,Tarascon,13340,174,13514
93,Provence-Alpes-Côte d'Azur,13,1,01,109,Le Tholonet,2227,52,2279
93,Provence-Alpes-Côte d'Azur,13,1,34,110,Trets,10239,157,10396
93,Provence-Alpes-Côte d'Azur,13,1,01,111,Vauvenargues,921,17,938
93,Provence-Alpes-Côte d'Azur,13,1,51,112,Velaux,8403,139,8542
93,Provence-Alpes-Côte d'Azur,13,1,01,113,Venelles,8100,210,8310
93,Provence-Alpes-Côte d'Azur,13,1,51,114,Ventabren,4766,186,4952
93,Provence-Alpes-Côte d'Azur,13,2,09,115,Vernègues,1365,26,1391
93,Provence-Alpes-Côte d'Azur,13,2,26,116,Verquières,779,17,796
93,Provence-Alpes-Côte d'Azur,13,4,53,117,Vitrolles,36610,397,37007
25,Basse-Normandie,14,3,19,001,Ablon,1175,19,1194
25,Basse-Normandie,14,2,31,002,Acqueville,168,4,172
25,Basse-Normandie,14,1,03,003,Agy,245,2,247
25,Basse-Normandie,14,1,33,004,Aignerville,173,3,176
25,Basse-Normandie,14,2,06,005,Airan,620,11,631
25,Basse-Normandie,14,2,16,006,Amayé-sur-Orne,1019,20,1039
25,Basse-Normandie,14,2,37,007,Amayé-sur-Seulles,203,8,211
25,Basse-Normandie,14,2,13,008,Amblie,260,7,267
25,Basse-Normandie,14,2,47,009,Amfreville,1188,20,1208
25,Basse-Normandie,14,1,11,011,Anctoville,1046,17,1063
25,Basse-Normandie,14,3,15,012,Angerville,125,5,130
25,Basse-Normandie,14,2,31,013,Angoville,32,0,32
25,Basse-Normandie,14,2,13,014,Anguerny,797,32,829
25,Basse-Normandie,14,2,13,015,Anisy,665,22,687
25,Basse-Normandie,14,3,15,016,Annebault,414,8,422
25,Basse-Normandie,14,1,03,019,Arganchy,229,9,238
25,Basse-Normandie,14,2,34,020,Argences,3506,61,3567
25,Basse-Normandie,14,1,28,021,Arromanches-les-Bains,609,8,617
25,Basse-Normandie,14,1,28,022,Asnelles,587,10,597
25,Basse-Normandie,14,1,20,023,Asnières-en-Bessin,61,0,61
25,Basse-Normandie,14,3,15,024,Auberville,480,12,492
25,Basse-Normandie,14,2,17,025,Aubigny,341,3,344
25,Basse-Normandie,14,2,32,026,Audrieu,1002,12,1014
25,Basse-Normandie,14,4,01,027,Aunay-sur-Odon,2949,42,2991
25,Basse-Normandie,14,3,23,028,Auquainville,302,7,309
25,Basse-Normandie,14,3,23,029,Les Autels-Saint-Bazile,48,1,49
25,Basse-Normandie,14,2,09,030,Authie,1394,41,1435
25,Basse-Normandie,14,3,24,031,Les Authieux-Papion,63,0,63
25,Basse-Normandie,14,3,05,032,Les Authieux-sur-Calonne,300,4,304
25,Basse-Normandie,14,3,10,033,Auvillars,213,2,215
25,Basse-Normandie,14,2,16,034,Avenay,513,7,520
25,Basse-Normandie,14,1,02,035,Balleroy,770,76,846
25,Basse-Normandie,14,2,34,036,Banneville-la-Campagne,122,1,123
25,Basse-Normandie,14,2,37,037,Banneville-sur-Ajon,394,6,400
25,Basse-Normandie,14,1,28,038,Banville,636,4,640
25,Basse-Normandie,14,2,07,039,Barbery,664,6,670
25,Basse-Normandie,14,1,03,040,Barbeville,182,2,184
25,Basse-Normandie,14,3,19,041,Barneville-la-Bertran,147,4,151
25,Basse-Normandie,14,2,16,042,Baron-sur-Odon,836,35,871
25,Basse-Normandie,14,2,25,043,Barou-en-Auge,91,1,92
25,Basse-Normandie,14,2,13,044,Basly,943,9,952
25,Basse-Normandie,14,3,15,045,Basseneville,261,3,264
25,Basse-Normandie,14,4,01,056,Bauquay,219,4,223
25,Basse-Normandie,14,2,47,046,Bavent,1760,26,1786
25,Basse-Normandie,14,1,03,047,Bayeux,13478,471,13949
25,Basse-Normandie,14,1,28,049,Bazenville,149,2,151
25,Basse-Normandie,14,1,02,050,La Bazoque,168,7,175
25,Basse-Normandie,14,3,10,231,Beaufour-Druval,432,8,440
25,Basse-Normandie,14,4,04,052,Beaulieu,168,2,170
25,Basse-Normandie,14,2,25,053,Beaumais,182,0,182
25,Basse-Normandie,14,4,30,054,Beaumesnil,199,9,208
25,Basse-Normandie,14,3,27,055,Beaumont-en-Auge,458,11,469
25,Basse-Normandie,14,2,06,057,Bellengreville,1529,23,1552
25,Basse-Normandie,14,3,23,058,Bellou,153,0,153
25,Basse-Normandie,14,3,35,059,Benerville-sur-Mer,490,40,530
25,Basse-Normandie,14,2,48,060,Bénouville,1946,42,1988
25,Basse-Normandie,14,4,04,061,Le Bény-Bocage,981,21,1002
25,Basse-Normandie,14,2,13,062,Bény-sur-Mer,333,1,334
25,Basse-Normandie,14,1,33,063,Bernesq,211,1,212
25,Basse-Normandie,14,2,25,064,Bernières-d'Ailly,250,3,253
25,Basse-Normandie,14,4,36,065,Bernières-le-Patry,559,10,569
25,Basse-Normandie,14,2,14,066,Bernières-sur-Mer,2371,41,2412
25,Basse-Normandie,14,3,21,069,Beuvillers,1234,29,1263
25,Basse-Normandie,14,3,10,070,Beuvron-en-Auge,222,4,226
25,Basse-Normandie,14,2,48,068,Biéville-Beuville,2525,68,2593
25,Basse-Normandie,14,3,24,527,Biéville-Quétiéville,325,13,338
25,Basse-Normandie,14,4,01,073,La Bigne,190,2,192
25,Basse-Normandie,14,2,06,074,Billy,334,6,340
25,Basse-Normandie,14,3,24,075,Bissières,155,1,156
25,Basse-Normandie,14,2,48,076,Blainville-sur-Orne,6002,74,6076
25,Basse-Normandie,14,3,05,077,Blangy-le-Château,672,72,744
25,Basse-Normandie,14,1,33,078,Blay,332,2,334
25,Basse-Normandie,14,3,35,079,Blonville-sur-Mer,1605,40,1645
25,Basse-Normandie,14,2,31,080,Le Bô,107,4,111
25,Basse-Normandie,14,3,29,081,Boissey,198,0,198
25,Basse-Normandie,14,3,49,082,La Boissière,163,2,165
25,Basse-Normandie,14,3,10,083,Bonnebosq,708,20,728
25,Basse-Normandie,14,2,37,084,Bonnemaison,367,10,377
25,Basse-Normandie,14,3,05,085,Bonneville-la-Louvet,786,4,790
25,Basse-Normandie,14,3,27,086,Bonneville-sur-Touques,385,16,401
25,Basse-Normandie,14,2,17,087,Bonnoeil,118,0,118
25,Basse-Normandie,14,2,17,088,Bons-Tassilly,391,7,398
25,Basse-Normandie,14,2,16,089,Bougy,424,7,431
25,Basse-Normandie,14,2,07,090,Boulon,583,5,588
25,Basse-Normandie,14,3,15,091,Bourgeauville,139,2,141
25,Basse-Normandie,14,2,06,092,Bourguébus,1384,11,1395
25,Basse-Normandie,14,3,15,093,Branville,201,6,207
25,Basse-Normandie,14,4,01,096,Brémoy,220,16,236
25,Basse-Normandie,14,2,32,098,Bretteville-l'Orgueilleuse,2278,41,2319
25,Basse-Normandie,14,2,07,097,Bretteville-le-Rabet,260,1,261
25,Basse-Normandie,14,3,29,099,Bretteville-sur-Dives,306,6,312
25,Basse-Normandie,14,2,07,100,Bretteville-sur-Laize,1566,18,1584
25,Basse-Normandie,14,2,08,101,Bretteville-sur-Odon,4060,176,4236
25,Basse-Normandie,14,3,05,102,Le Breuil-en-Auge,940,23,963
25,Basse-Normandie,14,1,33,103,Le Breuil-en-Bessin,375,8,383
25,Basse-Normandie,14,3,05,104,Le Brévedent,145,5,150
25,Basse-Normandie,14,3,23,105,La Brévière,118,6,124
25,Basse-Normandie,14,2,47,106,Bréville-les-Monts,662,5,667
25,Basse-Normandie,14,1,33,107,Bricqueville,134,1,135
25,Basse-Normandie,14,2,32,109,Brouay,465,7,472
25,Basse-Normandie,14,3,15,110,Brucourt,138,3,141
25,Basse-Normandie,14,2,07,116,Le Bû-sur-Rouvres,106,2,108
25,Basse-Normandie,14,1,02,111,Bucéels,390,8,398
25,Basse-Normandie,14,4,36,113,Burcy,366,6,372
25,Basse-Normandie,14,4,04,115,Bures-les-Monts,131,1,132
25,Basse-Normandie,14,2,47,117,Cabourg,4026,73,4099
25,Basse-Normandie,14,2,97,118,Caen,109899,2891,112790
25,Basse-Normandie,14,2,34,119,Cagny,1475,15,1490
25,Basse-Normandie,14,4,01,120,Cahagnes,1319,26,1345
25,Basse-Normandie,14,1,02,121,Cahagnolles,228,2,230
25,Basse-Normandie,14,2,16,122,La Caine,101,3,104
25,Basse-Normandie,14,2,13,123,Cairon,1571,45,1616
25,Basse-Normandie,14,1,20,124,La Cambe,644,22,666
25,Basse-Normandie,14,2,13,125,Cambes-en-Plaine,1439,56,1495
25,Basse-Normandie,14,3,10,126,Cambremer,1096,34,1130
25,Basse-Normandie,14,4,30,127,Campagnolles,448,9,457
25,Basse-Normandie,14,2,37,128,Campandré-Valcongrain,110,6,116
25,Basse-Normandie,14,4,04,129,Campeaux,526,9,535
25,Basse-Normandie,14,1,02,130,Campigny,182,4,186
25,Basse-Normandie,14,3,27,131,Canapville,233,5,238
25,Basse-Normandie,14,1,20,132,Canchy,212,3,215
25,Basse-Normandie,14,2,34,134,Canteloup,178,4,182
25,Basse-Normandie,14,2,32,135,Carcagny,282,3,285
25,Basse-Normandie,14,1,20,136,Cardonville,105,0,105
25,Basse-Normandie,14,2,09,137,Carpiquet,2248,34,2282
25,Basse-Normandie,14,1,20,138,Cartigny-l'Épinay,298,10,308
25,Basse-Normandie,14,4,04,139,Carville,348,3,351
25,Basse-Normandie,14,1,02,140,Castillon,302,9,311
25,Basse-Normandie,14,3,24,141,Castillon-en-Auge,143,3,146
25,Basse-Normandie,14,1,20,142,Castilly,274,4,278
25,Basse-Normandie,14,1,11,143,Caumont-l'Éventé,1346,12,1358
25,Basse-Normandie,14,2,31,144,Caumont-sur-Orne,83,0,83
25,Basse-Normandie,14,2,07,145,Cauvicourt,428,10,438
25,Basse-Normandie,14,2,31,146,Cauville,155,3,158
25,Basse-Normandie,14,3,26,147,Cernay,119,6,125
25,Basse-Normandie,14,3,26,148,Cerqueux,101,1,102
25,Basse-Normandie,14,2,06,149,Cesny-aux-Vignes,324,12,336
25,Basse-Normandie,14,2,31,150,Cesny-Bois-Halbout,659,7,666
25,Basse-Normandie,14,4,30,151,Champ-du-Boult,382,7,389
25,Basse-Normandie,14,4,12,152,La Chapelle-Engerbold,110,2,112
25,Basse-Normandie,14,3,23,153,La Chapelle-Haute-Grue,45,0,45
25,Basse-Normandie,14,3,26,154,La Chapelle-Yvon,508,9,517
25,Basse-Normandie,14,3,23,155,Cheffreville-Tonnencourt,229,6,235
25,Basse-Normandie,14,4,36,156,Chênedollé,245,6,251
25,Basse-Normandie,14,2,32,157,Cheux,1256,16,1272
25,Basse-Normandie,14,2,06,158,Chicheboville,507,9,516
25,Basse-Normandie,14,1,02,159,Chouain,214,4,218
25,Basse-Normandie,14,2,07,160,Cintheaux,188,3,191
25,Basse-Normandie,14,3,27,161,Clarbec,361,9,370
25,Basse-Normandie,14,2,31,162,Clécy,1225,16,1241
25,Basse-Normandie,14,2,34,163,Cléville,340,4,344
25,Basse-Normandie,14,2,06,164,Clinchamps-sur-Orne,1106,7,1113
25,Basse-Normandie,14,2,48,166,Colleville-Montgomery,2191,37,2228
25,Basse-Normandie,14,1,33,165,Colleville-sur-Mer,164,6,170
25,Basse-Normandie,14,2,47,167,Colombelles,5895,66,5961
25,Basse-Normandie,14,1,33,168,Colombières,198,0,198
25,Basse-Normandie,14,1,28,169,Colombiers-sur-Seulles,164,0,164
25,Basse-Normandie,14,2,13,170,Colomby-sur-Thaon,403,13,416
25,Basse-Normandie,14,2,31,171,Combray,130,4,134
25,Basse-Normandie,14,1,28,172,Commes,416,18,434
25,Basse-Normandie,14,2,07,173,Condé-sur-Ifs,430,9,439
25,Basse-Normandie,14,4,12,174,Condé-sur-Noireau,5611,209,5820
25,Basse-Normandie,14,1,02,175,Condé-sur-Seulles,234,7,241
25,Basse-Normandie,14,2,06,176,Conteville,98,0,98
25,Basse-Normandie,14,3,05,177,Coquainvilliers,830,17,847
25,Basse-Normandie,14,3,10,178,Corbon,67,0,67
25,Basse-Normandie,14,3,21,179,Cordebugle,125,2,127
25,Basse-Normandie,14,2,17,180,Cordey,129,3,132
25,Basse-Normandie,14,2,46,181,Cormelles-le-Royal,4479,80,4559
25,Basse-Normandie,14,1,11,182,Cormolain,402,3,405
25,Basse-Normandie,14,2,31,183,Cossesseville,108,4,112
25,Basse-Normandie,14,1,03,184,Cottun,175,3,178
25,Basse-Normandie,14,3,27,185,Coudray-Rabut,320,8,328
25,Basse-Normandie,14,2,13,186,Coulombs,300,3,303
25,Basse-Normandie,14,4,38,187,Coulonces,697,8,705
25,Basse-Normandie,14,4,01,188,Coulvain,348,2,350
25,Basse-Normandie,14,3,24,189,Coupesarte,41,0,41
25,Basse-Normandie,14,2,25,190,Courcy,153,5,158
25,Basse-Normandie,14,2,13,191,Courseulles-sur-Mer,4169,57,4226
25,Basse-Normandie,14,4,30,192,Courson,423,15,438
25,Basse-Normandie,14,3,21,193,Courtonne-la-Meurdrac,698,5,703
25,Basse-Normandie,14,3,26,194,Courtonne-les-Deux-Églises,604,11,615
25,Basse-Normandie,14,2,37,195,Courvaudon,211,6,217
25,Basse-Normandie,14,1,28,196,Crépon,213,3,216
25,Basse-Normandie,14,2,14,197,Cresserons,1231,31,1262
25,Basse-Normandie,14,3,15,198,Cresseveuille,288,6,294
25,Basse-Normandie,14,2,13,200,Creully,1569,24,1593
25,Basse-Normandie,14,3,24,201,Crèvecoeur-en-Auge,517,5,522
25,Basse-Normandie,14,3,19,202,Cricqueboeuf,203,6,209
25,Basse-Normandie,14,3,15,203,Cricqueville-en-Auge,183,4,187
25,Basse-Normandie,14,1,20,204,Cricqueville-en-Bessin,186,5,191
25,Basse-Normandie,14,2,32,205,Cristot,214,4,218
25,Basse-Normandie,14,2,25,206,Crocy,295,1,296
25,Basse-Normandie,14,2,31,207,Croisilles,483,6,489
25,Basse-Normandie,14,3,24,208,Croissanville,436,5,441
25,Basse-Normandie,14,1,33,209,Crouay,529,10,539
25,Basse-Normandie,14,3,26,210,La Croupte,122,0,122
25,Basse-Normandie,14,2,31,211,Culey-le-Patry,344,6,350
25,Basse-Normandie,14,2,13,212,Cully,173,2,175
25,Basse-Normandie,14,2,16,213,Curcy-sur-Orne,416,12,428
25,Basse-Normandie,14,1,03,214,Cussy,130,6,136
25,Basse-Normandie,14,2,34,215,Cuverville,2069,23,2092
25,Basse-Normandie,14,2,18,216,Damblainville,229,4,233
25,Basse-Normandie,14,4,01,217,Dampierre,116,2,118
25,Basse-Normandie,14,3,15,218,Danestal,273,0,273
25,Basse-Normandie,14,4,01,219,Danvou-la-Ferrière,165,3,168
25,Basse-Normandie,14,3,35,220,Deauville,3968,84,4052
25,Basse-Normandie,14,2,34,221,Démouville,3164,77,3241
25,Basse-Normandie,14,4,36,222,Le Désert,76,1,77
25,Basse-Normandie,14,2,17,223,Le Détroit,89,0,89
25,Basse-Normandie,14,1,20,224,Deux-Jumeaux,77,1,78
25,Basse-Normandie,14,3,15,225,Dives-sur-Mer,5912,164,6076
25,Basse-Normandie,14,2,31,226,Donnay,184,7,191
25,Basse-Normandie,14,3,15,227,Douville-en-Auge,229,4,233
25,Basse-Normandie,14,2,14,228,Douvres-la-Délivrande,4891,271,5162
25,Basse-Normandie,14,3,15,229,Dozulé,1899,30,1929
25,Basse-Normandie,14,3,27,230,Drubec,112,1,113
25,Basse-Normandie,14,2,32,232,Ducy-Sainte-Marguerite,143,3,146
25,Basse-Normandie,14,1,33,235,Écrammeville,198,3,201
25,Basse-Normandie,14,1,02,236,Ellon,388,2,390
25,Basse-Normandie,14,2,34,237,Émiéville,473,13,486
25,Basse-Normandie,14,3,27,238,Englesqueville-en-Auge,109,3,112
25,Basse-Normandie,14,1,20,239,Englesqueville-la-Percée,90,2,92
25,Basse-Normandie,14,2,25,240,Épaney,435,10,445
25,Basse-Normandie,14,2,37,241,Épinay-sur-Odon,594,15,609
25,Basse-Normandie,14,2,40,242,Épron,1598,61,1659
25,Basse-Normandie,14,3,19,243,Équemauville,1251,34,1285
25,Basse-Normandie,14,2,18,244,Eraines,270,9,279
25,Basse-Normandie,14,2,25,245,Ernes,298,6,304
25,Basse-Normandie,14,2,47,246,Escoville,726,9,735
25,Basse-Normandie,14,2,31,248,Espins,226,6,232
25,Basse-Normandie,14,2,16,249,Esquay-Notre-Dame,1281,19,1300
25,Basse-Normandie,14,1,28,250,Esquay-sur-Seulles,343,9,352
25,Basse-Normandie,14,2,31,251,Esson,406,8,414
25,Basse-Normandie,14,2,07,252,Estrées-la-Campagne,214,2,216
25,Basse-Normandie,14,4,36,253,Estry,356,5,361
25,Basse-Normandie,14,2,16,254,Éterville,1360,29,1389
25,Basse-Normandie,14,4,04,255,Étouvy,306,8,314
25,Basse-Normandie,14,1,33,256,Étréham,264,8,272
25,Basse-Normandie,14,2,16,257,Évrecy,1557,66,1623
25,Basse-Normandie,14,2,98,258,Falaise,8387,277,8664
25,Basse-Normandie,14,3,26,259,Familly,127,7,134
25,Basse-Normandie,14,3,21,260,Fauguernon,249,4,253
25,Basse-Normandie,14,3,05,261,Le Faulq,299,13,312
25,Basse-Normandie,14,4,04,264,La Ferrière-Harang,303,5,308
25,Basse-Normandie,14,3,23,265,Fervaques,715,31,746
25,Basse-Normandie,14,2,16,266,Feuguerolles-Bully,1331,26,1357
25,Basse-Normandie,14,2,07,268,Fierville-Bray,469,11,480
25,Basse-Normandie,14,3,05,269,Fierville-les-Parcs,223,5,228
25,Basse-Normandie,14,3,21,270,Firfol,447,19,466
25,Basse-Normandie,14,2,44,271,Fleury-sur-Orne,4063,89,4152
25,Basse-Normandie,14,1,20,272,La Folie,110,4,114
25,Basse-Normandie,14,3,26,273,La Folletière-Abenon,154,3,157
25,Basse-Normandie,14,2,16,274,Fontaine-Étoupefour,1898,34,1932
25,Basse-Normandie,14,2,13,275,Fontaine-Henry,476,2,478
25,Basse-Normandie,14,2,07,276,Fontaine-le-Pin,347,2,349
25,Basse-Normandie,14,2,06,277,Fontenay-le-Marmion,1582,27,1609
25,Basse-Normandie,14,2,32,278,Fontenay-le-Pesnel,914,15,929
25,Basse-Normandie,14,4,30,279,Fontenermont,143,8,151
25,Basse-Normandie,14,3,10,280,Formentin,221,2,223
25,Basse-Normandie,14,1,33,281,Formigny,264,5,269
25,Basse-Normandie,14,1,11,282,Foulognes,174,3,177
25,Basse-Normandie,14,2,25,283,Fourches,179,3,182
25,Basse-Normandie,14,2,17,284,Fourneaux-le-Val,178,3,181
25,Basse-Normandie,14,3,10,285,Le Fournet,53,1,54
25,Basse-Normandie,14,3,19,286,Fourneville,485,19,504
25,Basse-Normandie,14,2,06,287,Frénouville,1624,20,1644
25,Basse-Normandie,14,2,13,288,Le Fresne-Camilly,823,27,850
25,Basse-Normandie,14,2,18,289,Fresné-la-Mère,487,8,495
25,Basse-Normandie,14,2,07,290,Fresney-le-Puceux,647,10,657
25,Basse-Normandie,14,2,07,291,Fresney-le-Vieux,272,2,274
25,Basse-Normandie,14,3,26,292,Friardel,239,2,241
25,Basse-Normandie,14,3,21,293,Fumichon,276,4,280
25,Basse-Normandie,14,2,06,294,Garcelles-Secqueville,761,8,769
25,Basse-Normandie,14,4,30,296,Le Gast,251,3,254
25,Basse-Normandie,14,2,16,297,Gavrus,449,6,455
25,Basse-Normandie,14,1,20,298,Géfosse-Fontenay,137,2,139
25,Basse-Normandie,14,3,19,299,Genneville,735,9,744
25,Basse-Normandie,14,3,10,300,Gerrots,56,0,56
25,Basse-Normandie,14,2,34,301,Giberville,4771,46,4817
25,Basse-Normandie,14,3,27,302,Glanville,178,7,185
25,Basse-Normandie,14,3,21,303,Glos,895,17,912
25,Basse-Normandie,14,2,47,306,Gonneville-en-Auge,409,10,419
25,Basse-Normandie,14,3,19,304,Gonneville-sur-Honfleur,765,20,785
25,Basse-Normandie,14,3,15,305,Gonneville-sur-Mer,602,25,627
25,Basse-Normandie,14,2,16,307,Goupillières,158,5,163
25,Basse-Normandie,14,3,15,308,Goustranville,180,0,180
25,Basse-Normandie,14,2,07,309,Gouvix,833,8,841
25,Basse-Normandie,14,2,07,310,Grainville-Langannerie,650,7,657
25,Basse-Normandie,14,2,32,311,Grainville-sur-Odon,1007,11,1018
25,Basse-Normandie,14,1,20,312,Grandcamp-Maisy,1775,29,1804
25,Basse-Normandie,14,3,24,313,Grandchamp-le-Château,61,2,63
25,Basse-Normandie,14,3,15,316,Grangues,236,6,242
25,Basse-Normandie,14,4,04,317,La Graverie,1132,36,1168
25,Basse-Normandie,14,1,28,318,Graye-sur-Mer,652,6,658
25,Basse-Normandie,14,2,06,319,Grentheville,959,11,970
25,Basse-Normandie,14,2,07,320,Grimbosq,277,1,278
25,Basse-Normandie,14,1,03,322,Guéron,223,12,235
25,Basse-Normandie,14,2,16,324,Hamars,420,4,424
25,Basse-Normandie,14,2,14,325,Hermanville-sur-Mer,2708,43,2751
25,Basse-Normandie,14,3,21,326,Hermival-les-Vaux,852,33,885
25,Basse-Normandie,14,2,93,327,Hérouville-Saint-Clair,22267,364,22631
25,Basse-Normandie,14,2,47,328,Hérouvillette,1098,18,1116
25,Basse-Normandie,14,3,15,329,Heuland,89,1,90
25,Basse-Normandie,14,3,23,330,Heurtevent,171,4,175
25,Basse-Normandie,14,3,29,331,Hiéville,293,5,298
25,Basse-Normandie,14,2,18,332,La Hoguette,668,22,690
25,Basse-Normandie,14,3,19,333,Honfleur,8163,196,8359
25,Basse-Normandie,14,3,21,334,L' Hôtellerie,303,1,304
25,Basse-Normandie,14,3,10,335,Hotot-en-Auge,300,10,310
25,Basse-Normandie,14,1,11,336,Hottot-les-Bagues,470,6,476
25,Basse-Normandie,14,3,49,337,La Houblonnière,317,5,322
25,Basse-Normandie,14,3,15,338,Houlgate,1960,39,1999
25,Basse-Normandie,14,2,06,339,Hubert-Folie,332,7,339
25,Basse-Normandie,14,2,46,341,Ifs,10822,167,10989
25,Basse-Normandie,14,1,20,342,Isigny-sur-Mer,2761,42,2803
25,Basse-Normandie,14,2,17,343,Les Isles-Bardel,64,1,65
25,Basse-Normandie,14,2,34,344,Janville,372,9,381
25,Basse-Normandie,14,2,25,345,Jort,308,4,312
25,Basse-Normandie,14,1,02,346,Juaye-Mondaye,685,15,700
25,Basse-Normandie,14,4,01,347,Jurques,639,8,647
25,Basse-Normandie,14,2,32,348,Juvigny-sur-Seulles,66,0,66
25,Basse-Normandie,14,2,06,349,Laize-la-Ville,520,10,530
25,Basse-Normandie,14,1,11,350,La Lande-sur-Drôme,62,1,63
25,Basse-Normandie,14,4,30,352,Landelles-et-Coupigny,819,14,833
25,Basse-Normandie,14,2,37,353,Landes-sur-Ajon,348,4,352
25,Basse-Normandie,14,2,14,354,Langrune-sur-Mer,1757,32,1789
25,Basse-Normandie,14,2,13,355,Lantheuil,664,15,679
25,Basse-Normandie,14,2,13,356,Lasson,585,19,604
25,Basse-Normandie,14,4,12,357,Lassy,344,6,350
25,Basse-Normandie,14,3,10,358,Léaupartie,71,0,71
25,Basse-Normandie,14,3,24,359,Lécaude,151,4,155
25,Basse-Normandie,14,2,17,360,Leffard,160,4,164
25,Basse-Normandie,14,4,12,361,Lénault,183,2,185
25,Basse-Normandie,14,3,49,362,Lessard-et-le-Chêne,154,10,164
25,Basse-Normandie,14,1,02,364,Lingèvres,495,12,507
25,Basse-Normandie,14,2,14,365,Lion-sur-Mer,2584,30,2614
25,Basse-Normandie,14,3,99,366,Lisieux,22109,895,23004
25,Basse-Normandie,14,1,20,367,Lison,477,6,483
25,Basse-Normandie,14,3,23,368,Lisores,295,12,307
25,Basse-Normandie,14,1,02,369,Litteau,251,4,255
25,Basse-Normandie,14,3,23,371,Livarot,2309,48,2357
25,Basse-Normandie,14,1,11,372,Livry,784,17,801
25,Basse-Normandie,14,2,37,373,Le Locheur,276,8,284
25,Basse-Normandie,14,4,01,374,Les Loges,138,3,141
25,Basse-Normandie,14,2,17,375,Les Loges-Saulces,155,2,157
25,Basse-Normandie,14,1,11,376,Longraye,238,2,240
25,Basse-Normandie,14,1,28,377,Longues-sur-Mer,674,19,693
25,Basse-Normandie,14,1,20,378,Longueville,256,5,261
25,Basse-Normandie,14,2,37,379,Longvillers,334,8,342
25,Basse-Normandie,14,2,32,380,Loucelles,191,3,194
25,Basse-Normandie,14,2,25,381,Louvagny,73,1,74
25,Basse-Normandie,14,1,33,382,Louvières,67,0,67
25,Basse-Normandie,14,2,44,383,Louvigny,2665,68,2733
25,Basse-Normandie,14,2,14,384,Luc-sur-Mer,3172,55,3227
25,Basse-Normandie,14,1,28,385,Magny-en-Bessin,142,5,147
25,Basse-Normandie,14,2,07,386,Magny-la-Campagne,552,5,557
25,Basse-Normandie,14,3,24,387,Magny-le-Freule,298,4,302
25,Basse-Normandie,14,4,38,388,Maisoncelles-la-Jourdan,471,12,483
25,Basse-Normandie,14,2,37,389,Maisoncelles-Pelvey,256,3,259
25,Basse-Normandie,14,2,37,390,Maisoncelles-sur-Ajon,200,1,201
25,Basse-Normandie,14,1,33,391,Maisons,413,8,421
25,Basse-Normandie,14,2,16,393,Maizet,286,4,290
25,Basse-Normandie,14,2,07,394,Maizières,442,11,453
25,Basse-Normandie,14,4,04,395,Malloué,30,0,30
25,Basse-Normandie,14,2,16,396,Maltot,795,29,824
25,Basse-Normandie,14,1,33,397,Mandeville-en-Bessin,296,5,301
25,Basse-Normandie,14,3,05,398,Manerbe,477,6,483
25,Basse-Normandie,14,3,05,399,Manneville-la-Pipard,318,8,326
25,Basse-Normandie,14,1,28,400,Le Manoir,211,2,213
25,Basse-Normandie,14,1,28,401,Manvieux,115,4,119
25,Basse-Normandie,14,2,25,402,Le Marais-la-Chapelle,79,4,83
25,Basse-Normandie,14,3,21,403,Marolles,664,15,679
25,Basse-Normandie,14,2,31,404,Martainville,98,1,99
25,Basse-Normandie,14,2,17,405,Martigny-sur-l'Ante,326,14,340
25,Basse-Normandie,14,2,13,406,Martragny,350,6,356
25,Basse-Normandie,14,2,14,407,Mathieu,1944,82,2026
25,Basse-Normandie,14,2,06,408,May-sur-Orne,1876,32,1908
25,Basse-Normandie,14,2,47,409,Merville-Franceville-Plage,1874,24,1898
25,Basse-Normandie,14,3,24,410,Méry-Corbon,859,8,867
25,Basse-Normandie,14,2,31,411,Meslay,220,2,222
25,Basse-Normandie,14,2,37,412,Le Mesnil-au-Grain,57,2,59
25,Basse-Normandie,14,4,01,413,Le Mesnil-Auzouf,313,2,315
25,Basse-Normandie,14,3,23,414,Le Mesnil-Bacley,218,5,223
25,Basse-Normandie,14,4,30,415,Le Mesnil-Benoist,52,0,52
25,Basse-Normandie,14,4,30,416,Le Mesnil-Caussois,123,2,125
25,Basse-Normandie,14,4,30,417,Mesnil-Clinchamps,961,25,986
25,Basse-Normandie,14,3,23,418,Le Mesnil-Durand,326,5,331
25,Basse-Normandie,14,3,49,419,Le Mesnil-Eudes,315,7,322
25,Basse-Normandie,14,3,23,420,Le Mesnil-Germain,250,4,254
25,Basse-Normandie,14,3,21,421,Le Mesnil-Guillaume,543,17,560
25,Basse-Normandie,14,3,24,422,Le Mesnil-Mauger,1046,19,1065
25,Basse-Normandie,14,2,32,423,Le Mesnil-Patry,284,6,290
25,Basse-Normandie,14,4,30,424,Le Mesnil-Robert,183,2,185
25,Basse-Normandie,14,3,49,425,Le Mesnil-Simon,160,3,163
25,Basse-Normandie,14,3,05,426,Le Mesnil-sur-Blangy,178,5,183
25,Basse-Normandie,14,2,17,427,Le Mesnil-Villement,292,2,294
25,Basse-Normandie,14,3,26,429,Meulles,399,8,407
25,Basse-Normandie,14,1,28,430,Meuvaines,147,7,154
25,Basse-Normandie,14,3,24,431,Mézidon-Canon,4679,49,4728
25,Basse-Normandie,14,2,37,432,Missy,540,6,546
25,Basse-Normandie,14,3,29,433,Mittois,168,3,171
25,Basse-Normandie,14,1,02,370,Le Molay-Littry,3046,53,3099
25,Basse-Normandie,14,3,49,435,Les Monceaux,174,3,177
25,Basse-Normandie,14,1,03,436,Monceaux-en-Bessin,436,10,446
25,Basse-Normandie,14,2,43,437,Mondeville,9927,212,10139
25,Basse-Normandie,14,2,32,438,Mondrainville,442,1,443
25,Basse-Normandie,14,1,20,439,Monfréville,105,1,106
25,Basse-Normandie,14,4,04,441,Mont-Bertrand,233,4,237
25,Basse-Normandie,14,4,04,440,Montamy,91,2,93
25,Basse-Normandie,14,4,36,442,Montchamp,545,12,557
25,Basse-Normandie,14,4,04,443,Montchauvet,362,0,362
25,Basse-Normandie,14,3,24,444,Monteille,190,4,194
25,Basse-Normandie,14,1,02,445,Montfiquet,91,1,92
25,Basse-Normandie,14,2,16,446,Montigny,92,1,93
25,Basse-Normandie,14,3,10,448,Montreuil-en-Auge,44,4,48
25,Basse-Normandie,14,2,37,449,Monts-en-Bessin,407,10,417
25,Basse-Normandie,14,3,29,450,Montviette,175,3,178
25,Basse-Normandie,14,2,25,452,Morteaux-Couliboeuf,524,13,537
25,Basse-Normandie,14,1,33,453,Mosles,318,2,320
25,Basse-Normandie,14,2,32,454,Mouen,1324,25,1349
25,Basse-Normandie,14,2,07,455,Moulines,252,3,255
25,Basse-Normandie,14,2,06,456,Moult,1742,15,1757
25,Basse-Normandie,14,2,25,457,Les Moutiers-en-Auge,122,2,124
25,Basse-Normandie,14,2,07,458,Les Moutiers-en-Cinglais,417,68,485
25,Basse-Normandie,14,3,23,459,Les Moutiers-Hubert,50,0,50
25,Basse-Normandie,14,3,21,460,Moyaux,1342,27,1369
25,Basse-Normandie,14,2,07,461,Mutrécy,329,6,335
25,Basse-Normandie,14,1,20,462,Neuilly-la-Forêt,469,8,477
25,Basse-Normandie,14,1,03,465,Nonant,438,13,451
25,Basse-Normandie,14,3,05,466,Norolles,262,16,278
25,Basse-Normandie,14,2,17,467,Noron-l'Abbaye,300,3,303
25,Basse-Normandie,14,1,02,468,Noron-la-Poterie,308,2,310
25,Basse-Normandie,14,2,25,469,Norrey-en-Auge,102,0,102
25,Basse-Normandie,14,3,10,474,Notre-Dame-d'Estrées,151,5,156
25,Basse-Normandie,14,3,23,471,Notre-Dame-de-Courson,403,2,405
25,Basse-Normandie,14,3,24,473,Notre-Dame-de-Livaye,132,1,133
25,Basse-Normandie,14,2,37,475,Noyers-Bocage,1121,18,1139
25,Basse-Normandie,14,2,25,476,Olendon,186,7,193
25,Basse-Normandie,14,4,01,477,Ondefontaine,313,5,318
25,Basse-Normandie,14,3,26,478,Orbec,2384,71,2455
25,Basse-Normandie,14,1,20,480,Osmanville,591,4,595
25,Basse-Normandie,14,1,20,481,Les Oubeaux,223,4,227
25,Basse-Normandie,14,3,29,697,L' Oudon,1533,188,1721
25,Basse-Normandie,14,2,06,482,Ouézy,261,3,264
25,Basse-Normandie,14,2,16,483,Ouffières,184,1,185
25,Basse-Normandie,14,3,21,484,Ouilly-du-Houley,192,2,194
25,Basse-Normandie,14,2,07,486,Ouilly-le-Tesson,530,7,537
25,Basse-Normandie,14,3,21,487,Ouilly-le-Vicomte,788,23,811
25,Basse-Normandie,14,2,48,488,Ouistreham,9322,139,9461
25,Basse-Normandie,14,3,29,489,Ouville-la-Bien-Tournée,217,10,227
25,Basse-Normandie,14,2,37,491,Parfouru-sur-Odon,157,7,164
25,Basse-Normandie,14,3,19,492,Pennedepie,321,5,326
25,Basse-Normandie,14,3,24,493,Percy-en-Auge,248,2,250
25,Basse-Normandie,14,3,15,494,Périers-en-Auge,140,5,145
25,Basse-Normandie,14,2,48,495,Périers-sur-le-Dan,489,13,502
25,Basse-Normandie,14,4,12,496,Périgny,53,2,55
25,Basse-Normandie,14,2,25,497,Perrières,276,3,279
25,Basse-Normandie,14,2,18,498,Pertheville-Ners,246,1,247
25,Basse-Normandie,14,2,47,499,Petiville,498,10,508
25,Basse-Normandie,14,3,27,500,Pierrefitte-en-Auge,149,2,151
25,Basse-Normandie,14,2,17,501,Pierrefitte-en-Cinglais,250,2,252
25,Basse-Normandie,14,2,17,502,Pierrepont,92,1,93
25,Basse-Normandie,14,4,36,503,Pierres,197,7,204
25,Basse-Normandie,14,3,21,504,Le Pin,716,20,736
25,Basse-Normandie,14,2,31,505,Placy,131,3,134
25,Basse-Normandie,14,1,02,506,Planquery,219,8,227
25,Basse-Normandie,14,4,01,508,Le Plessis-Grimoult,352,10,362
25,Basse-Normandie,14,2,14,509,Plumetot,217,9,226
25,Basse-Normandie,14,2,31,510,La Pommeraye,41,0,41
25,Basse-Normandie,14,4,30,511,Pont-Bellanger,67,0,67
25,Basse-Normandie,14,2,17,764,Pont-d'Ouilly,1040,17,1057
25,Basse-Normandie,14,4,30,513,Pont-Farcy,525,8,533
25,Basse-Normandie,14,3,27,514,Pont-l'Évêque,4202,64,4266
25,Basse-Normandie,14,4,12,512,Pontécoulant,93,1,94
25,Basse-Normandie,14,1,28,515,Port-en-Bessin-Huppain,2080,35,2115
25,Basse-Normandie,14,2,17,516,Potigny,1750,30,1780
25,Basse-Normandie,14,2,06,517,Poussy-la-Campagne,95,1,96
25,Basse-Normandie,14,3,49,520,Le Pré-d'Auge,844,16,860
25,Basse-Normandie,14,2,16,519,Préaux-Bocage,124,0,124
25,Basse-Normandie,14,3,26,518,Préaux-Saint-Sébastien,37,2,39
25,Basse-Normandie,14,4,36,521,Presles,261,1,262
25,Basse-Normandie,14,3,49,522,Prêtreville,423,17,440
25,Basse-Normandie,14,4,12,523,Proussy,417,6,423
25,Basse-Normandie,14,3,15,524,Putot-en-Auge,286,7,293
25,Basse-Normandie,14,2,32,525,Putot-en-Bessin,393,11,404
25,Basse-Normandie,14,3,19,528,Quetteville,375,9,384
25,Basse-Normandie,14,1,03,529,Ranchy,193,2,195
25,Basse-Normandie,14,2,47,530,Ranville,1703,19,1722
25,Basse-Normandie,14,2,17,531,Rapilly,41,1,42
25,Basse-Normandie,14,4,04,532,Le Reculey,252,4,256
25,Basse-Normandie,14,3,10,533,Repentigny,89,2,91
25,Basse-Normandie,14,3,27,534,Reux,336,6,342
25,Basse-Normandie,14,2,13,535,Reviers,560,7,567
25,Basse-Normandie,14,3,19,536,La Rivière-Saint-Sauveur,2025,47,2072
25,Basse-Normandie,14,2,06,538,Rocquancourt,745,4,749
25,Basse-Normandie,14,4,36,539,La Rocque,97,5,102
25,Basse-Normandie,14,3,21,540,Rocques,318,12,330
25,Basse-Normandie,14,3,10,541,La Roque-Baignard,130,2,132
25,Basse-Normandie,14,2,13,542,Rosel,521,19,540
25,Basse-Normandie,14,2,32,543,Rots,1435,23,1458
25,Basse-Normandie,14,4,01,544,Roucamps,180,5,185
25,Basse-Normandie,14,4,38,545,Roullours,859,29,888
25,Basse-Normandie,14,2,07,546,Rouvres,216,6,222
25,Basse-Normandie,14,1,33,547,Rubercy,118,2,120
25,Basse-Normandie,14,2,13,548,Rucqueville,125,8,133
25,Basse-Normandie,14,4,36,549,Rully,220,2,222
25,Basse-Normandie,14,3,10,550,Rumesnil,92,4,96
25,Basse-Normandie,14,1,33,551,Russy,173,2,175
25,Basse-Normandie,14,1,28,552,Ryes,485,19,504
25,Basse-Normandie,14,2,37,553,Saint-Agnan-le-Malherbe,126,0,126
25,Basse-Normandie,14,2,06,554,Saint-Aignan-de-Cramesnil,496,7,503
25,Basse-Normandie,14,3,05,555,Saint-André-d'Hébertot,456,8,464
25,Basse-Normandie,14,2,06,556,Saint-André-sur-Orne,1947,30,1977
25,Basse-Normandie,14,3,35,557,Saint-Arnoult,1099,23,1122
25,Basse-Normandie,14,2,48,558,Saint-Aubin-d'Arquenay,795,15,810
25,Basse-Normandie,14,4,30,559,Saint-Aubin-des-Bois,230,8,238
25,Basse-Normandie,14,2,14,562,Saint-Aubin-sur-Mer,1942,27,1969
25,Basse-Normandie,14,3,27,563,Saint-Benoît-d'Hébertot,343,8,351
25,Basse-Normandie,14,4,36,564,Saint-Charles-de-Percy,190,3,193
25,Basse-Normandie,14,1,28,565,Saint-Côme-de-Fresné,228,4,232
25,Basse-Normandie,14,2,09,566,Saint-Contest,2348,83,2431
25,Basse-Normandie,14,3,26,570,Saint-Cyr-du-Ronceray,648,12,660
25,Basse-Normandie,14,3,26,571,Saint-Denis-de-Mailloc,321,7,328
25,Basse-Normandie,14,2,31,572,Saint-Denis-de-Méré,828,17,845
25,Basse-Normandie,14,4,04,573,Saint-Denis-Maisoncelles,101,0,101
25,Basse-Normandie,14,3,49,574,Saint-Désir,1685,119,1804
25,Basse-Normandie,14,3,27,575,Saint-Étienne-la-Thillaye,492,12,504
25,Basse-Normandie,14,2,13,577,Saint-Gabriel-Brécy,301,54,355
25,Basse-Normandie,14,3,19,578,Saint-Gatien-des-Bois,1354,17,1371
25,Basse-Normandie,14,4,01,579,Saint-Georges-d'Aunay,707,15,722
25,Basse-Normandie,14,3,29,580,Saint-Georges-en-Auge,95,3,98
25,Basse-Normandie,14,1,11,581,Saint-Germain-d'Ectot,318,3,321
25,Basse-Normandie,14,3,49,582,Saint-Germain-de-Livet,803,18,821
25,Basse-Normandie,14,3,23,583,Saint-Germain-de-Montgommery,160,1,161
25,Basse-Normandie,14,4,38,584,Saint-Germain-de-Tallevende-la-Lande-Vaumont,2000,50,2050
25,Basse-Normandie,14,4,12,585,Saint-Germain-du-Crioult,860,28,888
25,Basse-Normandie,14,1,20,586,Saint-Germain-du-Pert,159,5,164
25,Basse-Normandie,14,2,09,587,Saint-Germain-la-Blanche-Herbe,2435,47,2482
25,Basse-Normandie,14,2,17,588,Saint-Germain-Langot,307,2,309
25,Basse-Normandie,14,2,07,589,Saint-Germain-le-Vasson,928,13,941
25,Basse-Normandie,14,3,27,593,Saint-Hymer,692,27,719
25,Basse-Normandie,14,3,49,595,Saint-Jean-de-Livet,198,5,203
25,Basse-Normandie,14,4,01,596,Saint-Jean-des-Essartiers,195,4,199
25,Basse-Normandie,14,4,12,597,Saint-Jean-le-Blanc,329,7,336
25,Basse-Normandie,14,3,15,598,Saint-Jouin,206,3,209
25,Basse-Normandie,14,3,26,599,Saint-Julien-de-Mailloc,473,9,482
25,Basse-Normandie,14,3,24,600,Saint-Julien-le-Faucon,707,5,712
25,Basse-Normandie,14,3,27,601,Saint-Julien-sur-Calonne,192,2,194
25,Basse-Normandie,14,2,31,602,Saint-Lambert,239,2,241
25,Basse-Normandie,14,2,07,603,Saint-Laurent-de-Condel,517,11,528
25,Basse-Normandie,14,3,24,604,Saint-Laurent-du-Mont,189,7,196
25,Basse-Normandie,14,1,33,605,Saint-Laurent-sur-Mer,242,6,248
25,Basse-Normandie,14,3,15,606,Saint-Léger-Dubosq,177,5,182
25,Basse-Normandie,14,2,37,607,Saint-Louet-sur-Seulles,182,0,182
25,Basse-Normandie,14,3,24,608,Saint-Loup-de-Fribois,194,2,196
25,Basse-Normandie,14,1,03,609,Saint-Loup-Hors,288,7,295
25,Basse-Normandie,14,4,30,611,Saint-Manvieu-Bocage,558,13,571
25,Basse-Normandie,14,2,32,610,Saint-Manvieu-Norrey,1715,132,1847
25,Basse-Normandie,14,1,20,613,Saint-Marcouf,92,1,93
25,Basse-Normandie,14,3,27,620,Saint-Martin-aux-Chartrains,391,19,410
25,Basse-Normandie,14,3,26,621,Saint-Martin-de-Bienfaite-la-Cressonnière,480,9,489
25,Basse-Normandie,14,1,02,622,Saint-Martin-de-Blagny,124,3,127
25,Basse-Normandie,14,2,06,623,Saint-Martin-de-Fontenay,2373,27,2400
25,Basse-Normandie,14,3,22,625,Saint-Martin-de-la-Lieue,852,18,870
25,Basse-Normandie,14,3,26,626,Saint-Martin-de-Mailloc,860,15,875
25,Basse-Normandie,14,2,17,627,Saint-Martin-de-Mieux,411,8,419
25,Basse-Normandie,14,2,16,628,Saint-Martin-de-Sallen,575,7,582
25,Basse-Normandie,14,4,04,629,Saint-Martin-des-Besaces,1176,9,1185
25,Basse-Normandie,14,1,03,630,Saint-Martin-des-Entrées,537,19,556
25,Basse-Normandie,14,4,04,632,Saint-Martin-Don,244,2,246
25,Basse-Normandie,14,3,23,633,Saint-Martin-du-Mesnil-Oury,98,2,100
25,Basse-Normandie,14,3,23,634,Saint-Michel-de-Livet,187,6,193
25,Basse-Normandie,14,2,31,635,Saint-Omer,163,2,165
25,Basse-Normandie,14,4,04,636,Saint-Ouen-des-Besaces,318,2,320
25,Basse-Normandie,14,2,34,637,Saint-Ouen-du-Mesnil-Oger,182,5,187
25,Basse-Normandie,14,3,23,638,Saint-Ouen-le-Houx,78,2,80
25,Basse-Normandie,14,3,10,639,Saint-Ouen-le-Pin,297,3,300
25,Basse-Normandie,14,2,34,640,Saint-Pair,247,6,253
25,Basse-Normandie,14,1,02,643,Saint-Paul-du-Vernay,697,12,709
25,Basse-Normandie,14,3,05,644,Saint-Philbert-des-Champs,689,22,711
25,Basse-Normandie,14,3,15,645,Saint-Pierre-Azif,163,3,166
25,Basse-Normandie,14,2,17,646,Saint-Pierre-Canivet,365,4,369
25,Basse-Normandie,14,3,26,647,Saint-Pierre-de-Mailloc,478,15,493
25,Basse-Normandie,14,3,49,648,Saint-Pierre-des-Ifs,457,3,460
25,Basse-Normandie,14,2,17,649,Saint-Pierre-du-Bû,450,9,459
25,Basse-Normandie,14,4,01,650,Saint-Pierre-du-Fresne,200,2,202
25,Basse-Normandie,14,2,34,651,Saint-Pierre-du-Jonquet,193,1,194
25,Basse-Normandie,14,1,20,652,Saint-Pierre-du-Mont,78,1,79
25,Basse-Normandie,14,4,12,653,Saint-Pierre-la-Vieille,359,6,365
25,Basse-Normandie,14,3,29,654,Saint-Pierre-sur-Dives,3623,26,3649
25,Basse-Normandie,14,4,04,655,Saint-Pierre-Tarentaine,328,2,330
25,Basse-Normandie,14,2,31,656,Saint-Rémy,1087,17,1104
25,Basse-Normandie,14,3,15,657,Saint-Samson,341,3,344
25,Basse-Normandie,14,4,30,658,Saint-Sever-Calvados,1369,41,1410
25,Basse-Normandie,14,2,07,659,Saint-Sylvain,1198,15,1213
25,Basse-Normandie,14,3,15,660,Saint-Vaast-en-Auge,97,2,99
25,Basse-Normandie,14,2,32,661,Saint-Vaast-sur-Seulles,136,0,136
25,Basse-Normandie,14,4,12,662,Saint-Vigor-des-Mézerets,247,3,250
25,Basse-Normandie,14,1,03,663,Saint-Vigor-le-Grand,2023,62,2085
25,Basse-Normandie,14,2,32,568,Sainte-Croix-Grand-Tonne,297,4,301
25,Basse-Normandie,14,1,28,569,Sainte-Croix-sur-Mer,236,7,243
25,Basse-Normandie,14,3,23,576,Sainte-Foy-de-Montgommery,204,4,208
25,Basse-Normandie,14,1,11,590,Sainte-Honorine-de-Ducy,131,1,132
25,Basse-Normandie,14,1,33,591,Sainte-Honorine-des-Pertes,582,8,590
25,Basse-Normandie,14,2,16,592,Sainte-Honorine-du-Fay,1225,31,1256
25,Basse-Normandie,14,1,20,614,Sainte-Marguerite-d'Elle,757,10,767
25,Basse-Normandie,14,3,29,616,Sainte-Marguerite-de-Viette,406,7,413
25,Basse-Normandie,14,3,23,615,Sainte-Marguerite-des-Loges,192,7,199
25,Basse-Normandie,14,4,04,618,Sainte-Marie-Laumont,611,22,633
25,Basse-Normandie,14,4,30,619,Sainte-Marie-Outre-l'Eau,85,2,87
25,Basse-Normandie,14,1,11,664,Sallen,283,10,293
25,Basse-Normandie,14,2,47,665,Sallenelles,272,10,282
25,Basse-Normandie,14,2,34,666,Sannerville,1606,31,1637
25,Basse-Normandie,14,1,33,667,Saon,233,1,234
25,Basse-Normandie,14,1,33,668,Saonnet,210,3,213
25,Basse-Normandie,14,2,25,669,Sassy,190,2,192
25,Basse-Normandie,14,2,13,670,Secqueville-en-Bessin,355,4,359
25,Basse-Normandie,14,4,30,671,Sept-Frères,341,21,362
25,Basse-Normandie,14,1,11,672,Sept-Vents,404,10,414
25,Basse-Normandie,14,2,07,674,Soignolles,90,1,91
25,Basse-Normandie,14,2,06,675,Soliers,2177,29,2206
25,Basse-Normandie,14,1,28,676,Sommervieu,1037,22,1059
25,Basse-Normandie,14,2,17,677,Soulangy,265,8,273
25,Basse-Normandie,14,2,17,678,Soumont-Saint-Quentin,566,11,577
25,Basse-Normandie,14,1,03,679,Subles,618,16,634
25,Basse-Normandie,14,1,03,680,Sully,120,3,123
25,Basse-Normandie,14,1,33,681,Surrain,156,0,156
25,Basse-Normandie,14,3,27,682,Surville,439,23,462
25,Basse-Normandie,14,2,32,684,Tessel,230,4,234
25,Basse-Normandie,14,2,13,685,Thaon,1485,23,1508
25,Basse-Normandie,14,4,36,686,Le Theil-Bocage,269,1,270
25,Basse-Normandie,14,3,19,687,Le Theil-en-Auge,171,2,173
25,Basse-Normandie,14,3,29,688,Thiéville,311,8,319
25,Basse-Normandie,14,2,31,689,Thury-Harcourt,1914,36,1950
25,Basse-Normandie,14,1,28,690,Tierceville,169,0,169
25,Basse-Normandie,14,2,06,691,Tilly-la-Campagne,96,2,98
25,Basse-Normandie,14,2,32,692,Tilly-sur-Seulles,1448,27,1475
25,Basse-Normandie,14,3,26,693,Tordouet,280,8,288
25,Basse-Normandie,14,3,05,694,Le Torquesne,417,10,427
25,Basse-Normandie,14,1,11,695,Torteval-Quesnay,349,4,353
25,Basse-Normandie,14,3,23,696,Tortisambert,146,3,149
25,Basse-Normandie,14,2,34,698,Touffréville,303,12,315
25,Basse-Normandie,14,3,35,699,Touques,4033,70,4103
25,Basse-Normandie,14,1,33,700,Tour-en-Bessin,584,17,601
25,Basse-Normandie,14,3,35,701,Tourgéville,916,18,934
25,Basse-Normandie,14,2,37,702,Tournay-sur-Odon,367,7,374
25,Basse-Normandie,14,2,31,703,Tournebu,359,5,364
25,Basse-Normandie,14,4,04,704,Le Tourneur,577,9,586
25,Basse-Normandie,14,1,02,705,Tournières,178,0,178
25,Basse-Normandie,14,3,27,706,Tourville-en-Auge,233,6,239
25,Basse-Normandie,14,2,16,707,Tourville-sur-Odon,1139,14,1153
25,Basse-Normandie,14,2,37,708,Tracy-Bocage,348,6,354
25,Basse-Normandie,14,1,28,709,Tracy-sur-Mer,336,4,340
25,Basse-Normandie,14,2,17,710,Tréprel,104,0,104
25,Basse-Normandie,14,1,33,711,Trévières,942,21,963
25,Basse-Normandie,14,2,34,712,Troarn,3717,88,3805
25,Basse-Normandie,14,2,16,713,Trois-Monts,369,5,374
25,Basse-Normandie,14,1,02,714,Le Tronquay,754,13,767
25,Basse-Normandie,14,3,35,715,Trouville-sur-Mer,4864,145,5009
25,Basse-Normandie,14,1,02,716,Trungy,212,6,218
25,Basse-Normandie,14,4,38,717,Truttemer-le-Grand,605,19,624
25,Basse-Normandie,14,4,38,718,Truttemer-le-Petit,114,0,114
25,Basse-Normandie,14,2,07,719,Urville,465,7,472
25,Basse-Normandie,14,2,17,720,Ussy,847,17,864
25,Basse-Normandie,14,2,16,721,Vacognes-Neuilly,501,24,525
25,Basse-Normandie,14,1,11,722,La Vacquerie,274,3,277
25,Basse-Normandie,14,3,10,723,Valsemé,274,9,283
25,Basse-Normandie,14,2,47,724,Varaville,795,12,807
25,Basse-Normandie,14,4,36,726,Vassy,1761,30,1791
25,Basse-Normandie,14,1,02,727,Vaubadon,409,8,417
25,Basse-Normandie,14,1,03,728,Vaucelles,338,7,345
25,Basse-Normandie,14,3,29,729,Vaudeloges,208,1,209
25,Basse-Normandie,14,4,38,730,Vaudry,1507,58,1565
25,Basse-Normandie,14,3,27,731,Vauville,233,9,242
25,Basse-Normandie,14,1,28,732,Vaux-sur-Aure,316,10,326
25,Basse-Normandie,14,2,13,733,Vaux-sur-Seulles,298,6,304
25,Basse-Normandie,14,2,32,734,Vendes,302,6,308
25,Basse-Normandie,14,2,25,735,Vendeuvre,742,14,756
25,Basse-Normandie,14,1,28,739,Ver-sur-Mer,1565,22,1587
25,Basse-Normandie,14,2,18,737,Versainville,404,10,414
25,Basse-Normandie,14,2,16,738,Verson,3621,66,3687
25,Basse-Normandie,14,3,26,740,La Vespière,940,27,967
25,Basse-Normandie,14,2,31,741,Le Vey,85,1,86
25,Basse-Normandie,14,2,25,742,Vicques,51,1,52
25,Basse-Normandie,14,3,10,743,Victot-Pontfol,121,3,124
25,Basse-Normandie,14,1,28,744,Vienne-en-Bessin,287,6,293
25,Basse-Normandie,14,1,33,745,Vierville-sur-Mer,241,9,250
25,Basse-Normandie,14,4,36,746,Viessoix,756,13,769
25,Basse-Normandie,14,2,16,747,Vieux,595,13,608
25,Basse-Normandie,14,3,27,748,Vieux-Bourg,80,2,82
25,Basse-Normandie,14,2,07,749,Vieux-Fumé,403,10,413
25,Basse-Normandie,14,3,29,750,Vieux-Pont-en-Auge,297,6,303
25,Basse-Normandie,14,2,25,751,Vignats,256,6,262
25,Basse-Normandie,14,2,37,752,Villers-Bocage,2963,36,2999
25,Basse-Normandie,14,2,17,753,Villers-Canivet,716,14,730
25,Basse-Normandie,14,3,35,754,Villers-sur-Mer,2652,41,2693
25,Basse-Normandie,14,3,35,755,Villerville,771,22,793
25,Basse-Normandie,14,2,31,756,La Villette,178,4,182
25,Basse-Normandie,14,1,28,757,Villiers-le-Sec,275,8,283
25,Basse-Normandie,14,2,13,758,Villons-les-Buissons,693,21,714
25,Basse-Normandie,14,2,37,760,Villy-Bocage,752,15,767
25,Basse-Normandie,14,2,18,759,Villy-lez-Falaise,247,17,264
25,Basse-Normandie,14,2,34,761,Vimont,643,12,655
25,Basse-Normandie,14,4,38,762,Vire,12231,624,12855
25,Basse-Normandie,14,1,20,763,Vouilly,174,0,174
83,Auvergne,15,3,12,025,Albepierre-Bredons,218,8,226
83,Auvergne,15,3,01,001,Allanche,903,31,934
83,Auvergne,15,3,20,002,Alleuze,206,6,212
83,Auvergne,15,2,14,003,Ally,663,19,682
83,Auvergne,15,3,19,004,Andelat,423,12,435
83,Auvergne,15,3,19,005,Anglards-de-Saint-Flour,321,6,327
83,Auvergne,15,2,22,006,Anglards-de-Salers,783,15,798
83,Auvergne,15,3,05,007,Anterrieux,128,9,137
83,Auvergne,15,2,17,008,Antignac,276,10,286
83,Auvergne,15,2,15,009,Apchon,209,4,213
83,Auvergne,15,2,09,010,Arches,183,8,191
83,Auvergne,15,1,07,011,Arnac,150,3,153
83,Auvergne,15,1,26,012,Arpajon-sur-Cère,5964,274,6238
83,Auvergne,15,3,08,013,Auriac-l'Église,203,8,211
83,Auvergne,15,1,98,014,Aurillac,28641,1756,30397
83,Auvergne,15,2,09,015,Auzers,198,5,203
83,Auvergne,15,1,07,016,Ayrens,557,10,567
83,Auvergne,15,1,23,017,Badailhac,115,5,120
83,Auvergne,15,2,14,018,Barriac-les-Bosquets,167,5,172
83,Auvergne,15,2,17,019,Bassignac,226,8,234
83,Auvergne,15,2,04,020,Beaulieu,119,1,120
83,Auvergne,15,1,18,269,Besse,132,3,135
83,Auvergne,15,1,10,021,Boisset,619,14,633
83,Auvergne,15,3,08,022,Bonnac,149,4,153
83,Auvergne,15,2,14,024,Brageac,74,3,77
83,Auvergne,15,3,13,026,Brezons,212,3,215
83,Auvergne,15,1,11,027,Calvinet,471,8,479
83,Auvergne,15,1,23,028,Carlat,288,12,300
83,Auvergne,15,1,11,029,Cassaniouze,514,22,536
83,Auvergne,15,1,21,030,Cayrols,241,1,242
83,Auvergne,15,3,12,031,Celles,235,6,241
83,Auvergne,15,3,16,032,Celoux,80,2,82
83,Auvergne,15,3,13,033,Cézens,260,6,266
83,Auvergne,15,3,16,034,Chaliers,188,4,192
83,Auvergne,15,3,12,035,Chalinargues,433,3,436
83,Auvergne,15,2,09,036,Chalvignac,426,9,435
83,Auvergne,15,2,17,037,Champagnac,1105,53,1158
83,Auvergne,15,2,04,038,Champs-sur-Tarentaine-Marchal,1033,22,1055
83,Auvergne,15,3,06,040,Chanterelle,139,6,145
83,Auvergne,15,3,12,041,La Chapelle-d'Alagnon,240,7,247
83,Auvergne,15,3,08,042,La Chapelle-Laurent,342,12,354
83,Auvergne,15,3,01,043,Charmensac,92,4,96
83,Auvergne,15,3,12,044,Chastel-sur-Murat,133,7,140
83,Auvergne,15,3,05,045,Chaudes-Aigues,954,36,990
83,Auvergne,15,2,14,046,Chaussenac,238,4,242
83,Auvergne,15,3,12,047,Chavagnac,103,3,106
83,Auvergne,15,3,16,048,Chazelles,33,2,35
83,Auvergne,15,3,12,049,Cheylade,280,5,285
83,Auvergne,15,3,12,050,Le Claux,217,6,223
83,Auvergne,15,3,16,051,Clavières,240,8,248
83,Auvergne,15,2,15,052,Collandres,179,8,187
83,Auvergne,15,3,19,053,Coltines,433,6,439
83,Auvergne,15,3,06,054,Condat,995,33,1028
83,Auvergne,15,3,19,055,Coren,437,13,450
83,Auvergne,15,1,27,056,Crandelles,667,30,697
83,Auvergne,15,1,07,057,Cros-de-Montvert,220,2,222
83,Auvergne,15,1,23,058,Cros-de-Ronesque,127,3,130
83,Auvergne,15,3,20,059,Cussac,129,1,130
83,Auvergne,15,3,05,060,Deux-Verges,58,2,60
83,Auvergne,15,3,12,061,Dienne,255,5,260
83,Auvergne,15,2,09,063,Drugeac,369,7,376
83,Auvergne,15,2,14,064,Escorailles,70,0,70
83,Auvergne,15,3,05,065,Espinasse,74,2,76
83,Auvergne,15,2,22,066,Le Falgoux,150,3,153
83,Auvergne,15,2,22,067,Le Fau,27,0,27
83,Auvergne,15,3,16,068,Faverolles,303,11,314
83,Auvergne,15,3,08,069,Ferrières-Saint-Mary,247,6,253
83,Auvergne,15,2,22,070,Fontanges,220,7,227
83,Auvergne,15,1,10,071,Fournoulès,64,5,69
83,Auvergne,15,1,18,072,Freix-Anglards,182,4,186
83,Auvergne,15,3,05,073,Fridefont,114,3,117
83,Auvergne,15,1,25,074,Giou-de-Mamou,746,32,778
83,Auvergne,15,1,18,075,Girgols,76,0,76
83,Auvergne,15,1,07,076,Glénat,216,4,220
83,Auvergne,15,3,13,077,Gourdièges,66,0,66
83,Auvergne,15,3,05,078,Jabrun,154,10,164
83,Auvergne,15,2,09,079,Jaleyrac,374,19,393
83,Auvergne,15,1,23,081,Jou-sous-Monjou,112,1,113
83,Auvergne,15,3,01,080,Joursac,155,12,167
83,Auvergne,15,1,11,082,Junhac,333,9,342
83,Auvergne,15,1,27,083,Jussac,1837,53,1890
83,Auvergne,15,1,11,084,Labesserette,265,9,274
83,Auvergne,15,1,26,085,Labrousse,388,7,395
83,Auvergne,15,3,13,086,Lacapelle-Barrès,56,1,57
83,Auvergne,15,1,11,087,Lacapelle-del-Fraisse,296,11,307
83,Auvergne,15,1,07,088,Lacapelle-Viescamp,452,7,459
83,Auvergne,15,1,11,089,Ladinhac,483,9,492
83,Auvergne,15,1,11,090,Lafeuillade-en-Vézie,572,17,589
83,Auvergne,15,3,01,091,Landeyrat,103,1,104
83,Auvergne,15,2,04,092,Lanobre,1379,40,1419
83,Auvergne,15,1,11,093,Lapeyrugue,104,2,106
83,Auvergne,15,1,07,094,Laroquebrou,929,13,942
83,Auvergne,15,1,25,095,Laroquevieille,363,6,369
83,Auvergne,15,1,25,096,Lascelle,312,3,315
83,Auvergne,15,3,19,097,Lastic,112,7,119
83,Auvergne,15,3,08,098,Laurie,90,5,95
83,Auvergne,15,3,20,099,Lavastrie,222,3,225
83,Auvergne,15,3,12,100,Laveissenet,93,0,93
83,Auvergne,15,3,12,101,Laveissière,574,18,592
83,Auvergne,15,3,12,102,Lavigerie,102,0,102
83,Auvergne,15,1,11,103,Leucamp,234,4,238
83,Auvergne,15,1,10,104,Leynhac,352,10,362
83,Auvergne,15,3,08,105,Leyvaux,30,1,31
83,Auvergne,15,3,05,106,Lieutadès,213,12,225
83,Auvergne,15,3,16,107,Lorcières,199,4,203
83,Auvergne,15,3,16,108,Loubaresse,409,12,421
83,Auvergne,15,3,06,110,Lugarde,161,6,167
83,Auvergne,15,2,17,111,Madic,223,9,232
83,Auvergne,15,3,13,112,Malbo,124,2,126
83,Auvergne,15,1,25,113,Mandailles-Saint-Julien,205,2,207
83,Auvergne,15,3,06,114,Marcenat,532,12,544
83,Auvergne,15,3,06,116,Marchastel,163,11,174
83,Auvergne,15,1,21,117,Marcolès,611,50,661
83,Auvergne,15,1,25,118,Marmanhac,736,32,768
83,Auvergne,15,3,08,119,Massiac,1833,96,1929
83,Auvergne,15,2,09,120,Mauriac,3876,279,4155
83,Auvergne,15,3,05,121,Maurines,98,5,103
83,Auvergne,15,1,10,122,Maurs,2239,76,2315
83,Auvergne,15,2,09,123,Méallet,173,2,175
83,Auvergne,15,2,15,124,Menet,506,13,519
83,Auvergne,15,3,19,125,Mentières,129,3,132
83,Auvergne,15,3,08,126,Molèdes,99,5,104
83,Auvergne,15,3,08,127,Molompize,290,9,299
83,Auvergne,15,2,17,128,La Monselie,117,4,121
83,Auvergne,15,3,06,129,Montboudif,208,6,214
83,Auvergne,15,3,19,130,Montchamp,132,1,133
83,Auvergne,15,2,17,131,Le Monteil,261,1,262
83,Auvergne,15,3,06,132,Montgreleix,47,2,49
83,Auvergne,15,1,10,133,Montmurat,146,4,150
83,Auvergne,15,1,11,134,Montsalvy,882,22,904
83,Auvergne,15,1,07,135,Montvert,115,4,119
83,Auvergne,15,1,10,136,Mourjou,327,3,330
83,Auvergne,15,2,09,137,Moussages,264,6,270
83,Auvergne,15,3,12,138,Murat,2045,103,2148
83,Auvergne,15,3,13,139,Narnhac,79,1,80
83,Auvergne,15,1,27,140,Naucelles,1941,83,2024
83,Auvergne,15,3,12,141,Neussargues-Moissac,968,28,996
83,Auvergne,15,3,20,142,Neuvéglise,1153,31,1184
83,Auvergne,15,1,07,143,Nieudan,106,5,111
83,Auvergne,15,1,21,144,Omps,302,6,308
83,Auvergne,15,3,13,145,Oradour,294,16,310
83,Auvergne,15,1,23,146,Pailherols,169,1,170
83,Auvergne,15,1,21,147,Parlan,307,8,315
83,Auvergne,15,3,20,148,Paulhac,455,10,465
83,Auvergne,15,3,13,149,Paulhenc,265,5,270
83,Auvergne,15,1,21,150,Pers,297,7,304
83,Auvergne,15,3,01,151,Peyrusse,168,5,173
83,Auvergne,15,3,13,152,Pierrefort,911,22,933
83,Auvergne,15,2,14,153,Pleaux,1620,43,1663
83,Auvergne,15,1,23,154,Polminhac,1107,55,1162
83,Auvergne,15,3,01,155,Pradiers,102,3,105
83,Auvergne,15,1,26,156,Prunet,520,12,532
83,Auvergne,15,1,10,157,Quézac,330,59,389
83,Auvergne,15,3,16,158,Rageade,112,4,116
83,Auvergne,15,1,23,159,Raulhac,337,13,350
83,Auvergne,15,1,27,160,Reilhac,1013,34,1047
83,Auvergne,15,3,19,161,Rézentières,127,3,130
83,Auvergne,15,2,15,162,Riom-ès-Montagnes,2741,75,2816
83,Auvergne,15,1,21,163,Roannes-Saint-Mary,979,30,1009
83,Auvergne,15,3,19,164,Roffiac,573,16,589
83,Auvergne,15,1,07,165,Rouffiac,222,3,225
83,Auvergne,15,1,21,268,Le Rouget,981,16,997
83,Auvergne,15,1,21,166,Roumégoux,238,5,243
83,Auvergne,15,1,10,167,Rouziers,130,0,130
83,Auvergne,15,3,16,168,Ruynes-en-Margeride,634,22,656
83,Auvergne,15,2,17,169,Saignes,894,21,915
83,Auvergne,15,3,06,170,Saint-Amandin,244,6,250
83,Auvergne,15,1,10,172,Saint-Antoine,121,2,123
83,Auvergne,15,3,06,173,Saint-Bonnet-de-Condat,134,7,141
83,Auvergne,15,2,22,174,Saint-Bonnet-de-Salers,324,8,332
83,Auvergne,15,1,18,175,Saint-Cernin,1055,26,1081
83,Auvergne,15,2,22,176,Saint-Chamant,259,7,266
83,Auvergne,15,1,25,178,Saint-Cirgues-de-Jordanne,144,4,148
83,Auvergne,15,1,18,179,Saint-Cirgues-de-Malbert,220,4,224
83,Auvergne,15,1,23,180,Saint-Clément,70,4,74
83,Auvergne,15,1,10,181,Saint-Constant,565,6,571
83,Auvergne,15,1,07,182,Saint-Étienne-Cantalès,140,8,148
83,Auvergne,15,1,23,183,Saint-Étienne-de-Carlat,125,1,126
83,Auvergne,15,2,15,185,Saint-Étienne-de-Chomeil,213,5,218
83,Auvergne,15,1,10,184,Saint-Étienne-de-Maurs,751,8,759
83,Auvergne,15,3,99,187,Saint-Flour,6610,606,7216
83,Auvergne,15,3,19,188,Saint-Georges,1148,25,1173
83,Auvergne,15,1,07,189,Saint-Gérons,195,4,199
83,Auvergne,15,2,15,190,Saint-Hippolyte,112,2,114
83,Auvergne,15,1,18,191,Saint-Illide,672,9,681
83,Auvergne,15,1,23,192,Saint-Jacques-des-Blats,321,7,328
83,Auvergne,15,1,10,194,Saint-Julien-de-Toursac,141,4,145
83,Auvergne,15,3,16,195,Saint-Just,203,8,211
83,Auvergne,15,1,21,196,Saint-Mamet-la-Salvetat,1453,30,1483
83,Auvergne,15,3,16,197,Saint-Marc,83,6,89
83,Auvergne,15,3,05,199,Saint-Martial,75,1,76
83,Auvergne,15,2,14,200,Saint-Martin-Cantalès,172,11,183
83,Auvergne,15,3,13,201,Saint-Martin-sous-Vigouroux,260,3,263
83,Auvergne,15,2,22,202,Saint-Martin-Valmeroux,856,42,898
83,Auvergne,15,3,08,203,Saint-Mary-le-Plain,156,3,159
83,Auvergne,15,2,22,205,Saint-Paul-de-Salers,121,2,123
83,Auvergne,15,1,03,204,Saint-Paul-des-Landes,1399,37,1436
83,Auvergne,15,2,17,206,Saint-Pierre,171,3,174
83,Auvergne,15,3,08,207,Saint-Poncy,324,9,333
83,Auvergne,15,2,22,208,Saint-Projet-de-Salers,125,3,128
83,Auvergne,15,3,05,209,Saint-Rémy-de-Chaudes-Aigues,117,5,122
83,Auvergne,15,1,07,211,Saint-Santin-Cantalès,326,7,333
83,Auvergne,15,1,10,212,Saint-Santin-de-Maurs,342,6,348
83,Auvergne,15,3,01,213,Saint-Saturnin,227,10,237
83,Auvergne,15,1,21,214,Saint-Saury,203,4,207
83,Auvergne,15,1,25,215,Saint-Simon,1086,37,1123
83,Auvergne,15,3,05,216,Saint-Urcize,494,11,505
83,Auvergne,15,1,07,217,Saint-Victor,108,3,111
83,Auvergne,15,2,22,218,Saint-Vincent-de-Salers,79,2,81
83,Auvergne,15,3,01,171,Sainte-Anastasie,149,2,151
83,Auvergne,15,2,14,186,Sainte-Eulalie,204,5,209
83,Auvergne,15,3,13,198,Sainte-Marie,112,3,115
83,Auvergne,15,2,22,219,Salers,364,6,370
83,Auvergne,15,2,09,220,Salins,158,8,166
83,Auvergne,15,1,03,221,Sansac-de-Marmiesse,1277,32,1309
83,Auvergne,15,1,11,222,Sansac-Veinazès,197,3,200
83,Auvergne,15,2,17,223,Sauvat,189,7,196
83,Auvergne,15,1,21,224,La Ségalassière,119,0,119
83,Auvergne,15,3,01,225,Ségur-les-Villas,225,2,227
83,Auvergne,15,1,11,226,Sénezergues,193,2,195
83,Auvergne,15,3,20,227,Sériers,133,3,136
83,Auvergne,15,1,07,228,Siran,516,12,528
83,Auvergne,15,3,16,229,Soulages,83,2,85
83,Auvergne,15,2,09,230,Sourniac,188,11,199
83,Auvergne,15,3,19,231,Talizat,565,17,582
83,Auvergne,15,3,20,232,Tanavelle,248,7,255
83,Auvergne,15,1,27,233,Teissières-de-Cornet,207,6,213
83,Auvergne,15,1,26,234,Teissières-lès-Bouliès,309,8,317
83,Auvergne,15,3,20,235,Les Ternes,546,14,560
83,Auvergne,15,1,23,236,Thiézac,604,5,609
83,Auvergne,15,3,19,237,Tiviers,142,8,150
83,Auvergne,15,1,18,238,Tournemire,141,2,143
83,Auvergne,15,2,04,240,Trémouille,194,1,195
83,Auvergne,15,3,05,241,La Trinitat,42,0,42
83,Auvergne,15,1,10,242,Le Trioulou,94,2,96
83,Auvergne,15,2,15,243,Trizac,564,9,573
83,Auvergne,15,3,20,244,Ussel,474,18,492
83,Auvergne,15,3,19,245,Vabres,223,6,229
83,Auvergne,15,2,15,246,Valette,260,13,273
83,Auvergne,15,3,08,247,Valjouze,27,0,27
83,Auvergne,15,3,20,248,Valuéjols,529,8,537
83,Auvergne,15,2,22,249,Le Vaulmier,80,3,83
83,Auvergne,15,2,17,250,Vebret,468,14,482
83,Auvergne,15,3,16,251,Védrines-Saint-Loup,146,4,150
83,Auvergne,15,1,25,252,Velzic,391,14,405
83,Auvergne,15,3,01,253,Vernols,69,5,74
83,Auvergne,15,2,17,254,Veyrières,123,4,127
83,Auvergne,15,1,26,255,Vézac,1114,36,1150
83,Auvergne,15,3,01,256,Vèze,68,2,70
83,Auvergne,15,1,26,257,Vezels-Roussy,154,0,154
83,Auvergne,15,1,23,258,Vic-sur-Cère,1985,58,2043
83,Auvergne,15,3,19,259,Vieillespesse,256,6,262
83,Auvergne,15,1,11,260,Vieillevie,113,4,117
83,Auvergne,15,2,09,261,Le Vigean,825,43,868
83,Auvergne,15,3,20,262,Villedieu,534,27,561
83,Auvergne,15,3,12,263,Virargues,137,7,144
83,Auvergne,15,1,21,264,Vitrac,293,3,296
83,Auvergne,15,2,17,265,Ydes,1866,89,1955
83,Auvergne,15,1,25,266,Yolet,602,23,625
83,Auvergne,15,1,03,267,Ytrac,3831,146,3977
54,Poitou-Charentes,16,3,15,001,Abzac,505,18,523
54,Poitou-Charentes,16,3,24,002,Les Adjots,462,9,471
54,Poitou-Charentes,16,1,22,003,Agris,816,13,829
54,Poitou-Charentes,16,1,21,004,Aignes-et-Puypéroux,266,37,303
54,Poitou-Charentes,16,3,01,005,Aigre,1112,27,1139
54,Poitou-Charentes,16,3,11,007,Alloue,520,5,525
54,Poitou-Charentes,16,1,25,008,Ambérac,316,4,320
54,Poitou-Charentes,16,3,14,009,Ambernac,398,5,403
54,Poitou-Charentes,16,2,27,010,Ambleville,197,3,200
54,Poitou-Charentes,16,1,25,011,Anais,552,10,562
54,Poitou-Charentes,16,2,27,012,Angeac-Champagne,510,11,521
54,Poitou-Charentes,16,2,12,013,Angeac-Charente,380,9,389
54,Poitou-Charentes,16,2,06,014,Angeduc,108,1,109
54,Poitou-Charentes,16,1,98,015,Angoulême,43112,2957,46069
54,Poitou-Charentes,16,3,14,016,Ansac-sur-Vienne,820,35,855
54,Poitou-Charentes,16,2,23,017,Anville,195,1,196
54,Poitou-Charentes,16,2,33,018,Ars,722,24,746
54,Poitou-Charentes,16,1,16,019,Asnières-sur-Nouère,1103,25,1128
54,Poitou-Charentes,16,1,04,020,Aubeterre-sur-Dronne,420,1,421
54,Poitou-Charentes,16,1,07,021,Aubeville,142,0,142
54,Poitou-Charentes,16,2,23,339,Auge-Saint-Médard,312,9,321
54,Poitou-Charentes,16,3,18,023,Aunac,346,11,357
54,Poitou-Charentes,16,1,25,024,Aussac-Vadalle,411,17,428
54,Poitou-Charentes,16,2,05,025,Baignes-Sainte-Radegonde,1287,24,1311
54,Poitou-Charentes,16,1,35,026,Balzac,1265,39,1304
54,Poitou-Charentes,16,3,01,027,Barbezières,123,6,129
54,Poitou-Charentes,16,2,06,028,Barbezieux-Saint-Hilaire,4687,188,4875
54,Poitou-Charentes,16,1,10,029,Bardenac,244,8,252
54,Poitou-Charentes,16,2,06,030,Barret,898,29,927
54,Poitou-Charentes,16,3,24,031,Barro,354,12,366
54,Poitou-Charentes,16,2,17,032,Bassac,545,7,552
54,Poitou-Charentes,16,3,18,033,Bayers,128,4,132
54,Poitou-Charentes,16,1,10,034,Bazac,171,6,177
54,Poitou-Charentes,16,3,26,035,Beaulieu-sur-Sonnette,282,7,289
54,Poitou-Charentes,16,1,07,036,Bécheresse,242,6,248
54,Poitou-Charentes,16,1,04,037,Bellon,173,4,177
54,Poitou-Charentes,16,3,11,038,Benest,361,4,365
54,Poitou-Charentes,16,3,29,039,Bernac,436,13,449
54,Poitou-Charentes,16,2,06,040,Berneuil,342,6,348
54,Poitou-Charentes,16,1,07,041,Bessac,126,1,127
54,Poitou-Charentes,16,3,01,042,Bessé,149,4,153
54,Poitou-Charentes,16,2,23,043,Bignac,225,6,231
54,Poitou-Charentes,16,3,24,044,Bioussac,228,6,234
54,Poitou-Charentes,16,2,12,045,Birac,277,2,279
54,Poitou-Charentes,16,1,07,046,Blanzac-Porcheresse,833,28,861
54,Poitou-Charentes,16,1,28,047,Blanzaguet-Saint-Cybard,249,5,254
54,Poitou-Charentes,16,2,08,048,Boisbreteau,124,0,124
54,Poitou-Charentes,16,1,04,049,Bonnes,360,4,364
54,Poitou-Charentes,16,2,12,050,Bonneuil,254,6,260
54,Poitou-Charentes,16,2,23,051,Bonneville,158,4,162
54,Poitou-Charentes,16,2,05,053,Bors (Canton de Baignes-Sainte-Radegonde),131,0,131
54,Poitou-Charentes,16,1,21,052,Bors (Canton de Montmoreau-Saint-Cybard),260,1,261
54,Poitou-Charentes,16,3,11,054,Le Bouchage,168,1,169
54,Poitou-Charentes,16,1,32,055,Bouëx,912,16,928
54,Poitou-Charentes,16,2,27,056,Bourg-Charente,739,10,749
54,Poitou-Charentes,16,2,12,057,Bouteville,336,9,345
54,Poitou-Charentes,16,2,13,058,Boutiers-Saint-Trojan,1351,48,1399
54,Poitou-Charentes,16,3,29,059,Brettes,189,2,191
54,Poitou-Charentes,16,2,13,060,Bréville,521,14,535
54,Poitou-Charentes,16,1,22,061,Brie,3755,95,3850
54,Poitou-Charentes,16,2,06,062,Brie-sous-Barbezieux,116,7,123
54,Poitou-Charentes,16,1,10,063,Brie-sous-Chalais,166,2,168
54,Poitou-Charentes,16,3,15,064,Brigueuil,1055,23,1078
54,Poitou-Charentes,16,3,15,065,Brillac,638,9,647
54,Poitou-Charentes,16,2,08,066,Brossac,535,18,553
54,Poitou-Charentes,16,1,22,067,Bunzac,454,19,473
54,Poitou-Charentes,16,3,18,068,Cellefrouin,532,6,538
54,Poitou-Charentes,16,3,18,069,Cellettes,447,15,462
54,Poitou-Charentes,16,3,09,070,Chabanais,1879,28,1907
54,Poitou-Charentes,16,3,09,071,Chabrac,522,9,531
54,Poitou-Charentes,16,1,07,072,Chadurie,521,12,533
54,Poitou-Charentes,16,1,10,073,Chalais,1910,128,2038
54,Poitou-Charentes,16,2,06,074,Challignac,299,10,309
54,Poitou-Charentes,16,3,11,076,Champagne-Mouton,977,27,1004
54,Poitou-Charentes,16,1,07,075,Champagne-Vigny,201,3,204
54,Poitou-Charentes,16,1,16,077,Champmillon,526,15,541
54,Poitou-Charentes,16,1,35,078,Champniers,5091,145,5236
54,Poitou-Charentes,16,2,05,079,Chantillac,274,2,276
54,Poitou-Charentes,16,1,25,081,La Chapelle,190,1,191
54,Poitou-Charentes,16,1,28,082,Charmant,317,17,334
54,Poitou-Charentes,16,3,01,083,Charmé,380,8,388
54,Poitou-Charentes,16,1,19,084,Charras,324,4,328
54,Poitou-Charentes,16,3,26,085,Chasseneuil-sur-Bonnieure,2932,257,3189
54,Poitou-Charentes,16,3,09,086,Chassenon,895,14,909
54,Poitou-Charentes,16,3,11,087,Chassiecq,168,1,169
54,Poitou-Charentes,16,2,17,088,Chassors,1111,18,1129
54,Poitou-Charentes,16,2,33,089,Châteaubernard,3899,107,4006
54,Poitou-Charentes,16,2,12,090,Châteauneuf-sur-Charente,3452,59,3511
54,Poitou-Charentes,16,2,08,091,Châtignac,207,2,209
54,Poitou-Charentes,16,1,28,092,Chavenat,212,6,218
54,Poitou-Charentes,16,1,22,093,Chazelles,1523,28,1551
54,Poitou-Charentes,16,3,18,094,Chenommet,147,3,150
54,Poitou-Charentes,16,3,18,095,Chenon,157,3,160
54,Poitou-Charentes,16,3,20,096,Cherves-Châtelars,431,6,437
54,Poitou-Charentes,16,2,13,097,Cherves-Richemont,2420,77,2497
54,Poitou-Charentes,16,3,29,098,La Chèvrerie,146,5,151
54,Poitou-Charentes,16,2,08,099,Chillac,206,0,206
54,Poitou-Charentes,16,3,09,100,Chirac,706,17,723
54,Poitou-Charentes,16,1,07,101,Claix,898,16,914
54,Poitou-Charentes,16,2,97,102,Cognac,19066,649,19715
54,Poitou-Charentes,16,1,28,103,Combiers,115,2,117
54,Poitou-Charentes,16,3,24,104,Condac,474,15,489
54,Poitou-Charentes,16,2,05,105,Condéon,554,13,567
54,Poitou-Charentes,16,3,99,106,Confolens,2791,206,2997
54,Poitou-Charentes,16,1,22,107,Coulgens,488,18,506
54,Poitou-Charentes,16,1,25,108,Coulonges,147,5,152
54,Poitou-Charentes,16,2,23,109,Courbillac,600,11,611
54,Poitou-Charentes,16,3,29,110,Courcôme,429,10,439
54,Poitou-Charentes,16,1,21,111,Courgeac,199,2,201
54,Poitou-Charentes,16,1,10,112,Courlac,66,1,67
54,Poitou-Charentes,16,1,30,113,La Couronne,7013,298,7311
54,Poitou-Charentes,16,3,24,114,Couture,162,1,163
54,Poitou-Charentes,16,1,07,115,Cressac-Saint-Genis,155,1,156
54,Poitou-Charentes,16,2,27,116,Criteuil-la-Magdeleine,426,9,435
54,Poitou-Charentes,16,1,10,117,Curac,122,6,128
54,Poitou-Charentes,16,1,21,118,Deviat,166,5,171
54,Poitou-Charentes,16,1,28,119,Dignac,1298,32,1330
54,Poitou-Charentes,16,1,32,120,Dirac,1473,32,1505
54,Poitou-Charentes,16,1,16,121,Douzat,386,8,394
54,Poitou-Charentes,16,3,01,122,Ébréon,154,5,159
54,Poitou-Charentes,16,1,16,123,Échallat,460,11,471
54,Poitou-Charentes,16,1,19,124,Écuras,638,16,654
54,Poitou-Charentes,16,1,28,125,Édon,252,13,265
54,Poitou-Charentes,16,3,29,127,Empuré,120,3,123
54,Poitou-Charentes,16,3,14,128,Épenède,211,3,214
54,Poitou-Charentes,16,2,12,129,Éraville,186,0,186
54,Poitou-Charentes,16,1,04,130,Les Essards,211,4,215
54,Poitou-Charentes,16,3,15,131,Esse,493,10,503
54,Poitou-Charentes,16,3,09,132,Étagnac,989,17,1006
54,Poitou-Charentes,16,1,07,133,Étriac,189,5,194
54,Poitou-Charentes,16,3,09,134,Exideuil,1072,25,1097
54,Poitou-Charentes,16,1,19,135,Eymouthiers,303,15,318
54,Poitou-Charentes,16,3,29,136,La Faye,604,6,610
54,Poitou-Charentes,16,1,19,137,Feuillade,300,12,312
54,Poitou-Charentes,16,1,30,138,Fléac,3549,147,3696
54,Poitou-Charentes,16,2,17,139,Fleurac,228,1,229
54,Poitou-Charentes,16,3,18,140,Fontclaireau,368,15,383
54,Poitou-Charentes,16,3,18,141,Fontenille,339,7,346
54,Poitou-Charentes,16,3,29,142,La Forêt-de-Tessé,205,9,214
54,Poitou-Charentes,16,1,28,143,Fouquebrune,654,26,680
54,Poitou-Charentes,16,3,01,144,Fouqueure,426,6,432
54,Poitou-Charentes,16,2,17,145,Foussignac,611,7,618
54,Poitou-Charentes,16,1,32,146,Garat,1787,65,1852
54,Poitou-Charentes,16,1,28,147,Gardes-le-Pontaroux,273,8,281
54,Poitou-Charentes,16,2,23,148,Genac,668,16,684
54,Poitou-Charentes,16,3,26,149,Genouillac,588,15,603
54,Poitou-Charentes,16,2,27,150,Gensac-la-Pallue,1603,43,1646
54,Poitou-Charentes,16,2,27,151,Genté,886,31,917
54,Poitou-Charentes,16,2,33,152,Gimeux,716,20,736
54,Poitou-Charentes,16,1,35,154,Gond-Pontouvre,5999,240,6239
54,Poitou-Charentes,16,2,27,153,Gondeville,518,8,526
54,Poitou-Charentes,16,3,01,155,Les Gours,126,0,126
54,Poitou-Charentes,16,2,23,156,Gourville,653,5,658
54,Poitou-Charentes,16,3,26,157,Le Grand-Madieu,168,4,172
54,Poitou-Charentes,16,1,19,158,Grassac,285,4,289
54,Poitou-Charentes,16,2,12,297,Graves-Saint-Amant,324,4,328
54,Poitou-Charentes,16,2,06,160,Guimps,489,9,498
54,Poitou-Charentes,16,2,08,161,Guizengeard,162,0,162
54,Poitou-Charentes,16,1,28,162,Gurat,188,2,190
54,Poitou-Charentes,16,1,16,163,Hiersac,1082,26,1108
54,Poitou-Charentes,16,3,14,164,Hiesse,251,7,258
54,Poitou-Charentes,16,2,17,165,Houlette,388,8,396
54,Poitou-Charentes,16,1,31,166,L' Isle-d'Espagnac,5340,145,5485
54,Poitou-Charentes,16,2,17,167,Jarnac,4515,175,4690
54,Poitou-Charentes,16,1,22,168,Jauldes,726,11,737
54,Poitou-Charentes,16,2,33,169,Javrezac,638,17,655
54,Poitou-Charentes,16,1,21,170,Juignac,412,8,420
54,Poitou-Charentes,16,2,27,171,Juillac-le-Coq,669,27,696
54,Poitou-Charentes,16,1,28,172,Juillaguet,133,0,133
54,Poitou-Charentes,16,3,18,173,Juillé,185,1,186
54,Poitou-Charentes,16,2,17,174,Julienne,437,9,446
54,Poitou-Charentes,16,1,07,175,Jurignac,524,4,528
54,Poitou-Charentes,16,2,06,176,Lachaise,285,8,293
54,Poitou-Charentes,16,2,06,177,Ladiville,122,4,126
54,Poitou-Charentes,16,2,06,178,Lagarde-sur-le-Né,180,2,182
54,Poitou-Charentes,16,2,05,179,Lamérac,194,7,201
54,Poitou-Charentes,16,1,04,180,Laprade,224,5,229
54,Poitou-Charentes,16,3,20,183,Lésignac-Durand,188,3,191
54,Poitou-Charentes,16,3,14,181,Lessac,588,10,598
54,Poitou-Charentes,16,3,15,182,Lesterps,484,17,501
54,Poitou-Charentes,16,3,18,184,Lichères,86,0,86
54,Poitou-Charentes,16,3,01,185,Ligné,170,0,170
54,Poitou-Charentes,16,2,27,186,Lignières-Sonneville,599,12,611
54,Poitou-Charentes,16,1,16,187,Linars,2064,123,2187
54,Poitou-Charentes,16,3,20,188,Le Lindois,327,3,330
54,Poitou-Charentes,16,3,29,189,Londigny,247,3,250
54,Poitou-Charentes,16,3,29,190,Longré,220,6,226
54,Poitou-Charentes,16,3,18,191,Lonnes,166,3,169
54,Poitou-Charentes,16,2,33,193,Louzac-Saint-André,1048,33,1081
54,Poitou-Charentes,16,3,01,194,Lupsault,124,3,127
54,Poitou-Charentes,16,3,26,195,Lussac,284,2,286
54,Poitou-Charentes,16,3,18,196,Luxé,790,9,799
54,Poitou-Charentes,16,3,29,197,La Magdeleine,120,0,120
54,Poitou-Charentes,16,1,28,198,Magnac-Lavalette-Villars,427,69,496
54,Poitou-Charentes,16,1,31,199,Magnac-sur-Touvre,3032,81,3113
54,Poitou-Charentes,16,1,25,200,Maine-de-Boixe,455,10,465
54,Poitou-Charentes,16,1,07,201,Mainfonds,168,2,170
54,Poitou-Charentes,16,2,27,202,Mainxe,638,12,650
54,Poitou-Charentes,16,1,19,203,Mainzac,115,1,116
54,Poitou-Charentes,16,2,12,204,Malaville,417,13,430
54,Poitou-Charentes,16,3,14,205,Manot,594,21,615
54,Poitou-Charentes,16,3,18,206,Mansle,1520,26,1546
54,Poitou-Charentes,16,2,23,207,Marcillac-Lanville,597,17,614
54,Poitou-Charentes,16,2,23,208,Mareuil,385,7,392
54,Poitou-Charentes,16,1,22,209,Marillac-le-Franc,710,24,734
54,Poitou-Charentes,16,1,25,210,Marsac,796,17,813
54,Poitou-Charentes,16,1,19,211,Marthon,601,4,605
54,Poitou-Charentes,16,3,20,212,Massignac,407,6,413
54,Poitou-Charentes,16,3,20,213,Mazerolles,328,2,330
54,Poitou-Charentes,16,3,26,214,Mazières,101,4,105
54,Poitou-Charentes,16,1,10,215,Médillac,154,2,156
54,Poitou-Charentes,16,2,17,216,Mérignac,700,24,724
54,Poitou-Charentes,16,2,33,217,Merpins,1028,24,1052
54,Poitou-Charentes,16,2,13,218,Mesnac,367,9,376
54,Poitou-Charentes,16,2,17,220,Les Métairies,563,11,574
54,Poitou-Charentes,16,2,23,221,Mons,262,2,264
54,Poitou-Charentes,16,1,10,222,Montboyer,411,5,416
54,Poitou-Charentes,16,1,19,223,Montbron,2163,46,2209
54,Poitou-Charentes,16,2,06,224,Montchaude,518,6,524
54,Poitou-Charentes,16,3,20,225,Montemboeuf,698,39,737
54,Poitou-Charentes,16,1,25,226,Montignac-Charente,747,18,765
54,Poitou-Charentes,16,1,04,227,Montignac-le-Coq,135,3,138
54,Poitou-Charentes,16,2,23,228,Montigné,134,0,134
54,Poitou-Charentes,16,3,29,229,Montjean,261,6,267
54,Poitou-Charentes,16,1,21,230,Montmoreau-Saint-Cybard,1062,124,1186
54,Poitou-Charentes,16,3,15,231,Montrollet,294,4,298
54,Poitou-Charentes,16,1,31,232,Mornac,2166,52,2218
54,Poitou-Charentes,16,2,12,233,Mosnac,474,12,486
54,Poitou-Charentes,16,1,16,234,Moulidars,737,18,755
54,Poitou-Charentes,16,1,07,236,Mouthiers-sur-Boëme,2450,56,2506
54,Poitou-Charentes,16,3,18,237,Mouton,227,6,233
54,Poitou-Charentes,16,3,18,238,Moutonneau,102,3,105
54,Poitou-Charentes,16,3,20,239,Mouzon,141,2,143
54,Poitou-Charentes,16,1,04,240,Nabinaud,76,6,82
54,Poitou-Charentes,16,1,25,241,Nanclars,206,5,211
54,Poitou-Charentes,16,3,24,242,Nanteuil-en-Vallée,1462,21,1483
54,Poitou-Charentes,16,2,17,243,Nercillac,1025,32,1057
54,Poitou-Charentes,16,1,30,244,Nersac,2343,50,2393
54,Poitou-Charentes,16,3,26,245,Nieuil,937,23,960
54,Poitou-Charentes,16,1,21,246,Nonac,306,13,319
54,Poitou-Charentes,16,2,12,247,Nonaville,195,1,196
54,Poitou-Charentes,16,3,01,248,Oradour,204,12,216
54,Poitou-Charentes,16,3,15,249,Oradour-Fanais,371,16,387
54,Poitou-Charentes,16,1,19,250,Orgedeuil,222,3,225
54,Poitou-Charentes,16,2,08,251,Oriolles,247,6,253
54,Poitou-Charentes,16,1,10,252,Orival,155,6,161
54,Poitou-Charentes,16,3,29,253,Paizay-Naudouin-Embourie,400,3,403
54,Poitou-Charentes,16,1,21,254,Palluaud,274,4,278
54,Poitou-Charentes,16,3,26,255,Parzac,133,1,134
54,Poitou-Charentes,16,2,08,256,Passirac,257,7,264
54,Poitou-Charentes,16,1,07,257,Péreuil,408,7,415
54,Poitou-Charentes,16,1,07,258,Pérignac,530,14,544
54,Poitou-Charentes,16,3,09,259,La Péruse,496,49,545
54,Poitou-Charentes,16,1,04,260,Pillac,254,7,261
54,Poitou-Charentes,16,3,26,261,Les Pins,447,12,459
54,Poitou-Charentes,16,2,23,262,Plaizac,156,8,164
54,Poitou-Charentes,16,1,07,263,Plassac-Rouffiac,348,5,353
54,Poitou-Charentes,16,3,14,264,Pleuville,371,6,377
54,Poitou-Charentes,16,1,21,267,Poullignac,80,2,82
54,Poitou-Charentes,16,3,24,268,Poursac,207,3,210
54,Poitou-Charentes,16,1,22,269,Pranzac,900,13,913
54,Poitou-Charentes,16,3,09,270,Pressignac,428,5,433
54,Poitou-Charentes,16,1,30,271,Puymoyen,2405,220,2625
54,Poitou-Charentes,16,3,18,272,Puyréaux,463,4,467
54,Poitou-Charentes,16,3,29,273,Raix,149,3,152
54,Poitou-Charentes,16,1,22,274,Rancogne,375,12,387
54,Poitou-Charentes,16,3,01,275,Ranville-Breuillaud,183,3,186
54,Poitou-Charentes,16,2,05,276,Reignac,644,26,670
54,Poitou-Charentes,16,2,17,277,Réparsac,588,10,598
54,Poitou-Charentes,16,1,10,279,Rioux-Martin,227,10,237
54,Poitou-Charentes,16,1,22,280,Rivières,1865,39,1904
54,Poitou-Charentes,16,1,22,281,La Rochefoucauld,3162,160,3322
54,Poitou-Charentes,16,1,22,282,La Rochette,551,12,563
54,Poitou-Charentes,16,1,28,283,Ronsenac,551,15,566
54,Poitou-Charentes,16,1,04,284,Rouffiac,114,2,116
54,Poitou-Charentes,16,1,28,285,Rougnac,495,9,504
54,Poitou-Charentes,16,2,23,286,Rouillac,1765,30,1795
54,Poitou-Charentes,16,1,30,287,Roullet-Saint-Estèphe,3747,81,3828
54,Poitou-Charentes,16,3,26,192,Roumazières-Loubert,2558,52,2610
54,Poitou-Charentes,16,3,20,289,Roussines,310,9,319
54,Poitou-Charentes,16,1,19,290,Rouzède,266,16,282
54,Poitou-Charentes,16,1,31,291,Ruelle-sur-Touvre,7436,296,7732
54,Poitou-Charentes,16,3,24,292,Ruffec,3575,141,3716
54,Poitou-Charentes,16,3,20,293,Saint-Adjutory,360,5,365
54,Poitou-Charentes,16,1,21,294,Saint-Amant,674,13,687
54,Poitou-Charentes,16,1,25,295,Saint-Amant-de-Boixe,1325,18,1343
54,Poitou-Charentes,16,3,18,296,Saint-Amant-de-Bonnieure,346,5,351
54,Poitou-Charentes,16,1,16,298,Saint-Amant-de-Nouère,395,6,401
54,Poitou-Charentes,16,3,18,300,Saint-Angeau,677,5,682
54,Poitou-Charentes,16,2,06,301,Saint-Aulais-la-Chapelle,233,2,235
54,Poitou-Charentes,16,1,10,302,Saint-Avit,182,1,183
54,Poitou-Charentes,16,2,06,303,Saint-Bonnet,379,4,383
54,Poitou-Charentes,16,2,13,304,Saint-Brice,1095,29,1124
54,Poitou-Charentes,16,3,15,306,Saint-Christophe,320,11,331
54,Poitou-Charentes,16,3,18,307,Saint-Ciers-sur-Bonnieure,288,3,291
54,Poitou-Charentes,16,3,26,308,Saint-Claud,1099,12,1111
54,Poitou-Charentes,16,3,11,310,Saint-Coutant,215,3,218
54,Poitou-Charentes,16,2,23,312,Saint-Cybardeaux,787,22,809
54,Poitou-Charentes,16,1,21,314,Saint-Eutrope,163,3,166
54,Poitou-Charentes,16,2,08,315,Saint-Félix,113,6,119
54,Poitou-Charentes,16,2,27,316,Saint-Fort-sur-le-Né,402,5,407
54,Poitou-Charentes,16,3,01,317,Saint-Fraigne,463,9,472
54,Poitou-Charentes,16,3,18,318,Saint-Front,332,5,337
54,Poitou-Charentes,16,1,16,320,Saint-Genis-d'Hiersac,862,13,875
54,Poitou-Charentes,16,3,24,321,Saint-Georges,55,1,56
54,Poitou-Charentes,16,3,15,322,Saint-Germain-de-Confolens,96,2,98
54,Poitou-Charentes,16,1,19,323,Saint-Germain-de-Montbron,473,11,484
54,Poitou-Charentes,16,3,24,325,Saint-Gourson,133,3,136
54,Poitou-Charentes,16,3,18,326,Saint-Groux,137,0,137
54,Poitou-Charentes,16,1,21,328,Saint-Laurent-de-Belzagot,353,22,375
54,Poitou-Charentes,16,3,26,329,Saint-Laurent-de-Céris,758,25,783
54,Poitou-Charentes,16,2,33,330,Saint-Laurent-de-Cognac,888,11,899
54,Poitou-Charentes,16,2,08,331,Saint-Laurent-des-Combes,95,0,95
54,Poitou-Charentes,16,1,07,332,Saint-Léger,122,1,123
54,Poitou-Charentes,16,1,21,334,Saint-Martial,145,6,151
54,Poitou-Charentes,16,3,29,335,Saint-Martin-du-Clocher,132,1,133
54,Poitou-Charentes,16,3,26,336,Saint-Mary,376,4,380
54,Poitou-Charentes,16,3,15,337,Saint-Maurice-des-Lions,958,11,969
54,Poitou-Charentes,16,2,06,338,Saint-Médard,261,7,268
54,Poitou-Charentes,16,2,27,340,Saint-Même-les-Carrières,1094,27,1121
54,Poitou-Charentes,16,1,30,341,Saint-Michel,3106,111,3217
54,Poitou-Charentes,16,2,06,342,Saint-Palais-du-Né,272,4,276
54,Poitou-Charentes,16,2,27,343,Saint-Preuil,307,12,319
54,Poitou-Charentes,16,1,22,344,Saint-Projet-Saint-Constant,1126,71,1197
54,Poitou-Charentes,16,1,10,346,Saint-Quentin-de-Chalais,274,6,280
54,Poitou-Charentes,16,3,09,345,Saint-Quentin-sur-Charente,225,5,230
54,Poitou-Charentes,16,1,04,347,Saint-Romain,541,6,547
54,Poitou-Charentes,16,1,16,348,Saint-Saturnin,1307,51,1358
54,Poitou-Charentes,16,1,04,350,Saint-Séverin,787,19,806
54,Poitou-Charentes,16,2,12,351,Saint-Simeux,541,7,548
54,Poitou-Charentes,16,2,12,352,Saint-Simon,207,3,210
54,Poitou-Charentes,16,1,19,353,Saint-Sornin,819,20,839
54,Poitou-Charentes,16,2,13,355,Saint-Sulpice-de-Cognac,1281,17,1298
54,Poitou-Charentes,16,3,24,356,Saint-Sulpice-de-Ruffec,36,1,37
54,Poitou-Charentes,16,2,08,357,Saint-Vallier,150,1,151
54,Poitou-Charentes,16,1,35,358,Saint-Yrieix-sur-Charente,6969,287,7256
54,Poitou-Charentes,16,3,18,309,Sainte-Colombe,185,4,189
54,Poitou-Charentes,16,2,17,349,Sainte-Sévère,540,9,549
54,Poitou-Charentes,16,2,08,354,Sainte-Souline,126,3,129
54,Poitou-Charentes,16,2,27,359,Salles-d'Angles,1086,20,1106
54,Poitou-Charentes,16,2,06,360,Salles-de-Barbezieux,435,71,506
54,Poitou-Charentes,16,3,29,361,Salles-de-Villefagnan,341,8,349
54,Poitou-Charentes,16,1,21,362,Salles-Lavalette,348,7,355
54,Poitou-Charentes,16,3,09,363,Saulgond,509,10,519
54,Poitou-Charentes,16,3,20,364,Sauvagnac,75,1,76
54,Poitou-Charentes,16,2,08,365,Sauvignac,103,1,104
54,Poitou-Charentes,16,2,27,366,Segonzac,2156,78,2234
54,Poitou-Charentes,16,1,28,368,Sers,749,23,772
54,Poitou-Charentes,16,2,17,369,Sigogne,1021,32,1053
54,Poitou-Charentes,16,1,16,370,Sireuil,1183,40,1223
54,Poitou-Charentes,16,2,23,371,Sonneville,208,7,215
54,Poitou-Charentes,16,1,19,372,Souffrignac,124,5,129
54,Poitou-Charentes,16,3,29,373,Souvigné,240,4,244
54,Poitou-Charentes,16,1,32,374,Soyaux,10289,653,10942
54,Poitou-Charentes,16,3,26,375,Suaux,377,3,380
54,Poitou-Charentes,16,3,09,376,Suris,277,9,286
54,Poitou-Charentes,16,3,18,377,La Tâche,108,5,113
54,Poitou-Charentes,16,3,24,378,Taizé-Aizie,561,22,583
54,Poitou-Charentes,16,1,22,379,Taponnat-Fleurignac,1458,36,1494
54,Poitou-Charentes,16,2,05,380,Le Tâtre,336,10,346
54,Poitou-Charentes,16,3,29,381,Theil-Rabier,158,7,165
54,Poitou-Charentes,16,1,28,382,Torsac,770,15,785
54,Poitou-Charentes,16,1,25,383,Tourriers,728,7,735
54,Poitou-Charentes,16,2,05,384,Touvérac,744,13,757
54,Poitou-Charentes,16,1,31,385,Touvre,1109,23,1132
54,Poitou-Charentes,16,2,12,386,Touzac,451,10,461
54,Poitou-Charentes,16,2,17,387,Triac-Lautrait,454,70,524
54,Poitou-Charentes,16,1,16,388,Trois-Palis,786,14,800
54,Poitou-Charentes,16,3,11,389,Turgon,96,1,97
54,Poitou-Charentes,16,3,01,390,Tusson,293,17,310
54,Poitou-Charentes,16,3,29,391,Tuzie,146,1,147
54,Poitou-Charentes,16,3,18,392,Valence,233,11,244
54,Poitou-Charentes,16,1,25,393,Vars,1937,41,1978
54,Poitou-Charentes,16,1,28,394,Vaux-Lavalette,96,4,100
54,Poitou-Charentes,16,2,23,395,Vaux-Rouillac,299,7,306
54,Poitou-Charentes,16,3,18,396,Ventouse,121,2,123
54,Poitou-Charentes,16,3,01,397,Verdille,348,5,353
54,Poitou-Charentes,16,3,20,398,Verneuil,101,8,109
54,Poitou-Charentes,16,2,27,399,Verrières,367,22,389
54,Poitou-Charentes,16,3,24,400,Verteuil-sur-Charente,686,32,718
54,Poitou-Charentes,16,1,25,401,Vervant,132,1,133
54,Poitou-Charentes,16,2,12,402,Vibrac,303,1,304
54,Poitou-Charentes,16,3,11,403,Le Vieux-Cérier,141,0,141
54,Poitou-Charentes,16,3,24,404,Vieux-Ruffec,105,1,106
54,Poitou-Charentes,16,2,06,405,Vignolles,181,2,183
54,Poitou-Charentes,16,1,22,406,Vilhonneur,335,7,342
54,Poitou-Charentes,16,1,28,408,Villebois-Lavalette,747,25,772
54,Poitou-Charentes,16,3,29,409,Villefagnan,1038,36,1074
54,Poitou-Charentes,16,3,24,410,Villegats,244,14,258
54,Poitou-Charentes,16,3,01,411,Villejésus,555,13,568
54,Poitou-Charentes,16,1,25,412,Villejoubert,331,9,340
54,Poitou-Charentes,16,3,29,413,Villiers-le-Roux,118,3,121
54,Poitou-Charentes,16,3,18,414,Villognon,393,4,397
54,Poitou-Charentes,16,1,16,415,Vindelle,965,21,986
54,Poitou-Charentes,16,3,20,416,Vitrac-Saint-Vincent,525,9,534
54,Poitou-Charentes,16,2,12,417,Viville,134,2,136
54,Poitou-Charentes,16,1,30,418,Voeuil-et-Giget,1570,52,1622
54,Poitou-Charentes,16,1,25,419,Vouharte,328,8,336
54,Poitou-Charentes,16,1,07,420,Voulgézac,270,7,277
54,Poitou-Charentes,16,1,19,421,Vouthon,345,2,347
54,Poitou-Charentes,16,1,32,422,Vouzan,637,13,650
54,Poitou-Charentes,16,1,25,423,Xambes,302,6,308
54,Poitou-Charentes,16,1,10,424,Yviers,501,2,503
54,Poitou-Charentes,16,1,22,425,Yvrac-et-Malleyrand,530,10,540
54,Poitou-Charentes,17,1,11,002,Agudelle,111,3,114
54,Poitou-Charentes,17,2,01,003,Aigrefeuille-d'Aunis,3631,64,3695
54,Poitou-Charentes,17,1,16,005,Allas-Bocage,187,4,191
54,Poitou-Charentes,17,1,02,006,Allas-Champagne,235,5,240
54,Poitou-Charentes,17,3,10,007,Anais,299,9,308
54,Poitou-Charentes,17,3,13,008,Andilly,1935,30,1965
54,Poitou-Charentes,17,3,07,009,Angliers,784,12,796
54,Poitou-Charentes,17,3,46,010,Angoulins,3708,117,3825
54,Poitou-Charentes,17,5,33,011,Annepont,308,13,321
54,Poitou-Charentes,17,5,38,012,Annezay,160,2,162
54,Poitou-Charentes,17,5,29,013,Antezant-la-Chapelle,356,1,357
54,Poitou-Charentes,17,4,08,015,Arces,615,15,630
54,Poitou-Charentes,17,1,02,016,Archiac,813,22,835
54,Poitou-Charentes,17,5,33,017,Archingeay,622,11,633
54,Poitou-Charentes,17,2,01,018,Ardillières,778,13,791
54,Poitou-Charentes,17,3,03,019,Ars-en-Ré,1318,29,1347
54,Poitou-Charentes,17,1,02,020,Arthenac,322,5,327
54,Poitou-Charentes,17,2,40,021,Arvert,3084,80,3164
54,Poitou-Charentes,17,5,29,022,Asnières-la-Giraud,916,22,938
54,Poitou-Charentes,17,5,28,023,Aujac,314,5,319
54,Poitou-Charentes,17,5,04,024,Aulnay,1456,50,1506
54,Poitou-Charentes,17,5,28,025,Aumagne,671,23,694
54,Poitou-Charentes,17,5,28,026,Authon-Ébéon,386,8,394
54,Poitou-Charentes,17,4,20,027,Avy,471,11,482
54,Poitou-Charentes,17,3,46,028,Aytré,8820,211,9031
54,Poitou-Charentes,17,5,15,029,Bagnizeau,188,3,191
54,Poitou-Charentes,17,4,36,030,Balanzac,484,10,494
54,Poitou-Charentes,17,5,15,031,Ballans,200,6,206
54,Poitou-Charentes,17,2,01,032,Ballon,678,7,685
54,Poitou-Charentes,17,1,18,033,La Barde,428,8,436
54,Poitou-Charentes,17,4,08,034,Barzan,453,3,456
54,Poitou-Charentes,17,5,15,035,Bazauges,130,4,134
54,Poitou-Charentes,17,2,26,036,Beaugeay,629,4,633
54,Poitou-Charentes,17,5,15,037,Beauvais-sur-Matha,687,18,705
54,Poitou-Charentes,17,1,19,038,Bedenac,595,12,607
54,Poitou-Charentes,17,4,20,039,Belluire,183,4,187
54,Poitou-Charentes,17,5,29,040,La Benâte,412,18,430
54,Poitou-Charentes,17,3,07,041,Benon,723,10,733
54,Poitou-Charentes,17,5,28,042,Bercloux,382,9,391
54,Poitou-Charentes,17,5,12,043,Bernay-Saint-Martin,746,14,760
54,Poitou-Charentes,17,4,09,044,Berneuil,1011,13,1024
54,Poitou-Charentes,17,4,32,045,Beurlay,974,26,1000
54,Poitou-Charentes,17,5,29,046,Bignay,405,9,414
54,Poitou-Charentes,17,4,20,047,Biron,234,1,235
54,Poitou-Charentes,17,5,15,048,Blanzac-lès-Matha,330,5,335
54,Poitou-Charentes,17,5,04,049,Blanzay-sur-Boutonne,94,4,98
54,Poitou-Charentes,17,1,27,050,Bois,496,109,605
54,Poitou-Charentes,17,3,30,051,Le Bois-Plage-en-Ré,2330,72,2402
54,Poitou-Charentes,17,1,16,052,Boisredon,647,11,658
54,Poitou-Charentes,17,5,33,053,Bords,1252,23,1275
54,Poitou-Charentes,17,1,18,054,Boresse-et-Martron,186,6,192
54,Poitou-Charentes,17,1,18,055,Boscamnant,364,5,369
54,Poitou-Charentes,17,4,20,056,Bougneau,520,10,530
54,Poitou-Charentes,17,2,01,057,Bouhet,725,5,730
54,Poitou-Charentes,17,2,14,058,Bourcefranc-le-Chapus,3347,105,3452
54,Poitou-Charentes,17,3,10,059,Bourgneuf,1063,17,1080
54,Poitou-Charentes,17,4,08,060,Boutenac-Touvent,191,6,197
54,Poitou-Charentes,17,1,17,061,Bran,122,2,124
54,Poitou-Charentes,17,2,31,486,La Brée-les-Bains,753,20,773
54,Poitou-Charentes,17,5,15,062,Bresdon,264,7,271
54,Poitou-Charentes,17,2,37,063,Breuil-la-Réorte,360,8,368
54,Poitou-Charentes,17,2,21,065,Breuil-Magné,1547,44,1591
54,Poitou-Charentes,17,2,43,064,Breuillet,2583,66,2649
54,Poitou-Charentes,17,1,02,066,Brie-sous-Archiac,241,8,249
54,Poitou-Charentes,17,5,15,067,Brie-sous-Matha,195,4,199
54,Poitou-Charentes,17,4,08,068,Brie-sous-Mortagne,252,10,262
54,Poitou-Charentes,17,4,20,069,Brives-sur-Charente,226,2,228
54,Poitou-Charentes,17,5,28,070,Brizambourg,870,21,891
54,Poitou-Charentes,17,5,15,071,La Brousse,499,8,507
54,Poitou-Charentes,17,4,05,072,Burie,1259,21,1280
54,Poitou-Charentes,17,1,19,074,Bussac-Forêt,957,24,981
54,Poitou-Charentes,17,4,34,073,Bussac-sur-Charente,1265,36,1301
54,Poitou-Charentes,17,2,39,075,Cabariot,1235,52,1287
54,Poitou-Charentes,17,1,02,076,Celles,303,6,309
54,Poitou-Charentes,17,1,18,077,Cercoux,1129,17,1146
54,Poitou-Charentes,17,4,20,078,Chadenac,401,9,410
54,Poitou-Charentes,17,2,40,079,Chaillevette,1358,25,1383
54,Poitou-Charentes,17,2,01,080,Chambon,870,10,880
54,Poitou-Charentes,17,1,17,081,Chamouillac,321,8,329
54,Poitou-Charentes,17,1,11,082,Champagnac,531,19,550
54,Poitou-Charentes,17,2,26,083,Champagne,615,21,636
54,Poitou-Charentes,17,1,27,084,Champagnolles,518,14,532
54,Poitou-Charentes,17,5,33,085,Champdolent,389,4,393
54,Poitou-Charentes,17,4,51,086,Chaniers,3391,86,3477
54,Poitou-Charentes,17,5,38,087,Chantemerle-sur-la-Soie,128,3,131
54,Poitou-Charentes,17,4,51,089,La Chapelle-des-Pots,918,21,939
54,Poitou-Charentes,17,3,13,091,Charron,2259,35,2294
54,Poitou-Charentes,17,1,17,092,Chartuzac,167,3,170
54,Poitou-Charentes,17,2,06,093,Le Château-d'Oléron,3941,98,4039
54,Poitou-Charentes,17,3,46,094,Châtelaillon-Plage,6049,131,6180
54,Poitou-Charentes,17,1,19,095,Chatenet,220,2,222
54,Poitou-Charentes,17,1,11,096,Chaunac,79,3,82
54,Poitou-Charentes,17,4,36,097,Le Chay,729,11,740
54,Poitou-Charentes,17,4,08,098,Chenac-Saint-Seurin-d'Uzet,595,12,607
54,Poitou-Charentes,17,1,19,099,Chepniers,647,13,660
54,Poitou-Charentes,17,4,05,100,Chérac,1033,21,1054
54,Poitou-Charentes,17,5,04,101,Cherbonnières,330,17,347
54,Poitou-Charentes,17,4,35,102,Chermignac,1196,15,1211
54,Poitou-Charentes,17,5,38,103,Chervettes,128,2,130
54,Poitou-Charentes,17,1,19,104,Chevanceaux,1018,91,1109
54,Poitou-Charentes,17,5,04,105,Chives,371,3,374
54,Poitou-Charentes,17,1,02,106,Cierzac,231,7,238
54,Poitou-Charentes,17,2,01,107,Ciré-d'Aunis,1174,12,1186
54,Poitou-Charentes,17,1,27,108,Clam,354,9,363
54,Poitou-Charentes,17,3,10,109,Clavette,955,20,975
54,Poitou-Charentes,17,1,18,110,Clérac,931,23,954
54,Poitou-Charentes,17,1,27,111,Clion,771,21,792
54,Poitou-Charentes,17,4,36,112,La Clisse,559,8,567
54,Poitou-Charentes,17,1,18,113,La Clotte,615,10,625
54,Poitou-Charentes,17,5,12,114,Coivert,232,8,240
54,Poitou-Charentes,17,4,51,115,Colombiers,325,11,336
54,Poitou-Charentes,17,1,16,116,Consac,240,13,253
54,Poitou-Charentes,17,5,04,117,Contré,139,2,141
54,Poitou-Charentes,17,1,17,118,Corignac,338,1,339
54,Poitou-Charentes,17,4,36,119,Corme-Écluse,1006,17,1023
54,Poitou-Charentes,17,4,36,120,Corme-Royal,1573,46,1619
54,Poitou-Charentes,17,3,03,121,La Couarde-sur-Mer,1244,30,1274
54,Poitou-Charentes,17,4,20,122,Coulonges,224,1,225
54,Poitou-Charentes,17,5,12,124,Courant,353,4,357
54,Poitou-Charentes,17,5,29,125,Courcelles,434,17,451
54,Poitou-Charentes,17,5,15,126,Courcerac,282,2,284
54,Poitou-Charentes,17,4,51,128,Courcoury,704,13,717
54,Poitou-Charentes,17,1,16,129,Courpignac,407,6,413
54,Poitou-Charentes,17,3,07,127,Courçon,1630,19,1649
54,Poitou-Charentes,17,1,17,130,Coux,456,9,465
54,Poitou-Charentes,17,4,08,131,Cozes,1936,33,1969
54,Poitou-Charentes,17,3,07,132,Cramchaban,582,9,591
54,Poitou-Charentes,17,4,09,133,Cravans,713,79,792
54,Poitou-Charentes,17,4,32,134,Crazannes,445,9,454
54,Poitou-Charentes,17,5,15,135,Cressé,245,2,247
54,Poitou-Charentes,17,3,10,136,Croix-Chapeau,1130,18,1148
54,Poitou-Charentes,17,5,12,137,La Croix-Comtesse,171,7,178
54,Poitou-Charentes,17,5,04,138,Dampierre-sur-Boutonne,296,8,304
54,Poitou-Charentes,17,5,12,139,Doeuil-sur-le-Mignon,330,8,338
54,Poitou-Charentes,17,2,06,140,Dolus-d'Oléron,3166,81,3247
54,Poitou-Charentes,17,4,05,141,Dompierre-sur-Charente,460,10,470
54,Poitou-Charentes,17,3,49,142,Dompierre-sur-Mer,5280,109,5389
54,Poitou-Charentes,17,4,34,143,Le Douhet,704,20,724
54,Poitou-Charentes,17,4,20,145,Échebrune,488,12,500
54,Poitou-Charentes,17,2,26,146,Échillais,3284,70,3354
54,Poitou-Charentes,17,4,05,147,Écoyeux,1178,22,1200
54,Poitou-Charentes,17,4,35,148,Écurat,437,15,452
54,Poitou-Charentes,17,5,04,149,Les Éduts,66,1,67
54,Poitou-Charentes,17,5,29,150,Les Églises-d'Argenteuil,525,13,538
54,Poitou-Charentes,17,2,43,151,L' Éguille,914,30,944
54,Poitou-Charentes,17,4,08,152,Épargnes,802,14,816
54,Poitou-Charentes,17,3,44,153,Esnandes,2016,37,2053
54,Poitou-Charentes,17,4,32,154,Les Essards,567,7,574
54,Poitou-Charentes,17,2,40,155,Étaules,2217,45,2262
54,Poitou-Charentes,17,1,17,156,Expiremont,120,0,120
54,Poitou-Charentes,17,5,33,157,Fenioux,132,1,133
54,Poitou-Charentes,17,3,07,158,Ferrières,732,10,742
54,Poitou-Charentes,17,4,20,159,Fléac-sur-Seugne,350,4,354
54,Poitou-Charentes,17,4,08,160,Floirac,330,4,334
54,Poitou-Charentes,17,3,30,161,La Flotte,2946,63,3009
54,Poitou-Charentes,17,5,04,162,Fontaine-Chalendray,236,2,238
54,Poitou-Charentes,17,1,11,163,Fontaines-d'Ozillac,480,14,494
54,Poitou-Charentes,17,4,34,164,Fontcouverte,2135,71,2206
54,Poitou-Charentes,17,5,29,165,Fontenet,369,10,379
54,Poitou-Charentes,17,2,01,166,Forges,1147,13,1160
54,Poitou-Charentes,17,1,18,167,Le Fouilloux,709,6,715
54,Poitou-Charentes,17,2,21,168,Fouras,4095,94,4189
54,Poitou-Charentes,17,5,28,169,La Frédière,78,0,78
54,Poitou-Charentes,17,4,32,171,Geay,655,17,672
54,Poitou-Charentes,17,4,09,172,Gémozac,2588,58,2646
54,Poitou-Charentes,17,1,18,173,La Genétouze,213,6,219
54,Poitou-Charentes,17,2,39,174,Genouillé,774,20,794
54,Poitou-Charentes,17,1,02,175,Germignac,593,3,596
54,Poitou-Charentes,17,5,15,176,Gibourne,120,1,121
54,Poitou-Charentes,17,5,04,177,Le Gicq,117,4,121
54,Poitou-Charentes,17,1,27,178,Givrezac,70,2,72
54,Poitou-Charentes,17,4,51,179,Les Gonds,1508,42,1550
54,Poitou-Charentes,17,5,15,180,Gourvillette,105,2,107
54,Poitou-Charentes,17,2,06,485,Le Grand-Village-Plage,993,25,1018
54,Poitou-Charentes,17,5,33,181,Grandjean,251,9,260
54,Poitou-Charentes,17,3,07,182,La Grève-sur-Mignon,443,2,445
54,Poitou-Charentes,17,4,08,183,Grézac,730,8,738
54,Poitou-Charentes,17,2,26,184,La Gripperie-Saint-Symphorien,475,10,485
54,Poitou-Charentes,17,2,14,185,Le Gua,2023,54,2077
54,Poitou-Charentes,17,3,07,186,Le Gué-d'Alleré,663,11,674
54,Poitou-Charentes,17,1,11,187,Guitinières,413,12,425
54,Poitou-Charentes,17,5,15,188,Haimps,522,2,524
54,Poitou-Charentes,17,2,14,189,Hiers-Brouage,639,12,651
54,Poitou-Charentes,17,3,50,190,L' Houmeau,2076,78,2154
54,Poitou-Charentes,17,2,21,004,Île-d'Aix,223,16,239
54,Poitou-Charentes,17,4,51,191,La Jard,310,0,310
54,Poitou-Charentes,17,1,02,192,Jarnac-Champagne,752,24,776
54,Poitou-Charentes,17,3,10,193,La Jarne,2279,39,2318
54,Poitou-Charentes,17,3,10,194,La Jarrie,2780,91,2871
54,Poitou-Charentes,17,5,12,195,La Jarrie-Audouin,262,7,269
54,Poitou-Charentes,17,4,09,196,Jazennes,482,7,489
54,Poitou-Charentes,17,1,11,197,Jonzac,3552,362,3914
54,Poitou-Charentes,17,5,28,198,Juicq,181,3,184
54,Poitou-Charentes,17,1,17,199,Jussas,107,6,113
54,Poitou-Charentes,17,3,50,200,Lagord,7240,205,7445
54,Poitou-Charentes,17,3,07,201,La Laigne,283,13,296
54,Poitou-Charentes,17,5,29,202,Landes,561,23,584
54,Poitou-Charentes,17,2,01,203,Landrais,662,20,682
54,Poitou-Charentes,17,1,11,204,Léoville,313,5,318
54,Poitou-Charentes,17,2,21,205,Loire-les-Marais,332,4,336
54,Poitou-Charentes,17,5,04,206,Loiré-sur-Nie,294,11,305
54,Poitou-Charentes,17,3,03,207,Loix,729,11,740
54,Poitou-Charentes,17,3,13,208,Longèves,733,11,744
54,Poitou-Charentes,17,1,02,209,Lonzac,243,3,246
54,Poitou-Charentes,17,1,27,210,Lorignac,462,8,470
54,Poitou-Charentes,17,5,12,211,Loulay,754,21,775
54,Poitou-Charentes,17,5,15,212,Louzignac,166,6,172
54,Poitou-Charentes,17,5,12,213,Lozay,158,4,162
54,Poitou-Charentes,17,4,36,214,Luchat,381,10,391
54,Poitou-Charentes,17,1,11,215,Lussac,49,2,51
54,Poitou-Charentes,17,2,39,216,Lussant,907,41,948
54,Poitou-Charentes,17,5,15,217,Macqueville,293,6,299
54,Poitou-Charentes,17,3,13,218,Marans,4634,54,4688
54,Poitou-Charentes,17,2,14,219,Marennes,5465,108,5573
54,Poitou-Charentes,17,4,20,220,Marignac,385,4,389
54,Poitou-Charentes,17,2,37,221,Marsais,878,10,888
54,Poitou-Charentes,17,3,44,222,Marsilly,2504,41,2545
54,Poitou-Charentes,17,5,15,223,Massac,174,4,178
54,Poitou-Charentes,17,5,15,224,Matha,2167,92,2259
54,Poitou-Charentes,17,2,40,225,Les Mathes,1698,40,1738
54,Poitou-Charentes,17,5,29,226,Mazeray,911,26,937
54,Poitou-Charentes,17,4,20,227,Mazerolles,264,5,269
54,Poitou-Charentes,17,4,36,228,Médis,2661,54,2715
54,Poitou-Charentes,17,1,19,229,Mérignac,199,3,202
54,Poitou-Charentes,17,4,08,230,Meschers-sur-Gironde,2727,62,2789
54,Poitou-Charentes,17,1,17,231,Messac,109,4,113
54,Poitou-Charentes,17,4,09,232,Meursac,1269,18,1287
54,Poitou-Charentes,17,1,11,233,Meux,294,6,300
54,Poitou-Charentes,17,5,12,234,Migré,337,7,344
54,Poitou-Charentes,17,4,05,235,Migron,625,7,632
54,Poitou-Charentes,17,1,16,236,Mirambeau,1486,51,1537
54,Poitou-Charentes,17,2,26,237,Moëze,540,11,551
54,Poitou-Charentes,17,1,11,238,Moings,173,1,174
54,Poitou-Charentes,17,5,15,239,Mons,458,3,461
54,Poitou-Charentes,17,1,17,240,Montendre,3144,112,3256
54,Poitou-Charentes,17,1,18,241,Montguyon,1453,38,1491
54,Poitou-Charentes,17,4,20,242,Montils,722,16,738
54,Poitou-Charentes,17,1,19,243,Montlieu-la-Garde,1330,25,1355
54,Poitou-Charentes,17,4,09,244,Montpellier-de-Médillan,643,9,652
54,Poitou-Charentes,17,3,10,245,Montroy,654,14,668
54,Poitou-Charentes,17,2,39,246,Moragne,454,9,463
54,Poitou-Charentes,17,2,43,247,Mornac-sur-Seudre,782,16,798
54,Poitou-Charentes,17,4,08,248,Mortagne-sur-Gironde,1030,19,1049
54,Poitou-Charentes,17,1,11,249,Mortiers,189,5,194
54,Poitou-Charentes,17,1,27,250,Mosnac,470,14,484
54,Poitou-Charentes,17,5,33,252,Le Mung,262,2,264
54,Poitou-Charentes,17,2,39,253,Muron,1202,37,1239
54,Poitou-Charentes,17,5,38,254,Nachamps,221,3,224
54,Poitou-Charentes,17,4,36,255,Nancras,639,13,652
54,Poitou-Charentes,17,5,28,256,Nantillé,329,6,335
54,Poitou-Charentes,17,5,04,257,Néré,740,16,756
54,Poitou-Charentes,17,1,02,258,Neuillac,286,6,292
54,Poitou-Charentes,17,1,02,259,Neulles,141,2,143
54,Poitou-Charentes,17,1,18,260,Neuvicq,432,7,439
54,Poitou-Charentes,17,5,15,261,Neuvicq-le-Château,388,27,415
54,Poitou-Charentes,17,1,16,263,Nieul-le-Virouil,575,11,586
54,Poitou-Charentes,17,4,35,262,Nieul-lès-Saintes,988,30,1018
54,Poitou-Charentes,17,3,50,264,Nieul-sur-Mer,5620,186,5806
54,Poitou-Charentes,17,2,14,265,Nieulle-sur-Seudre,958,12,970
54,Poitou-Charentes,17,5,33,266,Les Nouillers,626,5,631
54,Poitou-Charentes,17,3,07,267,Nuaillé-d'Aunis,1002,6,1008
54,Poitou-Charentes,17,5,04,268,Nuaillé-sur-Boutonne,194,12,206
54,Poitou-Charentes,17,1,19,269,Orignolles,617,10,627
54,Poitou-Charentes,17,1,11,270,Ozillac,670,16,686
54,Poitou-Charentes,17,5,04,271,Paillé,334,6,340
54,Poitou-Charentes,17,2,37,272,Péré,338,11,349
54,Poitou-Charentes,17,4,20,273,Pérignac,959,35,994
54,Poitou-Charentes,17,3,49,274,Périgny,6794,196,6990
54,Poitou-Charentes,17,4,35,275,Pessines,767,23,790
54,Poitou-Charentes,17,1,19,276,Le Pin,71,0,71
54,Poitou-Charentes,17,4,36,278,Pisany,453,6,459
54,Poitou-Charentes,17,1,27,279,Plassac,585,9,594
54,Poitou-Charentes,17,4,32,280,Plassay,676,5,681
54,Poitou-Charentes,17,1,19,281,Polignac,135,0,135
54,Poitou-Charentes,17,1,17,282,Pommiers-Moulons,190,0,190
54,Poitou-Charentes,17,4,20,283,Pons,4427,174,4601
54,Poitou-Charentes,17,4,32,284,Pont-l'Abbé-d'Arnoult,1757,269,2026
54,Poitou-Charentes,17,4,32,285,Port-d'Envaux,1047,36,1083
54,Poitou-Charentes,17,2,26,484,Port-des-Barques,1851,43,1894
54,Poitou-Charentes,17,3,03,286,Les Portes-en-Ré,643,22,665
54,Poitou-Charentes,17,1,19,287,Pouillac,229,3,232
54,Poitou-Charentes,17,5,29,288,Poursay-Garnaud,294,5,299
54,Poitou-Charentes,17,4,35,289,Préguillac,417,20,437
54,Poitou-Charentes,17,5,15,290,Prignac,285,6,291
54,Poitou-Charentes,17,3,44,291,Puilboreau,5212,116,5328
54,Poitou-Charentes,17,5,38,292,Puy-du-Lac,380,8,388
54,Poitou-Charentes,17,2,37,293,Puyravault,567,10,577
54,Poitou-Charentes,17,5,38,294,Puyrolland,204,7,211
54,Poitou-Charentes,17,1,11,295,Réaux,452,12,464
54,Poitou-Charentes,17,4,09,296,Rétaud,957,25,982
54,Poitou-Charentes,17,4,09,298,Rioux,906,16,922
54,Poitou-Charentes,17,3,30,297,Rivedoux-Plage,2285,43,2328
54,Poitou-Charentes,17,2,97,299,Rochefort,25676,779,26455
54,Poitou-Charentes,17,3,98,300,La Rochelle,75822,2602,78424
54,Poitou-Charentes,17,5,04,301,Romazières,70,0,70
54,Poitou-Charentes,17,4,32,302,Romegoux,613,16,629
54,Poitou-Charentes,17,3,07,303,La Ronde,941,16,957
54,Poitou-Charentes,17,4,20,304,Rouffiac,442,4,446
54,Poitou-Charentes,17,1,17,305,Rouffignac,440,8,448
54,Poitou-Charentes,17,2,96,306,Royan,18541,708,19249
54,Poitou-Charentes,17,4,36,307,Sablonceaux,1195,27,1222
54,Poitou-Charentes,17,2,26,308,Saint-Agnant,2373,94,2467
54,Poitou-Charentes,17,1,18,309,Saint-Aigulin,1930,33,1963
54,Poitou-Charentes,17,4,09,310,Saint-André-de-Lidon,906,16,922
54,Poitou-Charentes,17,2,40,311,Saint-Augustin,1184,26,1210
54,Poitou-Charentes,17,1,16,312,Saint-Bonnet-sur-Gironde,859,17,876
54,Poitou-Charentes,17,4,05,313,Saint-Bris-des-Bois,405,15,420
54,Poitou-Charentes,17,4,05,314,Saint-Césaire,918,11,929
54,Poitou-Charentes,17,3,10,315,Saint-Christophe,1163,13,1176
54,Poitou-Charentes,17,1,02,316,Saint-Ciers-Champagne,381,8,389
54,Poitou-Charentes,17,1,16,317,Saint-Ciers-du-Taillon,507,5,512
54,Poitou-Charentes,17,3,03,318,Saint-Clément-des-Baleines,723,13,736
54,Poitou-Charentes,17,2,39,320,Saint-Coutant-le-Grand,336,6,342
54,Poitou-Charentes,17,5,38,321,Saint-Crépin,252,6,258
54,Poitou-Charentes,17,3,07,322,Saint-Cyr-du-Doret,566,9,575
54,Poitou-Charentes,17,2,31,323,Saint-Denis-d'Oléron,1283,37,1320
54,Poitou-Charentes,17,5,29,277,Saint-Denis-du-Pin,726,64,790
54,Poitou-Charentes,17,1,16,324,Saint-Dizant-du-Bois,107,1,108
54,Poitou-Charentes,17,1,27,325,Saint-Dizant-du-Gua,532,13,545
54,Poitou-Charentes,17,1,02,326,Saint-Eugène,319,3,322
54,Poitou-Charentes,17,5,12,327,Saint-Félix,300,1,301
54,Poitou-Charentes,17,1,27,328,Saint-Fort-sur-Gironde,885,17,902
54,Poitou-Charentes,17,2,26,329,Saint-Froult,300,3,303
54,Poitou-Charentes,17,1,27,331,Saint-Genis-de-Saintonge,1243,59,1302
54,Poitou-Charentes,17,1,27,332,Saint-Georges-Antignac,407,11,418
54,Poitou-Charentes,17,2,31,337,Saint-Georges-d'Oléron,3504,65,3569
54,Poitou-Charentes,17,2,25,333,Saint-Georges-de-Didonne,5039,97,5136
54,Poitou-Charentes,17,5,04,334,Saint-Georges-de-Longuepierre,223,5,228
54,Poitou-Charentes,17,1,16,335,Saint-Georges-des-Agoûts,258,4,262
54,Poitou-Charentes,17,4,35,336,Saint-Georges-des-Coteaux,2501,77,2578
54,Poitou-Charentes,17,2,37,338,Saint-Georges-du-Bois,1725,35,1760
54,Poitou-Charentes,17,1,11,339,Saint-Germain-de-Lusignan,1219,120,1339
54,Poitou-Charentes,17,2,37,340,Saint-Germain-de-Marencennes,1160,70,1230
54,Poitou-Charentes,17,1,02,341,Saint-Germain-de-Vibrac,201,1,202
54,Poitou-Charentes,17,1,27,342,Saint-Germain-du-Seudre,363,3,366
54,Poitou-Charentes,17,1,27,343,Saint-Grégoire-d'Ardennes,131,0,131
54,Poitou-Charentes,17,5,28,344,Saint-Hilaire-de-Villefranche,1165,27,1192
54,Poitou-Charentes,17,1,16,345,Saint-Hilaire-du-Bois,286,7,293
54,Poitou-Charentes,17,2,39,346,Saint-Hippolyte,1244,87,1331
54,Poitou-Charentes,17,5,29,347,Saint-Jean-d'Angély,7522,579,8101
54,Poitou-Charentes,17,2,26,348,Saint-Jean-d'Angle,546,5,551
54,Poitou-Charentes,17,3,07,349,Saint-Jean-de-Liversay,2295,34,2329
54,Poitou-Charentes,17,5,29,350,Saint-Julien-de-l'Escap,893,25,918
54,Poitou-Charentes,17,2,14,351,Saint-Just-Luzac,1805,51,1856
54,Poitou-Charentes,17,5,38,352,Saint-Laurent-de-la-Barrière,93,3,96
54,Poitou-Charentes,17,2,21,353,Saint-Laurent-de-la-Prée,1771,27,1798
54,Poitou-Charentes,17,4,20,354,Saint-Léger,571,14,585
54,Poitou-Charentes,17,5,38,356,Saint-Loup,274,4,278
54,Poitou-Charentes,17,1,02,357,Saint-Maigrin,550,13,563
54,Poitou-Charentes,17,5,04,358,Saint-Mandé-sur-Brédoire,315,8,323
54,Poitou-Charentes,17,2,37,359,Saint-Mard,1001,28,1029
54,Poitou-Charentes,17,5,12,361,Saint-Martial,122,3,125
54,Poitou-Charentes,17,1,16,362,Saint-Martial-de-Mirambeau,229,5,234
54,Poitou-Charentes,17,1,11,363,Saint-Martial-de-Vitaterne,471,11,482
54,Poitou-Charentes,17,1,02,364,Saint-Martial-sur-Né,375,8,383
54,Poitou-Charentes,17,1,18,365,Saint-Martin-d'Ary,504,14,518
54,Poitou-Charentes,17,1,18,366,Saint-Martin-de-Coux,406,5,411
54,Poitou-Charentes,17,5,04,367,Saint-Martin-de-Juillers,162,2,164
54,Poitou-Charentes,17,3,30,369,Saint-Martin-de-Ré,2585,32,2617
54,Poitou-Charentes,17,1,11,371,Saint-Maurice-de-Tavernole,135,4,139
54,Poitou-Charentes,17,1,11,372,Saint-Médard,96,2,98
54,Poitou-Charentes,17,3,10,373,Saint-Médard-d'Aunis,1667,27,1694
54,Poitou-Charentes,17,2,26,375,Saint-Nazaire-sur-Charente,1102,18,1120
54,Poitou-Charentes,17,5,15,377,Saint-Ouen,134,1,135
54,Poitou-Charentes,17,3,13,376,Saint-Ouen-d'Aunis,1200,40,1240
54,Poitou-Charentes,17,1,19,378,Saint-Palais-de-Négrignac,384,5,389
54,Poitou-Charentes,17,1,27,379,Saint-Palais-de-Phiolin,247,5,252
54,Poitou-Charentes,17,2,43,380,Saint-Palais-sur-Mer,3890,120,4010
54,Poitou-Charentes,17,5,29,381,Saint-Pardoult,211,7,218
54,Poitou-Charentes,17,2,37,382,Saint-Pierre-d'Amilly,440,9,449
54,Poitou-Charentes,17,2,31,385,Saint-Pierre-d'Oléron,6377,144,6521
54,Poitou-Charentes,17,5,04,383,Saint-Pierre-de-Juillers,366,10,376
54,Poitou-Charentes,17,5,12,384,Saint-Pierre-de-l'Île,258,2,260
54,Poitou-Charentes,17,1,18,386,Saint-Pierre-du-Palais,336,18,354
54,Poitou-Charentes,17,4,32,387,Saint-Porchaire,1602,34,1636
54,Poitou-Charentes,17,4,09,388,Saint-Quantin-de-Rançanne,262,7,269
54,Poitou-Charentes,17,3,10,391,Saint-Rogatien,1841,50,1891
54,Poitou-Charentes,17,4,36,393,Saint-Romain-de-Benet,1622,24,1646
54,Poitou-Charentes,17,4,08,392,Saint-Romain-sur-Gironde,50,0,50
54,Poitou-Charentes,17,2,37,394,Saint-Saturnin-du-Bois,857,18,875
54,Poitou-Charentes,17,4,05,395,Saint-Sauvant,517,10,527
54,Poitou-Charentes,17,3,07,396,Saint-Sauveur-d'Aunis,1453,29,1482
54,Poitou-Charentes,17,5,33,397,Saint-Savinien,2394,149,2543
54,Poitou-Charentes,17,4,20,398,Saint-Seurin-de-Palenne,153,2,155
54,Poitou-Charentes,17,4,20,400,Saint-Sever-de-Saintonge,612,18,630
54,Poitou-Charentes,17,5,12,401,Saint-Séverin-sur-Boutonne,124,5,129
54,Poitou-Charentes,17,1,27,402,Saint-Sigismond-de-Clermont,163,7,170
54,Poitou-Charentes,17,1,11,403,Saint-Simon-de-Bordes,669,12,681
54,Poitou-Charentes,17,4,09,404,Saint-Simon-de-Pellouaille,509,11,520
54,Poitou-Charentes,17,1,16,405,Saint-Sorlin-de-Conac,212,2,214
54,Poitou-Charentes,17,2,14,406,Saint-Sornin,301,12,313
54,Poitou-Charentes,17,4,32,408,Saint-Sulpice-d'Arnoult,637,18,655
54,Poitou-Charentes,17,2,43,409,Saint-Sulpice-de-Royan,2728,59,2787
54,Poitou-Charentes,17,1,16,410,Saint-Thomas-de-Conac,552,7,559
54,Poitou-Charentes,17,2,06,411,Saint-Trojan-les-Bains,1477,45,1522
54,Poitou-Charentes,17,4,34,412,Saint-Vaize,567,19,586
54,Poitou-Charentes,17,3,10,413,Saint-Vivien,952,12,964
54,Poitou-Charentes,17,3,44,414,Saint-Xandre,4567,141,4708
54,Poitou-Charentes,17,1,19,319,Sainte-Colombe,120,3,123
54,Poitou-Charentes,17,4,32,330,Sainte-Gemme,1273,25,1298
54,Poitou-Charentes,17,1,02,355,Sainte-Lheurine,461,8,469
54,Poitou-Charentes,17,3,30,360,Sainte-Marie-de-Ré,3112,85,3197
54,Poitou-Charentes,17,5,28,374,Sainte-Même,246,7,253
54,Poitou-Charentes,17,4,32,389,Sainte-Radegonde,465,24,489
54,Poitou-Charentes,17,1,16,390,Sainte-Ramée,129,6,135
54,Poitou-Charentes,17,3,10,407,Sainte-Soulle,3471,64,3535
54,Poitou-Charentes,17,4,99,415,Saintes,26470,1464,27934
54,Poitou-Charentes,17,5,04,416,Saleignes,66,1,67
54,Poitou-Charentes,17,1,16,417,Salignac-de-Mirambeau,152,8,160
54,Poitou-Charentes,17,4,20,418,Salignac-sur-Charente,631,10,641
54,Poitou-Charentes,17,3,10,420,Salles-sur-Mer,1968,58,2026
54,Poitou-Charentes,17,4,36,421,Saujon,6528,120,6648
54,Poitou-Charentes,17,5,04,422,Seigné,101,3,104
54,Poitou-Charentes,17,1,16,423,Semillac,66,1,67
54,Poitou-Charentes,17,1,16,424,Semoussac,270,6,276
54,Poitou-Charentes,17,4,08,425,Semussac,1923,33,1956
54,Poitou-Charentes,17,4,05,426,Le Seure,242,2,244
54,Poitou-Charentes,17,5,15,427,Siecq,208,6,214
54,Poitou-Charentes,17,5,15,428,Sonnac,528,9,537
54,Poitou-Charentes,17,2,26,429,Soubise,3032,35,3067
54,Poitou-Charentes,17,1,16,430,Soubran,382,6,388
54,Poitou-Charentes,17,4,32,431,Soulignonne,704,18,722
54,Poitou-Charentes,17,1,17,432,Souméras,333,11,344
54,Poitou-Charentes,17,1,17,433,Sousmoulins,212,7,219
54,Poitou-Charentes,17,2,37,434,Surgères,6317,203,6520
54,Poitou-Charentes,17,5,33,435,Taillant,157,5,162
54,Poitou-Charentes,17,5,33,436,Taillebourg,732,17,749
54,Poitou-Charentes,17,4,08,437,Talmont-sur-Gironde,79,0,79
54,Poitou-Charentes,17,4,09,438,Tanzac,281,4,285
54,Poitou-Charentes,17,3,07,439,Taugon,744,14,758
54,Poitou-Charentes,17,5,29,440,Ternant,315,25,340
54,Poitou-Charentes,17,4,09,441,Tesson,1010,14,1024
54,Poitou-Charentes,17,4,09,442,Thaims,334,10,344
54,Poitou-Charentes,17,2,01,443,Thairé,1440,22,1462
54,Poitou-Charentes,17,4,35,444,Thénac,1609,233,1842
54,Poitou-Charentes,17,4,36,445,Thézac,324,4,328
54,Poitou-Charentes,17,5,15,446,Thors,411,3,414
54,Poitou-Charentes,17,2,01,447,Le Thou,1439,18,1457
54,Poitou-Charentes,17,5,38,448,Tonnay-Boutonne,1159,19,1178
54,Poitou-Charentes,17,2,39,449,Tonnay-Charente,7792,193,7985
54,Poitou-Charentes,17,5,38,450,Torxé,238,11,249
54,Poitou-Charentes,17,5,15,451,Les Touches-de-Périgny,540,6,546
54,Poitou-Charentes,17,2,40,452,La Tremblade,4521,87,4608
54,Poitou-Charentes,17,4,32,453,Trizay,1289,19,1308
54,Poitou-Charentes,17,1,17,454,Tugéras-Saint-Maurice,356,5,361
54,Poitou-Charentes,17,4,32,455,La Vallée,677,19,696
54,Poitou-Charentes,17,2,37,457,Vandré,760,11,771
54,Poitou-Charentes,17,1,17,458,Vanzac,173,1,174
54,Poitou-Charentes,17,5,29,459,Varaize,582,18,600
54,Poitou-Charentes,17,4,35,460,Varzay,752,18,770
54,Poitou-Charentes,17,2,43,461,Vaux-sur-Mer,3793,102,3895
54,Poitou-Charentes,17,4,34,462,Vénérand,688,11,699
54,Poitou-Charentes,17,2,21,463,Vergeroux,988,17,1005
54,Poitou-Charentes,17,5,29,465,La Vergne,674,45,719
54,Poitou-Charentes,17,5,12,464,Vergné,146,5,151
54,Poitou-Charentes,17,3,10,466,Vérines,1784,36,1820
54,Poitou-Charentes,17,5,29,467,Vervant,206,5,211
54,Poitou-Charentes,17,1,11,468,Vibrac,157,2,159
54,Poitou-Charentes,17,4,09,469,Villars-en-Pons,563,9,572
54,Poitou-Charentes,17,4,05,470,Villars-les-Bois,248,2,250
54,Poitou-Charentes,17,5,04,471,La Villedieu,228,0,228
54,Poitou-Charentes,17,3,13,472,Villedoux,1137,16,1153
54,Poitou-Charentes,17,5,04,473,Villemorin,111,3,114
54,Poitou-Charentes,17,5,12,474,Villeneuve-la-Comtesse,697,16,713
54,Poitou-Charentes,17,1,11,476,Villexavier,308,7,315
54,Poitou-Charentes,17,5,04,477,Villiers-Couture,152,1,153
54,Poitou-Charentes,17,5,04,478,Vinax,65,0,65
54,Poitou-Charentes,17,4,09,479,Virollet,261,0,261
54,Poitou-Charentes,17,2,01,480,Virson,676,9,685
54,Poitou-Charentes,17,5,29,481,Voissay,155,4,159
54,Poitou-Charentes,17,2,37,482,Vouhé,593,17,610
54,Poitou-Charentes,17,2,21,483,Yves,1412,26,1438
24,Centre,18,1,15,001,Achères,350,11,361
24,Centre,18,2,27,002,Ainay-le-Vieil,212,7,219
24,Centre,18,1,01,003,Les Aix-d'Angillon,1923,38,1961
24,Centre,18,1,23,004,Allogny,997,21,1018
24,Centre,18,3,20,005,Allouis,927,22,949
24,Centre,18,1,17,006,Annoix,228,6,234
24,Centre,18,2,14,007,Apremont-sur-Allier,76,1,77
24,Centre,18,2,27,009,Arcomps,294,7,301
24,Centre,18,2,11,010,Ardenais,201,3,204
24,Centre,18,3,02,011,Argent-sur-Sauldre,2224,50,2274
24,Centre,18,1,24,012,Argenvières,458,9,467
24,Centre,18,2,07,013,Arpheuilles,341,13,354
24,Centre,18,1,17,008,Arçay,495,10,505
24,Centre,18,1,28,014,Assigny,154,7,161
24,Centre,18,3,03,015,Aubigny-sur-Nère,5851,171,6022
24,Centre,18,1,01,016,Aubinges,366,11,377
24,Centre,18,2,26,017,Augy-sur-Aubois,302,9,311
24,Centre,18,1,04,018,Avord,2628,37,2665
24,Centre,18,1,01,019,Azy,473,10,483
24,Centre,18,1,25,020,Bannay,771,19,790
24,Centre,18,2,07,021,Bannegon,270,5,275
24,Centre,18,1,28,022,Barlieu,406,10,416
24,Centre,18,1,04,023,Baugy,1321,30,1351
24,Centre,18,2,09,024,Beddes,96,0,96
24,Centre,18,1,24,025,Beffes,698,17,715
24,Centre,18,1,16,026,Belleville-sur-Loire,1034,32,1066
24,Centre,18,1,04,027,Bengy-sur-Craon,668,65,733
24,Centre,18,3,20,028,Berry-Bouy,1134,31,1165
24,Centre,18,2,07,029,Bessais-le-Fromental,313,4,317
24,Centre,18,3,02,030,Blancafort,1131,41,1172
24,Centre,18,2,21,031,Blet,647,21,668
24,Centre,18,1,16,032,Boulleret,1379,44,1423
24,Centre,18,1,98,033,Bourges,68980,2042,71022
24,Centre,18,2,22,034,Bouzais,271,11,282
24,Centre,18,1,01,035,Brécy,794,28,822
24,Centre,18,3,19,036,Brinay,503,21,524
24,Centre,18,3,02,037,Brinon-sur-Sauldre,1044,13,1057
24,Centre,18,2,22,038,Bruère-Allichamps,609,13,622
24,Centre,18,1,25,039,Bué,348,14,362
24,Centre,18,2,12,040,Bussy,367,3,370
24,Centre,18,2,27,041,La Celette,196,1,197
24,Centre,18,2,22,042,La Celle,361,12,373
24,Centre,18,2,18,043,La Celle-Condé,203,5,208
24,Centre,18,3,19,044,Cerbois,435,8,443
24,Centre,18,2,12,045,Chalivoy-Milon,424,27,451
24,Centre,18,2,10,046,Chambon,148,1,149
24,Centre,18,3,06,047,La Chapelle-d'Angillon,665,13,678
24,Centre,18,2,14,048,La Chapelle-Hugon,384,9,393
24,Centre,18,1,24,049,La Chapelle-Montlinard,493,16,509
24,Centre,18,1,35,050,La Chapelle-Saint-Ursin,3209,88,3297
24,Centre,18,1,15,051,La Chapelotte,183,1,184
24,Centre,18,2,07,052,Charenton-du-Cher,1119,28,1147
24,Centre,18,1,24,053,Charentonnay,326,2,328
24,Centre,18,2,21,054,Charly,226,7,233
24,Centre,18,1,08,055,Chârost,995,7,1002
24,Centre,18,1,04,056,Chassy,257,3,260
24,Centre,18,2,09,057,Châteaumeillant,2082,57,2139
24,Centre,18,2,10,058,Châteauneuf-sur-Cher,1537,40,1577
24,Centre,18,2,11,059,Le Châtelet,1140,45,1185
24,Centre,18,2,26,060,Chaumont,48,1,49
24,Centre,18,1,24,061,Chaumoux-Marcilly,102,7,109
24,Centre,18,2,14,062,Le Chautay,268,10,278
24,Centre,18,2,10,063,Chavannes,162,4,166
24,Centre,18,3,19,064,Chéry,219,6,225
24,Centre,18,2,18,065,Chezal-Benoît,866,32,898
24,Centre,18,1,08,066,Civray,994,21,1015
24,Centre,18,3,02,067,Clémont,683,9,692
24,Centre,18,2,12,068,Cogny,38,0,38
24,Centre,18,2,22,069,Colombiers,397,14,411
24,Centre,18,1,28,070,Concressault,227,7,234
24,Centre,18,2,12,071,Contres,31,0,31
24,Centre,18,2,21,072,Cornusse,279,8,287
24,Centre,18,2,10,073,Corquoy,238,3,241
24,Centre,18,1,25,074,Couargues,210,5,215
24,Centre,18,2,14,075,Cours-les-Barres,1099,20,1119
24,Centre,18,2,07,076,Coust,465,10,475
24,Centre,18,1,24,077,Couy,374,11,385
24,Centre,18,1,25,079,Crézancy-en-Sancerre,497,16,513
24,Centre,18,2,10,078,Crézançay-sur-Cher,65,0,65
24,Centre,18,2,21,080,Croisy,142,7,149
24,Centre,18,1,04,081,Crosses,317,10,327
24,Centre,18,2,14,082,Cuffy,1115,25,1140
24,Centre,18,2,09,083,Culan,796,11,807
24,Centre,18,1,28,084,Dampierre-en-Crot,219,3,222
24,Centre,18,3,13,085,Dampierre-en-Graçay,230,1,231
24,Centre,18,2,22,086,Drevant,589,16,605
24,Centre,18,2,12,087,Dun-sur-Auron,3942,86,4028
24,Centre,18,3,06,088,Ennordres,220,11,231
24,Centre,18,2,27,089,Épineuil-le-Fleuriel,456,9,465
24,Centre,18,1,24,090,Étréchy,425,9,434
24,Centre,18,2,22,091,Farges-Allichamps,214,0,214
24,Centre,18,1,04,092,Farges-en-Septaine,959,18,977
24,Centre,18,2,27,093,Faverdines,137,5,142
24,Centre,18,1,25,094,Feux,345,6,351
24,Centre,18,2,21,095,Flavigny,198,5,203
24,Centre,18,3,20,096,Foëcy,2071,51,2122
24,Centre,18,1,23,097,Fussy,1878,49,1927
24,Centre,18,1,25,098,Gardefort,128,4,132
24,Centre,18,1,24,099,Garigny,219,8,227
24,Centre,18,3,13,100,Genouilly,719,15,734
24,Centre,18,2,14,101,Germigny-l'Exempt,322,14,336
24,Centre,18,2,26,102,Givardon,320,5,325
24,Centre,18,3,13,103,Graçay,1557,28,1585
24,Centre,18,1,24,104,Groises,141,3,144
24,Centre,18,1,04,105,Gron,455,9,464
24,Centre,18,2,26,106,Grossouvre,296,4,300
24,Centre,18,2,22,107,La Groutte,122,5,127
24,Centre,18,2,14,108,La Guerche-sur-l'Aubois,3403,51,3454
24,Centre,18,1,15,109,Henrichemont,1800,57,1857
24,Centre,18,1,24,110,Herry,1075,22,1097
24,Centre,18,1,15,111,Humbligny,180,0,180
24,Centre,18,2,11,112,Ids-Saint-Roch,310,15,325
24,Centre,18,2,21,113,Ignol,155,7,162
24,Centre,18,2,18,114,Ineuil,242,12,254
24,Centre,18,3,06,115,Ivoy-le-Pré,873,19,892
24,Centre,18,1,25,116,Jalognes,296,17,313
24,Centre,18,1,28,117,Jars,486,18,504
24,Centre,18,2,14,118,Jouet-sur-l'Aubois,1506,25,1531
24,Centre,18,1,04,119,Jussy-Champagne,225,3,228
24,Centre,18,1,24,120,Jussy-le-Chaudrier,617,10,627
24,Centre,18,2,12,121,Lantan,106,3,109
24,Centre,18,1,17,122,Lapan,152,3,155
24,Centre,18,1,04,123,Laverdines,52,2,54
24,Centre,18,3,19,124,Lazenay,355,4,359
24,Centre,18,1,16,125,Léré,1217,32,1249
24,Centre,18,1,17,126,Levet,1335,29,1364
24,Centre,18,2,18,127,Lignières,1518,76,1594
24,Centre,18,3,19,128,Limeux,149,2,151
24,Centre,18,1,17,129,Lissay-Lochy,201,6,207
24,Centre,18,2,27,130,Loye-sur-Arnon,309,7,316
24,Centre,18,2,21,131,Lugny-Bourbonnais,33,6,39
24,Centre,18,1,24,132,Lugny-Champagne,181,3,184
24,Centre,18,1,08,133,Lunery,1469,44,1513
24,Centre,18,3,19,134,Lury-sur-Arnon,681,9,690
24,Centre,18,2,11,135,Maisonnais,213,4,217
24,Centre,18,1,08,137,Mareuil-sur-Arnon,579,15,594
24,Centre,18,1,35,138,Marmagne,2003,64,2067
24,Centre,18,1,24,139,Marseilles-lès-Aubigny,687,10,697
24,Centre,18,2,22,136,Marçais,307,12,319
24,Centre,18,3,30,140,Massay,1418,25,1443
24,Centre,18,3,20,141,Mehun-sur-Yèvre,6825,167,6992
24,Centre,18,2,22,142,Meillant,781,34,815
24,Centre,18,2,21,143,Menetou-Couture,342,3,345
24,Centre,18,1,25,144,Menetou-Râtel,488,8,496
24,Centre,18,1,23,145,Menetou-Salon,1667,38,1705
24,Centre,18,1,25,146,Ménétréol-sous-Sancerre,378,13,391
24,Centre,18,3,03,147,Ménétréol-sur-Sauldre,252,2,254
24,Centre,18,3,19,148,Méreau,2278,60,2338
24,Centre,18,3,06,149,Méry-ès-Bois,614,14,628
24,Centre,18,3,30,150,Méry-sur-Cher,686,22,708
24,Centre,18,1,15,151,Montigny,354,5,359
24,Centre,18,2,18,152,Montlouis,116,2,118
24,Centre,18,2,11,153,Morlac,342,3,345
24,Centre,18,2,21,154,Mornay-Berry,206,3,209
24,Centre,18,2,26,155,Mornay-sur-Allier,456,21,477
24,Centre,18,1,01,156,Morogues,465,10,475
24,Centre,18,1,08,157,Morthomiers,676,15,691
24,Centre,18,1,04,158,Moulins-sur-Yèvre,601,10,611
24,Centre,18,3,30,159,Nançay,870,44,914
24,Centre,18,2,21,160,Nérondes,1486,33,1519
24,Centre,18,2,26,161,Neuilly-en-Dun,304,2,306
24,Centre,18,1,15,162,Neuilly-en-Sancerre,234,4,238
24,Centre,18,1,15,163,Neuvy-Deux-Clochers,306,5,311
24,Centre,18,2,26,164,Neuvy-le-Barrois,160,0,160
24,Centre,18,3,30,165,Neuvy-sur-Barangeon,1250,55,1305
24,Centre,18,1,04,166,Nohant-en-Goût,552,12,564
24,Centre,18,3,13,167,Nohant-en-Graçay,317,6,323
24,Centre,18,1,28,168,Le Noyer,275,4,279
24,Centre,18,2,22,169,Nozières,230,5,235
24,Centre,18,3,03,170,Oizon,722,30,752
24,Centre,18,2,22,171,Orcenais,285,1,286
24,Centre,18,2,22,172,Orval,1933,50,1983
24,Centre,18,2,12,173,Osmery,266,8,274
24,Centre,18,1,04,174,Osmoy,174,11,185
24,Centre,18,2,21,175,Ourouer-les-Bourdelins,652,16,668
24,Centre,18,1,01,176,Parassy,412,12,424
24,Centre,18,2,12,177,Parnay,58,0,58
24,Centre,18,2,27,178,La Perche,254,4,258
24,Centre,18,1,23,179,Pigny,740,28,768
24,Centre,18,1,17,180,Plaimpied-Givaudins,1684,57,1741
24,Centre,18,1,08,181,Plou,459,16,475
24,Centre,18,1,08,182,Poisieux,209,3,212
24,Centre,18,2,07,183,Le Pondy,122,1,123
24,Centre,18,1,24,184,Précy,336,8,344
24,Centre,18,3,06,185,Presly,253,6,259
24,Centre,18,3,19,186,Preuilly,472,11,483
24,Centre,18,2,09,187,Préveranges,582,20,602
24,Centre,18,1,08,188,Primelles,256,8,264
24,Centre,18,1,23,189,Quantilly,430,12,442
24,Centre,18,3,19,190,Quincy,833,30,863
24,Centre,18,2,12,191,Raymond,205,4,209
24,Centre,18,2,09,192,Reigny,264,11,275
24,Centre,18,2,11,193,Rezay,231,8,239
24,Centre,18,1,01,194,Rians,1051,27,1078
24,Centre,18,2,26,195,Sagonne,230,2,232
24,Centre,18,2,26,196,Saint-Aignan-des-Noyers,99,1,100
24,Centre,18,2,22,197,Saint-Amand-Montrond,11376,453,11829
24,Centre,18,1,08,198,Saint-Ambroix,395,6,401
24,Centre,18,2,18,199,Saint-Baudel,296,5,301
24,Centre,18,1,25,200,Saint-Bouize,319,3,322
24,Centre,18,1,17,201,Saint-Caprais,616,10,626
24,Centre,18,1,01,202,Saint-Céols,18,0,18
24,Centre,18,2,09,203,Saint-Christophe-le-Chaudry,112,1,113
24,Centre,18,2,12,204,Saint-Denis-de-Palin,335,12,347
24,Centre,18,1,35,205,Saint-Doulchard,9051,320,9371
24,Centre,18,1,23,206,Saint-Éloy-de-Gy,1530,47,1577
24,Centre,18,1,08,207,Saint-Florent-sur-Cher,6692,182,6874
24,Centre,18,2,27,209,Saint-Georges-de-Poisieux,395,7,402
24,Centre,18,3,13,210,Saint-Georges-sur-la-Prée,641,9,650
24,Centre,18,1,23,211,Saint-Georges-sur-Moulon,734,17,751
24,Centre,18,2,12,212,Saint-Germain-des-Bois,576,9,585
24,Centre,18,1,01,213,Saint-Germain-du-Puy,4806,107,4913
24,Centre,18,3,30,214,Saint-Hilaire-de-Court,713,20,733
24,Centre,18,2,21,215,Saint-Hilaire-de-Gondilly,193,7,200
24,Centre,18,2,18,216,Saint-Hilaire-en-Lignières,511,12,523
24,Centre,18,2,09,217,Saint-Jeanvrin,160,10,170
24,Centre,18,1,17,218,Saint-Just,591,13,604
24,Centre,18,3,30,219,Saint-Laurent,398,5,403
24,Centre,18,1,24,220,Saint-Léger-le-Petit,397,4,401
24,Centre,18,2,10,221,Saint-Loup-des-Chaumes,290,9,299
24,Centre,18,1,23,223,Saint-Martin-d'Auxigny,2104,58,2162
24,Centre,18,1,24,224,Saint-Martin-des-Champs,345,14,359
24,Centre,18,2,09,225,Saint-Maur,274,6,280
24,Centre,18,1,01,226,Saint-Michel-de-Volangis,453,12,465
24,Centre,18,3,13,228,Saint-Outrille,216,8,224
24,Centre,18,1,23,229,Saint-Palais,626,17,643
24,Centre,18,2,11,230,Saint-Pierre-les-Bois,318,8,326
24,Centre,18,2,07,231,Saint-Pierre-les-Étieux,733,22,755
24,Centre,18,2,09,232,Saint-Priest-la-Marche,236,8,244
24,Centre,18,1,25,233,Saint-Satur,1659,39,1698
24,Centre,18,2,09,234,Saint-Saturnin,424,17,441
24,Centre,18,2,10,236,Saint-Symphorien,125,4,129
24,Centre,18,2,27,238,Saint-Vitte,138,3,141
24,Centre,18,1,16,208,Sainte-Gemme-en-Sancerrois,393,10,403
24,Centre,18,1,17,222,Sainte-Lunaise,23,8,31
24,Centre,18,3,03,227,Sainte-Montaine,212,2,214
24,Centre,18,1,01,235,Sainte-Solange,1195,33,1228
24,Centre,18,3,20,237,Sainte-Thorette,483,12,495
24,Centre,18,1,04,239,Saligny-le-Vif,160,3,163
24,Centre,18,1,24,240,Sancergues,701,21,722
24,Centre,18,1,25,241,Sancerre,1697,49,1746
24,Centre,18,2,26,242,Sancoins,3250,73,3323
24,Centre,18,1,16,243,Santranges,432,4,436
24,Centre,18,1,08,244,Saugy,64,1,65
24,Centre,18,2,27,245,Saulzais-le-Potier,536,10,546
24,Centre,18,1,16,246,Savigny-en-Sancerre,1080,23,1103
24,Centre,18,1,04,247,Savigny-en-Septaine,672,25,697
24,Centre,18,1,17,248,Senneçay,435,17,452
24,Centre,18,1,25,249,Sens-Beaujeu,426,7,433
24,Centre,18,2,10,250,Serruelles,53,0,53
24,Centre,18,1,24,251,Sévry,73,1,74
24,Centre,18,2,09,252,Sidiailles,304,3,307
24,Centre,18,1,01,253,Soulangis,439,12,451
24,Centre,18,1,17,254,Soye-en-Septaine,556,15,571
24,Centre,18,1,08,255,Le Subdray,860,16,876
24,Centre,18,1,28,256,Subligny,355,8,363
24,Centre,18,1,25,258,Sury-en-Vaux,728,15,743
24,Centre,18,1,28,259,Sury-ès-Bois,290,3,293
24,Centre,18,1,16,257,Sury-près-Léré,556,18,574
24,Centre,18,2,21,260,Tendron,121,4,125
24,Centre,18,2,07,261,Thaumiers,416,11,427
24,Centre,18,1,25,262,Thauvenay,347,15,362
24,Centre,18,3,30,263,Thénioux,614,16,630
24,Centre,18,1,28,264,Thou,78,2,80
24,Centre,18,2,14,265,Torteron,809,14,823
24,Centre,18,2,18,266,Touchay,287,11,298
24,Centre,18,1,17,267,Trouy,3836,120,3956
24,Centre,18,2,10,268,Uzay-le-Venon,403,14,417
24,Centre,18,1,28,269,Vailly-sur-Sauldre,818,56,874
24,Centre,18,2,10,270,Vallenay,697,9,706
24,Centre,18,1,23,271,Vasselay,1156,49,1205
24,Centre,18,1,25,272,Veaugues,653,10,663
24,Centre,18,2,10,273,Venesmes,882,24,906
24,Centre,18,1,25,274,Verdigny,281,14,295
24,Centre,18,2,26,275,Vereaux,173,3,176
24,Centre,18,2,07,276,Vernais,213,2,215
24,Centre,18,2,12,277,Verneuil,44,2,46
24,Centre,18,2,27,278,Vesdun,633,11,644
24,Centre,18,3,99,279,Vierzon,27495,691,28186
24,Centre,18,1,23,280,Vignoux-sous-les-Aix,713,23,736
24,Centre,18,3,30,281,Vignoux-sur-Barangeon,2062,56,2118
24,Centre,18,1,04,282,Villabon,554,9,563
24,Centre,18,2,18,283,Villecelin,109,0,109
24,Centre,18,1,28,284,Villegenon,229,6,235
24,Centre,18,1,08,285,Villeneuve-sur-Cher,422,5,427
24,Centre,18,1,04,286,Villequiers,520,3,523
24,Centre,18,1,25,287,Vinon,265,3,268
24,Centre,18,1,17,288,Vorly,245,4,249
24,Centre,18,1,04,289,Vornay,529,13,542
24,Centre,18,3,30,290,Vouzeron,561,11,572
74,Limousin,19,2,24,001,Affieux,369,10,379
74,Limousin,19,3,11,002,Aix,387,13,400
74,Limousin,19,1,04,003,Albignac,253,5,258
74,Limousin,19,2,01,004,Albussac,693,18,711
74,Limousin,19,1,09,005,Allassac,3715,108,3823
74,Limousin,19,3,17,006,Alleyrat,103,5,108
74,Limousin,19,2,16,007,Altillac,843,26,869
74,Limousin,19,3,17,008,Ambrugeat,207,11,218
74,Limousin,19,2,36,009,Les Angles-sur-Corrèze,101,6,107
74,Limousin,19,2,01,010,Argentat,3079,224,3303
74,Limousin,19,1,15,011,Arnac-Pompadour,1245,16,1261
74,Limousin,19,1,03,012,Astaillac,220,10,230
74,Limousin,19,1,04,013,Aubazines,829,13,842
74,Limousin,19,2,21,014,Auriac,219,3,222
74,Limousin,19,1,02,015,Ayen,701,21,722
74,Limousin,19,2,08,016,Bar,323,12,335
74,Limousin,19,2,16,017,Bassignac-le-Bas,93,3,96
74,Limousin,19,2,21,018,Bassignac-le-Haut,191,5,196
74,Limousin,19,1,03,019,Beaulieu-sur-Dordogne,1296,37,1333
74,Limousin,19,2,22,020,Beaumont,117,4,121
74,Limousin,19,3,23,021,Bellechassagne,73,2,75
74,Limousin,19,1,15,022,Benayes,270,8,278
74,Limousin,19,1,04,023,Beynat,1233,22,1255
74,Limousin,19,1,15,024,Beyssac,730,17,747
74,Limousin,19,1,15,025,Beyssenac,363,4,367
74,Limousin,19,1,03,026,Bilhac,220,7,227
74,Limousin,19,3,07,027,Bonnefond,124,7,131
74,Limousin,19,3,05,028,Bort-les-Orgues,3194,123,3317
74,Limousin,19,1,18,029,Branceilles,251,3,254
74,Limousin,19,1,02,030,Brignac-la-Plaine,817,27,844
74,Limousin,19,1,98,031,Brive-la-Gaillarde,49675,1404,51079
74,Limousin,19,1,03,032,Brivezac,188,2,190
74,Limousin,19,3,07,033,Bugeat,907,25,932
74,Limousin,19,2,16,034,Camps-Saint-Mathurin-Léobazel,248,7,255
74,Limousin,19,1,12,035,Chabrignac,520,9,529
74,Limousin,19,2,24,036,Chamberet,1316,30,1346
74,Limousin,19,2,22,037,Chamboulive,1259,20,1279
74,Limousin,19,2,35,038,Chameyrat,1585,58,1643
74,Limousin,19,2,10,039,Champagnac-la-Noaille,222,4,226
74,Limousin,19,2,20,040,Champagnac-la-Prune,168,3,171
74,Limousin,19,2,36,041,Chanac-les-Mines,503,12,515
74,Limousin,19,2,22,042,Chanteix,565,18,583
74,Limousin,19,1,34,043,La Chapelle-aux-Brocs,380,6,386
74,Limousin,19,1,03,044,La Chapelle-aux-Saints,206,1,207
74,Limousin,19,2,16,045,La Chapelle-Saint-Géraud,221,4,225
74,Limousin,19,2,10,046,Chapelle-Spinasse,119,6,125
74,Limousin,19,1,14,047,Chartrier-Ferrière,339,3,342
74,Limousin,19,2,36,048,Le Chastang,333,10,343
74,Limousin,19,1,14,049,Chasteaux,553,14,567
74,Limousin,19,1,18,050,Chauffour-sur-Vell,375,13,388
74,Limousin,19,2,08,051,Chaumeil,161,6,167
74,Limousin,19,3,23,052,Chavanac,59,1,60
74,Limousin,19,3,37,053,Chaveroche,205,7,212
74,Limousin,19,1,03,054,Chenailler-Mascheix,166,2,168
74,Limousin,19,3,19,055,Chirac-Bellevue,261,5,266
74,Limousin,19,2,20,056,Clergoux,373,8,381
74,Limousin,19,1,18,057,Collonges-la-Rouge,460,20,480
74,Limousin,19,3,17,058,Combressol,360,9,369
74,Limousin,19,1,12,059,Concèze,411,12,423
74,Limousin,19,2,28,060,Condat-sur-Ganaveix,656,10,666
74,Limousin,19,3,05,167,Confolent-Port-Dieu,29,2,31
74,Limousin,19,2,36,061,Cornil,1395,23,1418
74,Limousin,19,2,08,062,Corrèze,1175,37,1212
74,Limousin,19,1,30,063,Cosnac,2858,91,2949
74,Limousin,19,3,11,064,Couffy-sur-Sarsonne,74,2,76
74,Limousin,19,3,11,065,Courteix,66,3,69
74,Limousin,19,1,14,066,Cublac,1670,36,1706
74,Limousin,19,1,18,067,Curemonte,213,4,217
74,Limousin,19,1,34,068,Dampniat,657,14,671
74,Limousin,19,2,21,069,Darazac,158,9,167
74,Limousin,19,3,17,070,Darnets,344,12,356
74,Limousin,19,3,17,071,Davignac,249,6,255
74,Limousin,19,1,09,072,Donzenac,2440,35,2475
74,Limousin,19,2,10,073,Égletons,4396,735,5131
74,Limousin,19,2,24,074,L' Église-aux-Bois,36,0,36
74,Limousin,19,2,20,075,Espagnac,337,5,342
74,Limousin,19,2,28,076,Espartignac,381,12,393
74,Limousin,19,1,33,077,Estivals,135,3,138
74,Limousin,19,1,29,078,Estivaux,373,6,379
74,Limousin,19,2,28,079,Eyburie,481,13,494
74,Limousin,19,3,11,080,Eygurande,701,20,721
74,Limousin,19,2,08,081,Eyrein,517,6,523
74,Limousin,19,2,35,082,Favars,952,32,984
74,Limousin,19,3,11,083,Feyt,99,3,102
74,Limousin,19,2,01,084,Forgès,315,10,325
74,Limousin,19,2,36,085,Gimel-les-Cascades,704,7,711
74,Limousin,19,2,16,086,Goulles,352,9,361
74,Limousin,19,3,07,087,Gourdon-Murat,120,4,124
74,Limousin,19,3,07,088,Grandsaigne,47,0,47
74,Limousin,19,2,20,089,Gros-Chastang,171,3,174
74,Limousin,19,2,20,090,Gumond,113,0,113
74,Limousin,19,2,21,091,Hautefage,308,10,318
74,Limousin,19,2,10,092,Le Jardin,77,3,80
74,Limousin,19,1,33,093,Jugeals-Nazareth,819,17,836
74,Limousin,19,1,12,094,Juillac,1182,27,1209
74,Limousin,19,2,24,095,Lacelle,138,10,148
74,Limousin,19,2,36,096,Ladignac-sur-Rondelles,442,21,463
74,Limousin,19,2,13,097,Lafage-sur-Sombre,119,5,124
74,Limousin,19,2,36,098,Lagarde-Enval,746,20,766
74,Limousin,19,1,18,099,Lagleygeolle,233,3,236
74,Limousin,19,2,22,100,Lagraulière,1070,15,1085
74,Limousin,19,2,36,101,Laguenne,1471,56,1527
74,Limousin,19,3,19,102,Lamazière-Basse,278,16,294
74,Limousin,19,3,11,103,Lamazière-Haute,72,3,75
74,Limousin,19,2,28,104,Lamongerie,105,1,106
74,Limousin,19,1,04,105,Lanteuil,510,10,520
74,Limousin,19,2,13,106,Lapleau,393,8,401
74,Limousin,19,1,14,107,Larche,1664,39,1703
74,Limousin,19,3,11,108,Laroche-près-Feyt,79,2,81
74,Limousin,19,1,12,109,Lascaux,172,9,181
74,Limousin,19,2,13,110,Latronche,132,6,138
74,Limousin,19,2,13,111,Laval-sur-Luzège,90,1,91
74,Limousin,19,3,07,112,Lestards,110,4,114
74,Limousin,19,3,19,113,Liginiac,629,67,696
74,Limousin,19,3,37,114,Lignareix,159,9,168
74,Limousin,19,1,18,115,Ligneyrac,300,13,313
74,Limousin,19,1,03,116,Liourdres,208,5,213
74,Limousin,19,1,14,117,Lissac-sur-Couze,702,12,714
74,Limousin,19,2,24,118,Le Lonzac,796,15,811
74,Limousin,19,1,18,119,Lostanges,129,3,132
74,Limousin,19,1,02,120,Louignac,228,6,234
74,Limousin,19,1,15,121,Lubersac,2279,60,2339
74,Limousin,19,2,24,122,Madranges,187,2,189
74,Limousin,19,1,34,123,Malemort-sur-Corrèze,7315,178,7493
74,Limousin,19,1,14,124,Mansac,1374,33,1407
74,Limousin,19,2,36,127,Marc-la-Tour,163,7,170
74,Limousin,19,2,20,125,Marcillac-la-Croisille,834,16,850
74,Limousin,19,1,18,126,Marcillac-la-Croze,190,4,194
74,Limousin,19,3,05,128,Margerides,253,4,257
74,Limousin,19,2,28,129,Masseret,673,13,686
74,Limousin,19,3,17,130,Maussac,392,4,396
74,Limousin,19,2,28,131,Meilhards,525,10,535
74,Limousin,19,2,01,132,Ménoire,87,1,88
74,Limousin,19,2,16,133,Mercoeur,245,16,261
74,Limousin,19,3,11,134,Merlines,812,26,838
74,Limousin,19,3,27,135,Mestes,315,8,323
74,Limousin,19,3,17,136,Meymac,2625,170,2795
74,Limousin,19,2,08,137,Meyrignac-l'Église,51,3,54
74,Limousin,19,1,18,138,Meyssac,1236,77,1313
74,Limousin,19,3,23,139,Millevaches,91,3,94
74,Limousin,19,2,01,140,Monceaux-sur-Dordogne,679,26,705
74,Limousin,19,3,11,141,Monestier-Merlines,310,10,320
74,Limousin,19,3,05,142,Monestier-Port-Dieu,125,1,126
74,Limousin,19,2,10,143,Montaignac-Saint-Hippolyte,547,18,565
74,Limousin,19,1,15,144,Montgibaud,231,5,236
74,Limousin,19,2,10,145,Moustier-Ventadour,471,39,510
74,Limousin,19,2,35,146,Naves,2274,221,2495
74,Limousin,19,1,33,147,Nespouls,610,17,627
74,Limousin,19,3,19,148,Neuvic,1872,286,2158
74,Limousin,19,2,01,149,Neuville,194,6,200
74,Limousin,19,1,18,150,Noailhac,339,9,348
74,Limousin,19,1,33,151,Noailles,810,27,837
74,Limousin,19,1,03,152,Nonards,422,11,433
74,Limousin,19,1,02,153,Objat,3615,95,3710
74,Limousin,19,1,29,154,Orgnac-sur-Vézère,303,7,310
74,Limousin,19,2,08,155,Orliac-de-Bar,264,5,269
74,Limousin,19,1,04,156,Palazinges,112,0,112
74,Limousin,19,3,19,157,Palisse,231,5,236
74,Limousin,19,2,36,158,Pandrignes,172,8,180
74,Limousin,19,3,17,159,Péret-Bel-Air,103,3,106
74,Limousin,19,3,07,160,Pérols-sur-Vézère,185,4,189
74,Limousin,19,1,02,161,Perpezac-le-Blanc,455,8,463
74,Limousin,19,1,29,162,Perpezac-le-Noir,1038,17,1055
74,Limousin,19,1,04,163,Le Pescher,277,5,282
74,Limousin,19,3,23,164,Peyrelevade,825,22,847
74,Limousin,19,2,24,165,Peyrissac,135,2,137
74,Limousin,19,2,22,166,Pierrefitte,79,1,80
74,Limousin,19,3,07,168,Pradines,104,3,107
74,Limousin,19,1,03,169,Puy-d'Arnac,267,6,273
74,Limousin,19,1,03,170,Queyssac-les-Vignes,192,5,197
74,Limousin,19,2,16,171,Reygade,188,3,191
74,Limousin,19,2,24,172,Rilhac-Treignac,116,0,116
74,Limousin,19,2,21,173,Rilhac-Xaintrie,316,12,328
74,Limousin,19,2,20,174,La Roche-Canillac,174,4,178
74,Limousin,19,3,19,175,Roche-le-Peyroux,86,4,90
74,Limousin,19,2,10,176,Rosiers-d'Égletons,1089,31,1120
74,Limousin,19,1,12,177,Rosiers-de-Juillac,183,2,185
74,Limousin,19,1,09,178,Sadroc,771,15,786
74,Limousin,19,1,18,179,Saillac,178,5,183
74,Limousin,19,3,37,180,Saint-Angel,679,22,701
74,Limousin,19,2,08,181,Saint-Augustin,443,3,446
74,Limousin,19,1,02,182,Saint-Aulaire,851,20,871
74,Limousin,19,2,20,183,Saint-Bazile-de-la-Roche,158,10,168
74,Limousin,19,1,18,184,Saint-Bazile-de-Meyssac,157,2,159
74,Limousin,19,2,36,185,Saint-Bonnet-Avalouze,206,3,209
74,Limousin,19,2,01,186,Saint-Bonnet-Elvert,190,7,197
74,Limousin,19,1,29,188,Saint-Bonnet-l'Enfantier,326,4,330
74,Limousin,19,1,12,187,Saint-Bonnet-la-Rivière,348,9,357
74,Limousin,19,2,16,189,Saint-Bonnet-les-Tours-de-Merle,43,1,44
74,Limousin,19,3,05,190,Saint-Bonnet-près-Bort,182,2,184
74,Limousin,19,1,14,191,Saint-Cernin-de-Larche,576,19,595
74,Limousin,19,2,01,192,Saint-Chamant,511,14,525
74,Limousin,19,2,21,193,Saint-Cirgues-la-Loutre,196,7,203
74,Limousin,19,2,22,194,Saint-Clément,1226,25,1251
74,Limousin,19,1,02,195,Saint-Cyprien,331,6,337
74,Limousin,19,1,12,196,Saint-Cyr-la-Roche,435,14,449
74,Limousin,19,1,15,198,Saint-Éloy-les-Tuileries,121,9,130
74,Limousin,19,3,27,199,Saint-Étienne-aux-Clos,234,17,251
74,Limousin,19,3,19,200,Saint-Étienne-la-Geneste,80,2,82
74,Limousin,19,3,27,201,Saint-Exupéry-les-Roches,537,24,561
74,Limousin,19,3,27,204,Saint-Fréjoux,275,8,283
74,Limousin,19,2,21,205,Saint-Geniez-ô-Merle,107,8,115
74,Limousin,19,3,23,206,Saint-Germain-Lavolps,92,2,94
74,Limousin,19,2,35,207,Saint-Germain-les-Vergnes,952,18,970
74,Limousin,19,2,13,208,Saint-Hilaire-Foissac,212,3,215
74,Limousin,19,2,24,209,Saint-Hilaire-les-Courbes,160,8,168
74,Limousin,19,3,19,210,Saint-Hilaire-Luc,76,3,79
74,Limousin,19,2,35,211,Saint-Hilaire-Peyroux,899,11,910
74,Limousin,19,2,01,212,Saint-Hilaire-Taurieux,97,2,99
74,Limousin,19,2,22,213,Saint-Jal,647,6,653
74,Limousin,19,2,21,214,Saint-Julien-aux-Bois,481,10,491
74,Limousin,19,2,16,215,Saint-Julien-le-Pèlerin,139,1,140
74,Limousin,19,1,15,216,Saint-Julien-le-Vendômois,269,11,280
74,Limousin,19,1,18,217,Saint-Julien-Maumont,159,1,160
74,Limousin,19,3,05,218,Saint-Julien-près-Bort,422,9,431
74,Limousin,19,2,36,220,Saint-Martial-de-Gimel,488,10,498
74,Limousin,19,2,01,221,Saint-Martial-Entraygues,87,2,89
74,Limousin,19,2,20,222,Saint-Martin-la-Méanne,363,6,369
74,Limousin,19,1,15,223,Saint-Martin-Sepert,259,4,263
74,Limousin,19,2,13,225,Saint-Merd-de-Lapleau,128,0,128
74,Limousin,19,3,07,226,Saint-Merd-les-Oussines,118,5,123
74,Limousin,19,2,35,227,Saint-Mexant,1111,19,1130
74,Limousin,19,2,13,228,Saint-Pantaléon-de-Lapleau,68,5,73
74,Limousin,19,1,14,229,Saint-Pantaléon-de-Larche,4599,114,4713
74,Limousin,19,1,15,230,Saint-Pardoux-Corbier,354,4,358
74,Limousin,19,1,09,234,Saint-Pardoux-l'Ortigier,468,5,473
74,Limousin,19,2,20,231,Saint-Pardoux-la-Croisille,170,6,176
74,Limousin,19,3,11,232,Saint-Pardoux-le-Neuf,64,5,69
74,Limousin,19,3,37,233,Saint-Pardoux-le-Vieux,284,20,304
74,Limousin,19,2,20,235,Saint-Paul,226,5,231
74,Limousin,19,2,36,236,Saint-Priest-de-Gimel,467,11,478
74,Limousin,19,2,21,237,Saint-Privat,1116,16,1132
74,Limousin,19,3,23,238,Saint-Rémy,238,4,242
74,Limousin,19,1,02,239,Saint-Robert,343,9,352
74,Limousin,19,2,22,240,Saint-Salvadour,292,8,300
74,Limousin,19,3,23,241,Saint-Setiers,234,5,239
74,Limousin,19,1,12,242,Saint-Solve,395,8,403
74,Limousin,19,1,15,243,Saint-Sornin-Lavolps,924,20,944
74,Limousin,19,3,17,244,Saint-Sulpice-les-Bois,70,1,71
74,Limousin,19,2,01,245,Saint-Sylvain,145,3,148
74,Limousin,19,1,09,246,Saint-Viance,1620,56,1676
74,Limousin,19,3,05,247,Saint-Victour,179,2,181
74,Limousin,19,2,28,248,Saint-Ybard,656,9,665
74,Limousin,19,2,10,249,Saint-Yrieix-le-Déjalat,405,5,410
74,Limousin,19,1,09,202,Sainte-Féréole,1749,45,1794
74,Limousin,19,2,36,203,Sainte-Fortunade,1761,103,1864
74,Limousin,19,3,19,219,Sainte-Marie-Lapanouze,59,1,60
74,Limousin,19,2,28,250,Salon-la-Tour,703,8,711
74,Limousin,19,2,08,251,Sarran,263,8,271
74,Limousin,19,3,05,252,Sarroux,443,6,449
74,Limousin,19,1,02,253,Segonzac,237,5,242
74,Limousin,19,1,15,254,Ségur-le-Château,231,4,235
74,Limousin,19,2,22,255,Seilhac,1736,59,1795
74,Limousin,19,3,19,256,Sérandon,349,12,361
74,Limousin,19,1,04,257,Sérilhac,284,1,285
74,Limousin,19,2,21,258,Servières-le-Château,673,23,696
74,Limousin,19,2,16,259,Sexcles,224,4,228
74,Limousin,19,1,03,260,Sioniac,244,7,251
74,Limousin,19,3,23,261,Sornac,810,15,825
74,Limousin,19,2,24,262,Soudaine-Lavinadière,197,15,212
74,Limousin,19,3,17,263,Soudeilles,288,17,305
74,Limousin,19,2,13,264,Soursac,488,22,510
74,Limousin,19,3,07,265,Tarnac,322,10,332
74,Limousin,19,3,05,266,Thalamy,95,2,97
74,Limousin,19,3,07,268,Toy-Viam,31,0,31
74,Limousin,19,2,24,269,Treignac,1390,69,1459
74,Limousin,19,1,29,270,Troche,526,1,527
74,Limousin,19,1,03,271,Tudeils,249,8,257
74,Limousin,19,2,99,272,Tulle,15681,884,16565
74,Limousin,19,1,18,273,Turenne,794,22,816
74,Limousin,19,1,34,274,Ussac,3610,128,3738
74,Limousin,19,3,97,275,Ussel,10362,469,10831
74,Limousin,19,2,28,276,Uzerche,3187,74,3261
74,Limousin,19,3,27,277,Valiergues,143,2,145
74,Limousin,19,1,34,278,Varetz,2129,32,2161
74,Limousin,19,1,02,279,Vars-sur-Roseix,304,4,308
74,Limousin,19,1,03,280,Végennes,167,6,173
74,Limousin,19,2,24,281,Veix,71,0,71
74,Limousin,19,1,34,282,Venarsal,459,12,471
74,Limousin,19,3,05,283,Veyrières,56,2,58
74,Limousin,19,3,07,284,Viam,116,1,117
74,Limousin,19,1,29,285,Vigeois,1154,18,1172
74,Limousin,19,1,12,286,Vignols,576,15,591
74,Limousin,19,2,08,287,Vitrac-sur-Montane,252,5,257
74,Limousin,19,1,12,288,Voutezac,1219,142,1361
74,Limousin,19,1,02,289,Yssandon,615,18,633
94,Corse,2A,1,73,001,Afa,2718,98,2816
94,Corse,2A,1,98,004,Ajaccio,65153,730,65883
94,Corse,2A,1,73,006,Alata,2958,104,3062
94,Corse,2A,1,48,008,Albitreccia,1454,12,1466
94,Corse,2A,4,55,011,Altagène,51,3,54
94,Corse,2A,1,51,014,Ambiegna,57,1,58
94,Corse,2A,1,73,017,Appietto,1355,23,1378
94,Corse,2A,4,30,018,Arbellara,133,1,134
94,Corse,2A,1,61,019,Arbori,65,2,67
94,Corse,2A,4,34,021,Argiusta-Moriccio,86,2,88
94,Corse,2A,1,51,022,Arro,75,1,76
94,Corse,2A,4,55,024,Aullène,180,5,185
94,Corse,2A,1,48,026,Azilone-Ampaza,138,1,139
94,Corse,2A,1,51,027,Azzana,54,0,54
94,Corse,2A,1,61,028,Balogna,128,4,132
94,Corse,2A,1,02,031,Bastelica,531,7,538
94,Corse,2A,1,73,032,Bastelicaccia,3217,83,3300
94,Corse,2A,4,53,035,Belvédère-Campomoro,165,5,170
94,Corse,2A,4,53,038,Bilia,48,2,50
94,Corse,2A,1,06,040,Bocognano,482,9,491
94,Corse,2A,4,07,041,Bonifacio,2872,53,2925
94,Corse,2A,1,51,048,Calcatoggio,490,11,501
94,Corse,2A,1,48,056,Campo,77,3,80
94,Corse,2A,1,51,060,Cannelle,47,2,49
94,Corse,2A,4,22,061,Carbini,106,7,113
94,Corse,2A,1,06,062,Carbuccia,322,8,330
94,Corse,2A,1,48,064,Cardo-Torgia,41,0,41
94,Corse,2A,1,35,065,Cargèse,1159,17,1176
94,Corse,2A,4,55,066,Cargiaca,59,1,60
94,Corse,2A,1,51,070,Casaglione,360,5,365
94,Corse,2A,4,34,071,Casalabriva,180,3,183
94,Corse,2A,1,02,085,Cauro,1289,42,1331
94,Corse,2A,1,62,089,Ciamannacce,132,1,133
94,Corse,2A,1,61,090,Coggia,858,25,883
94,Corse,2A,1,48,091,Cognocoli-Monticchi,186,1,187
94,Corse,2A,4,40,092,Conca,1038,17,1055
94,Corse,2A,1,62,094,Corrano,87,1,88
94,Corse,2A,1,48,098,Coti-Chiavari,733,9,742
94,Corse,2A,1,62,099,Cozzano,259,4,263
94,Corse,2A,1,35,100,Cristinacce,61,2,63
94,Corse,2A,1,06,103,Cuttoli-Corticchiato,1861,40,1901
94,Corse,2A,1,02,104,Eccica-Suarella,918,23,941
94,Corse,2A,1,35,108,Évisa,182,7,189
94,Corse,2A,4,70,114,Figari,1157,27,1184
94,Corse,2A,4,53,115,Foce,135,6,141
94,Corse,2A,1,48,117,Forciolo,76,0,76
94,Corse,2A,4,30,118,Fozzano,193,8,201
94,Corse,2A,1,48,119,Frasseto,125,2,127
94,Corse,2A,4,53,127,Giuncheto,88,1,89
94,Corse,2A,4,53,128,Granace,57,1,58
94,Corse,2A,4,53,129,Grossa,54,1,55
94,Corse,2A,1,48,130,Grosseto-Prugna,2609,51,2660
94,Corse,2A,1,61,131,Guagno,156,4,160
94,Corse,2A,1,48,132,Guargualé,118,0,118
94,Corse,2A,1,62,133,Guitera-les-Bains,113,2,115
94,Corse,2A,4,40,139,Lecci,1178,16,1194
94,Corse,2A,1,61,141,Letia,110,4,114
94,Corse,2A,4,22,142,Levie,757,9,766
94,Corse,2A,1,51,144,Lopigna,108,0,108
94,Corse,2A,4,55,146,Loreto-di-Tallano,48,1,49
94,Corse,2A,1,35,154,Marignana,105,2,107
94,Corse,2A,4,55,158,Mela,31,0,31
94,Corse,2A,4,34,160,Moca-Croce,221,1,222
94,Corse,2A,4,70,163,Monacia-d'Aullène,478,6,484
94,Corse,2A,1,61,174,Murzo,93,1,94
94,Corse,2A,1,02,181,Ocana,523,11,534
94,Corse,2A,4,34,186,Olivese,264,2,266
94,Corse,2A,4,30,189,Olmeto,1216,23,1239
94,Corse,2A,4,55,191,Olmiccia,101,1,102
94,Corse,2A,1,61,196,Orto,58,0,58
94,Corse,2A,1,35,197,Osani,108,2,110
94,Corse,2A,1,35,198,Ota,540,13,553
94,Corse,2A,1,62,200,Palneca,157,4,161
94,Corse,2A,1,35,203,Partinello,101,4,105
94,Corse,2A,1,51,204,Pastricciola,84,2,86
94,Corse,2A,1,06,209,Peri,1635,24,1659
94,Corse,2A,4,34,211,Petreto-Bicchisano,565,9,574
94,Corse,2A,1,35,212,Piana,444,12,456
94,Corse,2A,4,70,215,Pianottoli-Caldarello,833,11,844
94,Corse,2A,1,48,228,Pietrosella,1232,27,1259
94,Corse,2A,1,48,232,Pila-Canale,283,2,285
94,Corse,2A,1,61,240,Poggiolo,93,2,95
94,Corse,2A,4,40,247,Porto-Vecchio,11057,331,11388
94,Corse,2A,4,30,249,Propriano,3254,50,3304
94,Corse,2A,1,48,253,Quasquara,58,1,59
94,Corse,2A,4,55,254,Quenza,222,9,231
94,Corse,2A,1,61,258,Renno,90,3,93
94,Corse,2A,1,51,259,Rezza,71,0,71
94,Corse,2A,1,51,262,Rosazia,61,0,61
94,Corse,2A,4,55,308,Sainte-Lucie-de-Tallano,405,10,415
94,Corse,2A,1,51,266,Salice,89,1,90
94,Corse,2A,1,62,268,Sampolo,57,0,57
94,Corse,2A,4,22,300,San-Gavino-di-Carbini,1018,21,1039
94,Corse,2A,1,51,295,Sant'Andréa-d'Orcino,74,2,76
94,Corse,2A,4,30,310,Santa-Maria-Figaniella,82,0,82
94,Corse,2A,1,48,312,Santa-Maria-Siché,396,4,400
94,Corse,2A,1,51,270,Sari-d'Orcino,307,3,310
94,Corse,2A,4,40,269,Sari-Solenzara,1227,22,1249
94,Corse,2A,1,06,271,Sarrola-Carcopino,1927,30,1957
94,Corse,2A,4,53,272,Sartène,3033,102,3135
94,Corse,2A,1,48,276,Serra-di-Ferro,438,8,446
94,Corse,2A,4,55,278,Serra-di-Scopamène,108,0,108
94,Corse,2A,1,35,279,Serriera,107,0,107
94,Corse,2A,1,61,282,Soccia,139,5,144
94,Corse,2A,4,34,284,Sollacaro,344,8,352
94,Corse,2A,4,55,285,Sorbollano,80,0,80
94,Corse,2A,4,70,288,Sotta,886,9,895
94,Corse,2A,1,62,322,Tasso,94,6,100
94,Corse,2A,1,06,323,Tavaco,270,4,274
94,Corse,2A,1,06,324,Tavera,389,7,396
94,Corse,2A,1,02,326,Tolla,126,1,127
94,Corse,2A,1,06,330,Ucciani,450,9,459
94,Corse,2A,1,48,331,Urbalacone,66,0,66
94,Corse,2A,1,06,336,Valle-di-Mezzana,303,5,308
94,Corse,2A,1,06,345,Vero,464,7,471
94,Corse,2A,1,61,348,Vico,958,30,988
94,Corse,2A,4,30,349,Viggianello,578,9,587
94,Corse,2A,1,73,351,Villanova,353,6,359
94,Corse,2A,4,55,357,Zérubia,29,4,33
94,Corse,2A,1,62,358,Zévaco,61,0,61
94,Corse,2A,1,62,359,Zicavo,246,13,259
94,Corse,2A,1,48,360,Zigliara,138,1,139
94,Corse,2A,4,22,362,Zonza,2226,45,2271
94,Corse,2A,4,55,363,Zoza,60,0,60
94,Corse,2B,3,60,002,Aghione,233,6,239
94,Corse,2B,3,54,003,Aiti,32,0,32
94,Corse,2B,3,54,005,Alando,27,1,28
94,Corse,2B,3,10,007,Albertacce,236,6,242
94,Corse,2B,3,24,009,Aléria,1957,45,2002
94,Corse,2B,5,05,010,Algajola,303,3,306
94,Corse,2B,3,54,012,Altiani,107,0,107
94,Corse,2B,3,54,013,Alzi,17,0,17
94,Corse,2B,3,24,015,Ampriani,11,1,12
94,Corse,2B,3,60,016,Antisanti,386,7,393
94,Corse,2B,5,05,020,Aregno,610,8,618
94,Corse,2B,3,25,023,Asco,129,1,130
94,Corse,2B,5,05,025,Avapessa,79,4,83
94,Corse,2B,5,29,029,Barbaggio,216,1,217
94,Corse,2B,2,42,030,Barrettali,159,0,159
94,Corse,2B,2,99,033,Bastia,43477,614,44091
94,Corse,2B,5,05,034,Belgodère,477,10,487
94,Corse,2B,3,14,036,Bigorno,79,1,80
94,Corse,2B,2,08,037,Biguglia,6365,127,6492
94,Corse,2B,3,25,039,Bisinchi,199,5,204
94,Corse,2B,2,08,042,Borgo,7456,86,7542
94,Corse,2B,2,09,043,Brando,1561,32,1593
94,Corse,2B,3,54,045,Bustanico,64,1,65
94,Corse,2B,2,42,046,Cagnano,196,4,200
94,Corse,2B,3,10,047,Calacuccia,325,13,338
94,Corse,2B,5,11,049,Calenzana,1943,21,1964
94,Corse,2B,5,12,050,Calvi,5409,107,5516
94,Corse,2B,3,54,051,Cambia,74,2,76
94,Corse,2B,3,37,052,Campana,23,1,24
94,Corse,2B,3,24,053,Campi,23,0,23
94,Corse,2B,3,14,054,Campile,193,0,193
94,Corse,2B,3,14,055,Campitello,102,1,103
94,Corse,2B,3,24,057,Canale-di-Verde,334,8,342
94,Corse,2B,2,09,058,Canari,325,4,329
94,Corse,2B,3,14,059,Canavaggia,109,0,109
94,Corse,2B,3,37,063,Carcheto-Brustico,24,0,24
94,Corse,2B,3,37,067,Carpineto,26,0,26
94,Corse,2B,3,54,068,Carticasi,31,3,34
94,Corse,2B,3,39,069,Casabianca,84,0,84
94,Corse,2B,3,39,072,Casalta,53,0,53
94,Corse,2B,3,10,073,Casamaccioli,101,3,104
94,Corse,2B,3,58,074,Casanova,350,7,357
94,Corse,2B,3,60,075,Casevecchie,65,0,65
94,Corse,2B,3,59,077,Castellare-di-Casinca,554,4,558
94,Corse,2B,3,54,078,Castellare-di-Mercurio,34,0,34
94,Corse,2B,3,25,079,Castello-di-Rostino,372,4,376
94,Corse,2B,3,25,080,Castifao,153,3,156
94,Corse,2B,3,10,081,Castiglione,34,0,34
94,Corse,2B,3,25,082,Castineta,53,3,56
94,Corse,2B,3,10,083,Castirla,183,1,184
94,Corse,2B,5,05,084,Cateri,209,2,211
94,Corse,2B,2,42,086,Centuri,225,4,229
94,Corse,2B,3,16,087,Cervione,1646,19,1665
94,Corse,2B,3,24,088,Chiatra,213,5,218
94,Corse,2B,3,41,366,Chisa,99,0,99
94,Corse,2B,5,20,093,Corbara,923,19,942
94,Corse,2B,3,10,095,Corscia,165,2,167
94,Corse,2B,3,17,096,Corte,6779,87,6866
94,Corse,2B,5,05,097,Costa,62,0,62
94,Corse,2B,3,39,101,Croce,82,1,83
94,Corse,2B,3,14,102,Crocicchia,43,2,45
94,Corse,2B,3,54,105,Erbajolo,109,1,110
94,Corse,2B,3,54,106,Érone,6,1,7
94,Corse,2B,2,42,107,Ersa,150,0,150
94,Corse,2B,5,29,109,Farinole,216,10,226
94,Corse,2B,3,54,110,Favalello,43,0,43
94,Corse,2B,3,37,111,Felce,50,0,50
94,Corse,2B,5,05,112,Feliceto,210,1,211
94,Corse,2B,3,39,113,Ficaja,49,0,49
94,Corse,2B,3,54,116,Focicchia,40,1,41
94,Corse,2B,2,71,120,Furiani,4731,156,4887
94,Corse,2B,5,11,121,Galéria,340,3,343
94,Corse,2B,3,25,122,Gavignano,48,1,49
94,Corse,2B,3,19,123,Ghisonaccia,3515,66,3581
94,Corse,2B,3,19,124,Ghisoni,224,2,226
94,Corse,2B,3,39,125,Giocatojo,47,0,47
94,Corse,2B,3,54,126,Giuncaggio,64,1,65
94,Corse,2B,5,20,134,L' Île-Rousse,2925,59,2984
94,Corse,2B,3,41,135,Isolaccio-di-Fiumorbo,393,3,396
94,Corse,2B,5,26,136,Lama,176,4,180
94,Corse,2B,3,54,137,Lano,22,1,23
94,Corse,2B,5,05,138,Lavatoggio,136,2,138
94,Corse,2B,3,14,140,Lento,116,4,120
94,Corse,2B,3,24,143,Linguizzetta,1025,6,1031
94,Corse,2B,3,59,145,Loreto-di-Casinca,251,3,254
94,Corse,2B,3,10,147,Lozzi,129,0,129
94,Corse,2B,2,08,148,Lucciana,4109,38,4147
94,Corse,2B,3,19,149,Lugo-di-Nazza,112,1,113
94,Corse,2B,5,12,150,Lumio,1180,26,1206
94,Corse,2B,2,42,152,Luri,694,15,709
94,Corse,2B,5,11,153,Manso,106,2,108
94,Corse,2B,3,24,155,Matra,51,0,51
94,Corse,2B,5,05,156,Mausoléo,14,1,15
94,Corse,2B,3,54,157,Mazzola,25,1,26
94,Corse,2B,2,42,159,Meria,97,4,101
94,Corse,2B,3,24,161,Moïta,81,0,81
94,Corse,2B,3,25,162,Moltifao,703,5,708
94,Corse,2B,3,37,164,Monacia-d'Orezza,33,0,33
94,Corse,2B,5,11,165,Moncale,243,5,248
94,Corse,2B,3,14,166,Monte,539,12,551
94,Corse,2B,5,11,167,Montegrosso,426,10,436
94,Corse,2B,5,20,168,Monticello,1708,48,1756
94,Corse,2B,3,25,169,Morosaglia,1072,5,1077
94,Corse,2B,2,42,170,Morsiglia,146,3,149
94,Corse,2B,3,58,171,Muracciole,46,0,46
94,Corse,2B,5,26,172,Murato,599,10,609
94,Corse,2B,5,05,173,Muro,263,12,275
94,Corse,2B,5,05,175,Nessa,114,2,116
94,Corse,2B,3,37,176,Nocario,56,0,56
94,Corse,2B,3,60,177,Noceta,61,0,61
94,Corse,2B,2,09,178,Nonza,66,7,73
94,Corse,2B,3,37,179,Novale,51,1,52
94,Corse,2B,5,05,180,Novella,86,0,86
94,Corse,2B,5,05,182,Occhiatana,174,3,177
94,Corse,2B,2,09,183,Ogliastro,105,1,106
94,Corse,2B,2,09,184,Olcani,65,0,65
94,Corse,2B,5,29,185,Oletta,1326,20,1346
94,Corse,2B,2,09,187,Olmeta-di-Capocorso,132,2,134
94,Corse,2B,5,29,188,Olmeta-di-Tuda,333,3,336
94,Corse,2B,5,05,190,Olmi-Cappella,188,5,193
94,Corse,2B,3,14,192,Olmo,209,2,211
94,Corse,2B,3,10,193,Omessa,590,9,599
94,Corse,2B,3,37,194,Ortale,29,0,29
94,Corse,2B,3,14,195,Ortiporio,126,1,127
94,Corse,2B,5,05,199,Palasca,138,3,141
94,Corse,2B,3,54,201,Pancheraccia,173,6,179
94,Corse,2B,3,37,202,Parata,32,0,32
94,Corse,2B,5,29,205,Patrimonio,666,15,681
94,Corse,2B,3,14,206,Penta-Acquatella,42,0,42
94,Corse,2B,3,59,207,Penta-di-Casinca,2855,30,2885
94,Corse,2B,3,37,208,Perelli,108,0,108
94,Corse,2B,3,39,210,Pero-Casevecchie,118,3,121
94,Corse,2B,3,24,213,Pianello,77,0,77
94,Corse,2B,3,39,214,Piano,32,0,32
94,Corse,2B,3,37,216,Piazzali,15,1,16
94,Corse,2B,3,37,217,Piazzole,44,0,44
94,Corse,2B,3,37,222,Pie-d'Orezza,35,0,35
94,Corse,2B,3,54,218,Piedicorte-di-Gaggio,123,0,123
94,Corse,2B,3,37,219,Piedicroce,127,2,129
94,Corse,2B,3,10,220,Piedigriggio,136,2,138
94,Corse,2B,3,37,221,Piedipartino,16,1,17
94,Corse,2B,3,24,225,Pietra-di-Verde,125,0,125
94,Corse,2B,2,09,224,Pietracorbara,557,12,569
94,Corse,2B,5,26,223,Pietralba,435,10,445
94,Corse,2B,3,54,226,Pietraserena,75,1,76
94,Corse,2B,3,37,227,Pietricaggio,46,1,47
94,Corse,2B,3,60,229,Pietroso,252,6,258
94,Corse,2B,5,26,230,Piève,120,2,122
94,Corse,2B,5,20,231,Pigna,102,2,104
94,Corse,2B,2,42,233,Pino,179,1,180
94,Corse,2B,3,37,234,Piobetta,24,0,24
94,Corse,2B,5,05,235,Pioggiola,90,0,90
94,Corse,2B,5,29,239,Poggio-d'Oletta,215,11,226
94,Corse,2B,3,19,236,Poggio-di-Nazza,182,3,185
94,Corse,2B,3,58,238,Poggio-di-Venaco,191,4,195
94,Corse,2B,3,39,241,Poggio-Marinaccio,26,0,26
94,Corse,2B,3,39,242,Poggio-Mezzana,653,10,663
94,Corse,2B,3,39,243,Polveroso,43,0,43
94,Corse,2B,3,10,244,Popolasca,49,2,51
94,Corse,2B,3,59,245,Porri,57,1,58
94,Corse,2B,3,39,246,La Porta,246,5,251
94,Corse,2B,3,10,248,Prato-di-Giovellina,53,1,54
94,Corse,2B,3,14,250,Prunelli-di-Casacconi,161,3,164
94,Corse,2B,3,41,251,Prunelli-di-Fiumorbo,3203,49,3252
94,Corse,2B,3,39,252,Pruno,191,5,196
94,Corse,2B,3,39,255,Quercitello,56,2,58
94,Corse,2B,3,37,256,Rapaggio,19,0,19
94,Corse,2B,5,26,257,Rapale,157,5,162
94,Corse,2B,3,58,260,Riventosa,175,6,181
94,Corse,2B,2,42,261,Rogliano,550,10,560
94,Corse,2B,3,60,263,Rospigliani,83,1,84
94,Corse,2B,3,54,264,Rusio,77,0,77
94,Corse,2B,5,26,265,Rutali,322,9,331
94,Corse,2B,5,29,298,Saint-Florent,1636,33,1669
94,Corse,2B,3,25,267,Saliceto,67,0,67
94,Corse,2B,3,39,297,San-Damiano,48,0,48
94,Corse,2B,3,39,299,San-Gavino-d'Ampugnani,91,3,94
94,Corse,2B,3,41,365,San-Gavino-di-Fiumorbo,182,6,188
94,Corse,2B,5,26,301,San-Gavino-di-Tenda,53,0,53
94,Corse,2B,3,16,302,San-Giovanni-di-Moriani,106,1,107
94,Corse,2B,3,16,303,San-Giuliano,605,5,610
94,Corse,2B,3,54,304,San-Lorenzo,152,1,153
94,Corse,2B,2,45,305,San-Martino-di-Lota,2750,48,2798
94,Corse,2B,3,16,313,San-Nicolao,1543,19,1562
94,Corse,2B,3,54,292,Sant'Andréa-di-Bozio,87,2,89
94,Corse,2B,3,16,293,Sant'Andréa-di-Cotone,229,2,231
94,Corse,2B,5,20,296,Sant'Antonino,93,3,96
94,Corse,2B,3,54,306,Santa-Lucia-di-Mercurio,89,2,91
94,Corse,2B,3,16,307,Santa-Lucia-di-Moriani,1210,14,1224
94,Corse,2B,2,45,309,Santa-Maria-di-Lota,1937,72,2009
94,Corse,2B,3,16,311,Santa-Maria-Poggio,650,11,661
94,Corse,2B,5,20,316,Santa-Reparata-di-Balagna,969,20,989
94,Corse,2B,3,16,317,Santa-Reparata-di-Moriani,45,2,47
94,Corse,2B,5,26,314,Santo-Pietro-di-Tenda,341,6,347
94,Corse,2B,3,58,315,Santo-Pietro-di-Venaco,217,1,218
94,Corse,2B,3,39,273,Scata,42,0,42
94,Corse,2B,3,14,274,Scolca,100,1,101
94,Corse,2B,3,54,275,Sermano,75,3,78
94,Corse,2B,3,41,277,Serra-di-Fiumorbo,304,5,309
94,Corse,2B,3,39,280,Silvareccio,118,0,118
94,Corse,2B,2,09,281,Sisco,947,14,961
94,Corse,2B,3,41,283,Solaro,651,20,671
94,Corse,2B,3,59,286,Sorbo-Ocagnano,742,10,752
94,Corse,2B,5,26,287,Sorio,154,5,159
94,Corse,2B,3,10,289,Soveria,110,0,110
94,Corse,2B,5,05,290,Speloncato,274,11,285
94,Corse,2B,3,37,291,Stazzona,39,5,44
94,Corse,2B,3,39,318,Taglio-Isolaccio,516,9,525
94,Corse,2B,3,39,319,Talasani,561,12,573
94,Corse,2B,3,24,320,Tallone,311,3,314
94,Corse,2B,3,37,321,Tarrano,14,0,14
94,Corse,2B,2,42,327,Tomino,213,6,219
94,Corse,2B,3,24,328,Tox,106,0,106
94,Corse,2B,3,54,329,Tralonca,93,1,94
94,Corse,2B,5,26,332,Urtaca,194,12,206
94,Corse,2B,3,37,334,Valle-d'Alesani,144,1,145
94,Corse,2B,3,37,338,Valle-d'Orezza,45,1,46
94,Corse,2B,3,16,335,Valle-di-Campoloro,300,8,308
94,Corse,2B,3,25,337,Valle-di-Rostino,132,6,138
94,Corse,2B,5,29,333,Vallecalle,110,1,111
94,Corse,2B,5,05,339,Vallica,40,0,40
94,Corse,2B,3,39,340,Velone-Orneto,113,0,113
94,Corse,2B,3,58,341,Venaco,752,8,760
94,Corse,2B,3,41,342,Ventiseri,2190,48,2238
94,Corse,2B,3,59,343,Venzolasca,1680,17,1697
94,Corse,2B,3,37,344,Verdèse,33,0,33
94,Corse,2B,3,59,346,Vescovato,2336,40,2376
94,Corse,2B,3,60,347,Vezzani,319,8,327
94,Corse,2B,2,08,350,Vignale,174,2,176
94,Corse,2B,5,05,352,Ville-di-Paraso,181,1,182
94,Corse,2B,2,45,353,Ville-di-Pietrabugno,3179,103,3282
94,Corse,2B,3,58,354,Vivario,523,2,525
94,Corse,2B,3,14,355,Volpajola,441,3,444
94,Corse,2B,3,24,356,Zalana,149,2,151
94,Corse,2B,5,11,361,Zilia,240,1,241
94,Corse,2B,3,24,364,Zuani,45,0,45
26,Bourgogne,21,1,24,001,Agencourt,392,68,460
26,Bourgogne,21,2,35,002,Agey,272,14,286
26,Bourgogne,21,2,43,003,Ahuy,1289,27,1316
26,Bourgogne,21,3,01,004,Aignay-le-Duc,350,14,364
26,Bourgogne,21,2,14,005,Aiserey,1347,21,1368
26,Bourgogne,21,3,08,006,Aisey-sur-Seine,220,42,262
26,Bourgogne,21,3,27,007,Aisy-sous-Thil,215,67,282
26,Bourgogne,21,3,36,008,Alise-Sainte-Reine,624,21,645
26,Bourgogne,21,1,02,009,Allerey,170,1,171
26,Bourgogne,21,1,05,010,Aloxe-Corton,173,6,179
26,Bourgogne,21,3,08,012,Ampilly-le-Sec,366,12,378
26,Bourgogne,21,3,04,011,Ampilly-les-Bordes,71,4,75
26,Bourgogne,21,2,35,013,Ancey,377,6,383
26,Bourgogne,21,1,07,014,Antheuil,65,0,65
26,Bourgogne,21,1,02,015,Antigny-la-Ville,114,4,118
26,Bourgogne,21,2,10,021,Arc-sur-Tille,2464,56,2520
26,Bourgogne,21,2,20,016,Arceau,634,16,650
26,Bourgogne,21,1,24,017,Arcenant,481,14,495
26,Bourgogne,21,2,35,018,Arcey,44,0,44
26,Bourgogne,21,1,26,020,Arconcey,201,5,206
26,Bourgogne,21,1,24,022,Argilly,444,10,454
26,Bourgogne,21,1,02,023,Arnay-le-Duc,1673,100,1773
26,Bourgogne,21,3,37,024,Arnay-sous-Vitteaux,117,2,119
26,Bourgogne,21,3,21,025,Arrans,67,1,68
26,Bourgogne,21,3,21,026,Asnières-en-Montagne,184,3,187
26,Bourgogne,21,2,43,027,Asnières-lès-Dijon,1240,25,1265
26,Bourgogne,21,2,03,028,Athée,764,8,772
26,Bourgogne,21,3,21,029,Athie,90,1,91
26,Bourgogne,21,1,07,030,Aubaine,89,0,89
26,Bourgogne,21,1,29,031,Aubigny-en-Plaine,344,4,348
26,Bourgogne,21,1,23,032,Aubigny-la-Ronce,167,7,174
26,Bourgogne,21,2,35,033,Aubigny-lès-Sombernon,124,1,125
26,Bourgogne,21,3,22,034,Autricourt,119,3,122
26,Bourgogne,21,1,34,035,Auvillars-sur-Saône,292,9,301
26,Bourgogne,21,1,07,036,Auxant,64,1,65
26,Bourgogne,21,1,05,037,Auxey-Duresses,338,12,350
26,Bourgogne,21,2,03,038,Auxonne,7752,132,7884
26,Bourgogne,21,2,17,039,Avelanges,43,0,43
26,Bourgogne,21,3,37,040,Avosnes,72,2,74
26,Bourgogne,21,2,16,041,Avot,142,4,146
26,Bourgogne,21,1,34,042,Bagnot,127,3,130
26,Bourgogne,21,3,04,043,Baigneux-les-Juifs,245,43,288
26,Bourgogne,21,3,18,044,Balot,90,1,91
26,Bourgogne,21,2,35,045,Barbirey-sur-Ouche,274,3,277
26,Bourgogne,21,1,19,046,Bard-le-Régulier,67,2,69
26,Bourgogne,21,3,33,047,Bard-lès-Époisses,69,5,74
26,Bourgogne,21,2,15,048,Barges,454,6,460
26,Bourgogne,21,2,16,049,Barjon,42,0,42
26,Bourgogne,21,1,23,050,Baubigny,252,15,267
26,Bourgogne,21,2,35,051,Baulme-la-Roche,122,5,127
26,Bourgogne,21,3,01,052,Beaulieu,29,0,29
26,Bourgogne,21,2,20,053,Beaumont-sur-Vingeanne,172,5,177
26,Bourgogne,21,1,98,054,Beaune,22218,717,22935
26,Bourgogne,21,3,01,055,Beaunotte,21,0,21
26,Bourgogne,21,2,20,056,Beire-le-Châtel,794,31,825
26,Bourgogne,21,2,14,057,Beire-le-Fort,289,10,299
26,Bourgogne,21,3,22,058,Belan-sur-Ource,263,6,269
26,Bourgogne,21,2,43,059,Bellefond,800,20,820
26,Bourgogne,21,2,20,060,Belleneuve,1419,23,1442
26,Bourgogne,21,3,01,061,Bellenod-sur-Seine,78,2,80
26,Bourgogne,21,1,26,062,Bellenot-sous-Pouilly,212,9,221
26,Bourgogne,21,3,28,063,Beneuvre,94,2,96
26,Bourgogne,21,3,21,064,Benoisey,72,0,72
26,Bourgogne,21,1,07,065,Bessey-en-Chaume,104,2,106
26,Bourgogne,21,1,07,066,Bessey-la-Cour,74,0,74
26,Bourgogne,21,2,14,067,Bessey-lès-Cîteaux,653,14,667
26,Bourgogne,21,1,26,068,Beurey-Bauguay,136,2,138
26,Bourgogne,21,3,37,069,Beurizot,114,7,121
26,Bourgogne,21,2,15,070,Bévy,96,2,98
26,Bourgogne,21,2,20,071,Bèze,721,10,731
26,Bourgogne,21,2,20,072,Bézouotte,199,6,205
26,Bourgogne,21,3,27,073,Bierre-lès-Semur,84,4,88
26,Bourgogne,21,2,03,074,Billey,212,6,218
26,Bourgogne,21,3,04,075,Billy-lès-Chanceaux,79,1,80
26,Bourgogne,21,2,25,076,Binges,621,9,630
26,Bourgogne,21,3,22,077,Bissey-la-Côte,94,2,96
26,Bourgogne,21,3,18,078,Bissey-la-Pierre,81,2,83
26,Bourgogne,21,2,20,079,Blagny-sur-Vingeanne,126,2,128
26,Bourgogne,21,2,35,080,Blaisy-Bas,696,17,713
26,Bourgogne,21,2,35,081,Blaisy-Haut,119,1,120
26,Bourgogne,21,1,26,082,Blancey,71,3,74
26,Bourgogne,21,1,19,083,Blanot,130,7,137
26,Bourgogne,21,2,30,085,Bligny-le-Sec,166,4,170
26,Bourgogne,21,1,06,086,Bligny-lès-Beaune,1186,45,1231
26,Bourgogne,21,1,07,087,Bligny-sur-Ouche,847,15,862
26,Bourgogne,21,1,24,088,Boncourt-le-Bois,270,3,273
26,Bourgogne,21,1,34,089,Bonnencontre,398,5,403
26,Bourgogne,21,3,22,090,Boudreville,62,1,63
26,Bourgogne,21,1,26,091,Bouhey,40,0,40
26,Bourgogne,21,1,05,092,Bouilland,192,6,198
26,Bourgogne,21,3,18,093,Bouix,162,3,165
26,Bourgogne,21,2,13,094,Bourberain,316,4,320
26,Bourgogne,21,1,34,095,Bousselange,54,2,56
26,Bourgogne,21,2,32,096,Boussenois,112,0,112
26,Bourgogne,21,3,37,097,Boussey,29,3,32
26,Bourgogne,21,3,36,098,Boux-sous-Salmaise,146,2,148
26,Bourgogne,21,1,05,099,Bouze-lès-Beaune,328,5,333
26,Bourgogne,21,3,37,100,Brain,28,0,28
26,Bourgogne,21,3,27,101,Braux,181,8,189
26,Bourgogne,21,1,19,102,Brazey-en-Morvan,169,1,170
26,Bourgogne,21,1,29,103,Brazey-en-Plaine,2563,39,2602
26,Bourgogne,21,3,08,104,Brémur-et-Vaurois,56,4,60
26,Bourgogne,21,2,10,105,Bressey-sur-Tille,647,6,653
26,Bourgogne,21,2,14,106,Bretenière,737,16,753
26,Bourgogne,21,2,09,107,Bretigny,893,19,912
26,Bourgogne,21,3,27,108,Brianny,114,4,118
26,Bourgogne,21,3,22,109,Brion-sur-Ource,226,7,233
26,Bourgogne,21,2,15,110,Brochon,644,118,762
26,Bourgogne,21,2,09,111,Brognon,255,4,259
26,Bourgogne,21,1,34,112,Broin,416,5,421
26,Bourgogne,21,2,15,113,Broindon,90,1,91
26,Bourgogne,21,3,21,114,Buffon,171,6,177
26,Bourgogne,21,3,08,115,Buncey,379,5,384
26,Bourgogne,21,3,28,116,Bure-les-Templiers,130,9,139
26,Bourgogne,21,3,01,117,Busseaut,66,3,69
26,Bourgogne,21,2,16,118,Busserotte-et-Montenaille,32,0,32
26,Bourgogne,21,1,07,120,La Bussière-sur-Ouche,155,4,159
26,Bourgogne,21,2,16,119,Bussières,40,1,41
26,Bourgogne,21,2,35,121,Bussy-la-Pesle,60,1,61
26,Bourgogne,21,3,36,122,Bussy-le-Grand,297,7,304
26,Bourgogne,21,3,28,123,Buxerolles,24,1,25
26,Bourgogne,21,1,19,124,Censerey,178,3,181
26,Bourgogne,21,3,18,125,Cérilly,257,6,263
26,Bourgogne,21,2,14,126,Cessey-sur-Tille,549,8,557
26,Bourgogne,21,2,17,127,Chaignay,498,8,506
26,Bourgogne,21,1,26,128,Chailly-sur-Armançon,282,5,287
26,Bourgogne,21,3,28,129,Chambain,30,1,31
26,Bourgogne,21,2,14,130,Chambeire,283,8,291
26,Bourgogne,21,1,34,131,Chamblanc,505,64,569
26,Bourgogne,21,2,15,132,Chamboeuf,331,10,341
26,Bourgogne,21,2,15,133,Chambolle-Musigny,320,3,323
26,Bourgogne,21,3,08,134,Chamesson,288,6,294
26,Bourgogne,21,3,21,137,Champ-d'Oiseau,78,2,80
26,Bourgogne,21,2,20,135,Champagne-sur-Vingeanne,259,2,261
26,Bourgogne,21,2,30,136,Champagny,39,2,41
26,Bourgogne,21,2,03,138,Champdôtre,549,8,557
26,Bourgogne,21,3,31,139,Champeau-en-Morvan,248,8,256
26,Bourgogne,21,1,02,140,Champignolles,75,1,76
26,Bourgogne,21,3,37,141,Champrenault,30,1,31
26,Bourgogne,21,2,30,142,Chanceaux,188,4,192
26,Bourgogne,21,3,18,143,Channay,65,3,68
26,Bourgogne,21,3,36,144,Charencey,29,1,30
26,Bourgogne,21,3,33,145,Charigny,42,0,42
26,Bourgogne,21,2,20,146,Charmes,123,3,126
26,Bourgogne,21,3,37,147,Charny,33,0,33
26,Bourgogne,21,1,29,148,Charrey-sur-Saône,317,3,320
26,Bourgogne,21,3,08,149,Charrey-sur-Seine,139,3,142
26,Bourgogne,21,1,23,150,Chassagne-Montrachet,391,10,401
26,Bourgogne,21,3,33,151,Chassey,91,1,92
26,Bourgogne,21,1,26,152,Châteauneuf,86,3,89
26,Bourgogne,21,1,26,153,Châtellenot,145,6,151
26,Bourgogne,21,3,08,154,Châtillon-sur-Seine,5719,453,6172
26,Bourgogne,21,1,07,155,Chaudenay-la-Ville,37,0,37
26,Bourgogne,21,1,07,156,Chaudenay-le-Château,44,0,44
26,Bourgogne,21,3,28,157,Chaugey,20,2,22
26,Bourgogne,21,3,22,159,La Chaume,123,1,124
26,Bourgogne,21,2,13,158,Chaume-et-Courchamp,147,1,148
26,Bourgogne,21,3,04,160,Chaume-lès-Baigneux,93,2,95
26,Bourgogne,21,3,08,161,Chaumont-le-Bois,87,2,89
26,Bourgogne,21,1,24,162,Chaux,408,15,423
26,Bourgogne,21,2,32,163,Chazeuil,220,5,225
26,Bourgogne,21,1,26,164,Chazilly,131,5,136
26,Bourgogne,21,3,08,165,Chemin-d'Aisey,55,1,56
26,Bourgogne,21,2,97,166,Chenôve,14481,202,14683
26,Bourgogne,21,2,20,167,Cheuge,105,3,108
26,Bourgogne,21,3,37,168,Chevannay,50,1,51
26,Bourgogne,21,2,15,169,Chevannes,134,6,140
26,Bourgogne,21,1,06,170,Chevigny-en-Valière,271,6,277
26,Bourgogne,21,2,10,171,Chevigny-Saint-Sauveur,9788,171,9959
26,Bourgogne,21,1,34,172,Chivres,234,3,237
26,Bourgogne,21,1,06,173,Chorey-les-Beaune,480,10,490
26,Bourgogne,21,2,25,175,Cirey-lès-Pontailler,128,1,129
26,Bourgogne,21,1,26,176,Civry-en-Montagne,97,2,99
26,Bourgogne,21,3,27,177,Clamerey,171,4,175
26,Bourgogne,21,2,15,178,Clémencey,120,3,123
26,Bourgogne,21,2,09,179,Clénay,847,6,853
26,Bourgogne,21,2,25,180,Cléry,126,3,129
26,Bourgogne,21,1,02,181,Clomot,98,8,106
26,Bourgogne,21,2,15,182,Collonges-lès-Bévy,90,1,91
26,Bourgogne,21,2,14,183,Collonges-lès-Premières,780,8,788
26,Bourgogne,21,1,07,184,Colombier,56,2,58
26,Bourgogne,21,1,06,185,Combertault,475,11,486
26,Bourgogne,21,1,24,186,Comblanchien,691,7,698
26,Bourgogne,21,1,26,187,Commarin,129,2,131
26,Bourgogne,21,1,34,189,Corberon,423,11,434
26,Bourgogne,21,1,06,190,Corcelles-les-Arts,470,18,488
26,Bourgogne,21,2,15,191,Corcelles-lès-Cîteaux,828,13,841
26,Bourgogne,21,2,39,192,Corcelles-les-Monts,673,11,684
26,Bourgogne,21,1,34,193,Corgengoux,347,7,354
26,Bourgogne,21,1,24,194,Corgoloin,946,29,975
26,Bourgogne,21,1,23,195,Cormot-le-Grand,143,4,147
26,Bourgogne,21,1,23,196,Corpeau,1042,21,1063
26,Bourgogne,21,3,36,197,Corpoyer-la-Chapelle,22,0,22
26,Bourgogne,21,3,33,198,Corrombles,234,5,239
26,Bourgogne,21,3,33,199,Corsaint,125,4,129
26,Bourgogne,21,2,15,200,Couchey,1208,28,1236
26,Bourgogne,21,3,08,201,Coulmier-le-Sec,273,8,281
26,Bourgogne,21,3,22,202,Courban,165,3,168
26,Bourgogne,21,3,33,203,Courcelles-Frémoy,120,3,123
26,Bourgogne,21,3,21,204,Courcelles-lès-Montbard,90,4,94
26,Bourgogne,21,3,33,205,Courcelles-lès-Semur,233,8,241
26,Bourgogne,21,2,16,207,Courlon,69,5,74
26,Bourgogne,21,2,17,208,Courtivron,184,2,186
26,Bourgogne,21,2,10,209,Couternon,1635,21,1656
26,Bourgogne,21,1,26,210,Créancey,512,4,516
26,Bourgogne,21,2,17,211,Crécey-sur-Tille,157,4,161
26,Bourgogne,21,3,21,212,Crépand,350,11,361
26,Bourgogne,21,2,10,213,Crimolois,591,9,600
26,Bourgogne,21,1,07,214,Crugey,173,3,176
26,Bourgogne,21,2,20,215,Cuiserey,150,4,154
26,Bourgogne,21,1,02,216,Culètre,73,1,74
26,Bourgogne,21,2,15,217,Curley,144,2,146
26,Bourgogne,21,2,30,218,Curtil-Saint-Seine,93,6,99
26,Bourgogne,21,2,15,219,Curtil-Vergy,111,2,113
26,Bourgogne,21,2,16,220,Cussey-les-Forges,135,2,137
26,Bourgogne,21,1,07,221,Cussy-la-Colonne,54,2,56
26,Bourgogne,21,1,02,222,Cussy-le-Châtel,114,3,117
26,Bourgogne,21,2,43,223,Daix,1391,40,1431
26,Bourgogne,21,3,37,224,Dampierre-en-Montagne,76,0,76
26,Bourgogne,21,2,13,225,Dampierre-et-Flée,112,4,116
26,Bourgogne,21,3,36,226,Darcey,336,9,345
26,Bourgogne,21,2,43,227,Darois,462,15,477
26,Bourgogne,21,2,15,228,Détain-et-Bruant,128,1,129
26,Bourgogne,21,1,19,229,Diancey,87,2,89
26,Bourgogne,21,2,17,230,Diénay,269,9,278
26,Bourgogne,21,2,99,231,Dijon,151576,3884,155460
26,Bourgogne,21,3,27,232,Dompierre-en-Morvan,219,10,229
26,Bourgogne,21,2,25,233,Drambon,165,4,169
26,Bourgogne,21,2,35,234,Drée,58,2,60
26,Bourgogne,21,3,01,235,Duesme,64,4,68
26,Bourgogne,21,1,06,236,Ébaty,215,5,220
26,Bourgogne,21,3,01,237,Échalot,108,0,108
26,Bourgogne,21,2,35,238,Échannay,121,3,124
26,Bourgogne,21,1,29,239,Échenon,680,8,688
26,Bourgogne,21,2,17,240,Échevannes,205,3,208
26,Bourgogne,21,1,05,241,Échevronne,275,8,283
26,Bourgogne,21,2,14,242,Échigey,287,9,296
26,Bourgogne,21,1,07,243,Écutigny,108,3,111
26,Bourgogne,21,1,26,244,Éguilly,63,0,63
26,Bourgogne,21,2,17,245,Épagny,281,3,284
26,Bourgogne,21,2,15,246,Épernay-sous-Gevrey,173,3,176
26,Bourgogne,21,3,33,247,Époisses,802,17,819
26,Bourgogne,21,3,21,248,Éringes,65,4,69
26,Bourgogne,21,1,29,249,Esbarres,763,13,776
26,Bourgogne,21,3,28,250,Essarois,90,1,91
26,Bourgogne,21,1,26,251,Essey,186,42,228
26,Bourgogne,21,3,18,252,Étais,89,4,93
26,Bourgogne,21,3,01,253,Étalante,130,6,136
26,Bourgogne,21,2,15,254,L' Étang-Vergy,199,4,203
26,Bourgogne,21,2,43,255,Étaules,244,11,255
26,Bourgogne,21,2,25,256,Étevaux,291,4,295
26,Bourgogne,21,3,04,257,Étormay,66,2,68
26,Bourgogne,21,3,08,258,Étrochey,236,7,243
26,Bourgogne,21,3,21,259,Fain-lès-Montbard,283,7,290
26,Bourgogne,21,3,21,260,Fain-lès-Moutiers,190,6,196
26,Bourgogne,21,2,14,261,Fauverney,695,14,709
26,Bourgogne,21,3,28,262,Faverolles-lès-Lucey,36,0,36
26,Bourgogne,21,2,15,263,Fénay,1378,63,1441
26,Bourgogne,21,1,02,264,Le Fête,48,5,53
26,Bourgogne,21,2,15,265,Fixin,753,11,764
26,Bourgogne,21,2,17,266,Flacey,170,2,172
26,Bourgogne,21,1,24,267,Flagey-Echézeaux,502,4,506
26,Bourgogne,21,2,03,268,Flagey-lès-Auxonne,184,6,190
26,Bourgogne,21,2,03,269,Flammerans,408,11,419
26,Bourgogne,21,2,39,270,Flavignerot,171,7,178
26,Bourgogne,21,3,36,271,Flavigny-sur-Ozerain,323,15,338
26,Bourgogne,21,3,33,272,Flée,161,7,168
26,Bourgogne,21,2,39,273,Fleurey-sur-Ouche,1178,48,1226
26,Bourgogne,21,1,02,274,Foissy,152,3,155
26,Bourgogne,21,2,32,275,Foncegrive,154,2,156
26,Bourgogne,21,2,13,277,Fontaine-Française,944,27,971
26,Bourgogne,21,2,43,278,Fontaine-lès-Dijon,9009,276,9285
26,Bourgogne,21,3,04,276,Fontaines-en-Duesmois,138,2,140
26,Bourgogne,21,3,18,279,Fontaines-les-Sèches,40,2,42
26,Bourgogne,21,3,27,280,Fontangy,152,2,154
26,Bourgogne,21,2,13,281,Fontenelle,129,9,138
26,Bourgogne,21,3,33,282,Forléans,83,3,86
26,Bourgogne,21,2,16,283,Fraignot-et-Vesvrotte,68,7,75
26,Bourgogne,21,2,30,284,Francheville,247,2,249
26,Bourgogne,21,1,29,285,Franxault,403,10,413
26,Bourgogne,21,2,30,286,Frénois,78,1,79
26,Bourgogne,21,3,21,287,Fresnes,175,3,178
26,Bourgogne,21,3,36,288,Frôlois,176,8,184
26,Bourgogne,21,1,24,289,Fussey,109,3,112
26,Bourgogne,21,2,17,290,Gemeaux,855,6,861
26,Bourgogne,21,3,33,291,Genay,336,3,339
26,Bourgogne,21,2,14,292,Genlis,5542,90,5632
26,Bourgogne,21,2,35,293,Gergueil,144,0,144
26,Bourgogne,21,1,24,294,Gerland,410,3,413
26,Bourgogne,21,2,15,295,Gevrey-Chambertin,3084,40,3124
26,Bourgogne,21,3,22,296,Gevrolles,161,4,165
26,Bourgogne,21,1,24,297,Gilly-lès-Cîteaux,603,6,609
26,Bourgogne,21,3,37,298,Gissey-le-Vieil,105,3,108
26,Bourgogne,21,3,36,299,Gissey-sous-Flavigny,102,0,102
26,Bourgogne,21,2,35,300,Gissey-sur-Ouche,364,5,369
26,Bourgogne,21,1,34,301,Glanon,216,2,218
26,Bourgogne,21,3,08,302,Gomméville,148,6,154
26,Bourgogne,21,3,22,303,Les Goulles,15,1,16
26,Bourgogne,21,2,16,304,Grancey-le-Château-Neuvelle,265,7,272
26,Bourgogne,21,3,22,305,Grancey-sur-Ource,200,3,203
26,Bourgogne,21,2,35,306,Grenant-lès-Sombernon,194,5,199
26,Bourgogne,21,3,36,307,Grésigny-Sainte-Reine,133,5,138
26,Bourgogne,21,3,36,308,Grignon,219,7,226
26,Bourgogne,21,3,18,309,Griselles,73,1,74
26,Bourgogne,21,2,35,310,Grosbois-en-Montagne,110,6,116
26,Bourgogne,21,1,34,311,Grosbois-lès-Tichey,65,0,65
26,Bourgogne,21,3,28,312,Gurgy-la-Ville,38,0,38
26,Bourgogne,21,3,28,313,Gurgy-le-Château,50,0,50
26,Bourgogne,21,3,36,314,Hauteroche,76,2,78
26,Bourgogne,21,2,43,315,Hauteville-lès-Dijon,1065,30,1095
26,Bourgogne,21,2,25,316,Heuilley-sur-Saône,298,9,307
26,Bourgogne,21,2,17,317,Is-sur-Tille,3882,79,3961
26,Bourgogne,21,1,23,318,Ivry-en-Montagne,190,5,195
26,Bourgogne,21,2,14,319,Izeure,786,6,792
26,Bourgogne,21,2,14,320,Izier,701,13,714
26,Bourgogne,21,3,36,321,Jailly-les-Moulins,93,4,97
26,Bourgogne,21,1,34,322,Jallanges,330,6,336
26,Bourgogne,21,2,20,323,Jancigny,123,3,126
26,Bourgogne,21,3,33,324,Jeux-lès-Bard,50,2,52
26,Bourgogne,21,1,02,325,Jouey,201,4,205
26,Bourgogne,21,1,23,327,Jours-en-Vaux,97,3,100
26,Bourgogne,21,3,04,326,Jours-lès-Baigneux,82,3,85
26,Bourgogne,21,3,31,328,Juillenay,51,0,51
26,Bourgogne,21,3,33,329,Juilly,47,6,53
26,Bourgogne,21,2,14,330,Labergement-Foigney,419,8,427
26,Bourgogne,21,2,03,331,Labergement-lès-Auxonne,350,10,360
26,Bourgogne,21,1,34,332,Labergement-lès-Seurre,942,16,958
26,Bourgogne,21,1,34,333,Labruyère,207,0,207
26,Bourgogne,21,1,02,334,Lacanche,607,9,616
26,Bourgogne,21,3,27,335,Lacour-d'Arcenay,130,3,133
26,Bourgogne,21,1,06,606,Ladoix-Serrigny,1739,35,1774
26,Bourgogne,21,3,18,336,Laignes,849,21,870
26,Bourgogne,21,2,25,337,Lamarche-sur-Saône,1199,18,1217
26,Bourgogne,21,2,30,338,Lamargelle,168,2,170
26,Bourgogne,21,2,39,339,Lantenay,480,18,498
26,Bourgogne,21,1,34,340,Lanthes,244,6,250
26,Bourgogne,21,3,33,341,Lantilly,99,1,100
26,Bourgogne,21,1,29,342,Laperrière-sur-Saône,412,5,417
26,Bourgogne,21,3,18,343,Larrey,93,3,96
26,Bourgogne,21,1,34,344,Lechâtelet,203,1,204
26,Bourgogne,21,2,30,345,Léry,214,8,222
26,Bourgogne,21,3,28,346,Leuglay,348,13,361
26,Bourgogne,21,1,06,347,Levernois,269,9,278
26,Bourgogne,21,2,13,348,Licey-sur-Vingeanne,105,2,107
26,Bourgogne,21,1,19,349,Liernais,567,42,609
26,Bourgogne,21,3,22,350,Lignerolles,52,0,52
26,Bourgogne,21,2,14,351,Longchamp,1183,85,1268
26,Bourgogne,21,2,14,352,Longeault,592,12,604
26,Bourgogne,21,2,14,353,Longecourt-en-Plaine,1274,18,1292
26,Bourgogne,21,1,02,354,Longecourt-lès-Culêtre,49,2,51
26,Bourgogne,21,2,38,355,Longvic,9385,180,9565
26,Bourgogne,21,1,29,356,Losne,1526,27,1553
26,Bourgogne,21,3,22,357,Louesme,116,2,118
26,Bourgogne,21,3,21,358,Lucenay-le-Duc,209,1,210
26,Bourgogne,21,3,28,359,Lucey,58,1,59
26,Bourgogne,21,1,07,360,Lusigny-sur-Ouche,89,2,91
26,Bourgogne,21,2,17,361,Lux,516,8,524
26,Bourgogne,21,1,26,362,Maconge,136,1,137
26,Bourgogne,21,1,02,363,Magnien,311,7,318
26,Bourgogne,21,3,33,365,Magny-la-Ville,83,3,86
26,Bourgogne,21,3,04,364,Magny-Lambert,91,3,94
26,Bourgogne,21,1,29,366,Magny-lès-Aubigny,197,9,206
26,Bourgogne,21,1,24,368,Magny-lès-Villers,261,7,268
26,Bourgogne,21,2,03,367,Magny-Montarlot,207,8,215
26,Bourgogne,21,2,20,369,Magny-Saint-Médard,244,2,246
26,Bourgogne,21,2,14,370,Magny-sur-Tille,814,11,825
26,Bourgogne,21,2,03,371,Les Maillys,817,30,847
26,Bourgogne,21,3,08,372,Maisey-le-Duc,107,4,111
26,Bourgogne,21,2,35,373,Mâlain,703,13,716
26,Bourgogne,21,1,02,374,Maligny,205,4,209
26,Bourgogne,21,1,19,375,Manlay,207,8,215
26,Bourgogne,21,2,25,376,Marandeuil,83,0,83
26,Bourgogne,21,3,37,377,Marcellois,33,1,34
26,Bourgogne,21,3,18,378,Marcenay,114,2,116
26,Bourgogne,21,1,19,379,Marcheseuil,160,2,162
26,Bourgogne,21,3,27,380,Marcigny-sous-Thil,59,0,59
26,Bourgogne,21,3,37,381,Marcilly-et-Dracy,92,3,95
26,Bourgogne,21,1,26,382,Marcilly-Ogny,200,8,208
26,Bourgogne,21,2,17,383,Marcilly-sur-Tille,1532,25,1557
26,Bourgogne,21,1,24,384,Marey-lès-Fussey,69,8,77
26,Bourgogne,21,2,17,385,Marey-sur-Tille,326,8,334
26,Bourgogne,21,3,36,386,Marigny-le-Cahouët,262,6,268
26,Bourgogne,21,1,06,387,Marigny-lès-Reullée,192,6,198
26,Bourgogne,21,2,14,388,Marliens,447,9,456
26,Bourgogne,21,3,21,389,Marmagne,242,7,249
26,Bourgogne,21,2,38,390,Marsannay-la-Côte,5127,112,5239
26,Bourgogne,21,2,17,391,Marsannay-le-Bois,729,16,745
26,Bourgogne,21,1,26,392,Martrois,56,3,59
26,Bourgogne,21,3,08,393,Massingy,161,6,167
26,Bourgogne,21,3,33,394,Massingy-lès-Semur,208,9,217
26,Bourgogne,21,3,37,395,Massingy-lès-Vitteaux,87,6,93
26,Bourgogne,21,3,01,396,Mauvilly,77,3,80
26,Bourgogne,21,1,05,397,Mavilly-Mandelot,158,7,165
26,Bourgogne,21,2,25,398,Maxilly-sur-Saône,317,5,322
26,Bourgogne,21,1,26,399,Meilly-sur-Rouvres,181,4,185
26,Bourgogne,21,2,16,400,Le Meix,45,0,45
26,Bourgogne,21,1,05,401,Meloisey,285,10,295
26,Bourgogne,21,3,28,402,Menesble,10,0,10
26,Bourgogne,21,1,19,403,Ménessaire,69,1,70
26,Bourgogne,21,3,36,404,Ménétreux-le-Pitois,432,16,448
26,Bourgogne,21,1,06,405,Merceuil,780,17,797
26,Bourgogne,21,2,35,406,Mesmont,202,3,205
26,Bourgogne,21,2,15,407,Messanges,241,4,245
26,Bourgogne,21,2,43,408,Messigny-et-Vantoux,1469,44,1513
26,Bourgogne,21,1,24,409,Meuilley,462,10,472
26,Bourgogne,21,3,01,410,Meulson,38,2,40
26,Bourgogne,21,1,06,411,Meursanges,469,6,475
26,Bourgogne,21,1,05,412,Meursault,1566,51,1617
26,Bourgogne,21,3,33,413,Millery,372,13,385
26,Bourgogne,21,1,02,414,Mimeure,275,6,281
26,Bourgogne,21,3,01,415,Minot,250,9,259
26,Bourgogne,21,2,20,416,Mirebeau-sur-Bèze,1912,28,1940
26,Bourgogne,21,3,27,417,Missery,105,3,108
26,Bourgogne,21,3,01,418,Moitron,58,3,61
26,Bourgogne,21,3,18,419,Molesme,227,1,228
26,Bourgogne,21,1,23,420,Molinot,150,2,152
26,Bourgogne,21,2,17,421,Moloy,224,11,235
26,Bourgogne,21,3,31,422,Molphey,134,6,140
26,Bourgogne,21,1,26,441,Mont-Saint-Jean,249,4,253
26,Bourgogne,21,1,06,423,Montagny-lès-Beaune,660,23,683
26,Bourgogne,21,1,29,424,Montagny-lès-Seurre,107,4,111
26,Bourgogne,21,3,21,425,Montbard,5554,197,5751
26,Bourgogne,21,3,33,426,Montberthault,247,6,253
26,Bourgogne,21,1,07,427,Montceau-et-Écharnant,152,3,155
26,Bourgogne,21,1,05,428,Monthelie,176,10,186
26,Bourgogne,21,3,21,429,Montigny-Montfort,288,16,304
26,Bourgogne,21,2,13,433,Montigny-Mornay-Villeneuve-sur-Vingeanne,370,9,379
26,Bourgogne,21,3,27,430,Montigny-Saint-Barthélemy,79,2,81
26,Bourgogne,21,3,33,431,Montigny-sur-Armançon,133,1,134
26,Bourgogne,21,3,22,432,Montigny-sur-Aube,317,8,325
26,Bourgogne,21,3,31,434,Montlay-en-Auxois,154,2,156
26,Bourgogne,21,3,08,435,Montliot-et-Courcelles,287,8,295
26,Bourgogne,21,1,34,436,Montmain,98,1,99
26,Bourgogne,21,2,25,437,Montmançon,212,8,220
26,Bourgogne,21,3,28,438,Montmoyen,83,1,84
26,Bourgogne,21,2,35,439,Montoillot,70,2,72
26,Bourgogne,21,1,29,440,Montot,197,4,201
26,Bourgogne,21,2,15,442,Morey-Saint-Denis,687,12,699
26,Bourgogne,21,3,08,444,Mosson,87,2,89
26,Bourgogne,21,3,31,445,La Motte-Ternant,167,3,170
26,Bourgogne,21,3,21,446,Moutiers-Saint-Jean,261,4,265
26,Bourgogne,21,1,02,447,Musigny,90,1,91
26,Bourgogne,21,3,36,448,Mussy-la-Fosse,79,1,80
26,Bourgogne,21,3,27,449,Nan-sous-Thil,179,3,182
26,Bourgogne,21,1,05,450,Nantoux,195,7,202
26,Bourgogne,21,3,18,451,Nesle-et-Massoult,85,6,91
26,Bourgogne,21,2,38,452,Neuilly-lès-Dijon,1920,29,1949
26,Bourgogne,21,3,18,454,Nicey,134,3,137
26,Bourgogne,21,3,08,455,Nod-sur-Seine,265,6,271
26,Bourgogne,21,3,21,456,Nogent-lès-Montbard,135,6,141
26,Bourgogne,21,3,27,457,Noidan,87,3,90
26,Bourgogne,21,2,15,458,Noiron-sous-Gevrey,1024,9,1033
26,Bourgogne,21,2,20,459,Noiron-sur-Bèze,218,4,222
26,Bourgogne,21,3,08,460,Noiron-sur-Seine,85,0,85
26,Bourgogne,21,1,23,461,Nolay,1496,25,1521
26,Bourgogne,21,2,43,462,Norges-la-Ville,905,25,930
26,Bourgogne,21,3,27,463,Normier,48,8,56
26,Bourgogne,21,1,24,464,Nuits-Saint-Georges,5516,110,5626
26,Bourgogne,21,3,08,465,Obtrée,72,0,72
26,Bourgogne,21,3,04,466,Oigny,35,2,37
26,Bourgogne,21,2,20,467,Oisilly,137,0,137
26,Bourgogne,21,2,13,468,Orain,95,3,98
26,Bourgogne,21,2,09,469,Orgeux,464,9,473
26,Bourgogne,21,3,01,470,Origny,35,0,35
26,Bourgogne,21,3,04,471,Orret,24,0,24
26,Bourgogne,21,2,32,472,Orville,195,5,200
26,Bourgogne,21,2,38,473,Ouges,1173,21,1194
26,Bourgogne,21,1,34,474,Pagny-la-Ville,422,6,428
26,Bourgogne,21,1,34,475,Pagny-le-Château,501,5,506
26,Bourgogne,21,1,07,476,Painblanc,163,2,165
26,Bourgogne,21,2,30,477,Panges,77,2,79
26,Bourgogne,21,2,39,478,Pasques,294,8,302
26,Bourgogne,21,2,30,479,Pellerey,95,2,97
26,Bourgogne,21,1,05,480,Pernand-Vergelesses,269,15,284
26,Bourgogne,21,2,38,481,Perrigny-lès-Dijon,1461,29,1490
26,Bourgogne,21,2,25,482,Perrigny-sur-l'Ognon,650,7,657
26,Bourgogne,21,2,17,483,Pichanges,252,5,257
26,Bourgogne,21,3,18,484,Planay,81,1,82
26,Bourgogne,21,2,43,485,Plombières-lès-Dijon,2853,107,2960
26,Bourgogne,21,2,14,486,Pluvault,534,12,546
26,Bourgogne,21,2,14,487,Pluvet,411,3,414
26,Bourgogne,21,3,18,488,Poinçon-lès-Larrey,201,2,203
26,Bourgogne,21,2,30,489,Poiseul-la-Grange,73,2,75
26,Bourgogne,21,3,04,490,Poiseul-la-Ville-et-Laperrière,169,5,174
26,Bourgogne,21,2,17,491,Poiseul-lès-Saulx,60,0,60
26,Bourgogne,21,1,05,492,Pommard,541,13,554
26,Bourgogne,21,2,03,493,Poncey-lès-Athée,544,11,555
26,Bourgogne,21,2,30,494,Poncey-sur-l'Ignon,85,0,85
26,Bourgogne,21,2,03,495,Pont,91,1,92
26,Bourgogne,21,3,33,497,Pont-et-Massène,199,10,209
26,Bourgogne,21,2,25,496,Pontailler-sur-Saône,1278,22,1300
26,Bourgogne,21,3,37,498,Posanges,63,2,65
26,Bourgogne,21,3,08,499,Pothières,188,6,194
26,Bourgogne,21,3,36,500,Pouillenay,552,10,562
26,Bourgogne,21,1,26,501,Pouilly-en-Auxois,1507,146,1653
26,Bourgogne,21,1,34,502,Pouilly-sur-Saône,670,8,678
26,Bourgogne,21,2,13,503,Pouilly-sur-Vingeanne,114,2,116
26,Bourgogne,21,2,35,504,Prâlon,80,3,83
26,Bourgogne,21,3,27,505,Précy-sous-Thil,768,24,792
26,Bourgogne,21,1,24,506,Premeaux-Prissey,382,6,388
26,Bourgogne,21,2,14,507,Premières,98,2,100
26,Bourgogne,21,2,39,508,Prenois,397,10,407
26,Bourgogne,21,3,08,510,Prusly-sur-Ource,175,4,179
26,Bourgogne,21,3,18,511,Puits,140,5,145
26,Bourgogne,21,1,23,512,Puligny-Montrachet,424,9,433
26,Bourgogne,21,2,15,513,Quemigny-Poisot,202,10,212
26,Bourgogne,21,3,01,514,Quemigny-sur-Seine,116,3,119
26,Bourgogne,21,2,10,515,Quetigny,9615,420,10035
26,Bourgogne,21,3,21,516,Quincerot,104,0,104
26,Bourgogne,21,1,24,517,Quincey,409,12,421
26,Bourgogne,21,3,21,518,Quincy-le-Vicomte,197,11,208
26,Bourgogne,21,3,28,519,Recey-sur-Ource,390,11,401
26,Bourgogne,21,2,35,520,Remilly-en-Montagne,129,4,133
26,Bourgogne,21,2,10,521,Remilly-sur-Tille,783,16,799
26,Bourgogne,21,2,20,522,Renève,437,3,440
26,Bourgogne,21,2,15,523,Reulle-Vergy,100,4,104
26,Bourgogne,21,3,22,524,Riel-les-Eaux,77,1,78
26,Bourgogne,21,3,31,525,La Roche-en-Brenil,919,18,937
26,Bourgogne,21,3,36,528,La Roche-Vanneau,139,7,146
26,Bourgogne,21,3,01,526,Rochefort-sur-Brévon,43,2,45
26,Bourgogne,21,1,23,527,La Rochepot,280,6,286
26,Bourgogne,21,3,27,529,Roilly,33,1,34
26,Bourgogne,21,3,21,530,Rougemont,174,4,178
26,Bourgogne,21,3,31,531,Rouvray,642,9,651
26,Bourgogne,21,2,14,532,Rouvres-en-Plaine,999,16,1015
26,Bourgogne,21,1,26,533,Rouvres-sous-Meilly,101,6,107
26,Bourgogne,21,1,06,534,Ruffey-lès-Beaune,678,83,761
26,Bourgogne,21,2,09,535,Ruffey-lès-Echirey,1132,32,1164
26,Bourgogne,21,2,32,536,Sacquenay,263,4,267
26,Bourgogne,21,3,37,537,Saffres,119,4,123
26,Bourgogne,21,3,31,538,Saint-Andeux,126,5,131
26,Bourgogne,21,2,35,539,Saint-Anthot,50,0,50
26,Bourgogne,21,2,09,540,Saint-Apollinaire,6273,112,6385
26,Bourgogne,21,1,23,541,Saint-Aubin,270,7,277
26,Bourgogne,21,1,24,542,Saint-Bernard,410,3,413
26,Bourgogne,21,3,28,543,Saint-Broing-les-Moines,186,3,189
26,Bourgogne,21,3,31,546,Saint-Didier,208,0,208
26,Bourgogne,21,3,33,547,Saint-Euphrône,198,7,205
26,Bourgogne,21,3,31,548,Saint-Germain-de-Modéon,185,4,189
26,Bourgogne,21,3,01,549,Saint-Germain-le-Rocheux,93,4,97
26,Bourgogne,21,3,21,550,Saint-Germain-lès-Senailly,94,2,96
26,Bourgogne,21,3,37,552,Saint-Hélier,39,0,39
26,Bourgogne,21,2,35,553,Saint-Jean-de-Boeuf,109,0,109
26,Bourgogne,21,1,29,554,Saint-Jean-de-Losne,1204,14,1218
26,Bourgogne,21,2,09,555,Saint-Julien,1396,45,1441
26,Bourgogne,21,2,25,556,Saint-Léger-Triey,204,2,206
26,Bourgogne,21,3,04,557,Saint-Marc-sur-Seine,124,8,132
26,Bourgogne,21,1,19,560,Saint-Martin-de-la-Mer,283,2,285
26,Bourgogne,21,2,30,561,Saint-Martin-du-Mont,440,10,450
26,Bourgogne,21,2,13,562,Saint-Maurice-sur-Vingeanne,201,8,209
26,Bourgogne,21,3,37,563,Saint-Mesmin,125,1,126
26,Bourgogne,21,1,24,564,Saint-Nicolas-lès-Cîteaux,454,10,464
26,Bourgogne,21,2,15,565,Saint-Philibert,441,2,443
26,Bourgogne,21,1,02,566,Saint-Pierre-en-Vaux,132,0,132
26,Bourgogne,21,1,02,567,Saint-Prix-lès-Arnay,246,6,252
26,Bourgogne,21,3,21,568,Saint-Rémy,810,25,835
26,Bourgogne,21,1,23,569,Saint-Romain,246,9,255
26,Bourgogne,21,2,25,571,Saint-Sauveur,196,2,198
26,Bourgogne,21,1,29,572,Saint-Seine-en-Bâche,278,3,281
26,Bourgogne,21,2,30,573,Saint-Seine-l'Abbaye,364,43,407
26,Bourgogne,21,2,13,574,Saint-Seine-sur-Vingeanne,370,8,378
26,Bourgogne,21,1,29,575,Saint-Symphorien-sur-Saône,333,6,339
26,Bourgogne,21,3,37,576,Saint-Thibault,148,5,153
26,Bourgogne,21,1,29,577,Saint-Usage,1127,10,1137
26,Bourgogne,21,2,35,578,Saint-Victor-sur-Ouche,230,4,234
26,Bourgogne,21,3,37,544,Sainte-Colombe,69,1,70
26,Bourgogne,21,3,08,545,Sainte-Colombe-sur-Seine,895,25,920
26,Bourgogne,21,1,06,558,Sainte-Marie-la-Blanche,798,19,817
26,Bourgogne,21,2,35,559,Sainte-Marie-sur-Ouche,637,44,681
26,Bourgogne,21,1,26,570,Sainte-Sabine,186,6,192
26,Bourgogne,21,2,16,579,Salives,267,11,278
26,Bourgogne,21,3,36,580,Salmaise,143,6,149
26,Bourgogne,21,1,29,581,Samerey,131,4,135
26,Bourgogne,21,1,23,582,Santenay,836,15,851
26,Bourgogne,21,1,23,583,Santosse,47,1,48
26,Bourgogne,21,3,31,584,Saulieu,2588,123,2711
26,Bourgogne,21,2,15,585,Saulon-la-Chapelle,1068,15,1083
26,Bourgogne,21,2,15,586,Saulon-la-Rue,571,6,577
26,Bourgogne,21,2,17,587,Saulx-le-Duc,262,2,264
26,Bourgogne,21,1,07,588,Saussey,84,4,88
26,Bourgogne,21,2,30,589,Saussy,101,0,101
26,Bourgogne,21,2,43,591,Savigny-le-Sec,823,20,843
26,Bourgogne,21,1,05,590,Savigny-lès-Beaune,1372,40,1412
26,Bourgogne,21,2,35,592,Savigny-sous-Mâlain,203,5,208
26,Bourgogne,21,1,19,593,Savilly,76,1,77
26,Bourgogne,21,3,18,594,Savoisy,227,4,231
26,Bourgogne,21,2,20,595,Savolles,164,5,169
26,Bourgogne,21,2,15,596,Savouges,372,1,373
26,Bourgogne,21,2,15,597,Segrois,51,1,52
26,Bourgogne,21,3,21,598,Seigny,165,3,168
26,Bourgogne,21,2,32,599,Selongey,2335,56,2391
26,Bourgogne,21,1,26,600,Semarey,111,2,113
26,Bourgogne,21,2,15,601,Semezanges,108,6,114
26,Bourgogne,21,3,04,602,Semond,31,0,31
26,Bourgogne,21,3,33,603,Semur-en-Auxois,4240,375,4615
26,Bourgogne,21,3,21,604,Senailly,143,7,150
26,Bourgogne,21,2,10,605,Sennecey-lès-Dijon,2254,38,2292
26,Bourgogne,21,1,34,607,Seurre,2446,28,2474
26,Bourgogne,21,3,31,608,Sincey-lès-Rouvray,120,2,122
26,Bourgogne,21,2,03,609,Soirans,470,1,471
26,Bourgogne,21,2,25,610,Soissons-sur-Nacey,306,4,310
26,Bourgogne,21,2,35,611,Sombernon,968,14,982
26,Bourgogne,21,3,33,612,Souhey,87,5,92
26,Bourgogne,21,3,36,084,Source-Seine,50,0,50
26,Bourgogne,21,3,37,613,Soussey-sur-Brionne,132,3,135
26,Bourgogne,21,2,17,614,Spoy,293,7,300
26,Bourgogne,21,1,19,615,Sussey,246,3,249
26,Bourgogne,21,1,06,616,Tailly,195,8,203
26,Bourgogne,21,2,43,617,Talant,11750,259,12009
26,Bourgogne,21,2,25,618,Talmay,484,11,495
26,Bourgogne,21,2,20,619,Tanay,227,3,230
26,Bourgogne,21,2,17,620,Tarsul,165,0,165
26,Bourgogne,21,2,14,621,Tart-l'Abbaye,233,11,244
26,Bourgogne,21,2,14,622,Tart-le-Bas,237,3,240
26,Bourgogne,21,2,14,623,Tart-le-Haut,1413,7,1420
26,Bourgogne,21,2,25,624,Tellecey,127,1,128
26,Bourgogne,21,2,15,625,Ternant,104,3,107
26,Bourgogne,21,3,28,626,Terrefondrée,60,3,63
26,Bourgogne,21,3,36,627,Thenissey,119,5,124
26,Bourgogne,21,3,22,628,Thoires,80,1,81
26,Bourgogne,21,3,31,629,Thoisy-la-Berchère,300,5,305
26,Bourgogne,21,1,26,630,Thoisy-le-Désert,197,3,200
26,Bourgogne,21,1,07,631,Thomirey,57,1,58
26,Bourgogne,21,2,14,632,Thorey-en-Plaine,992,14,1006
26,Bourgogne,21,3,37,633,Thorey-sous-Charny,188,4,192
26,Bourgogne,21,1,07,634,Thorey-sur-Ouche,151,0,151
26,Bourgogne,21,3,27,635,Thoste,118,7,125
26,Bourgogne,21,1,23,636,Thury,292,4,296
26,Bourgogne,21,1,34,637,Tichey,199,3,202
26,Bourgogne,21,2,17,638,Til-Châtel,974,13,987
26,Bourgogne,21,2,03,639,Tillenay,659,9,668
26,Bourgogne,21,3,33,640,Torcy-et-Pouligny,151,5,156
26,Bourgogne,21,3,21,641,Touillon,406,11,417
26,Bourgogne,21,3,33,642,Toutry,477,19,496
26,Bourgogne,21,2,03,643,Tréclun,326,2,328
26,Bourgogne,21,2,20,644,Trochères,185,1,186
26,Bourgogne,21,1,29,645,Trouhans,635,6,641
26,Bourgogne,21,2,30,646,Trouhaut,107,0,107
26,Bourgogne,21,1,34,647,Trugny,114,0,114
26,Bourgogne,21,2,30,648,Turcey,175,6,181
26,Bourgogne,21,3,37,649,Uncey-le-Franc,48,3,51
26,Bourgogne,21,2,15,650,Urcy,144,3,147
26,Bourgogne,21,2,30,651,Val-Suzon,220,11,231
26,Bourgogne,21,1,26,652,Vandenesse-en-Auxois,275,8,283
26,Bourgogne,21,3,08,653,Vannaire,67,1,68
26,Bourgogne,21,3,08,655,Vanvey,249,19,268
26,Bourgogne,21,2,14,656,Varanges,798,14,812
26,Bourgogne,21,2,09,657,Varois-et-Chaignot,1971,49,2020
26,Bourgogne,21,1,23,658,Vauchignon,39,0,39
26,Bourgogne,21,2,30,659,Vaux-Saules,172,0,172
26,Bourgogne,21,1,07,660,Veilly,54,3,57
26,Bourgogne,21,2,39,661,Velars-sur-Ouche,1689,46,1735
26,Bourgogne,21,3,37,662,Velogny,37,0,37
26,Bourgogne,21,3,36,663,Venarey-les-Laumes,3046,76,3122
26,Bourgogne,21,3,18,664,Verdonnet,86,1,87
26,Bourgogne,21,2,32,665,Vernois-lès-Vesvres,190,3,193
26,Bourgogne,21,2,17,666,Vernot,76,2,78
26,Bourgogne,21,2,32,667,Véronnes,381,8,389
26,Bourgogne,21,2,35,669,Verrey-sous-Drée,50,0,50
26,Bourgogne,21,3,36,670,Verrey-sous-Salmaise,318,9,327
26,Bourgogne,21,3,18,671,Vertault,54,1,55
26,Bourgogne,21,3,37,672,Vesvres,25,1,26
26,Bourgogne,21,1,07,673,Veuvey-sur-Ouche,185,1,186
26,Bourgogne,21,3,22,674,Veuxhaulles-sur-Aube,232,7,239
26,Bourgogne,21,1,19,675,Vianges,73,2,75
26,Bourgogne,21,3,33,676,Vic-de-Chassenay,235,12,247
26,Bourgogne,21,1,07,677,Vic-des-Prés,102,0,102
26,Bourgogne,21,3,27,678,Vic-sous-Thil,205,8,213
26,Bourgogne,21,2,35,679,Vieilmoulin,98,2,100
26,Bourgogne,21,2,25,680,Vielverge,494,2,496
26,Bourgogne,21,3,33,681,Vieux-Château,100,1,101
26,Bourgogne,21,2,20,682,Viévigne,208,2,210
26,Bourgogne,21,1,02,683,Viévy,355,8,363
26,Bourgogne,21,1,06,684,Vignoles,770,15,785
26,Bourgogne,21,3,04,685,Villaines-en-Duesmois,303,7,310
26,Bourgogne,21,3,21,686,Villaines-les-Prévôtes,137,9,146
26,Bourgogne,21,3,31,687,Villargoix,172,4,176
26,Bourgogne,21,3,33,689,Villars-et-Villenotte,155,7,162
26,Bourgogne,21,1,24,688,Villars-Fontaine,129,5,134
26,Bourgogne,21,3,37,690,Villeberny,84,3,87
26,Bourgogne,21,1,24,691,Villebichot,351,6,357
26,Bourgogne,21,2,17,692,Villecomte,255,3,258
26,Bourgogne,21,3,18,693,Villedieu,83,4,87
26,Bourgogne,21,3,37,694,Villeferry,30,1,31
26,Bourgogne,21,3,04,695,La Villeneuve-les-Convers,40,1,41
26,Bourgogne,21,3,33,696,Villeneuve-sous-Charigny,96,3,99
26,Bourgogne,21,1,24,698,Villers-la-Faye,401,9,410
26,Bourgogne,21,2,03,699,Villers-les-Pots,1020,17,1037
26,Bourgogne,21,3,08,700,Villers-Patras,95,4,99
26,Bourgogne,21,2,03,701,Villers-Rotin,134,1,135
26,Bourgogne,21,2,17,702,Villey-sur-Tille,286,4,290
26,Bourgogne,21,1,19,703,Villiers-en-Morvan,42,1,43
26,Bourgogne,21,3,08,704,Villiers-le-Duc,110,4,114
26,Bourgogne,21,2,30,705,Villotte-Saint-Seine,66,0,66
26,Bourgogne,21,3,08,706,Villotte-sur-Ource,113,3,116
26,Bourgogne,21,3,37,707,Villy-en-Auxois,243,0,243
26,Bourgogne,21,1,24,708,Villy-le-Moutier,330,1,331
26,Bourgogne,21,3,21,709,Viserny,203,7,210
26,Bourgogne,21,3,37,710,Vitteaux,1096,38,1134
26,Bourgogne,21,3,08,711,Vix,109,6,115
26,Bourgogne,21,1,05,712,Volnay,286,6,292
26,Bourgogne,21,2,25,713,Vonges,334,7,341
26,Bourgogne,21,1,24,714,Vosne-Romanée,427,10,437
26,Bourgogne,21,1,02,715,Voudenay,194,1,195
26,Bourgogne,21,1,24,716,Vougeot,201,3,204
26,Bourgogne,21,3,28,717,Voulaines-les-Templiers,320,18,338
53,Bretagne,22,4,48,001,Allineuc,524,7,531
53,Bretagne,22,4,18,002,Andel,1055,22,1077
53,Bretagne,22,1,12,003,Aucaleuc,875,27,902
53,Bretagne,22,2,01,004,Bégard,4597,76,4673
53,Bretagne,22,2,02,005,Belle-Isle-en-Terre,1057,24,1081
53,Bretagne,22,3,42,006,Berhet,209,7,216
53,Bretagne,22,4,13,007,Binic,3528,86,3614
53,Bretagne,22,1,12,008,Bobital,997,25,1022
53,Bretagne,22,4,34,009,Le Bodéo,183,5,188
53,Bretagne,22,4,07,011,Boqueho,1011,20,1031
53,Bretagne,22,1,24,012,La Bouillie,822,17,839
53,Bretagne,22,2,03,013,Bourbriac,2346,56,2402
53,Bretagne,22,1,30,014,Bourseul,1038,20,1058
53,Bretagne,22,4,26,015,Bréhand,1421,24,1445
53,Bretagne,22,2,40,018,Brélidy,301,12,313
53,Bretagne,22,2,35,019,Bringolo,366,8,374
53,Bretagne,22,1,04,020,Broons,2829,71,2900
53,Bretagne,22,1,12,021,Brusvily,1008,26,1034
53,Bretagne,22,2,05,023,Bulat-Pestivien,474,9,483
53,Bretagne,22,2,05,024,Calanhel,252,9,261
53,Bretagne,22,2,05,025,Callac,2351,37,2388
53,Bretagne,22,1,12,026,Calorguen,665,25,690
53,Bretagne,22,4,08,027,Le Cambout,499,18,517
53,Bretagne,22,3,47,028,Camlez,813,28,841
53,Bretagne,22,2,46,029,Canihuel,376,14,390
53,Bretagne,22,3,19,030,Caouënnec-Lanvézéac,836,15,851
53,Bretagne,22,2,05,031,Carnoët,756,6,762
53,Bretagne,22,1,06,032,Caulnes,2303,132,2435
53,Bretagne,22,2,27,033,Caurel,384,13,397
53,Bretagne,22,3,42,034,Cavan,1383,26,1409
53,Bretagne,22,1,14,035,Les Champs-Géraux,1015,13,1028
53,Bretagne,22,1,06,036,La Chapelle-Blanche,221,4,225
53,Bretagne,22,2,02,037,La Chapelle-Neuve,425,10,435
53,Bretagne,22,4,07,038,Châtelaudren,1073,44,1117
53,Bretagne,22,4,08,039,La Chèze,637,24,661
53,Bretagne,22,2,16,040,Coadout,517,5,522
53,Bretagne,22,3,42,041,Coatascorn,253,4,257
53,Bretagne,22,3,47,042,Coatréven,421,18,439
53,Bretagne,22,4,08,043,Coëtlogon,235,7,242
53,Bretagne,22,4,18,044,Coëtmieux,1547,27,1574
53,Bretagne,22,4,07,045,Cohiniac,350,6,356
53,Bretagne,22,1,09,046,Collinée,927,25,952
53,Bretagne,22,4,10,047,Corlay,1046,24,1070
53,Bretagne,22,1,30,048,Corseul,1975,88,2063
53,Bretagne,22,1,30,049,Créhen,1660,66,1726
53,Bretagne,22,1,98,050,Dinan,10953,489,11442
53,Bretagne,22,1,17,051,Dolo,554,6,560
53,Bretagne,22,2,05,052,Duault,339,12,351
53,Bretagne,22,1,04,053,Éréac,627,7,634
53,Bretagne,22,4,32,054,Erquy,3783,91,3874
53,Bretagne,22,4,13,055,Étables-sur-Mer,2999,75,3074
53,Bretagne,22,1,14,056,Évran,1632,23,1655
53,Bretagne,22,4,20,057,Le Faouët,299,5,304
53,Bretagne,22,4,08,058,La Ferrière,459,13,472
53,Bretagne,22,4,41,059,Le Foeil,1405,42,1447
53,Bretagne,22,1,24,179,Fréhel,1551,35,1586
53,Bretagne,22,4,38,060,Gausson,593,22,615
53,Bretagne,22,2,43,061,Glomel,1381,62,1443
53,Bretagne,22,1,25,062,Gomené,598,16,614
53,Bretagne,22,4,20,063,Gommenec'h,515,11,526
53,Bretagne,22,2,15,064,Gouarec,947,31,978
53,Bretagne,22,2,35,065,Goudelin,1616,37,1653
53,Bretagne,22,1,09,066,Le Gouray,1140,15,1155
53,Bretagne,22,4,48,068,Grâce-Uzel,404,12,416
53,Bretagne,22,2,16,067,Grâces,2404,73,2477
53,Bretagne,22,1,06,069,Guenroc,197,6,203
53,Bretagne,22,2,16,070,Guingamp,7477,786,8263
53,Bretagne,22,1,06,071,Guitté,623,16,639
53,Bretagne,22,2,02,072,Gurunhuel,399,10,409
53,Bretagne,22,4,34,073,La Harmoye,423,12,435
53,Bretagne,22,4,10,074,Le Haut-Corlay,705,26,731
53,Bretagne,22,4,22,075,Hémonstoir,660,8,668
53,Bretagne,22,1,24,076,Hénanbihen,1339,32,1371
53,Bretagne,22,1,24,077,Hénansal,1063,23,1086
53,Bretagne,22,3,42,078,Hengoat,210,5,215
53,Bretagne,22,4,26,079,Hénon,2105,35,2140
53,Bretagne,22,4,34,080,L' Hermitage-Lorge,754,18,772
53,Bretagne,22,4,49,081,Hillion,4101,82,4183
53,Bretagne,22,1,12,082,Le Hinglé,847,33,880
53,Bretagne,22,4,28,016,Île-de-Bréhat,444,11,455
53,Bretagne,22,1,25,083,Illifaut,687,18,705
53,Bretagne,22,1,17,084,Jugon-les-Lacs,1636,37,1673
53,Bretagne,22,3,21,085,Kerbors,326,10,336
53,Bretagne,22,4,28,086,Kerfot,611,19,630
53,Bretagne,22,2,43,087,Kergrist-Moëlou,661,18,679
53,Bretagne,22,2,03,088,Kerien,275,3,278
53,Bretagne,22,3,29,090,Kermaria-Sulard,958,30,988
53,Bretagne,22,2,01,091,Kermoroc'h,395,5,400
53,Bretagne,22,2,46,092,Kerpert,297,4,301
53,Bretagne,22,4,18,093,Lamballe,11705,434,12139
53,Bretagne,22,1,37,094,Lancieux,1412,49,1461
53,Bretagne,22,2,01,095,Landebaëron,202,4,206
53,Bretagne,22,1,30,096,Landébia,462,12,474
53,Bretagne,22,1,31,097,La Landec,689,19,708
53,Bretagne,22,4,18,098,Landéhen,1284,22,1306
53,Bretagne,22,4,34,099,Lanfains,987,39,1026
53,Bretagne,22,4,38,100,Langast,634,22,656
53,Bretagne,22,3,47,101,Langoat,1128,45,1173
53,Bretagne,22,1,09,102,Langourla,579,4,583
53,Bretagne,22,1,37,103,Langrolay-sur-Rance,838,23,861
53,Bretagne,22,1,31,104,Languédias,457,32,489
53,Bretagne,22,1,30,105,Languenan,1039,22,1061
53,Bretagne,22,4,49,106,Langueux,7018,355,7373
53,Bretagne,22,2,15,107,Laniscat,823,19,842
53,Bretagne,22,4,39,108,Lanleff,103,6,109
53,Bretagne,22,4,39,109,Lanloup,276,8,284
53,Bretagne,22,3,47,110,Lanmérin,478,6,484
53,Bretagne,22,3,21,111,Lanmodez,443,9,452
53,Bretagne,22,4,20,112,Lannebert,405,7,412
53,Bretagne,22,3,19,113,Lannion,19733,877,20610
53,Bretagne,22,1,04,114,Lanrelas,850,16,866
53,Bretagne,22,2,46,115,Lanrivain,564,14,578
53,Bretagne,22,2,35,116,Lanrodec,1050,139,1189
53,Bretagne,22,4,13,117,Lantic,1426,31,1457
53,Bretagne,22,1,11,118,Lanvallay,3550,134,3684
53,Bretagne,22,3,33,119,Lanvellec,546,7,553
53,Bretagne,22,4,20,121,Lanvollon,1728,41,1769
53,Bretagne,22,1,25,122,Laurenan,716,20,736
53,Bretagne,22,1,11,123,Léhon,2937,136,3073
53,Bretagne,22,2,15,124,Lescouët-Gouarec,218,9,227
53,Bretagne,22,4,41,126,Le Leslay,125,4,129
53,Bretagne,22,3,21,127,Lézardrieux,1624,46,1670
53,Bretagne,22,2,02,129,Loc-Envel,84,1,85
53,Bretagne,22,2,23,128,Locarn,527,20,547
53,Bretagne,22,3,36,131,Loguivy-Plougras,961,28,989
53,Bretagne,22,2,05,132,Lohuec,273,3,276
53,Bretagne,22,1,25,133,Loscouët-sur-Meu,654,20,674
53,Bretagne,22,3,29,134,Louannec,2912,125,3037
53,Bretagne,22,2,02,135,Louargat,2230,65,2295
53,Bretagne,22,4,22,136,Loudéac,9733,432,10165
53,Bretagne,22,2,23,137,Maël-Carhaix,1565,30,1595
53,Bretagne,22,2,05,138,Maël-Pestivien,403,10,413
53,Bretagne,22,2,03,139,Magoar,90,7,97
53,Bretagne,22,4,18,140,La Malhoure,458,8,466
53,Bretagne,22,3,42,141,Mantallot,187,3,190
53,Bretagne,22,1,24,143,Matignon,1563,46,1609
53,Bretagne,22,4,51,144,La Méaugon,1295,41,1336
53,Bretagne,22,1,04,145,Mégrit,700,15,715
53,Bretagne,22,2,15,146,Mellionnec,405,17,422
53,Bretagne,22,1,25,147,Merdrignac,2923,171,3094
53,Bretagne,22,1,25,148,Mérillac,233,6,239
53,Bretagne,22,4,48,149,Merléac,507,5,512
53,Bretagne,22,4,20,150,Le Merzer,857,19,876
53,Bretagne,22,4,18,151,Meslin,922,21,943
53,Bretagne,22,3,47,152,Minihy-Tréguier,1096,58,1154
53,Bretagne,22,4,26,153,Moncontour,937,19,956
53,Bretagne,22,4,18,154,Morieux,882,16,898
53,Bretagne,22,4,22,155,La Motte,2018,54,2072
53,Bretagne,22,2,16,156,Moustéru,679,10,689
53,Bretagne,22,2,23,157,Le Moustoir,649,18,667
53,Bretagne,22,2,27,158,Mûr-de-Bretagne,2094,60,2154
53,Bretagne,22,4,18,160,Noyal,820,23,843
53,Bretagne,22,2,16,161,Pabu,2777,143,2920
53,Bretagne,22,4,28,162,Paimpol,7835,415,8250
53,Bretagne,22,2,23,163,Paule,713,24,737
53,Bretagne,22,2,01,164,Pédernec,1870,55,1925
53,Bretagne,22,4,26,165,Penguily,583,8,591
53,Bretagne,22,3,47,166,Penvénan,2617,98,2715
53,Bretagne,22,2,15,167,Perret,179,3,182
53,Bretagne,22,3,29,168,Perros-Guirec,7297,307,7604
53,Bretagne,22,2,46,169,Peumerit-Quintin,163,0,163
53,Bretagne,22,4,41,170,Plaine-Haute,1307,25,1332
53,Bretagne,22,4,34,171,Plaintel,3810,136,3946
53,Bretagne,22,1,30,172,Plancoët,3089,75,3164
53,Bretagne,22,4,32,173,Planguenoual,1840,34,1874
53,Bretagne,22,1,24,174,Pléboulle,718,17,735
53,Bretagne,22,1,17,175,Plédéliac,1262,38,1300
53,Bretagne,22,4,51,176,Plédran,5872,112,5984
53,Bretagne,22,4,20,177,Pléguien,1114,36,1150
53,Bretagne,22,4,39,178,Pléhédel,1309,27,1336
53,Bretagne,22,1,31,180,Plélan-le-Petit,1710,67,1777
53,Bretagne,22,2,15,181,Plélauff,693,32,725
53,Bretagne,22,4,07,182,Plélo,3234,90,3324
53,Bretagne,22,4,08,183,Plémet,2929,153,3082
53,Bretagne,22,4,38,184,Plémy,1627,42,1669
53,Bretagne,22,1,17,185,Plénée-Jugon,2427,66,2493
53,Bretagne,22,4,32,186,Pléneuf-Val-André,3949,108,4057
53,Bretagne,22,4,50,187,Plérin,13522,581,14103
53,Bretagne,22,4,07,188,Plerneuf,1022,35,1057
53,Bretagne,22,2,03,189,Plésidy,697,53,750
53,Bretagne,22,1,37,190,Pleslin-Trigavou,3463,74,3537
53,Bretagne,22,4,38,191,Plessala,1852,54,1906
53,Bretagne,22,1,37,192,Plessix-Balisson,93,0,93
53,Bretagne,22,1,17,193,Plestan,1540,40,1580
53,Bretagne,22,3,33,194,Plestin-les-Grèves,3673,123,3796
53,Bretagne,22,3,21,195,Pleubian,2531,64,2595
53,Bretagne,22,3,21,196,Pleudaniel,1011,33,1044
53,Bretagne,22,1,11,197,Pleudihen-sur-Rance,2775,82,2857
53,Bretagne,22,3,29,198,Pleumeur-Bodou,4017,183,4200
53,Bretagne,22,3,21,199,Pleumeur-Gautier,1139,21,1160
53,Bretagne,22,1,30,200,Pléven,609,17,626
53,Bretagne,22,1,24,201,Plévenon,709,14,723
53,Bretagne,22,2,23,202,Plévin,789,30,819
53,Bretagne,22,4,34,203,Ploeuc-sur-Lié,3224,66,3290
53,Bretagne,22,2,40,204,Ploëzal,1194,36,1230
53,Bretagne,22,1,31,205,Plorec-sur-Arguenon,395,6,401
53,Bretagne,22,2,35,206,Plouagat,2436,58,2494
53,Bretagne,22,3,36,207,Plouaret,2216,49,2265
53,Bretagne,22,1,14,208,Plouasne,1511,28,1539
53,Bretagne,22,1,37,209,Ploubalay,2606,56,2662
53,Bretagne,22,4,28,210,Ploubazlanec,3238,178,3416
53,Bretagne,22,3,19,211,Ploubezre,3105,85,3190
53,Bretagne,22,2,40,212,Plouëc-du-Trieux,1106,25,1131
53,Bretagne,22,1,12,213,Plouër-sur-Rance,3329,117,3446
53,Bretagne,22,4,28,214,Plouézec,3338,94,3432
53,Bretagne,22,4,51,215,Ploufragan,10953,453,11406
53,Bretagne,22,2,02,216,Plougonver,702,20,722
53,Bretagne,22,3,36,217,Plougras,462,15,477
53,Bretagne,22,3,47,218,Plougrescant,1348,49,1397
53,Bretagne,22,4,38,219,Plouguenast,1809,66,1875
53,Bretagne,22,2,43,220,Plouguernével,1817,62,1879
53,Bretagne,22,3,47,221,Plouguiel,1899,61,1960
53,Bretagne,22,4,39,222,Plouha,4558,97,4655
53,Bretagne,22,2,16,223,Plouisy,1908,230,2138
53,Bretagne,22,3,19,224,Ploulec'h,1649,62,1711
53,Bretagne,22,2,16,225,Ploumagoar,4983,115,5098
53,Bretagne,22,3,33,226,Ploumilliau,2534,60,2594
53,Bretagne,22,3,36,227,Plounérin,743,13,756
53,Bretagne,22,3,36,228,Plounévez-Moëdec,1433,34,1467
53,Bretagne,22,2,43,229,Plounévez-Quintin,1095,60,1155
53,Bretagne,22,2,05,231,Plourac'h,350,10,360
53,Bretagne,22,4,13,232,Plourhan,1945,48,1993
53,Bretagne,22,4,28,233,Plourivo,2162,75,2237
53,Bretagne,22,4,07,234,Plouvara,1084,32,1116
53,Bretagne,22,3,33,235,Plouzélambre,214,9,223
53,Bretagne,22,4,39,236,Pludual,684,17,701
53,Bretagne,22,1,30,237,Pluduno,1963,51,2014
53,Bretagne,22,3,33,238,Plufur,547,21,568
53,Bretagne,22,1,06,239,Plumaudan,1067,19,1086
53,Bretagne,22,1,06,240,Plumaugat,1050,27,1077
53,Bretagne,22,4,08,241,Plumieux,1086,27,1113
53,Bretagne,22,4,32,242,Plurien,1378,31,1409
53,Bretagne,22,2,05,243,Plusquellec,531,23,554
53,Bretagne,22,4,10,244,Plussulien,487,5,492
53,Bretagne,22,3,36,245,Pluzunet,1016,37,1053
53,Bretagne,22,4,18,246,Pommeret,1852,52,1904
53,Bretagne,22,3,42,247,Pommerit-Jaudy,1227,465,1692
53,Bretagne,22,4,20,248,Pommerit-le-Vicomte,1839,44,1883
53,Bretagne,22,2,03,249,Pont-Melvez,660,15,675
53,Bretagne,22,2,40,250,Pontrieux,1081,20,1101
53,Bretagne,22,4,50,251,Pordic,5737,165,5902
53,Bretagne,22,3,42,253,Pouldouran,152,9,161
53,Bretagne,22,3,42,254,Prat,1121,39,1160
53,Bretagne,22,4,08,255,La Prénessaye,834,16,850
53,Bretagne,22,2,40,256,Quemper-Guézennec,1065,22,1087
53,Bretagne,22,3,42,257,Quemperven,383,15,398
53,Bretagne,22,4,26,258,Quessoy,3396,255,3651
53,Bretagne,22,1,12,259,Quévert,3488,142,3630
53,Bretagne,22,4,48,260,Le Quillio,540,15,555
53,Bretagne,22,4,18,261,Quintenic,319,10,329
53,Bretagne,22,4,41,262,Quintin,2835,201,3036
53,Bretagne,22,1,14,263,Le Quiou,327,5,332
53,Bretagne,22,3,42,264,La Roche-Derrien,1064,44,1108
53,Bretagne,22,3,19,265,Rospez,1710,51,1761
53,Bretagne,22,2,43,266,Rostrenen,3390,257,3647
53,Bretagne,22,1,04,267,Rouillac,359,5,364
53,Bretagne,22,1,24,268,Ruca,522,9,531
53,Bretagne,22,2,40,269,Runan,252,7,259
53,Bretagne,22,2,03,271,Saint-Adrien,324,11,335
53,Bretagne,22,2,16,272,Saint-Agathon,2023,67,2090
53,Bretagne,22,4,32,273,Saint-Alban,1882,28,1910
53,Bretagne,22,1,14,274,Saint-André-des-Eaux,254,6,260
53,Bretagne,22,4,08,275,Saint-Barnabé,1252,39,1291
53,Bretagne,22,4,41,276,Saint-Bihy,176,4,180
53,Bretagne,22,4,41,277,Saint-Brandan,2306,58,2364
53,Bretagne,22,4,99,278,Saint-Brieuc,45879,2092,47971
53,Bretagne,22,4,22,279,Saint-Caradec,1198,28,1226
53,Bretagne,22,1,12,280,Saint-Carné,924,52,976
53,Bretagne,22,4,26,281,Saint-Carreuc,1476,11,1487
53,Bretagne,22,1,24,282,Saint-Cast-le-Guildo,3487,112,3599
53,Bretagne,22,2,40,283,Saint-Clet,845,27,872
53,Bretagne,22,2,46,284,Saint-Connan,306,8,314
53,Bretagne,22,2,27,285,Saint-Connec,288,18,306
53,Bretagne,22,1,24,286,Saint-Denoual,401,11,412
53,Bretagne,22,4,51,287,Saint-Donan,1424,44,1468
53,Bretagne,22,4,08,288,Saint-Étienne-du-Gué-de-l'Isle,412,3,415
53,Bretagne,22,2,35,289,Saint-Fiacre,226,2,228
53,Bretagne,22,2,15,290,Saint-Gelven,313,7,320
53,Bretagne,22,4,41,291,Saint-Gildas,280,8,288
53,Bretagne,22,1,09,292,Saint-Gilles-du-Mené,478,10,488
53,Bretagne,22,2,40,293,Saint-Gilles-les-Bois,417,12,429
53,Bretagne,22,2,46,294,Saint-Gilles-Pligeaux,285,7,292
53,Bretagne,22,2,27,295,Saint-Gilles-Vieux-Marché,321,10,331
53,Bretagne,22,4,26,296,Saint-Glen,573,17,590
53,Bretagne,22,1,09,297,Saint-Gouéno,652,22,674
53,Bretagne,22,2,27,298,Saint-Guen,460,21,481
53,Bretagne,22,1,11,299,Saint-Hélen,1206,28,1234
53,Bretagne,22,4,48,300,Saint-Hervé,395,10,405
53,Bretagne,22,2,15,334,Saint-Igeaux,160,4,164
53,Bretagne,22,1,37,302,Saint-Jacut-de-la-Mer,840,29,869
53,Bretagne,22,1,09,303,Saint-Jacut-du-Mené,726,16,742
53,Bretagne,22,2,35,304,Saint-Jean-Kerdaniel,563,11,574
53,Bretagne,22,1,06,305,Saint-Jouan-de-l'Isle,439,10,449
53,Bretagne,22,1,14,306,Saint-Judoce,519,25,544
53,Bretagne,22,4,51,307,Saint-Julien,1962,44,2006
53,Bretagne,22,1,14,308,Saint-Juvat,638,11,649
53,Bretagne,22,1,25,309,Saint-Launeuc,194,0,194
53,Bretagne,22,2,01,310,Saint-Laurent,423,17,440
53,Bretagne,22,1,30,311,Saint-Lormel,887,13,900
53,Bretagne,22,1,06,312,Saint-Maden,206,8,214
53,Bretagne,22,4,10,313,Saint-Martin-des-Prés,352,13,365
53,Bretagne,22,4,22,314,Saint-Maudan,392,17,409
53,Bretagne,22,1,31,315,Saint-Maudez,281,6,287
53,Bretagne,22,4,10,316,Saint-Mayeux,540,9,549
53,Bretagne,22,1,31,317,Saint-Méloir-des-Bois,265,4,269
53,Bretagne,22,1,31,318,Saint-Michel-de-Plélan,297,3,300
53,Bretagne,22,3,33,319,Saint-Michel-en-Grève,483,17,500
53,Bretagne,22,2,05,320,Saint-Nicodème,156,2,158
53,Bretagne,22,2,46,321,Saint-Nicolas-du-Pélem,1798,65,1863
53,Bretagne,22,2,35,322,Saint-Péver,357,5,362
53,Bretagne,22,1,24,323,Saint-Pôtan,772,5,777
53,Bretagne,22,3,29,324,Saint-Quay-Perros,1462,63,1525
53,Bretagne,22,4,13,325,Saint-Quay-Portrieux,3057,247,3304
53,Bretagne,22,4,18,326,Saint-Rieul,422,4,426
53,Bretagne,22,1,12,327,Saint-Samson-sur-Rance,1508,37,1545
53,Bretagne,22,2,05,328,Saint-Servais,406,6,412
53,Bretagne,22,4,48,330,Saint-Thélo,432,7,439
53,Bretagne,22,4,26,332,Saint-Trimoël,409,7,416
53,Bretagne,22,1,25,333,Saint-Vran,721,11,732
53,Bretagne,22,2,46,331,Sainte-Tréphine,213,4,217
53,Bretagne,22,2,03,335,Senven-Léhart,241,5,246
53,Bretagne,22,1,04,337,Sévignac,1110,26,1136
53,Bretagne,22,2,01,338,Squiffiec,745,14,759
53,Bretagne,22,1,12,339,Taden,2330,144,2474
53,Bretagne,22,3,36,340,Tonquédec,1064,39,1103
53,Bretagne,22,1,17,341,Tramain,647,10,657
53,Bretagne,22,1,31,342,Trébédan,373,11,384
53,Bretagne,22,3,29,343,Trébeurden,3717,122,3839
53,Bretagne,22,2,23,344,Trébrivan,693,16,709
53,Bretagne,22,4,26,345,Trébry,723,21,744
53,Bretagne,22,4,26,346,Trédaniel,974,15,989
53,Bretagne,22,3,21,347,Trédarzec,1102,42,1144
53,Bretagne,22,1,04,348,Trédias,484,4,488
53,Bretagne,22,3,33,349,Trédrez-Locquémeau,1433,29,1462
53,Bretagne,22,3,33,350,Tréduder,194,10,204
53,Bretagne,22,2,23,351,Treffrin,550,27,577
53,Bretagne,22,1,14,352,Tréfumel,256,13,269
53,Bretagne,22,3,29,353,Trégastel,2412,71,2483
53,Bretagne,22,2,02,354,Tréglamus,977,31,1008
53,Bretagne,22,4,07,356,Trégomeur,896,19,915
53,Bretagne,22,1,37,357,Trégon,229,6,235
53,Bretagne,22,2,01,358,Trégonneau,482,21,503
53,Bretagne,22,3,36,359,Trégrom,390,10,400
53,Bretagne,22,4,49,360,Trégueux,7575,222,7797
53,Bretagne,22,4,20,361,Tréguidel,630,18,648
53,Bretagne,22,3,47,362,Tréguier,2659,251,2910
53,Bretagne,22,3,29,363,Trélévern,1400,48,1448
53,Bretagne,22,1,12,364,Trélivan,2386,76,2462
53,Bretagne,22,2,43,365,Trémargat,168,10,178
53,Bretagne,22,3,33,366,Trémel,403,11,414
53,Bretagne,22,4,07,367,Tréméloir,692,7,699
53,Bretagne,22,1,37,368,Tréméreuc,594,18,612
53,Bretagne,22,1,04,369,Trémeur,679,14,693
53,Bretagne,22,4,20,370,Tréméven,341,7,348
53,Bretagne,22,1,25,371,Trémorel,1077,12,1089
53,Bretagne,22,4,50,372,Trémuson,1843,43,1886
53,Bretagne,22,2,23,373,Tréogan,100,3,103
53,Bretagne,22,4,20,375,Tressignaux,580,11,591
53,Bretagne,22,4,22,376,Trévé,1494,62,1556
53,Bretagne,22,4,13,377,Tréveneuc,764,22,786
53,Bretagne,22,4,20,378,Trévérec,191,2,193
53,Bretagne,22,3,29,379,Trévou-Tréguignec,1423,37,1460
53,Bretagne,22,1,12,380,Trévron,687,14,701
53,Bretagne,22,3,47,381,Trézény,261,11,272
53,Bretagne,22,3,42,383,Troguéry,284,4,288
53,Bretagne,22,4,48,384,Uzel,1056,29,1085
53,Bretagne,22,1,11,385,La Vicomté-sur-Rance,916,41,957
53,Bretagne,22,4,41,386,Le Vieux-Bourg,734,10,744
53,Bretagne,22,3,36,387,Le Vieux-Marché,1205,35,1240
53,Bretagne,22,1,31,388,Vildé-Guingalan,1168,24,1192
53,Bretagne,22,4,49,389,Yffiniac,4699,105,4804
53,Bretagne,22,4,28,390,Yvias,714,19,733
53,Bretagne,22,1,04,391,Yvignac-la-Tour,1169,22,1191
74,Limousin,23,2,01,001,Ahun,1568,252,1820
74,Limousin,23,2,19,002,Ajain,1099,29,1128
74,Limousin,23,1,02,003,Alleyrat,150,8,158
74,Limousin,23,2,24,004,Anzême,561,17,578
74,Limousin,23,1,15,005,Arfeuille-Châtain,178,7,185
74,Limousin,23,2,05,006,Arrènes,221,7,228
74,Limousin,23,1,23,007,Ars,252,7,259
74,Limousin,23,1,02,008,Aubusson,4149,215,4364
74,Limousin,23,1,09,009,Auge,105,0,105
74,Limousin,23,2,05,010,Augères,135,2,137
74,Limousin,23,2,05,011,Aulon,171,1,172
74,Limousin,23,2,07,012,Auriat,124,0,124
74,Limousin,23,1,03,013,Auzances,1377,64,1441
74,Limousin,23,2,05,014,Azat-Châtenet,132,2,134
74,Limousin,23,2,25,015,Azerables,890,16,906
74,Limousin,23,1,23,016,Banize,158,2,160
74,Limousin,23,1,13,017,Basville,178,8,186
74,Limousin,23,2,25,018,Bazelat,291,3,294
74,Limousin,23,1,12,019,Beissat,32,3,35
74,Limousin,23,1,04,020,Bellegarde-en-Marche,434,11,445
74,Limousin,23,2,05,021,Bénévent-l'Abbaye,858,16,874
74,Limousin,23,2,10,022,Bétête,359,11,370
74,Limousin,23,2,20,023,Blaudeix,114,2,116
74,Limousin,23,1,02,024,Blessac,521,22,543
74,Limousin,23,2,06,025,Bonnat,1304,30,1334
74,Limousin,23,2,08,026,Bord-Saint-Georges,359,25,384
74,Limousin,23,2,07,027,Bosmoreau-les-Mines,249,2,251
74,Limousin,23,1,04,028,Bosroger,99,0,99
74,Limousin,23,2,06,029,Le Bourg-d'Hem,220,3,223
74,Limousin,23,2,07,030,Bourganeuf,2917,231,3148
74,Limousin,23,2,08,031,Boussac,1394,49,1443
74,Limousin,23,2,08,032,Boussac-Bourg,789,23,812
74,Limousin,23,2,24,033,La Brionne,394,12,406
74,Limousin,23,1,03,034,Brousse,26,1,27
74,Limousin,23,1,09,035,Budelière,793,12,805
74,Limousin,23,2,24,036,Bussière-Dunoise,1105,23,1128
74,Limousin,23,1,03,037,Bussière-Nouvelle,113,2,115
74,Limousin,23,2,08,038,Bussière-Saint-Georges,212,5,217
74,Limousin,23,2,14,039,La Celle-Dunoise,607,27,634
74,Limousin,23,2,20,040,La Celle-sous-Gouzon,140,3,143
74,Limousin,23,2,10,041,La Cellette,271,2,273
74,Limousin,23,2,05,042,Ceyroux,126,0,126
74,Limousin,23,1,23,043,Chamberaud,111,3,114
74,Limousin,23,2,06,044,Chambon-Sainte-Croix,93,1,94
74,Limousin,23,1,09,045,Chambon-sur-Voueize,1014,14,1028
74,Limousin,23,1,15,046,Chambonchard,84,0,84
74,Limousin,23,2,18,047,Chamborand,234,10,244
74,Limousin,23,1,04,048,Champagnat,428,9,437
74,Limousin,23,2,06,049,Champsanglard,227,5,232
74,Limousin,23,2,14,050,La Chapelle-Baloue,133,5,138
74,Limousin,23,2,21,051,La Chapelle-Saint-Martial,90,2,92
74,Limousin,23,2,27,052,La Chapelle-Taillefert,370,6,376
74,Limousin,23,1,03,053,Chard,197,4,201
74,Limousin,23,1,03,054,Charron,238,7,245
74,Limousin,23,1,03,055,Châtelard,34,1,35
74,Limousin,23,2,05,056,Châtelus-le-Marcheix,365,8,373
74,Limousin,23,2,10,057,Châtelus-Malvaleix,570,10,580
74,Limousin,23,1,11,058,Le Chauchet,105,1,106
74,Limousin,23,1,04,059,La Chaussade,115,2,117
74,Limousin,23,1,23,060,Chavanat,130,3,133
74,Limousin,23,1,11,061,Chénérailles,736,26,762
74,Limousin,23,2,06,062,Chéniers,567,14,581
74,Limousin,23,1,12,063,Clairavaux,155,2,157
74,Limousin,23,2,10,064,Clugnat,686,17,703
74,Limousin,23,2,14,065,Colondannes,297,4,301
74,Limousin,23,1,03,066,Le Compas,218,2,220
74,Limousin,23,1,12,067,La Courtine,874,22,896
74,Limousin,23,2,01,068,Cressat,565,5,570
74,Limousin,23,1,13,069,Crocq,496,15,511
74,Limousin,23,2,14,070,Crozant,511,16,527
74,Limousin,23,1,16,071,Croze,185,5,190
74,Limousin,23,2,20,072,Domeyrot,223,9,232
74,Limousin,23,1,03,073,Dontreix,393,27,420
74,Limousin,23,1,23,074,Le Donzeil,159,4,163
74,Limousin,23,2,14,075,Dun-le-Palestel,1160,23,1183
74,Limousin,23,1,15,076,Évaux-les-Bains,1515,61,1576
74,Limousin,23,1,17,077,Faux-la-Montagne,364,10,374
74,Limousin,23,2,07,078,Faux-Mazuras,168,7,175
74,Limousin,23,1,16,079,Felletin,1866,285,2151
74,Limousin,23,1,17,080,Féniers,86,0,86
74,Limousin,23,1,13,081,Flayat,339,12,351
74,Limousin,23,2,18,082,Fleurat,271,7,278
74,Limousin,23,1,15,083,Fontanières,262,3,265
74,Limousin,23,2,06,084,La Forêt-du-Temple,151,2,153
74,Limousin,23,1,23,086,Fransèches,240,12,252
74,Limousin,23,2,14,087,Fresselines,629,9,638
74,Limousin,23,2,24,088,Gartempe,138,1,139
74,Limousin,23,2,10,089,Genouillac,806,10,816
74,Limousin,23,1,17,090,Gentioux-Pigerolles,380,12,392
74,Limousin,23,1,17,091,Gioux,173,7,180
74,Limousin,23,2,19,092,Glénic,595,28,623
74,Limousin,23,2,20,093,Gouzon,1475,58,1533
74,Limousin,23,2,18,095,Le Grand-Bourg,1196,64,1260
74,Limousin,23,2,98,096,Guéret,14063,1008,15071
74,Limousin,23,1,11,097,Issoudun-Létrieix,297,5,302
74,Limousin,23,2,10,098,Jalesches,80,1,81
74,Limousin,23,2,21,099,Janaillat,356,8,364
74,Limousin,23,2,20,100,Jarnages,520,9,529
74,Limousin,23,2,19,101,Jouillat,469,10,479
74,Limousin,23,2,19,102,Ladapeyre,345,8,353
74,Limousin,23,2,14,103,Lafat,381,7,388
74,Limousin,23,2,08,104,Lavaufranche,243,4,247
74,Limousin,23,1,11,105,Lavaveix-les-Mines,788,58,846
74,Limousin,23,1,09,106,Lépaud,373,7,380
74,Limousin,23,2,01,107,Lépinas,175,3,178
74,Limousin,23,2,08,108,Leyrat,157,5,162
74,Limousin,23,2,06,109,Linard,166,3,169
74,Limousin,23,1,03,110,Lioux-les-Monges,48,2,50
74,Limousin,23,2,18,111,Lizières,266,8,274
74,Limousin,23,2,06,112,Lourdoueix-Saint-Pierre,844,19,863
74,Limousin,23,1,04,113,Lupersat,329,13,342
74,Limousin,23,1,09,114,Lussat,449,11,460
74,Limousin,23,1,12,115,Magnat-l'Étrange,229,7,236
74,Limousin,23,1,04,116,Mainsat,627,23,650
74,Limousin,23,2,14,117,Maison-Feyne,303,5,308
74,Limousin,23,2,01,118,Maisonnisses,207,5,212
74,Limousin,23,1,12,119,Malleret,39,2,41
74,Limousin,23,2,08,120,Malleret-Boussac,234,5,239
74,Limousin,23,2,06,121,Malval,46,0,46
74,Limousin,23,2,07,122,Mansat-la-Courrière,87,3,90
74,Limousin,23,1,03,123,Les Mars,207,6,213
74,Limousin,23,2,05,124,Marsac,707,18,725
74,Limousin,23,1,12,125,Le Mas-d'Artige,101,1,102
74,Limousin,23,2,07,126,Masbaraud-Mérignat,371,8,379
74,Limousin,23,1,04,127,Mautes,218,2,220
74,Limousin,23,2,01,128,Mazeirat,138,5,143
74,Limousin,23,1,13,129,La Mazière-aux-Bons-Hommes,60,2,62
74,Limousin,23,2,06,130,Méasnes,592,8,600
74,Limousin,23,1,13,131,Mérinchal,745,26,771
74,Limousin,23,2,24,132,Montaigut-le-Blanc,383,9,392
74,Limousin,23,2,07,133,Montboucher,367,33,400
74,Limousin,23,1,22,134,Le Monteil-au-Vicomte,226,49,275
74,Limousin,23,2,06,136,Mortroux,309,9,318
74,Limousin,23,2,05,137,Mourioux-Vieilleville,588,12,600
74,Limousin,23,2,01,138,Moutier-d'Ahun,168,4,172
74,Limousin,23,2,06,139,Moutier-Malcard,543,4,547
74,Limousin,23,1,16,140,Moutier-Rozeille,436,19,455
74,Limousin,23,2,14,141,Naillat,657,12,669
74,Limousin,23,1,02,142,Néoux,299,11,310
74,Limousin,23,2,25,143,Noth,517,7,524
74,Limousin,23,1,17,144,La Nouaille,247,4,251
74,Limousin,23,1,09,145,Nouhant,306,6,312
74,Limousin,23,2,08,146,Nouzerines,252,3,255
74,Limousin,23,2,06,147,Nouzerolles,102,0,102
74,Limousin,23,2,10,148,Nouziers,240,3,243
74,Limousin,23,2,20,149,Parsac,583,14,597
74,Limousin,23,2,01,150,Peyrabout,140,3,143
74,Limousin,23,1,11,151,Peyrat-la-Nonière,467,4,471
74,Limousin,23,2,20,152,Pierrefitte,79,5,84
74,Limousin,23,2,01,154,Pionnat,758,11,769
74,Limousin,23,2,21,155,Pontarion,357,13,370
74,Limousin,23,1,13,156,Pontcharraud,85,3,88
74,Limousin,23,2,21,157,La Pouge,79,1,80
74,Limousin,23,1,16,158,Poussanges,145,3,148
74,Limousin,23,1,11,159,Puy-Malsignat,165,1,166
74,Limousin,23,1,15,160,Reterre,307,4,311
74,Limousin,23,2,20,161,Rimondeix,98,4,102
74,Limousin,23,2,10,162,Roches,397,4,401
74,Limousin,23,1,03,164,Rougnat,556,13,569
74,Limousin,23,1,22,165,Royère-de-Vassivière,566,19,585
74,Limousin,23,2,14,166,Sagnat,201,9,210
74,Limousin,23,2,25,177,Saint-Agnant-de-Versillat,1127,40,1167
74,Limousin,23,1,13,178,Saint-Agnant-près-Crocq,203,4,207
74,Limousin,23,1,02,179,Saint-Alpinien,293,2,295
74,Limousin,23,1,02,180,Saint-Amand,520,25,545
74,Limousin,23,2,07,181,Saint-Amand-Jartoudeix,173,4,177
74,Limousin,23,1,02,182,Saint-Avit-de-Tardes,191,3,194
74,Limousin,23,1,23,183,Saint-Avit-le-Pauvre,75,2,77
74,Limousin,23,1,13,184,Saint-Bard,105,1,106
74,Limousin,23,1,11,185,Saint-Chabrais,325,25,350
74,Limousin,23,2,27,186,Saint-Christophe,127,8,135
74,Limousin,23,1,11,187,Saint-Dizier-la-Tour,228,7,235
74,Limousin,23,2,10,188,Saint-Dizier-les-Domaines,195,5,200
74,Limousin,23,2,07,189,Saint-Dizier-Leyrenne,876,26,902
74,Limousin,23,1,04,190,Saint-Domet,172,8,180
74,Limousin,23,2,21,191,Saint-Éloi,203,3,206
74,Limousin,23,2,18,192,Saint-Étienne-de-Fursac,849,13,862
74,Limousin,23,2,19,195,Saint-Fiel,935,39,974
74,Limousin,23,1,16,196,Saint-Frion,194,3,197
74,Limousin,23,2,21,197,Saint-Georges-la-Pouge,340,2,342
74,Limousin,23,1,13,198,Saint-Georges-Nigremont,164,5,169
74,Limousin,23,2,25,199,Saint-Germain-Beaupré,397,6,403
74,Limousin,23,2,05,200,Saint-Goussaud,205,1,206
74,Limousin,23,2,01,201,Saint-Hilaire-la-Plaine,223,5,228
74,Limousin,23,2,21,202,Saint-Hilaire-le-Château,270,5,275
74,Limousin,23,1,15,203,Saint-Julien-la-Genête,240,4,244
74,Limousin,23,1,09,204,Saint-Julien-le-Châtel,168,1,169
74,Limousin,23,1,22,205,Saint-Junien-la-Bregère,156,2,158
74,Limousin,23,2,26,206,Saint-Laurent,648,14,662
74,Limousin,23,2,25,207,Saint-Léger-Bridereix,189,4,193
74,Limousin,23,2,24,208,Saint-Léger-le-Guérétois,417,6,423
74,Limousin,23,1,09,209,Saint-Loup,177,2,179
74,Limousin,23,1,02,210,Saint-Maixant,224,6,230
74,Limousin,23,1,02,211,Saint-Marc-à-Frongier,356,7,363
74,Limousin,23,1,17,212,Saint-Marc-à-Loubaud,135,4,139
74,Limousin,23,2,08,213,Saint-Marien,174,7,181
74,Limousin,23,1,23,214,Saint-Martial-le-Mont,264,8,272
74,Limousin,23,1,12,215,Saint-Martial-le-Vieux,130,1,131
74,Limousin,23,1,22,216,Saint-Martin-Château,148,6,154
74,Limousin,23,2,07,217,Saint-Martin-Sainte-Catherine,354,5,359
74,Limousin,23,2,25,219,Saint-Maurice-la-Souterraine,1201,32,1233
74,Limousin,23,1,13,218,Saint-Maurice-près-Crocq,119,1,120
74,Limousin,23,1,11,220,Saint-Médard-la-Rochette,574,16,590
74,Limousin,23,1,12,221,Saint-Merd-la-Breuille,208,4,212
74,Limousin,23,1,23,222,Saint-Michel-de-Veisse,158,12,170
74,Limousin,23,1,22,223,Saint-Moreil,253,4,257
74,Limousin,23,1,12,224,Saint-Oradoux-de-Chirouze,86,1,87
74,Limousin,23,1,13,225,Saint-Oradoux-près-Crocq,118,6,124
74,Limousin,23,1,13,226,Saint-Pardoux-d'Arnet,159,5,164
74,Limousin,23,1,02,228,Saint-Pardoux-le-Neuf,175,8,183
74,Limousin,23,1,11,229,Saint-Pardoux-les-Cards,295,10,305
74,Limousin,23,1,22,227,Saint-Pardoux-Morterolles,213,8,221
74,Limousin,23,1,22,232,Saint-Pierre-Bellevue,233,9,242
74,Limousin,23,2,07,230,Saint-Pierre-Chérignat,168,3,171
74,Limousin,23,2,18,231,Saint-Pierre-de-Fursac,813,26,839
74,Limousin,23,2,08,233,Saint-Pierre-le-Bost,152,6,158
74,Limousin,23,1,15,234,Saint-Priest,171,7,178
74,Limousin,23,2,25,235,Saint-Priest-la-Feuille,695,16,711
74,Limousin,23,2,18,236,Saint-Priest-la-Plaine,269,6,275
74,Limousin,23,2,07,237,Saint-Priest-Palus,44,1,45
74,Limousin,23,1,16,238,Saint-Quentin-la-Chabanne,356,15,371
74,Limousin,23,2,14,239,Saint-Sébastien,692,20,712
74,Limousin,23,2,08,240,Saint-Silvain-Bas-le-Roc,493,9,502
74,Limousin,23,1,04,241,Saint-Silvain-Bellegarde,217,3,220
74,Limousin,23,2,24,242,Saint-Silvain-Montaigut,188,3,191
74,Limousin,23,2,20,243,Saint-Silvain-sous-Toulx,147,3,150
74,Limousin,23,2,14,244,Saint-Sulpice-le-Dunois,638,5,643
74,Limousin,23,2,24,245,Saint-Sulpice-le-Guérétois,2013,58,2071
74,Limousin,23,1,23,246,Saint-Sulpice-les-Champs,384,16,400
74,Limousin,23,2,24,247,Saint-Vaury,1861,112,1973
74,Limousin,23,2,27,248,Saint-Victor-en-Marche,362,12,374
74,Limousin,23,1,16,249,Saint-Yrieix-la-Montagne,230,8,238
74,Limousin,23,2,01,250,Saint-Yrieix-les-Bois,324,8,332
74,Limousin,23,2,26,193,Sainte-Feyre,2241,67,2308
74,Limousin,23,1,16,194,Sainte-Feyre-la-Montagne,118,3,121
74,Limousin,23,1,15,167,Sannat,384,9,393
74,Limousin,23,2,21,168,Sardent,818,34,852
74,Limousin,23,2,26,169,La Saunière,629,20,649
74,Limousin,23,2,27,170,Savennes,218,11,229
74,Limousin,23,1,03,171,Sermur,100,1,101
74,Limousin,23,1,11,172,La Serre-Bussière-Vieille,125,2,127
74,Limousin,23,2,07,173,Soubrebost,144,1,145
74,Limousin,23,2,08,174,Soumans,580,15,595
74,Limousin,23,1,23,175,Sous-Parsat,150,2,152
74,Limousin,23,2,25,176,La Souterraine,5435,238,5673
74,Limousin,23,1,09,251,Tardes,141,1,142
74,Limousin,23,2,10,252,Tercillat,172,9,181
74,Limousin,23,2,21,253,Thauron,185,11,196
74,Limousin,23,2,08,254,Toulx-Sainte-Croix,299,5,304
74,Limousin,23,2,20,255,Trois-Fonds,115,0,115
74,Limousin,23,1,16,257,Vallière,755,26,781
74,Limousin,23,2,25,258,Vareilles,291,7,298
74,Limousin,23,1,09,259,Verneiges,97,0,97
74,Limousin,23,2,21,260,Vidaillat,170,1,171
74,Limousin,23,1,09,261,Viersat,335,4,339
74,Limousin,23,2,01,262,Vigeville,141,1,142
74,Limousin,23,2,14,263,Villard,329,3,332
74,Limousin,23,1,17,264,La Villedieu,45,4,49
74,Limousin,23,1,13,265,La Villeneuve,76,3,79
74,Limousin,23,1,13,266,La Villetelle,160,6,166
72,Aquitaine,24,2,26,001,Abjat-sur-Bandiat,651,10,661
72,Aquitaine,24,3,04,002,Agonac,1625,35,1660
72,Aquitaine,24,3,40,004,Ajat,306,4,310
72,Aquitaine,24,4,32,006,Allas-les-Mines,204,2,206
72,Aquitaine,24,3,28,007,Allemans,566,24,590
72,Aquitaine,24,1,07,005,Alles-sur-Dordogne,342,2,344
72,Aquitaine,24,2,18,008,Angoisse,606,9,615
72,Aquitaine,24,3,11,009,Anlhiac,285,6,291
72,Aquitaine,24,3,30,010,Annesse-et-Beaulieu,1468,30,1498
72,Aquitaine,24,3,37,011,Antonne-et-Trigonant,1202,38,1240
72,Aquitaine,24,4,35,012,Archignac,334,7,341
72,Aquitaine,24,3,34,013,Atur,1719,45,1764
72,Aquitaine,24,4,22,014,Aubas,611,11,622
72,Aquitaine,24,4,32,015,Audrix,292,11,303
72,Aquitaine,24,2,26,016,Augignac,826,24,850
72,Aquitaine,24,4,22,018,Auriac-du-Périgord,416,14,430
72,Aquitaine,24,3,40,019,Azerat,424,5,429
72,Aquitaine,24,4,39,020,La Bachellerie,878,18,896
72,Aquitaine,24,3,13,021,Badefols-d'Ans,477,7,484
72,Aquitaine,24,1,07,022,Badefols-sur-Dordogne,206,7,213
72,Aquitaine,24,1,17,023,Baneuil,353,5,358
72,Aquitaine,24,1,14,024,Bardou,43,1,44
72,Aquitaine,24,3,40,025,Bars,235,6,241
72,Aquitaine,24,3,34,026,Bassillac,1789,39,1828
72,Aquitaine,24,1,01,027,Bayac,368,8,376
72,Aquitaine,24,1,01,028,Beaumont-du-Périgord,1142,19,1161
72,Aquitaine,24,3,24,029,Beaupouyet,463,4,467
72,Aquitaine,24,4,39,030,Beauregard-de-Terrasson,694,16,710
72,Aquitaine,24,1,45,031,Beauregard-et-Bassac,294,3,297
72,Aquitaine,24,3,25,032,Beauronne,310,7,317
72,Aquitaine,24,2,19,033,Beaussac,187,5,192
72,Aquitaine,24,1,45,034,Beleymas,245,8,253
72,Aquitaine,24,4,02,035,Belvès,1457,47,1504
72,Aquitaine,24,4,32,036,Berbiguières,180,12,192
72,Aquitaine,24,1,96,037,Bergerac,27555,1061,28616
72,Aquitaine,24,3,44,038,Bertric-Burée,409,13,422
72,Aquitaine,24,4,47,039,Besse,150,5,155
72,Aquitaine,24,4,36,040,Beynac-et-Cazenac,514,4,518
72,Aquitaine,24,4,32,041,Bézenac,128,0,128
72,Aquitaine,24,3,04,042,Biras,531,4,535
72,Aquitaine,24,1,20,043,Biron,183,5,188
72,Aquitaine,24,3,34,044,Blis-et-Born,409,8,417
72,Aquitaine,24,1,14,045,Boisse,238,4,242
72,Aquitaine,24,3,13,046,Boisseuilh,127,1,128
72,Aquitaine,24,3,40,047,La Boissière-d'Ans,237,0,237
72,Aquitaine,24,1,42,048,Bonneville-et-Saint-Avit-de-Fumadières,317,5,322
72,Aquitaine,24,4,35,050,Borrèze,350,12,362
72,Aquitaine,24,1,16,051,Bosset,202,5,207
72,Aquitaine,24,1,07,052,Bouillac,119,5,124
72,Aquitaine,24,3,34,053,Boulazac,6601,336,6937
72,Aquitaine,24,1,14,054,Bouniagues,489,22,511
72,Aquitaine,24,3,04,055,Bourdeilles,775,20,795
72,Aquitaine,24,2,26,056,Le Bourdeix,260,1,261
72,Aquitaine,24,3,44,057,Bourg-des-Maisons,68,0,68
72,Aquitaine,24,3,28,058,Bourg-du-Bost,237,5,242
72,Aquitaine,24,3,24,059,Bourgnac,304,9,313
72,Aquitaine,24,1,01,060,Bourniquel,64,2,66
72,Aquitaine,24,3,43,061,Bourrou,147,2,149
72,Aquitaine,24,3,44,062,Bouteilles-Saint-Sébastien,189,4,193
72,Aquitaine,24,4,10,063,Bouzic,135,2,137
72,Aquitaine,24,3,04,064,Brantôme,2159,48,2207
72,Aquitaine,24,3,43,065,Breuilh,227,5,232
72,Aquitaine,24,3,40,066,Brouchaud,214,2,216
72,Aquitaine,24,4,05,067,Le Bugue,2793,68,2861
72,Aquitaine,24,1,07,068,Le Buisson-de-Cadouin,2168,48,2216
72,Aquitaine,24,3,04,069,Bussac,368,4,372
72,Aquitaine,24,2,06,070,Busserolles,556,4,560
72,Aquitaine,24,2,06,071,Bussière-Badil,483,5,488
72,Aquitaine,24,1,07,073,Calès,364,8,372
72,Aquitaine,24,4,08,074,Calviac-en-Périgord,523,6,529
72,Aquitaine,24,4,47,075,Campagnac-lès-Quercy,311,7,318
72,Aquitaine,24,4,05,076,Campagne,345,7,352
72,Aquitaine,24,1,45,077,Campsegret,398,10,408
72,Aquitaine,24,2,09,079,Cantillac,184,5,189
72,Aquitaine,24,1,20,080,Capdrot,491,10,501
72,Aquitaine,24,4,08,081,Carlux,644,24,668
72,Aquitaine,24,4,08,082,Carsac-Aillac,1473,42,1515
72,Aquitaine,24,1,46,083,Carsac-de-Gurson,193,9,202
72,Aquitaine,24,4,02,084,Carves,112,4,116
72,Aquitaine,24,4,39,085,La Cassagne,151,2,153
72,Aquitaine,24,4,10,086,Castelnaud-la-Chapelle,470,9,479
72,Aquitaine,24,4,32,087,Castels,565,17,582
72,Aquitaine,24,1,17,088,Cause-de-Clérans,319,6,325
72,Aquitaine,24,4,08,089,Cazoulès,441,10,451
72,Aquitaine,24,3,21,090,Celles,555,7,562
72,Aquitaine,24,4,10,091,Cénac-et-Saint-Julien,1230,34,1264
72,Aquitaine,24,3,43,092,Cendrieux,533,14,547
72,Aquitaine,24,3,44,093,Cercles,179,4,183
72,Aquitaine,24,3,43,094,Chalagnac,383,5,388
72,Aquitaine,24,2,15,095,Chalais,454,10,464
72,Aquitaine,24,2,09,096,Champagnac-de-Belair,712,19,731
72,Aquitaine,24,3,44,097,Champagne-et-Fontaine,399,10,409
72,Aquitaine,24,3,49,098,Champcevinel,2518,107,2625
72,Aquitaine,24,2,19,099,Champeaux-et-la-Chapelle-Pommier,163,4,167
72,Aquitaine,24,2,06,100,Champniers-et-Reilhac,504,4,508
72,Aquitaine,24,2,33,101,Champs-Romain,313,8,321
72,Aquitaine,24,3,50,102,Chancelade,4174,134,4308
72,Aquitaine,24,3,37,103,Le Change,598,9,607
72,Aquitaine,24,3,25,104,Chantérac,532,14,546
72,Aquitaine,24,3,21,105,Chapdeuil,125,1,126
72,Aquitaine,24,4,22,106,La Chapelle-Aubareil,458,5,463
72,Aquitaine,24,2,09,107,La Chapelle-Faucher,381,6,387
72,Aquitaine,24,3,30,108,La Chapelle-Gonaguet,1042,9,1051
72,Aquitaine,24,3,44,109,La Chapelle-Grésignac,132,3,135
72,Aquitaine,24,3,44,110,La Chapelle-Montabourlet,66,4,70
72,Aquitaine,24,2,09,111,La Chapelle-Montmoreau,75,1,76
72,Aquitaine,24,3,13,113,La Chapelle-Saint-Jean,78,3,81
72,Aquitaine,24,3,28,114,Chassaignes,81,0,81
72,Aquitaine,24,3,49,115,Château-l'Évêque,2001,39,2040
72,Aquitaine,24,4,39,116,Châtres,172,1,173
72,Aquitaine,24,4,39,117,Chavagnac,332,8,340
72,Aquitaine,24,3,31,118,Chenaud,317,24,341
72,Aquitaine,24,3,44,119,Cherval,303,7,310
72,Aquitaine,24,3,13,120,Cherveix-Cubas,619,14,633
72,Aquitaine,24,3,13,121,Chourgnac,74,0,74
72,Aquitaine,24,4,02,122,Cladech,90,0,90
72,Aquitaine,24,3,11,124,Clermont-d'Excideuil,266,1,267
72,Aquitaine,24,1,45,123,Clermont-de-Beauregard,117,5,122
72,Aquitaine,24,1,14,126,Colombier,244,8,252
72,Aquitaine,24,4,39,127,Coly,229,4,233
72,Aquitaine,24,3,28,128,Comberanche-et-Épeluche,176,3,179
72,Aquitaine,24,2,09,129,Condat-sur-Trincou,500,10,510
72,Aquitaine,24,4,39,130,Condat-sur-Vézère,848,17,865
72,Aquitaine,24,1,14,132,Conne-de-Labarde,216,12,228
72,Aquitaine,24,2,26,131,Connezac,83,0,83
72,Aquitaine,24,2,15,133,La Coquille,1377,20,1397
72,Aquitaine,24,2,41,134,Corgnac-sur-l'Isle,803,8,811
72,Aquitaine,24,3,37,135,Cornille,659,18,677
72,Aquitaine,24,3,13,136,Coubjours,149,3,152
72,Aquitaine,24,3,37,137,Coulaures,736,130,866
72,Aquitaine,24,3,50,138,Coulounieix-Chamiers,8356,432,8788
72,Aquitaine,24,1,48,140,Cours-de-Pile,1446,39,1485
72,Aquitaine,24,3,30,139,Coursac,1761,30,1791
72,Aquitaine,24,3,44,141,Coutures,187,1,188
72,Aquitaine,24,4,32,142,Coux-et-Bigaroque,975,14,989
72,Aquitaine,24,1,17,143,Couze-et-Saint-Front,779,27,806
72,Aquitaine,24,3,21,144,Creyssac,102,0,102
72,Aquitaine,24,1,48,145,Creysse,1851,53,1904
72,Aquitaine,24,3,43,146,Creyssensac-et-Pissot,220,7,227
72,Aquitaine,24,3,37,147,Cubjac,697,29,726
72,Aquitaine,24,1,38,148,Cunèges,317,5,322
72,Aquitaine,24,4,10,150,Daglan,546,11,557
72,Aquitaine,24,4,02,151,Doissat,122,2,124
72,Aquitaine,24,4,10,152,Domme,1004,18,1022
72,Aquitaine,24,4,39,153,La Dornac,398,14,412
72,Aquitaine,24,3,21,154,Douchapt,284,5,289
72,Aquitaine,24,1,45,155,Douville,437,9,446
72,Aquitaine,24,3,34,156,La Douze,1018,7,1025
72,Aquitaine,24,3,25,157,Douzillac,809,9,818
72,Aquitaine,24,2,18,158,Dussac,368,12,380
72,Aquitaine,24,3,23,159,Échourgnac,415,5,420
72,Aquitaine,24,1,45,161,Église-Neuve-d'Issac,129,1,130
72,Aquitaine,24,3,43,160,Église-Neuve-de-Vergt,396,9,405
72,Aquitaine,24,3,37,162,Escoire,465,14,479
72,Aquitaine,24,2,06,163,Étouars,145,1,146
72,Aquitaine,24,3,11,164,Excideuil,1314,29,1343
72,Aquitaine,24,3,23,165,Eygurande-et-Gardedeuil,363,5,368
72,Aquitaine,24,3,34,166,Eyliac,679,11,690
72,Aquitaine,24,1,12,167,Eymet,2538,84,2622
72,Aquitaine,24,3,04,170,Eyvirat,272,8,280
72,Aquitaine,24,2,41,171,Eyzerac,569,5,574
72,Aquitaine,24,4,32,172,Les Eyzies-de-Tayac-Sireuil,835,22,857
72,Aquitaine,24,4,22,174,Fanlac,143,5,148
72,Aquitaine,24,4,22,175,Les Farges,324,26,350
72,Aquitaine,24,1,14,176,Faurilles,49,2,51
72,Aquitaine,24,1,14,177,Faux,576,34,610
72,Aquitaine,24,3,31,178,Festalemps,249,3,252
72,Aquitaine,24,4,39,179,La Feuillade,750,13,763
72,Aquitaine,24,2,33,180,Firbeix,331,3,334
72,Aquitaine,24,1,38,181,Flaugeac,306,55,361
72,Aquitaine,24,1,16,182,Le Fleix,1425,70,1495
72,Aquitaine,24,4,05,183,Fleurac,265,10,275
72,Aquitaine,24,4,10,184,Florimont-Gaumier,144,2,146
72,Aquitaine,24,1,12,186,Fonroque,250,7,257
72,Aquitaine,24,1,16,222,La Force,2527,109,2636
72,Aquitaine,24,3,40,188,Fossemagne,611,11,622
72,Aquitaine,24,1,42,189,Fougueyrolles,472,10,482
72,Aquitaine,24,3,43,190,Fouleix,208,1,209
72,Aquitaine,24,1,16,191,Fraisse,151,4,155
72,Aquitaine,24,3,40,192,Gabillou,98,2,100
72,Aquitaine,24,1,38,193,Gageac-et-Rouillac,465,11,476
72,Aquitaine,24,1,38,194,Gardonne,1411,29,1440
72,Aquitaine,24,1,20,195,Gaugeac,114,0,114
72,Aquitaine,24,3,11,196,Génis,489,14,503
72,Aquitaine,24,1,16,197,Ginestet,839,39,878
72,Aquitaine,24,2,09,198,La Gonterie-Boulouneix,236,2,238
72,Aquitaine,24,3,44,199,Gout-Rossignol,413,11,424
72,Aquitaine,24,3,21,200,Grand-Brassac,530,6,536
72,Aquitaine,24,3,13,202,Granges-d'Ans,166,4,170
72,Aquitaine,24,2,19,203,Les Graulges,83,3,86
72,Aquitaine,24,4,39,204,Grèzes,173,4,177
72,Aquitaine,24,3,30,205,Grignols,630,4,634
72,Aquitaine,24,4,02,206,Grives,120,3,123
72,Aquitaine,24,4,10,207,Groléjac,645,16,661
72,Aquitaine,24,3,43,208,Grun-Bordas,214,2,216
72,Aquitaine,24,2,26,209,Hautefaye,112,1,113
72,Aquitaine,24,3,13,210,Hautefort,1100,23,1123
72,Aquitaine,24,1,45,211,Issac,374,10,384
72,Aquitaine,24,1,14,212,Issigeac,648,26,674
72,Aquitaine,24,3,30,213,Jaure,145,1,146
72,Aquitaine,24,2,26,214,Javerlhac-et-la-Chapelle-Saint-Robert,901,18,919
72,Aquitaine,24,4,35,215,Jayac,192,2,194
72,Aquitaine,24,3,31,216,La Jemaye,100,1,101
72,Aquitaine,24,4,05,217,Journiac,408,11,419
72,Aquitaine,24,2,15,218,Jumilhac-le-Grand,1240,69,1309
72,Aquitaine,24,1,01,219,Labouquerie,208,4,212
72,Aquitaine,24,3,43,220,Lacropte,617,12,629
72,Aquitaine,24,1,17,223,Lalinde,2967,87,3054
72,Aquitaine,24,1,48,224,Lamonzie-Montastruc,609,6,615
72,Aquitaine,24,1,38,225,Lamonzie-Saint-Martin,2255,64,2319
72,Aquitaine,24,1,42,226,Lamothe-Montravel,1279,41,1320
72,Aquitaine,24,2,18,227,Lanouaille,988,17,1005
72,Aquitaine,24,1,17,228,Lanquais,520,15,535
72,Aquitaine,24,4,39,229,Le Lardin-Saint-Lazare,1937,34,1971
72,Aquitaine,24,4,02,230,Larzac,140,2,142
72,Aquitaine,24,1,20,231,Lavalade,105,1,106
72,Aquitaine,24,4,47,232,Lavaur,84,2,86
72,Aquitaine,24,1,45,233,Laveyssière,116,11,127
72,Aquitaine,24,1,16,234,Les Lèches,311,9,320
72,Aquitaine,24,2,19,235,Léguillac-de-Cercles,290,7,297
72,Aquitaine,24,3,30,236,Léguillac-de-l'Auche,857,16,873
72,Aquitaine,24,1,48,237,Lembras,1187,27,1214
72,Aquitaine,24,2,41,238,Lempzours,144,6,150
72,Aquitaine,24,3,37,239,Ligueux,263,7,270
72,Aquitaine,24,1,29,240,Limeuil,332,14,346
72,Aquitaine,24,3,40,241,Limeyrat,450,6,456
72,Aquitaine,24,1,17,242,Liorac-sur-Louyre,219,7,226
72,Aquitaine,24,3,04,243,Lisle,924,19,943
72,Aquitaine,24,1,20,244,Lolme,141,2,143
72,Aquitaine,24,4,47,245,Loubejac,247,12,259
72,Aquitaine,24,1,16,246,Lunas,344,9,353
72,Aquitaine,24,3,44,247,Lusignac,186,2,188
72,Aquitaine,24,2,26,248,Lussas-et-Nontronneau,341,12,353
72,Aquitaine,24,4,05,249,Manaurie,159,3,162
72,Aquitaine,24,3,30,251,Manzac-sur-Vern,527,14,541
72,Aquitaine,24,4,36,252,Marcillac-Saint-Quentin,780,18,798
72,Aquitaine,24,2,19,253,Mareuil,1130,22,1152
72,Aquitaine,24,4,32,254,Marnac,189,5,194
72,Aquitaine,24,4,36,255,Marquay,564,7,571
72,Aquitaine,24,3,50,256,Marsac-sur-l'Isle,2650,74,2724
72,Aquitaine,24,1,20,257,Marsalès,223,2,225
72,Aquitaine,24,3,34,258,Marsaneix,989,35,1024
72,Aquitaine,24,1,45,259,Maurens,1037,34,1071
72,Aquitaine,24,1,17,260,Mauzac-et-Grand-Castang,845,11,856
72,Aquitaine,24,4,05,261,Mauzens-et-Miremont,326,8,334
72,Aquitaine,24,3,37,262,Mayac,294,10,304
72,Aquitaine,24,4,47,263,Mazeyrolles,360,8,368
72,Aquitaine,24,3,23,264,Ménesplet,1614,23,1637
72,Aquitaine,24,3,30,266,Mensignac,1387,46,1433
72,Aquitaine,24,1,38,267,Mescoules,159,1,160
72,Aquitaine,24,4,32,268,Meyrals,578,19,597
72,Aquitaine,24,2,33,269,Mialet,669,9,678
72,Aquitaine,24,3,34,270,Milhac-d'Auberoche,525,6,531
72,Aquitaine,24,2,33,271,Milhac-de-Nontron,601,8,609
72,Aquitaine,24,1,46,272,Minzac,433,6,439
72,Aquitaine,24,1,07,273,Molières,317,2,319
72,Aquitaine,24,1,38,274,Monbazillac,958,87,1045
72,Aquitaine,24,1,38,276,Monestier,369,9,378
72,Aquitaine,24,1,16,277,Monfaucon,266,11,277
72,Aquitaine,24,1,14,278,Monmadalès,70,0,70
72,Aquitaine,24,1,14,279,Monmarvès,50,1,51
72,Aquitaine,24,1,20,280,Monpazier,527,8,535
72,Aquitaine,24,4,02,293,Monplaisant,279,11,290
72,Aquitaine,24,1,01,281,Monsac,178,10,188
72,Aquitaine,24,1,14,282,Monsaguel,153,6,159
72,Aquitaine,24,2,19,283,Monsec,181,5,186
72,Aquitaine,24,3,40,284,Montagnac-d'Auberoche,135,6,141
72,Aquitaine,24,1,45,285,Montagnac-la-Crempse,383,8,391
72,Aquitaine,24,3,21,286,Montagrier,506,9,515
72,Aquitaine,24,1,14,287,Montaut,107,3,110
72,Aquitaine,24,1,42,288,Montazeau,304,7,311
72,Aquitaine,24,1,42,289,Montcaret,1382,32,1414
72,Aquitaine,24,1,01,290,Montferrand-du-Périgord,170,3,173
72,Aquitaine,24,4,22,291,Montignac,2852,75,2927
72,Aquitaine,24,1,46,292,Montpeyroux,424,0,424
72,Aquitaine,24,3,23,294,Montpon-Ménestérol,5606,91,5697
72,Aquitaine,24,3,30,295,Montrem,1214,19,1233
72,Aquitaine,24,1,48,296,Mouleydier,1007,26,1033
72,Aquitaine,24,1,46,297,Moulin-Neuf,857,12,869
72,Aquitaine,24,4,32,298,Mouzens,241,7,248
72,Aquitaine,24,3,24,299,Mussidan,2837,70,2907
72,Aquitaine,24,4,10,300,Nabirat,374,7,381
72,Aquitaine,24,4,35,301,Nadaillac,340,5,345
72,Aquitaine,24,3,13,302,Nailhac,284,3,287
72,Aquitaine,24,3,44,303,Nanteuil-Auriac-de-Bourzac,281,3,284
72,Aquitaine,24,2,41,304,Nantheuil,1039,11,1050
72,Aquitaine,24,2,18,305,Nanthiat,283,7,290
72,Aquitaine,24,1,42,306,Nastringues,113,5,118
72,Aquitaine,24,1,01,307,Naussannes,221,5,226
72,Aquitaine,24,3,37,308,Négrondes,816,11,827
72,Aquitaine,24,3,25,309,Neuvic,3591,108,3699
72,Aquitaine,24,1,01,310,Nojals-et-Clotte,203,4,207
72,Aquitaine,24,2,26,311,Nontron,3444,167,3611
72,Aquitaine,24,3,34,312,Notre-Dame-de-Sanilhac,2959,77,3036
72,Aquitaine,24,4,47,313,Orliac,53,1,54
72,Aquitaine,24,4,08,314,Orliaguet,84,4,88
72,Aquitaine,24,3,31,316,Parcoul,359,1,360
72,Aquitaine,24,4,35,317,Paulin,273,8,281
72,Aquitaine,24,1,29,318,Paunat,307,9,316
72,Aquitaine,24,3,21,319,Paussac-et-Saint-Vivien,451,7,458
72,Aquitaine,24,2,18,320,Payzac,1064,20,1084
72,Aquitaine,24,4,39,321,Pazayac,866,17,883
72,Aquitaine,24,3,97,322,Périgueux,29080,1378,30458
72,Aquitaine,24,3,28,323,Petit-Bersac,173,6,179
72,Aquitaine,24,4,39,324,Peyrignac,508,5,513
72,Aquitaine,24,4,08,325,Peyrillac-et-Millac,209,4,213
72,Aquitaine,24,4,22,326,Peyzac-le-Moustier,151,2,153
72,Aquitaine,24,1,29,327,Pezuls,126,4,130
72,Aquitaine,24,2,06,328,Piégut-Pluviers,1216,39,1255
72,Aquitaine,24,3,23,329,Le Pizou,1216,15,1231
72,Aquitaine,24,1,14,168,Plaisance,470,8,478
72,Aquitaine,24,4,22,330,Plazac,736,19,755
72,Aquitaine,24,1,38,331,Pomport,788,21,809
72,Aquitaine,24,3,31,333,Ponteyraud,52,1,53
72,Aquitaine,24,1,07,334,Pontours,201,5,206
72,Aquitaine,24,1,42,335,Port-Sainte-Foy-et-Ponchapt,2513,108,2621
72,Aquitaine,24,4,08,336,Prats-de-Carlux,507,12,519
72,Aquitaine,24,4,47,337,Prats-du-Périgord,164,2,166
72,Aquitaine,24,1,17,338,Pressignac-Vicq,454,4,458
72,Aquitaine,24,3,11,339,Preyssac-d'Excideuil,146,2,148
72,Aquitaine,24,1,16,340,Prigonrieux,3942,109,4051
72,Aquitaine,24,4,36,341,Proissans,870,24,894
72,Aquitaine,24,3,31,343,Puymangou,92,1,93
72,Aquitaine,24,2,19,344,Puyrenier,61,1,62
72,Aquitaine,24,1,48,345,Queyssac,461,22,483
72,Aquitaine,24,2,09,346,Quinsac,383,6,389
72,Aquitaine,24,1,01,347,Rampieux,147,2,149
72,Aquitaine,24,1,12,348,Razac-d'Eymet,287,8,295
72,Aquitaine,24,1,38,349,Razac-de-Saussignac,380,12,392
72,Aquitaine,24,3,30,350,Razac-sur-l'Isle,2438,36,2474
72,Aquitaine,24,1,38,351,Ribagnac,314,6,320
72,Aquitaine,24,3,28,352,Ribérac,4125,214,4339
72,Aquitaine,24,3,31,354,La Roche-Chalais,2828,56,2884
72,Aquitaine,24,2,19,353,La Rochebeaucourt-et-Argentine,398,10,408
72,Aquitaine,24,4,36,355,La Roque-Gageac,412,15,427
72,Aquitaine,24,1,38,357,Rouffignac-de-Sigoulès,346,4,350
72,Aquitaine,24,4,22,356,Rouffignac-Saint-Cernin-de-Reilhac,1547,36,1583
72,Aquitaine,24,2,19,221,Rudeau-Ladosse,170,3,173
72,Aquitaine,24,1,12,359,Sadillac,103,3,106
72,Aquitaine,24,4,02,360,Sagelat,355,4,359
72,Aquitaine,24,1,17,361,Saint-Agne,393,9,402
72,Aquitaine,24,4,02,363,Saint-Amand-de-Belvès,88,1,89
72,Aquitaine,24,4,22,364,Saint-Amand-de-Coly,386,15,401
72,Aquitaine,24,3,43,365,Saint-Amand-de-Vergt,209,3,212
72,Aquitaine,24,4,36,366,Saint-André-d'Allas,741,19,760
72,Aquitaine,24,3,25,367,Saint-André-de-Double,160,5,165
72,Aquitaine,24,3,31,368,Saint-Antoine-Cumond,388,5,393
72,Aquitaine,24,3,34,369,Saint-Antoine-d'Auberoche,149,0,149
72,Aquitaine,24,1,42,370,Saint-Antoine-de-Breuilh,2049,63,2112
72,Aquitaine,24,3,25,371,Saint-Aquilin,495,5,500
72,Aquitaine,24,3,30,372,Saint-Astier,5383,178,5561
72,Aquitaine,24,1,12,373,Saint-Aubin-de-Cadelech,319,12,331
72,Aquitaine,24,1,14,374,Saint-Aubin-de-Lanquais,280,6,286
72,Aquitaine,24,4,10,375,Saint-Aubin-de-Nabirat,127,3,130
72,Aquitaine,24,3,31,376,Saint-Aulaye,1354,25,1379
72,Aquitaine,24,4,05,377,Saint-Avit-de-Vialard,141,4,145
72,Aquitaine,24,1,20,378,Saint-Avit-Rivière,80,6,86
72,Aquitaine,24,1,01,379,Saint-Avit-Sénieur,440,18,458
72,Aquitaine,24,3,23,380,Saint-Barthélemy-de-Bellegarde,510,7,517
72,Aquitaine,24,2,06,381,Saint-Barthélemy-de-Bussière,231,3,234
72,Aquitaine,24,1,12,383,Saint-Capraise-d'Eymet,139,0,139
72,Aquitaine,24,1,17,382,Saint-Capraise-de-Lalinde,537,35,572
72,Aquitaine,24,1,20,384,Saint-Cassien,34,0,34
72,Aquitaine,24,4,47,386,Saint-Cernin-de-l'Herm,248,12,260
72,Aquitaine,24,1,14,385,Saint-Cernin-de-Labarde,198,13,211
72,Aquitaine,24,4,32,388,Saint-Chamassy,508,13,521
72,Aquitaine,24,4,05,389,Saint-Cirq,112,6,118
72,Aquitaine,24,3,34,390,Saint-Crépin-d'Auberoche,282,4,286
72,Aquitaine,24,2,19,391,Saint-Crépin-de-Richemont,234,2,236
72,Aquitaine,24,4,35,392,Saint-Crépin-et-Carlucet,488,10,498
72,Aquitaine,24,4,10,395,Saint-Cybranet,373,6,379
72,Aquitaine,24,4,32,396,Saint-Cyprien,1557,58,1615
72,Aquitaine,24,2,18,397,Saint-Cyr-les-Champagnes,274,8,282
72,Aquitaine,24,2,26,398,Saint-Estèphe,596,14,610
72,Aquitaine,24,3,24,399,Saint-Étienne-de-Puycorbier,102,2,104
72,Aquitaine,24,2,19,403,Saint-Félix-de-Bourdeilles,72,1,73
72,Aquitaine,24,4,05,404,Saint-Félix-de-Reillac-et-Mortemart,195,11,206
72,Aquitaine,24,1,17,405,Saint-Félix-de-Villadeix,313,5,318
72,Aquitaine,24,3,04,408,Saint-Front-d'Alemps,267,6,273
72,Aquitaine,24,3,24,409,Saint-Front-de-Pradoux,1092,28,1120
72,Aquitaine,24,2,33,410,Saint-Front-la-Rivière,530,7,537
72,Aquitaine,24,2,26,411,Saint-Front-sur-Nizonne,146,4,150
72,Aquitaine,24,4,35,412,Saint-Geniès,948,31,979
72,Aquitaine,24,1,16,413,Saint-Georges-Blancaneix,223,6,229
72,Aquitaine,24,1,45,414,Saint-Georges-de-Montclard,269,8,277
72,Aquitaine,24,1,46,415,Saint-Géraud-de-Corps,203,6,209
72,Aquitaine,24,4,02,416,Saint-Germain-de-Belvès,139,4,143
72,Aquitaine,24,3,11,417,Saint-Germain-des-Prés,501,9,510
72,Aquitaine,24,3,25,418,Saint-Germain-du-Salembre,841,8,849
72,Aquitaine,24,1,48,419,Saint-Germain-et-Mons,725,18,743
72,Aquitaine,24,1,16,420,Saint-Géry,211,4,215
72,Aquitaine,24,3,34,421,Saint-Geyrac,235,6,241
72,Aquitaine,24,1,45,422,Saint-Hilaire-d'Estissac,112,3,115
72,Aquitaine,24,3,25,424,Saint-Jean-d'Ataux,119,2,121
72,Aquitaine,24,1,45,426,Saint-Jean-d'Estissac,143,0,143
72,Aquitaine,24,1,45,427,Saint-Jean-d'Eyraud,194,8,202
72,Aquitaine,24,2,41,425,Saint-Jean-de-Côle,349,5,354
72,Aquitaine,24,2,15,428,Saint-Jory-de-Chalais,635,31,666
72,Aquitaine,24,3,11,429,Saint-Jory-las-Bloux,252,3,255
72,Aquitaine,24,1,12,433,Saint-Julien-d'Eymet,113,4,117
72,Aquitaine,24,3,04,430,Saint-Julien-de-Bourdeilles,92,1,93
72,Aquitaine,24,1,45,431,Saint-Julien-de-Crempse,201,5,206
72,Aquitaine,24,4,08,432,Saint-Julien-de-Lampon,607,10,617
72,Aquitaine,24,3,21,434,Saint-Just,131,1,132
72,Aquitaine,24,1,29,435,Saint-Laurent-des-Bâtons,240,5,245
72,Aquitaine,24,3,24,436,Saint-Laurent-des-Hommes,1019,16,1035
72,Aquitaine,24,1,48,437,Saint-Laurent-des-Vignes,731,24,755
72,Aquitaine,24,4,10,438,Saint-Laurent-la-Vallée,255,11,266
72,Aquitaine,24,3,34,439,Saint-Laurent-sur-Manoire,888,18,906
72,Aquitaine,24,1,14,441,Saint-Léon-d'Issigeac,118,3,121
72,Aquitaine,24,3,30,442,Saint-Léon-sur-l'Isle,1983,34,2017
72,Aquitaine,24,4,22,443,Saint-Léon-sur-Vézère,433,5,438
72,Aquitaine,24,3,24,444,Saint-Louis-en-l'Isle,253,2,255
72,Aquitaine,24,3,43,459,Saint-Maime-de-Péreyrol,264,10,274
72,Aquitaine,24,1,17,445,Saint-Marcel-du-Périgord,145,2,147
72,Aquitaine,24,1,20,446,Saint-Marcory,53,0,53
72,Aquitaine,24,3,11,448,Saint-Martial-d'Albarède,459,10,469
72,Aquitaine,24,3,23,449,Saint-Martial-d'Artenset,948,15,963
72,Aquitaine,24,4,10,450,Saint-Martial-de-Nabirat,644,7,651
72,Aquitaine,24,2,26,451,Saint-Martial-de-Valette,841,18,859
72,Aquitaine,24,3,44,452,Saint-Martial-Viveyrol,221,0,221
72,Aquitaine,24,2,41,453,Saint-Martin-de-Fressengeas,380,4,384
72,Aquitaine,24,1,46,454,Saint-Martin-de-Gurson,584,11,595
72,Aquitaine,24,3,28,455,Saint-Martin-de-Ribérac,683,14,697
72,Aquitaine,24,1,45,456,Saint-Martin-des-Combes,199,5,204
72,Aquitaine,24,3,24,457,Saint-Martin-l'Astier,130,3,133
72,Aquitaine,24,2,26,458,Saint-Martin-le-Pin,299,7,306
72,Aquitaine,24,3,28,460,Saint-Méard-de-Drône,472,6,478
72,Aquitaine,24,1,46,461,Saint-Méard-de-Gurçon,800,20,820
72,Aquitaine,24,3,11,463,Saint-Médard-d'Excideuil,604,10,614
72,Aquitaine,24,3,24,462,Saint-Médard-de-Mussidan,1662,19,1681
72,Aquitaine,24,3,11,464,Saint-Mesmin,270,1,271
72,Aquitaine,24,3,24,465,Saint-Michel-de-Double,270,4,274
72,Aquitaine,24,1,42,466,Saint-Michel-de-Montaigne,360,9,369
72,Aquitaine,24,3,43,468,Saint-Michel-de-Villadeix,287,5,292
72,Aquitaine,24,1,48,472,Saint-Nexans,857,19,876
72,Aquitaine,24,2,09,474,Saint-Pancrace,158,3,161
72,Aquitaine,24,3,37,475,Saint-Pantaly-d'Ans,158,7,165
72,Aquitaine,24,3,11,476,Saint-Pantaly-d'Excideuil,155,8,163
72,Aquitaine,24,3,28,477,Saint-Pardoux-de-Drône,216,5,221
72,Aquitaine,24,4,02,478,Saint-Pardoux-et-Vielvic,185,1,186
72,Aquitaine,24,2,33,479,Saint-Pardoux-la-Rivière,1158,21,1179
72,Aquitaine,24,3,43,480,Saint-Paul-de-Serre,260,7,267
72,Aquitaine,24,2,15,481,Saint-Paul-la-Roche,517,6,523
72,Aquitaine,24,3,44,482,Saint-Paul-Lizonne,317,10,327
72,Aquitaine,24,1,14,483,Saint-Perdoux,134,1,135
72,Aquitaine,24,1,16,487,Saint-Pierre-d'Eyraud,1619,33,1652
72,Aquitaine,24,3,34,484,Saint-Pierre-de-Chignac,786,11,797
72,Aquitaine,24,2,41,485,Saint-Pierre-de-Côle,453,13,466
72,Aquitaine,24,2,15,486,Saint-Pierre-de-Frugie,404,12,416
72,Aquitaine,24,4,10,488,Saint-Pompont,440,8,448
72,Aquitaine,24,2,15,489,Saint-Priest-les-Fougères,389,5,394
72,Aquitaine,24,3,31,490,Saint-Privat-des-Prés,559,12,571
72,Aquitaine,24,4,39,491,Saint-Rabier,550,11,561
72,Aquitaine,24,3,11,493,Saint-Raphaël,103,1,104
72,Aquitaine,24,1,46,494,Saint-Rémy,441,6,447
72,Aquitaine,24,1,20,495,Saint-Romain-de-Monpazier,78,2,80
72,Aquitaine,24,2,41,496,Saint-Romain-et-Saint-Clément,327,9,336
72,Aquitaine,24,2,33,498,Saint-Saud-Lacoussière,860,17,877
72,Aquitaine,24,1,48,499,Saint-Sauveur,769,24,793
72,Aquitaine,24,3,23,500,Saint-Sauveur-Lalande,123,1,124
72,Aquitaine,24,1,42,501,Saint-Seurin-de-Prats,505,10,515
72,Aquitaine,24,3,25,502,Saint-Séverin-d'Estissac,75,2,77
72,Aquitaine,24,2,18,505,Saint-Sulpice-d'Excideuil,319,12,331
72,Aquitaine,24,2,19,503,Saint-Sulpice-de-Mareuil,121,3,124
72,Aquitaine,24,3,28,504,Saint-Sulpice-de-Roumagnac,214,2,216
72,Aquitaine,24,3,21,508,Saint-Victor,197,3,200
72,Aquitaine,24,3,25,509,Saint-Vincent-de-Connezac,531,7,538
72,Aquitaine,24,4,32,510,Saint-Vincent-de-Cosse,385,9,394
72,Aquitaine,24,3,31,511,Saint-Vincent-Jalmoutiers,255,2,257
72,Aquitaine,24,4,36,512,Saint-Vincent-le-Paluel,273,11,284
72,Aquitaine,24,3,37,513,Saint-Vincent-sur-l'Isle,252,5,257
72,Aquitaine,24,1,42,514,Saint-Vivien,286,10,296
72,Aquitaine,24,1,29,362,Sainte-Alvère,891,24,915
72,Aquitaine,24,1,01,393,Sainte-Croix,89,3,92
72,Aquitaine,24,2,19,394,Sainte-Croix-de-Mareuil,129,5,134
72,Aquitaine,24,3,13,401,Sainte-Eulalie-d'Ans,295,24,319
72,Aquitaine,24,1,12,402,Sainte-Eulalie-d'Eymet,72,2,74
72,Aquitaine,24,4,02,406,Sainte-Foy-de-Belvès,129,2,131
72,Aquitaine,24,1,29,407,Sainte-Foy-de-Longas,239,9,248
72,Aquitaine,24,1,12,423,Sainte-Innocence,104,1,105
72,Aquitaine,24,3,34,447,Sainte-Marie-de-Chignac,585,5,590
72,Aquitaine,24,4,08,470,Sainte-Mondane,234,3,237
72,Aquitaine,24,4,36,471,Sainte-Nathalène,548,15,563
72,Aquitaine,24,3,40,473,Sainte-Orse,375,7,382
72,Aquitaine,24,1,14,492,Sainte-Radegonde,55,0,55
72,Aquitaine,24,1,01,497,Sainte-Sabine-Born,379,8,387
72,Aquitaine,24,3,11,507,Sainte-Trie,125,4,129
72,Aquitaine,24,3,11,515,Salagnac,891,19,910
72,Aquitaine,24,4,35,516,Salignac-Eyvigues,1140,59,1199
72,Aquitaine,24,4,02,517,Salles-de-Belvès,71,3,74
72,Aquitaine,24,3,43,518,Salon,245,6,251
72,Aquitaine,24,2,18,519,Sarlande,417,11,428
72,Aquitaine,24,4,36,520,Sarlat-la-Canéda,9331,540,9871
72,Aquitaine,24,3,37,521,Sarliac-sur-l'Isle,1020,26,1046
72,Aquitaine,24,2,18,522,Sarrazac,385,6,391
72,Aquitaine,24,1,38,523,Saussignac,409,7,416
72,Aquitaine,24,4,05,524,Savignac-de-Miremont,153,2,155
72,Aquitaine,24,2,26,525,Savignac-de-Nontron,192,0,192
72,Aquitaine,24,2,18,526,Savignac-Lédrier,745,16,761
72,Aquitaine,24,3,37,527,Savignac-les-Églises,958,42,1000
72,Aquitaine,24,2,26,528,Sceau-Saint-Angel,122,4,126
72,Aquitaine,24,3,21,529,Segonzac,217,5,222
72,Aquitaine,24,3,04,530,Sencenac-Puy-de-Fourches,211,1,212
72,Aquitaine,24,4,22,531,Sergeac,198,7,205
72,Aquitaine,24,1,12,532,Serres-et-Montguyard,182,4,186
72,Aquitaine,24,3,31,533,Servanches,84,3,87
72,Aquitaine,24,1,38,534,Sigoulès,812,189,1001
72,Aquitaine,24,4,08,535,Simeyrols,228,6,234
72,Aquitaine,24,1,12,536,Singleyrac,308,2,310
72,Aquitaine,24,3,28,537,Siorac-de-Ribérac,258,2,260
72,Aquitaine,24,4,02,538,Siorac-en-Périgord,1005,24,1029
72,Aquitaine,24,3,37,540,Sorges,1265,20,1285
72,Aquitaine,24,2,06,541,Soudat,83,0,83
72,Aquitaine,24,1,20,542,Soulaures,86,2,88
72,Aquitaine,24,3,24,543,Sourzac,1093,26,1119
72,Aquitaine,24,4,36,544,Tamniès,318,13,331
72,Aquitaine,24,3,13,545,Teillots,125,6,131
72,Aquitaine,24,3,13,546,Temple-Laguyon,41,3,44
72,Aquitaine,24,4,39,547,Terrasson-Lavilledieu,6218,117,6335
72,Aquitaine,24,2,26,548,Teyjat,270,3,273
72,Aquitaine,24,1,38,549,Thénac,379,6,385
72,Aquitaine,24,3,40,550,Thenon,1290,28,1318
72,Aquitaine,24,2,41,551,Thiviers,3147,236,3383
72,Aquitaine,24,4,22,552,Thonac,262,2,264
72,Aquitaine,24,3,21,553,Tocane-Saint-Apre,1633,33,1666
72,Aquitaine,24,3,44,554,La Tour-Blanche,442,6,448
72,Aquitaine,24,3,13,555,Tourtoirac,639,16,655
72,Aquitaine,24,3,49,557,Trélissac,6798,292,7090
72,Aquitaine,24,1,29,558,Trémolat,636,14,650
72,Aquitaine,24,4,32,559,Tursac,319,5,324
72,Aquitaine,24,1,07,560,Urval,150,5,155
72,Aquitaine,24,3,04,561,Valeuil,409,6,415
72,Aquitaine,24,3,25,562,Vallereuil,276,3,279
72,Aquitaine,24,4,22,563,Valojoulx,253,6,259
72,Aquitaine,24,3,28,564,Vanxains,744,135,879
72,Aquitaine,24,2,06,565,Varaignes,419,3,422
72,Aquitaine,24,1,17,566,Varennes,453,7,460
72,Aquitaine,24,2,41,567,Vaunac,255,7,262
72,Aquitaine,24,1,42,568,Vélines,1129,35,1164
72,Aquitaine,24,3,44,569,Vendoire,149,2,151
72,Aquitaine,24,1,17,570,Verdon,53,9,62
72,Aquitaine,24,3,43,571,Vergt,1748,41,1789
72,Aquitaine,24,1,20,572,Vergt-de-Biron,188,5,193
72,Aquitaine,24,3,44,573,Verteillac,644,13,657
72,Aquitaine,24,4,08,574,Veyrignac,306,4,310
72,Aquitaine,24,4,10,575,Veyrines-de-Domme,220,28,248
72,Aquitaine,24,3,43,576,Veyrines-de-Vergt,230,13,243
72,Aquitaine,24,4,36,577,Vézac,612,19,631
72,Aquitaine,24,2,19,579,Vieux-Mareuil,327,18,345
72,Aquitaine,24,4,39,580,Villac,236,1,237
72,Aquitaine,24,1,45,581,Villamblard,900,4,904
72,Aquitaine,24,2,09,582,Villars,479,11,490
72,Aquitaine,24,1,46,584,Villefranche-de-Lonchat,895,13,908
72,Aquitaine,24,4,47,585,Villefranche-du-Périgord,766,16,782
72,Aquitaine,24,3,28,586,Villetoureix,877,23,900
72,Aquitaine,24,4,36,587,Vitrac,853,19,872
43,Franche-Comté,25,1,07,001,Abbans-Dessous,239,5,244
43,Franche-Comté,25,1,07,002,Abbans-Dessus,316,6,322
43,Franche-Comté,25,1,23,003,Abbenans,357,5,362
43,Franche-Comté,25,2,09,004,Abbévillers,1037,17,1054
43,Franche-Comté,25,2,10,005,Accolans,94,0,94
43,Franche-Comté,25,1,04,006,Adam-lès-Passavant,94,3,97
43,Franche-Comté,25,3,27,007,Adam-lès-Vercel,98,2,100
43,Franche-Comté,25,2,30,008,Aibre,456,14,470
43,Franche-Comté,25,1,04,009,Aïssey,162,4,166
43,Franche-Comté,25,2,34,011,Allenjoie,710,7,717
43,Franche-Comté,25,3,15,012,Les Alliés,108,5,113
43,Franche-Comté,25,2,30,013,Allondans,216,5,221
43,Franche-Comté,25,1,13,014,Amagney,724,12,736
43,Franche-Comté,25,1,01,015,Amancey,638,36,674
43,Franche-Comté,25,1,18,016,Amathay-Vésigneux,136,2,138
43,Franche-Comté,25,1,01,017,Amondans,94,4,98
43,Franche-Comté,25,2,08,018,Anteuil,568,10,578
43,Franche-Comté,25,2,10,019,Appenans,419,10,429
43,Franche-Comté,25,2,03,020,Arbouans,1003,18,1021
43,Franche-Comté,25,1,22,021,Arc-et-Senans,1448,42,1490
43,Franche-Comté,25,3,15,025,Arc-sous-Cicon,630,22,652
43,Franche-Comté,25,3,11,026,Arc-sous-Montenot,225,11,236
43,Franche-Comté,25,2,10,022,Arcey,1374,34,1408
43,Franche-Comté,25,1,06,027,Arguel,249,10,259
43,Franche-Comté,25,3,15,024,Arçon,765,19,784
43,Franche-Comté,25,3,27,028,Athose,158,3,161
43,Franche-Comté,25,3,15,029,Aubonne,238,9,247
43,Franche-Comté,25,1,02,030,Audeux,445,5,450
43,Franche-Comté,25,2,03,031,Audincourt,14534,310,14844
43,Franche-Comté,25,1,04,032,Autechaux,382,5,387
43,Franche-Comté,25,2,09,033,Autechaux-Roide,579,17,596
43,Franche-Comté,25,1,02,034,Auxon-Dessous,1176,20,1196
43,Franche-Comté,25,1,02,035,Auxon-Dessus,1124,23,1147
43,Franche-Comté,25,1,07,036,Avanne-Aveney,2375,61,2436
43,Franche-Comté,25,1,23,038,Avilley,177,1,178
43,Franche-Comté,25,3,27,039,Avoudrey,781,21,802
43,Franche-Comté,25,2,34,040,Badevel,871,16,887
43,Franche-Comté,25,3,20,041,Bannans,338,11,349
43,Franche-Comté,25,3,25,042,Le Barboux,237,6,243
43,Franche-Comté,25,2,30,043,Bart,1931,49,1980
43,Franche-Comté,25,1,22,044,Bartherans,47,1,48
43,Franche-Comté,25,1,13,045,Battenans-les-Mines,55,0,55
43,Franche-Comté,25,2,12,046,Battenans-Varin,52,1,53
43,Franche-Comté,25,1,04,047,Baume-les-Dames,5317,110,5427
43,Franche-Comté,25,2,30,048,Bavans,3573,63,3636
43,Franche-Comté,25,2,12,049,Belfays,104,3,107
43,Franche-Comté,25,3,25,050,Le Bélieu,310,11,321
43,Franche-Comté,25,2,12,051,Belleherbe,587,19,606
43,Franche-Comté,25,3,27,052,Belmont,58,2,60
43,Franche-Comté,25,2,08,053,Belvoir,99,4,103
43,Franche-Comté,25,2,21,054,Berche,446,5,451
43,Franche-Comté,25,1,02,055,Berthelange,266,3,269
43,Franche-Comté,25,1,99,056,Besançon,117599,4072,121671
43,Franche-Comté,25,2,14,057,Bethoncourt,6057,62,6119
43,Franche-Comté,25,1,06,058,Beure,1385,22,1407
43,Franche-Comté,25,2,30,059,Beutal,263,2,265
43,Franche-Comté,25,3,11,060,Bians-les-Usiers,559,13,572
43,Franche-Comté,25,2,26,061,Bief,117,3,120
43,Franche-Comté,25,3,25,062,Le Bizot,256,9,265
43,Franche-Comté,25,2,09,063,Blamont,1108,19,1127
43,Franche-Comté,25,1,13,065,Blarians,47,0,47
43,Franche-Comté,25,2,10,066,Blussangeaux,73,2,75
43,Franche-Comté,25,2,10,067,Blussans,187,2,189
43,Franche-Comté,25,1,01,070,Bolandoz,342,12,354
43,Franche-Comté,25,2,09,071,Bondeval,464,15,479
43,Franche-Comté,25,1,23,072,Bonnal,23,2,25
43,Franche-Comté,25,1,13,073,Bonnay,768,9,777
43,Franche-Comté,25,3,25,074,Bonnétage,758,23,781
43,Franche-Comté,25,3,17,075,Bonnevaux,325,12,337
43,Franche-Comté,25,1,18,076,Bonnevaux-le-Prieuré,111,2,113
43,Franche-Comté,25,3,25,077,La Bosse,79,0,79
43,Franche-Comté,25,1,24,078,Bouclans,965,23,988
43,Franche-Comté,25,3,11,079,Boujailles,423,6,429
43,Franche-Comté,25,2,21,082,Bourguignon,942,24,966
43,Franche-Comté,25,2,10,083,Bournois,174,5,179
43,Franche-Comté,25,1,07,084,Boussières,1073,21,1094
43,Franche-Comté,25,3,20,085,Bouverans,323,8,331
43,Franche-Comté,25,1,13,086,Braillans,137,0,137
43,Franche-Comté,25,2,08,087,Branne,175,3,178
43,Franche-Comté,25,1,24,088,Breconchaux,87,2,89
43,Franche-Comté,25,3,27,089,Bremondans,82,1,83
43,Franche-Comté,25,1,22,090,Brères,32,0,32
43,Franche-Comté,25,2,12,091,Les Bréseux,418,16,434
43,Franche-Comté,25,1,13,092,La Bretenière,65,2,67
43,Franche-Comté,25,2,30,093,Bretigney,79,1,80
43,Franche-Comté,25,1,04,094,Bretigney-Notre-Dame,107,1,108
43,Franche-Comté,25,3,25,095,Bretonvillers,225,8,233
43,Franche-Comté,25,3,17,096,Brey-et-Maison-du-Bois,104,4,108
43,Franche-Comté,25,2,34,097,Brognard,444,13,457
43,Franche-Comté,25,1,22,098,Buffard,162,5,167
43,Franche-Comté,25,3,15,099,Bugny,156,5,161
43,Franche-Comté,25,3,11,100,Bulle,383,15,398
43,Franche-Comté,25,1,02,101,Burgille,470,5,475
43,Franche-Comté,25,2,26,102,Burnevillers,48,0,48
43,Franche-Comté,25,1,07,103,Busy,532,17,549
43,Franche-Comté,25,1,22,104,By,80,6,86
43,Franche-Comté,25,1,07,105,Byans-sur-Doubs,572,13,585
43,Franche-Comté,25,1,22,106,Cademène,86,4,90
43,Franche-Comté,25,1,13,107,Cendrey,175,7,182
43,Franche-Comté,25,2,12,108,Cernay-l'Église,252,7,259
43,Franche-Comté,25,1,22,109,Cessey,338,5,343
43,Franche-Comté,25,3,20,110,Chaffois,870,31,901
43,Franche-Comté,25,1,28,111,Chalèze,371,4,375
43,Franche-Comté,25,1,28,112,Chalezeule,1126,22,1148
43,Franche-Comté,25,3,25,113,Chamesey,116,3,119
43,Franche-Comté,25,2,26,114,Chamesol,377,10,387
43,Franche-Comté,25,1,02,115,Champagney,272,7,279
43,Franche-Comté,25,1,24,116,Champlive,259,4,263
43,Franche-Comté,25,1,13,117,Champoux,85,0,85
43,Franche-Comté,25,1,02,119,Champvans-les-Moulins,333,2,335
43,Franche-Comté,25,1,18,120,Chantrans,395,14,409
43,Franche-Comté,25,3,11,122,Chapelle-d'Huin,391,13,404
43,Franche-Comté,25,3,17,121,Chapelle-des-Bois,268,16,284
43,Franche-Comté,25,1,18,123,Charbonnières-les-Sapins,195,2,197
43,Franche-Comté,25,2,12,124,Charmauvillers,248,4,252
43,Franche-Comté,25,2,12,125,Charmoille,303,11,314
43,Franche-Comté,25,1,22,126,Charnay,442,4,446
43,Franche-Comté,25,2,12,127,Charquemont,2438,55,2493
43,Franche-Comté,25,3,27,128,Chasnans,236,4,240
43,Franche-Comté,25,1,18,129,Chassagne-Saint-Denis,113,2,115
43,Franche-Comté,25,1,18,130,Châteauvieux-les-Fossés,9,0,9
43,Franche-Comté,25,3,17,131,Châtelblanc,108,2,110
43,Franche-Comté,25,1,24,132,Châtillon-Guyotte,141,5,146
43,Franche-Comté,25,1,13,133,Châtillon-le-Duc,1960,58,2018
43,Franche-Comté,25,1,22,134,Châtillon-sur-Lison,14,1,15
43,Franche-Comté,25,1,02,136,Chaucenne,535,5,540
43,Franche-Comté,25,1,13,137,Chaudefontaine,224,0,224
43,Franche-Comté,25,3,15,139,La Chaux,416,6,422
43,Franche-Comté,25,2,08,140,Chaux-lès-Clerval,190,5,195
43,Franche-Comté,25,3,27,141,Chaux-lès-Passavant,148,4,152
43,Franche-Comté,25,3,17,142,Chaux-Neuve,261,3,264
43,Franche-Comté,25,1,22,143,Chay,187,5,192
43,Franche-Comté,25,2,08,145,Chazot,130,6,136
43,Franche-Comté,25,1,02,147,Chemaudin,1423,38,1461
43,Franche-Comté,25,3,25,148,La Chenalotte,368,10,378
43,Franche-Comté,25,1,22,149,Chenecey-Buillon,550,6,556
43,Franche-Comté,25,3,27,151,Chevigney-lès-Vercel,129,4,133
43,Franche-Comté,25,1,02,150,Chevigney-sur-l'Ognon,245,3,248
43,Franche-Comté,25,1,06,152,La Chevillotte,86,5,91
43,Franche-Comté,25,1,13,153,Chevroz,104,1,105
43,Franche-Comté,25,1,22,154,Chouzelot,303,5,308
43,Franche-Comté,25,1,01,155,Cléron,307,12,319
43,Franche-Comté,25,2,08,156,Clerval,1030,13,1043
43,Franche-Comté,25,3,20,157,La Cluse-et-Mijoux,1159,37,1196
43,Franche-Comté,25,2,21,159,Colombier-Fontaine,1408,30,1438
43,Franche-Comté,25,3,16,160,Les Combes,692,20,712
43,Franche-Comté,25,3,19,161,Consolation-Maisonnettes,28,0,28
43,Franche-Comté,25,1,13,163,Corcelle-Mieslot,102,1,103
43,Franche-Comté,25,1,02,162,Corcelles-Ferrières,190,3,193
43,Franche-Comté,25,1,02,164,Corcondray,116,1,117
43,Franche-Comté,25,1,04,166,Côtebrune,70,0,70
43,Franche-Comté,25,2,12,173,Cour-Saint-Maurice,180,4,184
43,Franche-Comté,25,1,22,171,Courcelles,75,3,78
43,Franche-Comté,25,2,03,170,Courcelles-lès-Montbéliard,1119,34,1153
43,Franche-Comté,25,1,02,172,Courchapon,170,2,172
43,Franche-Comté,25,2,26,174,Courtefontaine,234,3,237
43,Franche-Comté,25,3,27,175,Courtetain-et-Salans,76,4,80
43,Franche-Comté,25,3,11,176,Courvières,244,9,253
43,Franche-Comté,25,2,08,177,Crosey-le-Grand,174,2,176
43,Franche-Comté,25,2,08,178,Crosey-le-Petit,112,6,118
43,Franche-Comté,25,3,17,179,Le Crouzet,65,0,65
43,Franche-Comté,25,1,01,180,Crouzet-Migette,147,1,148
43,Franche-Comté,25,1,23,181,Cubrial,137,2,139
43,Franche-Comté,25,1,23,182,Cubry,77,0,77
43,Franche-Comté,25,1,04,183,Cusance,92,0,92
43,Franche-Comté,25,1,23,184,Cuse-et-Adrisans,253,6,259
43,Franche-Comté,25,1,13,186,Cussey-sur-l'Ognon,912,18,930
43,Franche-Comté,25,1,22,185,Cussey-sur-Lison,69,3,72
43,Franche-Comté,25,2,21,187,Dambelin,483,7,490
43,Franche-Comté,25,2,34,188,Dambenois,720,20,740
43,Franche-Comté,25,1,24,189,Dammartin-les-Templiers,191,7,198
43,Franche-Comté,25,2,34,190,Dampierre-les-Bois,1582,34,1616
43,Franche-Comté,25,2,21,191,Dampierre-sur-le-Doubs,504,11,515
43,Franche-Comté,25,2,26,192,Dampjoux,137,1,138
43,Franche-Comté,25,2,12,193,Damprichard,1781,47,1828
43,Franche-Comté,25,2,09,194,Dannemarie,105,1,106
43,Franche-Comté,25,1,02,195,Dannemarie-sur-Crète,1317,290,1607
43,Franche-Comté,25,2,03,196,Dasle,1367,19,1386
43,Franche-Comté,25,1,24,197,Deluz,644,11,655
43,Franche-Comté,25,2,30,198,Désandans,715,9,724
43,Franche-Comté,25,1,01,199,Déservillers,301,11,312
43,Franche-Comté,25,1,13,200,Devecey,1402,25,1427
43,Franche-Comté,25,3,20,201,Dommartin,568,14,582
43,Franche-Comté,25,3,11,202,Dompierre-les-Tilleuls,265,9,274
43,Franche-Comté,25,3,19,203,Domprel,137,8,145
43,Franche-Comté,25,3,20,204,Doubs,2482,91,2573
43,Franche-Comté,25,2,30,207,Dung,656,21,677
43,Franche-Comté,25,1,18,208,Durnes,156,5,161
43,Franche-Comté,25,1,22,209,Échay,102,2,104
43,Franche-Comté,25,2,30,210,Échenans,120,3,123
43,Franche-Comté,25,1,18,211,Échevannes,85,1,86
43,Franche-Comté,25,1,02,212,École-Valentin,2308,54,2362
43,Franche-Comté,25,2,12,213,Les Écorces,591,30,621
43,Franche-Comté,25,2,21,214,Écot,451,6,457
43,Franche-Comté,25,1,24,215,L' Écouvotte,117,1,118
43,Franche-Comté,25,2,09,216,Écurcey,281,5,286
43,Franche-Comté,25,1,02,217,Émagny,610,14,624
43,Franche-Comté,25,3,27,218,Épenouse,128,2,130
43,Franche-Comté,25,3,27,219,Épenoy,556,15,571
43,Franche-Comté,25,1,22,220,Épeugney,496,7,503
43,Franche-Comté,25,1,04,221,Esnans,44,0,44
43,Franche-Comté,25,3,27,222,Étalans,1111,42,1153
43,Franche-Comté,25,1,01,223,Éternoz,330,7,337
43,Franche-Comté,25,2,21,224,Étouvans,761,16,777
43,Franche-Comté,25,1,02,225,Étrabonne,172,1,173
43,Franche-Comté,25,2,10,226,Étrappe,180,2,182
43,Franche-Comté,25,3,27,227,Étray,181,4,185
43,Franche-Comté,25,2,34,228,Étupes,3428,54,3482
43,Franche-Comté,25,3,11,229,Évillers,317,10,327
43,Franche-Comté,25,2,34,230,Exincourt,3208,65,3273
43,Franche-Comté,25,3,27,231,Eysson,87,2,89
43,Franche-Comté,25,2,10,232,Faimbe,111,1,112
43,Franche-Comté,25,3,27,233,Fallerans,248,9,257
43,Franche-Comté,25,2,12,234,Ferrières-le-Lac,151,1,152
43,Franche-Comté,25,1,02,235,Ferrières-les-Bois,327,9,336
43,Franche-Comté,25,1,01,236,Fertans,241,6,247
43,Franche-Comté,25,2,34,237,Fesches-le-Châtel,2244,27,2271
43,Franche-Comté,25,2,12,238,Fessevillers,172,1,173
43,Franche-Comté,25,2,21,239,Feule,169,3,172
43,Franche-Comté,25,3,16,240,Les Fins,2816,223,3039
43,Franche-Comté,25,1,01,241,Flagey,137,6,143
43,Franche-Comté,25,1,13,242,Flagey-Rigney,74,1,75
43,Franche-Comté,25,3,19,243,Flangebouche,648,5,653
43,Franche-Comté,25,2,26,244,Fleurey,90,0,90
43,Franche-Comté,25,1,06,245,Fontain,944,21,965
43,Franche-Comté,25,2,08,246,Fontaine-lès-Clerval,242,6,248
43,Franche-Comté,25,1,23,247,Fontenelle-Montby,106,2,108
43,Franche-Comté,25,3,25,248,Les Fontenelles,548,150,698
43,Franche-Comté,25,1,04,249,Fontenotte,54,2,56
43,Franche-Comté,25,1,18,250,Foucherans,432,16,448
43,Franche-Comté,25,1,04,251,Fourbanne,176,1,177
43,Franche-Comté,25,3,17,252,Fourcatier-et-Maison-Neuve,77,6,83
43,Franche-Comté,25,1,22,253,Fourg,328,4,332
43,Franche-Comté,25,3,20,254,Les Fourgs,1175,38,1213
43,Franche-Comté,25,2,12,255,Fournet-Blancheroche,338,10,348
43,Franche-Comté,25,3,19,288,Fournets-Luisans,599,15,614
43,Franche-Comté,25,2,12,256,Frambouhans,715,14,729
43,Franche-Comté,25,1,02,257,Franey,277,3,280
43,Franche-Comté,25,1,02,258,Franois,1902,44,1946
43,Franche-Comté,25,3,11,259,Frasne,1789,49,1838
43,Franche-Comté,25,2,26,261,Froidevaux,57,6,63
43,Franche-Comté,25,3,19,262,Fuans,437,5,442
43,Franche-Comté,25,3,17,263,Gellin,183,8,191
43,Franche-Comté,25,2,10,264,Gémonval,88,0,88
43,Franche-Comté,25,1,13,265,Geneuille,1295,14,1309
43,Franche-Comté,25,2,10,266,Geney,146,4,150
43,Franche-Comté,25,1,06,267,Gennes,615,8,623
43,Franche-Comté,25,3,19,268,Germéfontaine,117,1,118
43,Franche-Comté,25,1,13,269,Germondans,71,1,72
43,Franche-Comté,25,1,01,270,Gevresin,110,5,115
43,Franche-Comté,25,3,15,271,Gilley,1417,24,1441
43,Franche-Comté,25,1,24,273,Glamondans,214,4,218
43,Franche-Comté,25,2,09,274,Glay,330,9,339
43,Franche-Comté,25,2,26,275,Glère,212,2,214
43,Franche-Comté,25,1,23,277,Gondenans-les-Moulins,74,4,78
43,Franche-Comté,25,1,23,276,Gondenans-Montby,168,0,168
43,Franche-Comté,25,1,24,278,Gonsans,513,9,522
43,Franche-Comté,25,1,23,279,Gouhelans,116,5,121
43,Franche-Comté,25,2,12,280,Goumois,187,5,192
43,Franche-Comté,25,2,21,281,Goux-lès-Dambelin,276,5,281
43,Franche-Comté,25,3,11,282,Goux-les-Usiers,662,4,666
43,Franche-Comté,25,1,22,283,Goux-sous-Landet,49,0,49
43,Franche-Comté,25,2,31,284,Grand-Charmont,4999,91,5090
43,Franche-Comté,25,3,16,285,Grand'Combe-Châteleu,1352,39,1391
43,Franche-Comté,25,3,25,286,Grand'Combe-des-Bois,117,3,120
43,Franche-Comté,25,1,07,287,Grandfontaine,1426,38,1464
43,Franche-Comté,25,3,19,289,Grandfontaine-sur-Creuse,88,2,90
43,Franche-Comté,25,2,12,290,La Grange,82,1,83
43,Franche-Comté,25,3,20,293,Granges-Narboz,800,34,834
43,Franche-Comté,25,3,20,295,Les Grangettes,224,10,234
43,Franche-Comté,25,3,16,296,Les Gras,740,21,761
43,Franche-Comté,25,1,06,297,Le Gratteris,148,0,148
43,Franche-Comté,25,1,04,298,Grosbois,243,3,246
43,Franche-Comté,25,1,04,299,Guillon-les-Bains,124,1,125
43,Franche-Comté,25,1,18,300,Guyans-Durnes,237,10,247
43,Franche-Comté,25,3,19,301,Guyans-Vennes,696,17,713
43,Franche-Comté,25,3,27,302,Hautepierre-le-Châtelet,83,0,83
43,Franche-Comté,25,3,15,303,Hauterive-la-Fresse,213,4,217
43,Franche-Comté,25,2,09,304,Hérimoncourt,3885,88,3973
43,Franche-Comté,25,1,18,305,L' Hôpital-du-Grosbois,529,9,538
43,Franche-Comté,25,2,08,306,L' Hôpital-Saint-Lieffroy,85,1,86
43,Franche-Comté,25,3,20,307,Les Hôpitaux-Neufs,723,16,739
43,Franche-Comté,25,3,20,308,Les Hôpitaux-Vieux,353,9,362
43,Franche-Comté,25,3,20,309,Houtaud,924,55,979
43,Franche-Comté,25,1,23,310,Huanne-Montmartin,81,2,83
43,Franche-Comté,25,2,10,311,Hyémondans,191,2,193
43,Franche-Comté,25,1,04,312,Hyèvre-Magny,68,0,68
43,Franche-Comté,25,1,04,313,Hyèvre-Paroisse,194,4,198
43,Franche-Comté,25,2,26,314,Indevillers,233,3,236
43,Franche-Comté,25,2,10,315,L' Isle-sur-le-Doubs,3249,63,3312
43,Franche-Comté,25,2,30,316,Issans,245,13,258
43,Franche-Comté,25,1,02,317,Jallerange,204,1,205
43,Franche-Comté,25,3,17,318,Jougne,1376,37,1413
43,Franche-Comté,25,1,01,319,Labergement-du-Navois,113,0,113
43,Franche-Comté,25,3,17,320,Labergement-Sainte-Marie,1034,36,1070
43,Franche-Comté,25,2,30,322,Laire,388,9,397
43,Franche-Comté,25,1,24,323,Laissey,442,1,443
43,Franche-Comté,25,1,04,324,Lanans,134,4,138
43,Franche-Comté,25,3,19,325,Landresse,202,3,205
43,Franche-Comté,25,1,02,326,Lantenne-Vertière,535,9,544
43,Franche-Comté,25,2,10,327,Lanthenans,63,1,64
43,Franche-Comté,25,1,07,328,Larnod,583,17,600
43,Franche-Comté,25,3,25,329,Laval-le-Prieuré,34,2,36
43,Franche-Comté,25,1,22,330,Lavans-Quingey,178,6,184
43,Franche-Comté,25,1,18,331,Lavans-Vuillafans,213,5,218
43,Franche-Comté,25,1,02,332,Lavernay,580,8,588
43,Franche-Comté,25,3,19,333,Laviron,341,6,347
43,Franche-Comté,25,3,11,334,Levier,1934,225,2159
43,Franche-Comté,25,2,26,335,Liebvillers,189,6,195
43,Franche-Comté,25,1,22,336,Liesle,525,19,544
43,Franche-Comté,25,1,01,338,Lizine,96,4,100
43,Franche-Comté,25,1,18,339,Lods,247,6,253
43,Franche-Comté,25,1,22,340,Lombard,218,2,220
43,Franche-Comté,25,1,04,341,Lomont-sur-Crête,159,4,163
43,Franche-Comté,25,3,27,342,Longechaux,55,0,55
43,Franche-Comté,25,3,27,343,Longemaison,131,3,134
43,Franche-Comté,25,3,25,344,Longevelle-lès-Russey,50,1,51
43,Franche-Comté,25,2,10,345,Longevelle-sur-Doubs,635,14,649
43,Franche-Comté,25,1,18,346,Longeville,145,8,153
43,Franche-Comté,25,3,15,347,La Longeville,610,15,625
43,Franche-Comté,25,3,17,348,Longevilles-Mont-d'Or,405,11,416
43,Franche-Comté,25,3,19,349,Loray,466,11,477
43,Franche-Comté,25,2,30,350,Lougres,756,15,771
43,Franche-Comté,25,3,25,351,Le Luhier,187,8,195
43,Franche-Comté,25,1,04,354,Luxiol,175,3,178
43,Franche-Comté,25,3,27,355,Magny-Châtelard,33,0,33
43,Franche-Comté,25,2,12,356,Maîche,4179,113,4292
43,Franche-Comté,25,3,15,357,Maisons-du-Bois-Lièvremont,600,11,611
43,Franche-Comté,25,1,01,359,Malans,157,0,157
43,Franche-Comté,25,1,18,360,Malbrans,125,1,126
43,Franche-Comté,25,3,20,361,Malbuisson,626,15,641
43,Franche-Comté,25,3,20,362,Malpas,201,1,202
43,Franche-Comté,25,1,06,364,Mamirolle,1648,23,1671
43,Franche-Comté,25,2,10,365,Mancenans,349,5,354
43,Franche-Comté,25,2,12,366,Mancenans-Lizerne,165,5,170
43,Franche-Comté,25,2,35,367,Mandeure,4998,198,5196
43,Franche-Comté,25,1,13,368,Marchaux,1030,14,1044
43,Franche-Comté,25,2,10,369,Marvelise,159,2,161
43,Franche-Comté,25,2,21,370,Mathay,2156,43,2199
43,Franche-Comté,25,1,02,371,Mazerolles-le-Salin,190,3,193
43,Franche-Comté,25,2,10,372,Médière,327,12,339
43,Franche-Comté,25,3,25,373,Le Mémont,39,1,40
43,Franche-Comté,25,1,02,374,Mercey-le-Grand,461,1,462
43,Franche-Comté,25,1,18,375,Mérey-sous-Montrond,443,4,447
43,Franche-Comté,25,1,13,376,Mérey-Vieilley,100,2,102
43,Franche-Comté,25,1,23,377,Mésandans,153,4,157
43,Franche-Comté,25,2,09,378,Meslières,352,5,357
43,Franche-Comté,25,1,22,379,Mesmay,68,3,71
43,Franche-Comté,25,3,17,380,Métabief,954,14,968
43,Franche-Comté,25,1,02,381,Miserey-Salines,2117,56,2173
43,Franche-Comté,25,1,13,382,Moncey,478,10,488
43,Franche-Comté,25,1,02,383,Moncley,333,4,337
43,Franche-Comté,25,1,23,384,Mondon,73,0,73
43,Franche-Comté,25,3,25,391,Mont-de-Laval,181,9,190
43,Franche-Comté,25,2,12,392,Mont-de-Vougney,166,4,170
43,Franche-Comté,25,1,23,385,Montagney-Servigney,111,1,112
43,Franche-Comté,25,2,26,386,Montancy,154,5,159
43,Franche-Comté,25,2,26,387,Montandon,335,3,338
43,Franche-Comté,25,2,95,388,Montbéliard,26207,620,26827
43,Franche-Comté,25,3,25,389,Montbéliardot,89,3,92
43,Franche-Comté,25,3,15,390,Montbenoît,365,9,374
43,Franche-Comté,25,2,26,393,Montécheroux,563,16,579
43,Franche-Comté,25,2,10,394,Montenois,1553,36,1589
43,Franche-Comté,25,1,06,395,Montfaucon,1478,52,1530
43,Franche-Comté,25,1,07,397,Montferrand-le-Château,2179,43,2222
43,Franche-Comté,25,3,15,398,Montflovin,93,1,94
43,Franche-Comté,25,1,22,399,Montfort,90,35,125
43,Franche-Comté,25,1,18,400,Montgesoye,514,11,525
43,Franche-Comté,25,1,04,401,Montivernage,30,1,31
43,Franche-Comté,25,2,26,402,Montjoie-le-Château,26,0,26
43,Franche-Comté,25,3,16,403,Montlebon,1919,47,1966
43,Franche-Comté,25,1,01,404,Montmahoux,80,3,83
43,Franche-Comté,25,3,20,405,Montperreux,768,31,799
43,Franche-Comté,25,1,22,406,Montrond-le-Château,561,14,575
43,Franche-Comté,25,1,23,408,Montussaint,68,0,68
43,Franche-Comté,25,1,06,410,Morre,1270,40,1310
43,Franche-Comté,25,3,16,411,Morteau,6499,325,6824
43,Franche-Comté,25,3,17,413,Mouthe,972,31,1003
43,Franche-Comté,25,1,02,414,Le Moutherot,103,0,103
43,Franche-Comté,25,1,18,415,Mouthier-Haute-Pierre,310,5,315
43,Franche-Comté,25,1,22,416,Myon,186,11,197
43,Franche-Comté,25,1,24,417,Naisey-les-Granges,706,12,718
43,Franche-Comté,25,1,24,418,Nancray,1237,28,1265
43,Franche-Comté,25,1,23,419,Nans,84,4,88
43,Franche-Comté,25,1,01,420,Nans-sous-Sainte-Anne,145,3,148
43,Franche-Comté,25,3,25,421,Narbief,74,0,74
43,Franche-Comté,25,2,21,422,Neuchâtel-Urtière,155,1,156
43,Franche-Comté,25,3,27,424,Nods,537,12,549
43,Franche-Comté,25,3,25,425,Noël-Cerneux,354,7,361
43,Franche-Comté,25,2,21,426,Noirefontaine,357,10,367
43,Franche-Comté,25,1,02,427,Noironte,310,9,319
43,Franche-Comté,25,2,31,428,Nommay,1588,40,1628
43,Franche-Comté,25,1,13,429,Novillars,1603,47,1650
43,Franche-Comté,25,1,13,430,Ollans,42,3,45
43,Franche-Comté,25,2,10,431,Onans,369,11,380
43,Franche-Comté,25,3,19,432,Orchamps-Vennes,1826,46,1872
43,Franche-Comté,25,2,12,433,Orgeans-Blanchefontaine,45,0,45
43,Franche-Comté,25,1,18,434,Ornans,4124,111,4235
43,Franche-Comté,25,3,27,435,Orsans,160,1,161
43,Franche-Comté,25,2,08,436,Orve,69,1,70
43,Franche-Comté,25,1,24,437,Osse,322,9,331
43,Franche-Comté,25,1,07,438,Osselle,380,6,386
43,Franche-Comté,25,1,24,439,Ougney-Douvot,183,6,189
43,Franche-Comté,25,3,15,440,Ouhans,373,8,381
43,Franche-Comté,25,3,19,441,Ouvans,60,1,61
43,Franche-Comté,25,3,20,442,Oye-et-Pallet,688,13,701
43,Franche-Comté,25,1,22,443,Palantine,37,0,37
43,Franche-Comté,25,1,13,444,Palise,123,0,123
43,Franche-Comté,25,1,22,445,Paroy,113,3,116
43,Franche-Comté,25,1,04,446,Passavant,215,7,222
43,Franche-Comté,25,3,27,447,Passonfontaine,274,10,284
43,Franche-Comté,25,1,02,448,Pelousey,1404,28,1432
43,Franche-Comté,25,2,21,449,Péseux,92,6,98
43,Franche-Comté,25,1,22,450,Pessans,74,3,77
43,Franche-Comté,25,3,17,451,Petite-Chaux,129,6,135
43,Franche-Comté,25,2,09,452,Pierrefontaine-lès-Blamont,393,7,400
43,Franche-Comté,25,3,19,453,Pierrefontaine-les-Varans,1300,40,1340
43,Franche-Comté,25,1,02,454,Pirey,1772,53,1825
43,Franche-Comté,25,1,02,455,Placey,154,4,158
43,Franche-Comté,25,3,25,456,Plaimbois-du-Miroir,196,3,199
43,Franche-Comté,25,3,19,457,Plaimbois-Vennes,73,4,77
43,Franche-Comté,25,2,26,458,Les Plains-et-Grands-Essarts,196,0,196
43,Franche-Comté,25,3,20,459,La Planée,232,6,238
43,Franche-Comté,25,1,22,460,Pointvillers,115,0,115
43,Franche-Comté,25,2,08,461,Pompierre-sur-Doubs,325,7,332
43,Franche-Comté,25,2,21,463,Pont-de-Roide,4597,118,4715
43,Franche-Comté,25,1,04,465,Pont-les-Moulins,175,2,177
43,Franche-Comté,25,3,20,462,Pontarlier,18639,811,19450
43,Franche-Comté,25,3,17,464,Les Pontets,104,3,107
43,Franche-Comté,25,1,02,466,Pouilley-Français,695,13,708
43,Franche-Comté,25,1,02,467,Pouilley-les-Vignes,1882,50,1932
43,Franche-Comté,25,1,24,468,Pouligney-Lusans,759,10,769
43,Franche-Comté,25,2,30,469,Présentevillers,475,11,486
43,Franche-Comté,25,2,10,470,La Prétière,159,0,159
43,Franche-Comté,25,2,12,471,Provenchère,116,3,119
43,Franche-Comté,25,1,23,472,Puessans,44,1,45
43,Franche-Comté,25,1,07,473,Pugey,746,6,752
43,Franche-Comté,25,1,24,474,Le Puy,81,0,81
43,Franche-Comté,25,1,22,475,Quingey,1274,17,1291
43,Franche-Comté,25,2,08,476,Rahon,116,1,117
43,Franche-Comté,25,1,07,477,Rancenay,296,8,304
43,Franche-Comté,25,2,08,478,Randevillers,106,2,108
43,Franche-Comté,25,2,10,479,Rang,404,10,414
43,Franche-Comté,25,3,27,480,Rantechaux,190,4,194
43,Franche-Comté,25,2,30,481,Raynans,294,10,304
43,Franche-Comté,25,1,02,482,Recologne,551,16,567
43,Franche-Comté,25,3,17,483,Reculfoz,52,1,53
43,Franche-Comté,25,2,21,485,Rémondans-Vaivre,220,4,224
43,Franche-Comté,25,3,17,486,Remoray-Boujeons,323,6,329
43,Franche-Comté,25,3,15,487,Renédale,37,2,39
43,Franche-Comté,25,1,22,488,Rennes-sur-Loue,93,3,96
43,Franche-Comté,25,1,01,489,Reugney,310,6,316
43,Franche-Comté,25,1,13,490,Rigney,429,6,435
43,Franche-Comté,25,1,13,491,Rignosot,120,0,120
43,Franche-Comté,25,1,23,492,Rillans,81,1,82
43,Franche-Comté,25,3,20,493,La Rivière-Drugeon,771,16,787
43,Franche-Comté,25,2,08,496,Roche-lès-Clerval,97,2,99
43,Franche-Comté,25,1,13,495,Roche-lez-Beaupré,2070,29,2099
43,Franche-Comté,25,3,17,494,Rochejean,549,12,561
43,Franche-Comté,25,2,09,497,Roches-lès-Blamont,643,18,661
43,Franche-Comté,25,1,23,498,Rognon,46,0,46
43,Franche-Comté,25,1,23,499,Romain,102,2,104
43,Franche-Comté,25,1,22,500,Ronchaux,87,4,91
43,Franche-Comté,25,3,17,501,Rondefontaine,28,1,29
43,Franche-Comté,25,1,07,502,Roset-Fluans,449,10,459
43,Franche-Comté,25,2,21,503,Rosières-sur-Barbèche,101,7,108
43,Franche-Comté,25,3,25,504,Rosureux,90,2,92
43,Franche-Comté,25,1,23,505,Rougemont,1235,22,1257
43,Franche-Comté,25,1,13,506,Rougemontot,91,1,92
43,Franche-Comté,25,1,22,507,Rouhe,76,1,77
43,Franche-Comté,25,1,24,508,Roulans,1075,15,1090
43,Franche-Comté,25,1,07,509,Routelle,485,10,495
43,Franche-Comté,25,1,02,510,Ruffey-le-Château,306,2,308
43,Franche-Comté,25,1,22,511,Rurey,319,5,324
43,Franche-Comté,25,3,25,512,Le Russey,2017,98,2115
43,Franche-Comté,25,3,17,514,Saint-Antoine,290,8,298
43,Franche-Comté,25,2,08,516,Saint-Georges-Armont,108,3,111
43,Franche-Comté,25,3,15,517,Saint-Gorgon-Main,252,2,254
43,Franche-Comté,25,1,24,518,Saint-Hilaire,149,1,150
43,Franche-Comté,25,2,26,519,Saint-Hippolyte,922,24,946
43,Franche-Comté,25,1,04,520,Saint-Juan,189,5,194
43,Franche-Comté,25,2,30,521,Saint-Julien-lès-Montbéliard,172,4,176
43,Franche-Comté,25,3,25,522,Saint-Julien-lès-Russey,147,1,148
43,Franche-Comté,25,2,10,524,Saint-Maurice-Colombier,886,12,898
43,Franche-Comté,25,3,20,525,Saint-Point-Lac,261,17,278
43,Franche-Comté,25,1,07,527,Saint-Vit,4642,76,4718
43,Franche-Comté,25,1,01,513,Sainte-Anne,29,1,30
43,Franche-Comté,25,3,20,515,Sainte-Colombe,279,12,291
43,Franche-Comté,25,2,30,523,Sainte-Marie,717,23,740
43,Franche-Comté,25,2,30,526,Sainte-Suzanne,1444,21,1465
43,Franche-Comté,25,1,22,528,Samson,71,1,72
43,Franche-Comté,25,2,08,529,Sancey-le-Grand,980,39,1019
43,Franche-Comté,25,2,08,530,Sancey-le-Long,386,20,406
43,Franche-Comté,25,2,08,531,Santoche,81,1,82
43,Franche-Comté,25,1,06,532,Saône,3189,76,3265
43,Franche-Comté,25,1,01,533,Saraz,19,5,24
43,Franche-Comté,25,3,17,534,Sarrageois,148,3,151
43,Franche-Comté,25,1,18,535,Saules,215,3,218
43,Franche-Comté,25,1,02,536,Sauvagney,157,8,165
43,Franche-Comté,25,1,18,537,Scey-Maisières,315,6,321
43,Franche-Comté,25,1,24,538,Séchin,130,2,132
43,Franche-Comté,25,2,09,539,Seloncourt,5913,203,6116
43,Franche-Comté,25,2,30,540,Semondans,320,7,327
43,Franche-Comté,25,3,11,541,Septfontaines,287,10,297
43,Franche-Comté,25,1,02,542,Serre-les-Sapins,1554,34,1588
43,Franche-Comté,25,1,04,544,Servin,185,7,192
43,Franche-Comté,25,1,01,545,Silley-Amancey,124,2,126
43,Franche-Comté,25,1,04,546,Silley-Bléfond,73,1,74
43,Franche-Comté,25,2,31,547,Sochaux,4212,62,4274
43,Franche-Comté,25,2,21,548,Solemont,140,5,145
43,Franche-Comté,25,3,11,549,Sombacour,583,7,590
43,Franche-Comté,25,3,19,550,La Sommette,186,4,190
43,Franche-Comté,25,2,26,551,Soulce-Cernay,106,2,108
43,Franche-Comté,25,2,10,552,Sourans,125,0,125
43,Franche-Comté,25,2,10,553,Soye,322,2,324
43,Franche-Comté,25,2,08,554,Surmont,135,5,140
43,Franche-Comté,25,2,03,555,Taillecourt,1036,22,1058
43,Franche-Comté,25,1,23,556,Tallans,37,0,37
43,Franche-Comté,25,1,13,557,Tallenay,402,10,412
43,Franche-Comté,25,1,18,558,Tarcenay,895,18,913
43,Franche-Comté,25,2,26,138,Les Terres-de-Chaux,128,1,129
43,Franche-Comté,25,2,12,559,Thiébouhans,231,3,234
43,Franche-Comté,25,1,13,560,Thise,3237,58,3295
43,Franche-Comté,25,1,07,561,Thoraise,284,7,291
43,Franche-Comté,25,2,09,562,Thulay,213,7,220
43,Franche-Comté,25,1,13,563,Thurey-le-Mont,110,3,113
43,Franche-Comté,25,1,07,564,Torpes,849,11,860
43,Franche-Comté,25,3,20,565,Touillon-et-Loutelet,217,5,222
43,Franche-Comté,25,1,13,566,La Tour-de-Sçay,242,7,249
43,Franche-Comté,25,1,23,567,Tournans,116,4,120
43,Franche-Comté,25,1,18,569,Trépot,498,4,502
43,Franche-Comté,25,1,23,570,Tressandans,35,1,36
43,Franche-Comté,25,2,12,571,Trévillers,479,11,490
43,Franche-Comté,25,1,23,572,Trouvans,82,0,82
43,Franche-Comté,25,2,12,573,Urtière,8,0,8
43,Franche-Comté,25,1,23,574,Uzelle,153,2,155
43,Franche-Comté,25,1,13,575,Vaire-Arcier,515,6,521
43,Franche-Comté,25,1,13,576,Vaire-le-Petit,197,4,201
43,Franche-Comté,25,1,24,579,Val-de-Roulans,130,2,132
43,Franche-Comté,25,3,27,578,Valdahon,4791,119,4910
43,Franche-Comté,25,2,35,580,Valentigney,11509,231,11740
43,Franche-Comté,25,1,13,582,Valleroy,121,1,122
43,Franche-Comté,25,2,21,583,Valonne,221,2,223
43,Franche-Comté,25,2,26,584,Valoreille,105,5,110
43,Franche-Comté,25,3,27,585,Vanclans,208,10,218
43,Franche-Comté,25,2,09,586,Vandoncourt,819,23,842
43,Franche-Comté,25,1,24,587,Vauchamps,123,4,127
43,Franche-Comté,25,2,12,588,Vaucluse,107,47,154
43,Franche-Comté,25,2,12,589,Vauclusotte,99,5,104
43,Franche-Comté,25,1,04,590,Vaudrivillers,80,4,84
43,Franche-Comté,25,2,26,591,Vaufrey,143,2,145
43,Franche-Comté,25,3,17,592,Vaux-et-Chantegrue,563,8,571
43,Franche-Comté,25,1,02,593,Vaux-les-Prés,365,12,377
43,Franche-Comté,25,1,07,594,Velesmes-Essarts,318,0,318
43,Franche-Comté,25,2,08,595,Vellerot-lès-Belvoir,116,0,116
43,Franche-Comté,25,3,19,596,Vellerot-lès-Vercel,45,4,49
43,Franche-Comté,25,2,08,597,Vellevans,192,11,203
43,Franche-Comté,25,1,13,598,Venise,443,7,450
43,Franche-Comté,25,1,24,599,Vennans,175,5,180
43,Franche-Comté,25,3,19,600,Vennes,138,2,140
43,Franche-Comté,25,3,27,601,Vercel-Villedieu-le-Camp,1436,126,1562
43,Franche-Comté,25,1,04,602,Vergranne,121,4,125
43,Franche-Comté,25,1,04,604,Verne,146,2,148
43,Franche-Comté,25,3,27,605,Vernierfontaine,419,5,424
43,Franche-Comté,25,2,21,607,Vernois-lès-Belvoir,66,2,68
43,Franche-Comté,25,2,30,608,Le Vernoy,143,2,145
43,Franche-Comté,25,3,20,609,Verrières-de-Joux,413,8,421
43,Franche-Comté,25,3,27,610,Verrières-du-Grosbois,22,0,22
43,Franche-Comté,25,1,06,611,La Vèze,439,15,454
43,Franche-Comté,25,1,13,612,Vieilley,713,7,720
43,Franche-Comté,25,1,23,613,Viéthorey,123,1,124
43,Franche-Comté,25,2,31,614,Vieux-Charmont,2485,54,2539
43,Franche-Comté,25,2,09,615,Villars-lès-Blamont,452,11,463
43,Franche-Comté,25,1,07,616,Villars-Saint-Georges,245,1,246
43,Franche-Comté,25,2,21,617,Villars-sous-Dampjoux,391,8,399
43,Franche-Comté,25,2,21,618,Villars-sous-Écot,387,8,395
43,Franche-Comté,25,3,15,620,Ville-du-Pont,286,4,290
43,Franche-Comté,25,3,17,619,Les Villedieu,159,2,161
43,Franche-Comté,25,3,11,621,Villeneuve-d'Amont,266,36,302
43,Franche-Comté,25,1,02,622,Villers-Buzon,260,9,269
43,Franche-Comté,25,3,19,623,Villers-Chief,117,1,118
43,Franche-Comté,25,1,24,624,Villers-Grélot,154,4,158
43,Franche-Comté,25,3,19,625,Villers-la-Combe,51,1,52
43,Franche-Comté,25,3,16,321,Villers-le-Lac,4415,122,4537
43,Franche-Comté,25,1,04,626,Villers-Saint-Martin,209,2,211
43,Franche-Comté,25,3,11,627,Villers-sous-Chalamont,280,11,291
43,Franche-Comté,25,1,18,628,Villers-sous-Montrond,169,10,179
43,Franche-Comté,25,1,04,629,Voillans,211,8,219
43,Franche-Comté,25,1,18,630,Voires,57,2,59
43,Franche-Comté,25,1,07,631,Vorges-les-Pins,515,8,523
43,Franche-Comté,25,2,35,632,Voujeaucourt,3399,86,3485
43,Franche-Comté,25,1,18,633,Vuillafans,710,12,722
43,Franche-Comté,25,3,20,634,Vuillecin,600,20,620
43,Franche-Comté,25,2,08,635,Vyt-lès-Belvoir,175,3,178
82,Rhône-Alpes,26,1,09,001,Aix-en-Diois,351,9,360
82,Rhône-Alpes,26,3,26,002,Albon,1722,39,1761
82,Rhône-Alpes,26,2,10,003,Aleyrac,48,2,50
82,Rhône-Alpes,26,3,02,004,Alixan,2318,59,2377
82,Rhône-Alpes,26,2,33,005,Allan,1591,55,1646
82,Rhône-Alpes,26,1,07,006,Allex,2472,69,2541
82,Rhône-Alpes,26,3,13,007,Ambonil,118,8,126
82,Rhône-Alpes,26,2,16,008,Ancône,1042,28,1070
82,Rhône-Alpes,26,3,26,009,Andancette,1249,20,1269
82,Rhône-Alpes,26,3,26,010,Anneyron,3737,119,3856
82,Rhône-Alpes,26,1,07,011,Aouste-sur-Sye,2254,41,2295
82,Rhône-Alpes,26,1,17,012,Arnayon,32,0,32
82,Rhône-Alpes,26,2,18,013,Arpavon,71,3,74
82,Rhône-Alpes,26,3,23,014,Arthémonay,526,9,535
82,Rhône-Alpes,26,1,22,015,Aubenasson,66,3,69
82,Rhône-Alpes,26,2,18,016,Aubres,426,12,438
82,Rhône-Alpes,26,1,14,017,Aucelon,28,0,28
82,Rhône-Alpes,26,2,27,018,Aulan,4,0,4
82,Rhône-Alpes,26,1,22,019,Aurel,229,5,234
82,Rhône-Alpes,26,1,08,021,Autichamp,149,1,150
82,Rhône-Alpes,26,2,27,022,Ballons,86,2,88
82,Rhône-Alpes,26,3,02,023,Barbières,766,14,780
82,Rhône-Alpes,26,3,04,024,Barcelonne,359,13,372
82,Rhône-Alpes,26,1,14,025,Barnave,158,10,168
82,Rhône-Alpes,26,2,27,026,Barret-de-Lioure,78,2,80
82,Rhône-Alpes,26,1,09,027,Barsac,166,3,169
82,Rhône-Alpes,26,3,23,028,Bathernay,238,10,248
82,Rhône-Alpes,26,1,14,030,La Bâtie-des-Fonds,8,0,8
82,Rhône-Alpes,26,2,15,031,La Bâtie-Rolland,913,34,947
82,Rhône-Alpes,26,3,04,032,La Baume-Cornillane,445,14,459
82,Rhône-Alpes,26,3,02,034,La Baume-d'Hostun,482,9,491
82,Rhône-Alpes,26,2,25,033,La Baume-de-Transit,826,30,856
82,Rhône-Alpes,26,1,07,035,Beaufort-sur-Gervanne,388,10,398
82,Rhône-Alpes,26,1,14,036,Beaumont-en-Diois,79,3,82
82,Rhône-Alpes,26,3,34,037,Beaumont-lès-Valence,3811,121,3932
82,Rhône-Alpes,26,3,28,038,Beaumont-Monteux,1041,25,1066
82,Rhône-Alpes,26,3,02,039,Beauregard-Baret,784,22,806
82,Rhône-Alpes,26,1,14,040,Beaurières,85,3,88
82,Rhône-Alpes,26,3,26,041,Beausemblant,1276,37,1313
82,Rhône-Alpes,26,3,34,042,Beauvallon,1621,33,1654
82,Rhône-Alpes,26,2,03,043,Beauvoisin,180,3,183
82,Rhône-Alpes,26,2,10,045,La Bégude-de-Mazenc,1457,52,1509
82,Rhône-Alpes,26,2,03,046,Bellecombe-Tarendol,96,1,97
82,Rhône-Alpes,26,1,17,047,Bellegarde-en-Diois,77,3,80
82,Rhône-Alpes,26,2,03,048,Bénivay-Ollon,64,2,66
82,Rhône-Alpes,26,3,02,049,Bésayes,1006,29,1035
82,Rhône-Alpes,26,2,03,050,Bésignan,67,1,68
82,Rhône-Alpes,26,1,01,051,Bézaudun-sur-Bîne,88,0,88
82,Rhône-Alpes,26,2,15,052,Bonlieu-sur-Roubion,381,5,386
82,Rhône-Alpes,26,2,25,054,Bouchet,1079,12,1091
82,Rhône-Alpes,26,1,06,055,Boulc,121,3,124
82,Rhône-Alpes,26,1,01,056,Bourdeaux,616,16,632
82,Rhône-Alpes,26,3,02,057,Bourg-de-Péage,10091,254,10345
82,Rhône-Alpes,26,3,32,058,Bourg-lès-Valence,18356,555,18911
82,Rhône-Alpes,26,3,24,059,Bouvante,239,9,248
82,Rhône-Alpes,26,1,01,060,Bouvières,152,7,159
82,Rhône-Alpes,26,3,23,061,Bren,535,9,544
82,Rhône-Alpes,26,1,17,062,Brette,31,0,31
82,Rhône-Alpes,26,2,03,063,Buis-les-Baronnies,2312,69,2381
82,Rhône-Alpes,26,3,04,064,Chabeuil,6528,178,6706
82,Rhône-Alpes,26,1,08,065,Chabrillan,659,20,679
82,Rhône-Alpes,26,3,04,066,Le Chaffal,49,4,53
82,Rhône-Alpes,26,1,17,067,Chalancon,63,0,63
82,Rhône-Alpes,26,3,35,068,Le Chalon,193,2,195
82,Rhône-Alpes,26,1,09,069,Chamaloc,115,6,121
82,Rhône-Alpes,26,2,12,070,Chamaret,543,17,560
82,Rhône-Alpes,26,3,28,071,Chanos-Curson,1091,22,1113
82,Rhône-Alpes,26,3,28,072,Chantemerle-les-Blés,1106,21,1127
82,Rhône-Alpes,26,2,12,073,Chantemerle-lès-Grignan,225,7,232
82,Rhône-Alpes,26,1,05,074,La Chapelle-en-Vercors,673,117,790
82,Rhône-Alpes,26,2,20,075,La Charce,39,0,39
82,Rhône-Alpes,26,1,14,076,Charens,22,1,23
82,Rhône-Alpes,26,3,23,077,Charmes-sur-l'Herbasse,875,23,898
82,Rhône-Alpes,26,2,15,078,Charols,748,17,765
82,Rhône-Alpes,26,3,02,079,Charpey,1238,12,1250
82,Rhône-Alpes,26,1,22,080,Chastel-Arnaud,49,1,50
82,Rhône-Alpes,26,3,04,081,Châteaudouble,544,21,565
82,Rhône-Alpes,26,2,18,082,Châteauneuf-de-Bordette,108,1,109
82,Rhône-Alpes,26,3,26,083,Châteauneuf-de-Galaure,1550,499,2049
82,Rhône-Alpes,26,2,33,085,Châteauneuf-du-Rhône,2255,58,2313
82,Rhône-Alpes,26,3,02,084,Châteauneuf-sur-Isère,3658,115,3773
82,Rhône-Alpes,26,1,06,086,Châtillon-en-Diois,566,17,583
82,Rhône-Alpes,26,3,35,087,Châtillon-Saint-Jean,1189,25,1214
82,Rhône-Alpes,26,3,02,088,Chatuzange-le-Goubet,4633,101,4734
82,Rhône-Alpes,26,2,18,089,Chaudebonne,60,3,63
82,Rhône-Alpes,26,1,22,090,La Chaudière,22,0,22
82,Rhône-Alpes,26,2,20,091,Chauvac-Laux-Montaux,44,3,47
82,Rhône-Alpes,26,3,23,092,Chavannes,460,9,469
82,Rhône-Alpes,26,2,25,093,Clansayes,552,25,577
82,Rhône-Alpes,26,3,26,094,Claveyson,848,21,869
82,Rhône-Alpes,26,2,15,095,Cléon-d'Andran,900,10,910
82,Rhône-Alpes,26,3,21,096,Clérieux,2053,35,2088
82,Rhône-Alpes,26,3,13,097,Cliousclat,617,24,641
82,Rhône-Alpes,26,1,07,098,Cobonne,168,4,172
82,Rhône-Alpes,26,2,12,099,Colonzelle,479,24,503
82,Rhône-Alpes,26,3,04,100,Combovin,408,9,417
82,Rhône-Alpes,26,2,10,101,Comps,163,7,170
82,Rhône-Alpes,26,2,15,102,Condillac,156,5,161
82,Rhône-Alpes,26,2,18,103,Condorcet,474,8,482
82,Rhône-Alpes,26,2,20,104,Cornillac,86,0,86
82,Rhône-Alpes,26,2,20,105,Cornillon-sur-l'Oule,71,1,72
82,Rhône-Alpes,26,2,15,106,La Coucourde,960,11,971
82,Rhône-Alpes,26,3,35,107,Crépol,491,12,503
82,Rhône-Alpes,26,1,99,108,Crest,7793,305,8098
82,Rhône-Alpes,26,3,28,110,Crozes-Hermitage,524,7,531
82,Rhône-Alpes,26,1,01,111,Crupies,91,2,93
82,Rhône-Alpes,26,2,18,112,Curnier,204,10,214
82,Rhône-Alpes,26,1,09,113,Die,4358,271,4629
82,Rhône-Alpes,26,2,10,114,Dieulefit,3088,168,3256
82,Rhône-Alpes,26,1,08,115,Divajeu,612,50,662
82,Rhône-Alpes,26,2,19,116,Donzère,5063,111,5174
82,Rhône-Alpes,26,3,24,117,Échevis,57,2,59
82,Rhône-Alpes,26,3,11,118,Épinouze,1344,37,1381
82,Rhône-Alpes,26,3,28,119,Érôme,817,9,826
82,Rhône-Alpes,26,2,33,121,Espeluche,1068,28,1096
82,Rhône-Alpes,26,1,22,122,Espenel,119,7,126
82,Rhône-Alpes,26,1,17,123,Establet,28,2,30
82,Rhône-Alpes,26,3,34,124,Étoile-sur-Rhône,4557,127,4684
82,Rhône-Alpes,26,1,07,125,Eurre,1115,19,1134
82,Rhône-Alpes,26,2,27,126,Eygalayes,70,3,73
82,Rhône-Alpes,26,2,03,127,Eygaliers,129,4,133
82,Rhône-Alpes,26,1,22,128,Eygluy-Escoulin,70,3,73
82,Rhône-Alpes,26,3,02,129,Eymeux,915,21,936
82,Rhône-Alpes,26,2,18,130,Eyroles,22,0,22
82,Rhône-Alpes,26,2,10,131,Eyzahut,129,3,132
82,Rhône-Alpes,26,3,26,133,Fay-le-Clos,153,8,161
82,Rhône-Alpes,26,1,01,134,Félines-sur-Rimandoule,71,1,72
82,Rhône-Alpes,26,2,27,135,Ferrassières,118,1,119
82,Rhône-Alpes,26,1,08,137,Francillon-sur-Roubion,175,6,181
82,Rhône-Alpes,26,2,19,138,La Garde-Adhémar,1141,47,1188
82,Rhône-Alpes,26,3,35,139,Génissieux,2022,78,2100
82,Rhône-Alpes,26,3,28,380,Gervans,526,12,538
82,Rhône-Alpes,26,3,21,140,Geyssans,585,39,624
82,Rhône-Alpes,26,1,07,141,Gigors-et-Lozeron,166,9,175
82,Rhône-Alpes,26,1,06,142,Glandage,93,5,98
82,Rhône-Alpes,26,3,11,143,Le Grand-Serre,793,41,834
82,Rhône-Alpes,26,1,08,144,Grane,1722,78,1800
82,Rhône-Alpes,26,2,19,145,Les Granges-Gontardes,565,10,575
82,Rhône-Alpes,26,3,28,379,Granges-les-Beaumont,947,29,976
82,Rhône-Alpes,26,2,12,146,Grignan,1521,43,1564
82,Rhône-Alpes,26,1,17,147,Gumiane,26,0,26
82,Rhône-Alpes,26,3,11,148,Hauterives,1584,50,1634
82,Rhône-Alpes,26,3,02,149,Hostun,964,17,981
82,Rhône-Alpes,26,2,27,150,Izon-la-Bruisse,11,0,11
82,Rhône-Alpes,26,3,02,381,Jaillans,828,11,839
82,Rhône-Alpes,26,1,14,152,Jonchères,37,1,38
82,Rhône-Alpes,26,2,27,153,Laborel,97,1,98
82,Rhône-Alpes,26,2,27,154,Lachau,206,2,208
82,Rhône-Alpes,26,3,11,155,Lapeyrouse-Mornay,1062,21,1083
82,Rhône-Alpes,26,3,28,156,Larnage,986,22,1008
82,Rhône-Alpes,26,2,15,157,La Laupie,673,19,692
82,Rhône-Alpes,26,1,09,159,Laval-d'Aix,114,1,115
82,Rhône-Alpes,26,3,26,160,Laveyron,916,16,932
82,Rhône-Alpes,26,2,20,161,Lemps,41,0,41
82,Rhône-Alpes,26,3,11,162,Lens-Lestang,801,16,817
82,Rhône-Alpes,26,3,24,163,Léoncel,46,1,47
82,Rhône-Alpes,26,1,14,164,Lesches-en-Diois,54,2,56
82,Rhône-Alpes,26,3,13,165,Livron-sur-Drôme,8963,169,9132
82,Rhône-Alpes,26,3,13,166,Loriol-sur-Drôme,5745,104,5849
82,Rhône-Alpes,26,1,14,167,Luc-en-Diois,533,6,539
82,Rhône-Alpes,26,1,06,168,Lus-la-Croix-Haute,498,8,506
82,Rhône-Alpes,26,2,33,169,Malataverne,1697,58,1755
82,Rhône-Alpes,26,3,04,170,Malissard,3180,118,3298
82,Rhône-Alpes,26,2,15,171,Manas,175,6,181
82,Rhône-Alpes,26,3,11,172,Manthes,616,15,631
82,Rhône-Alpes,26,3,02,173,Marches,709,15,724
82,Rhône-Alpes,26,3,23,174,Margès,877,19,896
82,Rhône-Alpes,26,1,09,175,Marignac-en-Diois,154,9,163
82,Rhône-Alpes,26,2,15,176,Marsanne,1211,38,1249
82,Rhône-Alpes,26,3,23,177,Marsaz,637,26,663
82,Rhône-Alpes,26,1,06,178,Menglon,398,13,411
82,Rhône-Alpes,26,3,28,179,Mercurol,2122,57,2179
82,Rhône-Alpes,26,2,03,180,Mérindol-les-Oliviers,194,10,204
82,Rhône-Alpes,26,2,27,181,Mévouillon,213,4,217
82,Rhône-Alpes,26,2,18,182,Mirabel-aux-Baronnies,1523,40,1563
82,Rhône-Alpes,26,1,07,183,Mirabel-et-Blacons,896,38,934
82,Rhône-Alpes,26,3,35,184,Miribel,256,6,262
82,Rhône-Alpes,26,3,13,185,Mirmande,486,22,508
82,Rhône-Alpes,26,1,14,186,Miscon,49,4,53
82,Rhône-Alpes,26,1,09,187,Molières-Glandaz,125,2,127
82,Rhône-Alpes,26,2,03,188,Mollans-sur-Ouvèze,1023,16,1039
82,Rhône-Alpes,26,2,27,189,Montauban-sur-l'Ouvèze,116,4,120
82,Rhône-Alpes,26,2,18,190,Montaulieu,74,3,77
82,Rhône-Alpes,26,2,33,191,Montboucher-sur-Jabron,1918,58,1976
82,Rhône-Alpes,26,2,12,192,Montbrison-sur-Lez,311,11,322
82,Rhône-Alpes,26,2,27,193,Montbrun-les-Bains,581,14,595
82,Rhône-Alpes,26,3,23,194,Montchenu,564,11,575
82,Rhône-Alpes,26,1,07,195,Montclar-sur-Gervanne,187,1,188
82,Rhône-Alpes,26,3,34,196,Montéléger,1900,124,2024
82,Rhône-Alpes,26,3,04,197,Montélier,3433,97,3530
82,Rhône-Alpes,26,2,96,198,Montélimar,34847,1347,36194
82,Rhône-Alpes,26,2,20,199,Montferrand-la-Fare,54,1,55
82,Rhône-Alpes,26,2,27,200,Montfroc,81,3,84
82,Rhône-Alpes,26,2,27,201,Montguers,58,0,58
82,Rhône-Alpes,26,2,10,202,Montjoux,310,5,315
82,Rhône-Alpes,26,2,12,203,Montjoyer,277,7,284
82,Rhône-Alpes,26,1,14,204,Montlaur-en-Diois,150,7,157
82,Rhône-Alpes,26,1,09,205,Montmaur-en-Diois,80,5,85
82,Rhône-Alpes,26,3,04,206,Montmeyran,2820,84,2904
82,Rhône-Alpes,26,3,35,207,Montmiral,619,27,646
82,Rhône-Alpes,26,1,07,208,Montoison,1706,42,1748
82,Rhône-Alpes,26,2,20,209,Montréal-les-Sources,30,0,30
82,Rhône-Alpes,26,3,11,210,Montrigaud,498,10,508
82,Rhône-Alpes,26,2,25,211,Montségur-sur-Lauzon,1147,40,1187
82,Rhône-Alpes,26,3,04,212,Montvendre,1019,17,1036
82,Rhône-Alpes,26,3,11,213,Moras-en-Valloire,604,22,626
82,Rhône-Alpes,26,1,01,214,Mornans,68,0,68
82,Rhône-Alpes,26,1,17,215,La Motte-Chalancon,441,3,444
82,Rhône-Alpes,26,3,26,216,La Motte-de-Galaure,716,7,723
82,Rhône-Alpes,26,3,24,217,La Motte-Fanjas,171,4,175
82,Rhône-Alpes,26,3,21,218,Mours-Saint-Eusèbe,2478,67,2545
82,Rhône-Alpes,26,3,26,219,Mureils,348,5,353
82,Rhône-Alpes,26,2,18,220,Nyons,7096,253,7349
82,Rhône-Alpes,26,1,07,221,Omblèze,69,1,70
82,Rhône-Alpes,26,2,10,222,Orcinas,27,0,27
82,Rhône-Alpes,26,3,24,223,Oriol-en-Royans,510,18,528
82,Rhône-Alpes,26,1,07,224,Ourches,216,7,223
82,Rhône-Alpes,26,3,35,225,Parnans,638,12,650
82,Rhône-Alpes,26,2,12,226,Le Pègue,386,9,395
82,Rhône-Alpes,26,2,20,227,Pelonne,18,0,18
82,Rhône-Alpes,26,2,03,229,La Penne-sur-l'Ouvèze,95,10,105
82,Rhône-Alpes,26,1,14,228,Pennes-le-Sec,18,1,19
82,Rhône-Alpes,26,3,21,231,Peyrins,2435,96,2531
82,Rhône-Alpes,26,3,04,232,Peyrus,609,23,632
82,Rhône-Alpes,26,2,18,233,Piégon,247,13,260
82,Rhône-Alpes,26,1,08,234,Piégros-la-Clastre,863,36,899
82,Rhône-Alpes,26,2,19,235,Pierrelatte,12893,341,13234
82,Rhône-Alpes,26,2,03,236,Pierrelongue,174,8,182
82,Rhône-Alpes,26,2,18,238,Les Pilles,251,5,256
82,Rhône-Alpes,26,2,03,239,Plaisians,182,8,190
82,Rhône-Alpes,26,1,07,240,Plan-de-Baix,144,1,145
82,Rhône-Alpes,26,1,01,241,Le Poët-Célard,140,5,145
82,Rhône-Alpes,26,2,03,242,Le Poët-en-Percip,19,0,19
82,Rhône-Alpes,26,2,10,243,Le Poët-Laval,893,60,953
82,Rhône-Alpes,26,2,20,244,Le Poët-Sigillat,115,1,116
82,Rhône-Alpes,26,2,20,245,Pommerol,17,1,18
82,Rhône-Alpes,26,1,09,246,Ponet-et-Saint-Auban,130,2,132
82,Rhône-Alpes,26,3,26,247,Ponsas,435,18,453
82,Rhône-Alpes,26,2,10,249,Pont-de-Barret,551,23,574
82,Rhône-Alpes,26,3,28,250,Pont-de-l'Isère,2713,36,2749
82,Rhône-Alpes,26,1,09,248,Pontaix,167,0,167
82,Rhône-Alpes,26,2,33,251,Portes-en-Valdaine,385,23,408
82,Rhône-Alpes,26,3,34,252,Portes-lès-Valence,9376,153,9529
82,Rhône-Alpes,26,1,14,253,Poyols,79,1,80
82,Rhône-Alpes,26,1,17,254,Pradelle,17,2,19
82,Rhône-Alpes,26,1,14,255,Les Prés,23,1,24
82,Rhône-Alpes,26,2,03,256,Propiac,108,0,108
82,Rhône-Alpes,26,1,08,258,Puy-Saint-Martin,839,23,862
82,Rhône-Alpes,26,2,33,257,Puygiron,422,12,434
82,Rhône-Alpes,26,3,26,259,Ratières,274,6,280
82,Rhône-Alpes,26,2,12,261,Réauville,376,8,384
82,Rhône-Alpes,26,1,14,262,Recoubeau-Jansac,237,5,242
82,Rhône-Alpes,26,2,27,263,Reilhanette,149,7,156
82,Rhône-Alpes,26,2,20,264,Rémuzat,317,8,325
82,Rhône-Alpes,26,1,08,020,La Répara-Auriples,229,7,236
82,Rhône-Alpes,26,1,22,266,Rimon-et-Savel,31,2,33
82,Rhône-Alpes,26,2,03,267,Rioms,27,2,29
82,Rhône-Alpes,26,3,28,271,La Roche-de-Glun,3154,65,3219
82,Rhône-Alpes,26,2,10,276,Roche-Saint-Secret-Béconne,358,13,371
82,Rhône-Alpes,26,1,08,277,La Roche-sur-Grane,155,3,158
82,Rhône-Alpes,26,2,03,278,La Roche-sur-le-Buis,330,9,339
82,Rhône-Alpes,26,2,10,268,Rochebaudin,123,5,128
82,Rhône-Alpes,26,2,03,269,Rochebrune,49,0,49
82,Rhône-Alpes,26,3,24,270,Rochechinard,100,13,113
82,Rhône-Alpes,26,2,33,272,Rochefort-en-Valdaine,338,19,357
82,Rhône-Alpes,26,3,02,273,Rochefort-Samson,930,22,952
82,Rhône-Alpes,26,1,17,274,Rochefourchat,1,0,1
82,Rhône-Alpes,26,2,25,275,Rochegude,1431,39,1470
82,Rhône-Alpes,26,2,03,279,La Rochette-du-Buis,68,3,71
82,Rhône-Alpes,26,3,97,281,Romans-sur-Isère,33440,747,34187
82,Rhône-Alpes,26,1,09,282,Romeyer,214,10,224
82,Rhône-Alpes,26,1,17,283,Rottier,30,2,32
82,Rhône-Alpes,26,2,12,284,Roussas,339,18,357
82,Rhône-Alpes,26,2,12,285,Rousset-les-Vignes,289,19,308
82,Rhône-Alpes,26,2,20,286,Roussieux,23,1,24
82,Rhône-Alpes,26,2,15,287,Roynac,431,22,453
82,Rhône-Alpes,26,2,20,288,Sahune,312,9,321
82,Rhône-Alpes,26,1,22,289,Saillans,1056,18,1074
82,Rhône-Alpes,26,1,05,290,Saint-Agnan-en-Vercors,381,19,400
82,Rhône-Alpes,26,1,09,291,Saint-Andéol,54,1,55
82,Rhône-Alpes,26,2,03,292,Saint-Auban-sur-l'Ouvèze,208,0,208
82,Rhône-Alpes,26,3,26,293,Saint-Avit,314,8,322
82,Rhône-Alpes,26,3,21,294,Saint-Bardoux,610,16,626
82,Rhône-Alpes,26,3,26,295,Saint-Barthélemy-de-Vals,1838,34,1872
82,Rhône-Alpes,26,1,22,296,Saint-Benoit-en-Diois,33,5,38
82,Rhône-Alpes,26,3,35,297,Saint-Bonnet-de-Valclérieux,213,1,214
82,Rhône-Alpes,26,3,11,298,Saint-Christophe-et-le-Laris,393,8,401
82,Rhône-Alpes,26,1,17,300,Saint-Dizier-en-Diois,35,1,36
82,Rhône-Alpes,26,3,23,301,Saint-Donat-sur-l'Herbasse,3635,71,3706
82,Rhône-Alpes,26,2,18,304,Saint-Ferréol-Trente-Pas,232,5,237
82,Rhône-Alpes,26,2,15,305,Saint-Gervais-sur-Roubion,789,13,802
82,Rhône-Alpes,26,3,24,307,Saint-Jean-en-Royans,3023,89,3112
82,Rhône-Alpes,26,1,09,308,Saint-Julien-en-Quint,128,1,129
82,Rhône-Alpes,26,1,05,309,Saint-Julien-en-Vercors,218,5,223
82,Rhône-Alpes,26,3,35,310,Saint-Laurent-d'Onay,131,3,134
82,Rhône-Alpes,26,3,24,311,Saint-Laurent-en-Royans,1302,88,1390
82,Rhône-Alpes,26,2,15,312,Saint-Marcel-lès-Sauzet,1138,48,1186
82,Rhône-Alpes,26,3,32,313,Saint-Marcel-lès-Valence,4951,127,5078
82,Rhône-Alpes,26,3,26,314,Saint-Martin-d'Août,382,15,397
82,Rhône-Alpes,26,1,05,315,Saint-Martin-en-Vercors,360,16,376
82,Rhône-Alpes,26,3,24,316,Saint-Martin-le-Colonel,178,6,184
82,Rhône-Alpes,26,2,18,317,Saint-Maurice-sur-Eygues,639,12,651
82,Rhône-Alpes,26,2,20,318,Saint-May,45,1,46
82,Rhône-Alpes,26,3,35,319,Saint-Michel-sur-Savasse,516,6,522
82,Rhône-Alpes,26,3,24,320,Saint-Nazaire-en-Royans,713,10,723
82,Rhône-Alpes,26,1,17,321,Saint-Nazaire-le-Désert,138,2,140
82,Rhône-Alpes,26,2,12,322,Saint-Pantaléon-les-Vignes,428,14,442
82,Rhône-Alpes,26,3,35,323,Saint-Paul-lès-Romans,1713,44,1757
82,Rhône-Alpes,26,2,25,324,Saint-Paul-Trois-Châteaux,8465,475,8940
82,Rhône-Alpes,26,3,26,325,Saint-Rambert-d'Albon,5309,60,5369
82,Rhône-Alpes,26,2,25,326,Saint-Restitut,1379,63,1442
82,Rhône-Alpes,26,1,06,327,Saint-Roman,160,4,164
82,Rhône-Alpes,26,1,22,328,Saint-Sauveur-en-Diois,62,0,62
82,Rhône-Alpes,26,2,03,329,Saint-Sauveur-Gouvernet,209,11,220
82,Rhône-Alpes,26,3,11,330,Saint-Sorlin-en-Valloire,1965,39,2004
82,Rhône-Alpes,26,3,24,331,Saint-Thomas-en-Royans,502,17,519
82,Rhône-Alpes,26,3,26,332,Saint-Uze,1884,26,1910
82,Rhône-Alpes,26,3,26,333,Saint-Vallier,4005,127,4132
82,Rhône-Alpes,26,3,02,382,Saint-Vincent-la-Commanderie,415,9,424
82,Rhône-Alpes,26,1,09,299,Sainte-Croix,89,3,92
82,Rhône-Alpes,26,3,24,302,Sainte-Eulalie-en-Royans,517,9,526
82,Rhône-Alpes,26,2,03,303,Sainte-Euphémie-sur-Ouvèze,94,3,97
82,Rhône-Alpes,26,2,18,306,Sainte-Jalle,277,3,280
82,Rhône-Alpes,26,2,10,334,Salettes,126,1,127
82,Rhône-Alpes,26,2,12,335,Salles-sous-Bois,208,7,215
82,Rhône-Alpes,26,1,08,336,Saou,514,22,536
82,Rhône-Alpes,26,3,13,337,Saulce-sur-Rhône,1705,41,1746
82,Rhône-Alpes,26,2,15,338,Sauzet,1855,87,1942
82,Rhône-Alpes,26,2,15,339,Savasse,1297,47,1344
82,Rhône-Alpes,26,2,27,340,Séderon,295,4,299
82,Rhône-Alpes,26,3,28,341,Serves-sur-Rhône,685,7,692
82,Rhône-Alpes,26,2,25,342,Solérieux,304,5,309
82,Rhône-Alpes,26,2,10,343,Souspierre,104,0,104
82,Rhône-Alpes,26,1,08,344,Soyans,338,13,351
82,Rhône-Alpes,26,1,07,346,Suze,252,6,258
82,Rhône-Alpes,26,2,25,345,Suze-la-Rousse,1865,58,1923
82,Rhône-Alpes,26,3,28,347,Tain-l'Hermitage,5917,198,6115
82,Rhône-Alpes,26,2,12,348,Taulignan,1588,36,1624
82,Rhône-Alpes,26,3,11,349,Tersanne,290,7,297
82,Rhône-Alpes,26,2,10,350,Teyssières,86,3,89
82,Rhône-Alpes,26,1,01,351,Les Tonils,17,0,17
82,Rhône-Alpes,26,2,33,352,La Touche,197,15,212
82,Rhône-Alpes,26,2,15,353,Les Tourrettes,947,7,954
82,Rhône-Alpes,26,1,06,354,Treschenu-Creyers,131,4,135
82,Rhône-Alpes,26,3,35,355,Triors,539,11,550
82,Rhône-Alpes,26,1,01,356,Truinas,129,7,136
82,Rhône-Alpes,26,2,25,357,Tulette,1898,30,1928
82,Rhône-Alpes,26,3,04,358,Upie,1389,45,1434
82,Rhône-Alpes,26,1,09,359,Vachères-en-Quint,30,2,32
82,Rhône-Alpes,26,1,14,136,Val-Maravel,43,2,45
82,Rhône-Alpes,26,2,12,360,Valaurie,534,19,553
82,Rhône-Alpes,26,1,14,361,Valdrôme,138,7,145
82,Rhône-Alpes,26,3,98,362,Valence,64484,1785,66269
82,Rhône-Alpes,26,2,18,363,Valouse,43,1,44
82,Rhône-Alpes,26,1,05,364,Vassieux-en-Vercors,351,13,364
82,Rhône-Alpes,26,1,07,365,Vaunaveys-la-Rochette,573,18,591
82,Rhône-Alpes,26,3,28,366,Veaunes,271,5,276
82,Rhône-Alpes,26,2,18,367,Venterol,627,18,645
82,Rhône-Alpes,26,1,22,368,Vercheny,437,15,452
82,Rhône-Alpes,26,2,20,369,Verclause,78,5,83
82,Rhône-Alpes,26,2,03,370,Vercoiran,125,2,127
82,Rhône-Alpes,26,1,22,371,Véronne,42,1,43
82,Rhône-Alpes,26,2,27,372,Vers-sur-Méouge,42,1,43
82,Rhône-Alpes,26,2,10,373,Vesc,280,12,292
82,Rhône-Alpes,26,2,27,374,Villebois-les-Pins,16,0,16
82,Rhône-Alpes,26,2,27,375,Villefranche-le-Château,23,1,24
82,Rhône-Alpes,26,2,20,376,Villeperdrix,105,3,108
82,Rhône-Alpes,26,2,18,377,Vinsobres,1101,57,1158
82,Rhône-Alpes,26,1,17,378,Volvent,44,0,44
23,Haute-Normandie,27,2,09,001,Aclou,255,0,255
23,Haute-Normandie,27,3,25,002,Acon,469,3,472
23,Haute-Normandie,27,1,39,003,Acquigny,1611,57,1668
23,Haute-Normandie,27,3,26,004,Aigleville,341,4,345
23,Haute-Normandie,27,1,42,005,Ailly,1052,22,1074
23,Haute-Normandie,27,2,29,006,Aizier,118,1,119
23,Haute-Normandie,27,2,03,007,Ajou,244,1,245
23,Haute-Normandie,27,1,28,008,Alizay,1374,8,1382
23,Haute-Normandie,27,3,31,009,Ambenay,498,7,505
23,Haute-Normandie,27,1,20,010,Amécourt,173,3,176
23,Haute-Normandie,27,2,01,011,Amfreville-la-Campagne,902,16,918
23,Haute-Normandie,27,1,18,012,Amfreville-les-Champs,419,6,425
23,Haute-Normandie,27,1,18,013,Amfreville-sous-les-Monts,546,22,568
23,Haute-Normandie,27,1,39,014,Amfreville-sur-Iton,778,10,788
23,Haute-Normandie,27,1,21,015,Andé,1057,20,1077
23,Haute-Normandie,27,1,02,016,Les Andelys,8253,225,8478
23,Haute-Normandie,27,3,17,017,Angerville-la-Campagne,1132,49,1181
23,Haute-Normandie,27,2,23,018,Appeville-Annebault,878,12,890
23,Haute-Normandie,27,3,35,019,Armentières-sur-Avre,177,2,179
23,Haute-Normandie,27,3,38,020,Arnières-sur-Iton,1640,55,1695
23,Haute-Normandie,27,2,12,021,Asnières,267,3,270
23,Haute-Normandie,27,1,19,022,Aubevoye,4545,70,4615
23,Haute-Normandie,27,3,38,023,Aulnay-sur-Iton,700,18,718
23,Haute-Normandie,27,1,42,025,Autheuil-Authouillet,833,20,853
23,Haute-Normandie,27,1,20,026,Authevernes,396,10,406
23,Haute-Normandie,27,3,32,027,Les Authieux,237,6,243
23,Haute-Normandie,27,2,23,028,Authou,345,2,347
23,Haute-Normandie,27,3,16,031,Aviron,1121,43,1164
23,Haute-Normandie,27,3,13,032,Avrilly,399,8,407
23,Haute-Normandie,27,3,16,033,Bacquepuis,333,8,341
23,Haute-Normandie,27,1,18,034,Bacqueville,515,5,520
23,Haute-Normandie,27,2,12,035,Bailleul-la-Vallée,125,1,126
23,Haute-Normandie,27,3,35,036,Bâlines,440,13,453
23,Haute-Normandie,27,2,04,037,Barc,953,15,968
23,Haute-Normandie,27,3,35,038,Les Barils,168,10,178
23,Haute-Normandie,27,2,30,039,Barneville-sur-Seine,468,39,507
23,Haute-Normandie,27,2,04,040,Barquet,363,9,372
23,Haute-Normandie,27,2,03,041,La Barre-en-Ouche,945,12,957
23,Haute-Normandie,27,2,34,042,Barville,75,2,77
23,Haute-Normandie,27,3,08,043,Les Baux-de-Breteuil,643,11,654
23,Haute-Normandie,27,3,17,044,Les Baux-Sainte-Croix,925,32,957
23,Haute-Normandie,27,1,20,045,Bazincourt-sur-Epte,646,24,670
23,Haute-Normandie,27,2,34,046,Bazoques,154,3,157
23,Haute-Normandie,27,3,11,047,Beaubray,282,10,292
23,Haute-Normandie,27,1,22,048,Beauficel-en-Lyons,168,0,168
23,Haute-Normandie,27,2,03,049,Beaumesnil,542,71,613
23,Haute-Normandie,27,2,04,051,Beaumont-le-Roger,2942,35,2977
23,Haute-Normandie,27,2,04,050,Beaumontel,715,13,728
23,Haute-Normandie,27,2,09,052,Le Bec-Hellouin,416,1,417
23,Haute-Normandie,27,2,01,053,Le Bec-Thomas,224,7,231
23,Haute-Normandie,27,3,08,054,Bémécourt,463,8,471
23,Haute-Normandie,27,3,24,055,Bérengeville-la-Campagne,287,5,292
23,Haute-Normandie,27,2,96,056,Bernay,10480,478,10958
23,Haute-Normandie,27,3,16,057,Bernienville,268,6,274
23,Haute-Normandie,27,1,42,058,Bernières-sur-Seine,321,9,330
23,Haute-Normandie,27,1,20,059,Bernouville,325,10,335
23,Haute-Normandie,27,1,14,060,Berthenonville,233,7,240
23,Haute-Normandie,27,2,09,061,Berthouville,287,5,292
23,Haute-Normandie,27,2,07,062,Berville-en-Roumois,708,11,719
23,Haute-Normandie,27,2,04,063,Berville-la-Campagne,144,2,146
23,Haute-Normandie,27,2,06,064,Berville-sur-Mer,547,7,554
23,Haute-Normandie,27,2,06,065,Beuzeville,3649,35,3684
23,Haute-Normandie,27,1,22,066,Bézu-la-Forêt,217,3,220
23,Haute-Normandie,27,1,20,067,Bézu-Saint-Éloi,1270,21,1291
23,Haute-Normandie,27,3,31,068,Bois-Anzeray,158,0,158
23,Haute-Normandie,27,3,31,069,Bois-Arnault,729,15,744
23,Haute-Normandie,27,2,12,071,Le Bois-Hellain,227,4,231
23,Haute-Normandie,27,1,14,072,Bois-Jérôme-Saint-Ouen,743,34,777
23,Haute-Normandie,27,3,32,073,Bois-le-Roi,951,15,966
23,Haute-Normandie,27,3,31,075,Bois-Normand-près-Lyre,347,3,350
23,Haute-Normandie,27,1,02,070,Boisemont,786,11,797
23,Haute-Normandie,27,2,09,074,Boisney,283,8,291
23,Haute-Normandie,27,3,26,076,Boisset-les-Prévanches,436,8,444
23,Haute-Normandie,27,2,07,077,Boissey-le-Châtel,845,14,859
23,Haute-Normandie,27,3,32,078,La Boissière,260,7,267
23,Haute-Normandie,27,2,34,079,Boissy-Lamberville,276,5,281
23,Haute-Normandie,27,3,26,081,Boncourt,171,0,171
23,Haute-Normandie,27,2,23,083,Bonneville-Aptot,214,5,219
23,Haute-Normandie,27,3,11,082,La Bonneville-sur-Iton,2284,43,2327
23,Haute-Normandie,27,2,07,084,Bosc-Bénard-Commin,311,0,311
23,Haute-Normandie,27,2,07,085,Bosc-Bénard-Crescy,377,5,382
23,Haute-Normandie,27,2,03,088,Bosc-Renoult-en-Ouche,156,1,157
23,Haute-Normandie,27,2,07,089,Bosc-Renoult-en-Roumois,426,9,435
23,Haute-Normandie,27,2,07,090,Le Bosc-Roger-en-Roumois,3241,67,3308
23,Haute-Normandie,27,2,30,091,Bosgouet,585,9,594
23,Haute-Normandie,27,2,07,092,Bosguérard-de-Marcouville,573,8,581
23,Haute-Normandie,27,2,07,093,Bosnormand,326,3,329
23,Haute-Normandie,27,1,22,094,Bosquentin,94,0,94
23,Haute-Normandie,27,2,09,095,Bosrobert,492,5,497
23,Haute-Normandie,27,3,31,096,Les Bottereaux,317,5,322
23,Haute-Normandie,27,1,02,097,Bouafles,634,15,649
23,Haute-Normandie,27,1,20,098,Bouchevilliers,75,0,75
23,Haute-Normandie,27,3,16,099,Le Boulay-Morin,664,13,677
23,Haute-Normandie,27,2,06,100,Boulleville,929,14,943
23,Haute-Normandie,27,2,29,101,Bouquelon,385,10,395
23,Haute-Normandie,27,2,30,102,Bouquetot,1012,15,1027
23,Haute-Normandie,27,2,30,103,Bourg-Achard,2885,48,2933
23,Haute-Normandie,27,1,18,104,Bourg-Beaudouin,741,10,751
23,Haute-Normandie,27,2,07,105,Bourgtheroulde-Infreville,2915,66,2981
23,Haute-Normandie,27,2,34,106,Bournainville-Faverolles,381,11,392
23,Haute-Normandie,27,2,29,107,Bourneville,854,22,876
23,Haute-Normandie,27,3,35,108,Bourth,1224,25,1249
23,Haute-Normandie,27,2,04,109,Bray,288,5,293
23,Haute-Normandie,27,2,23,110,Brestot,468,10,478
23,Haute-Normandie,27,3,32,111,Bretagnolles,182,5,187
23,Haute-Normandie,27,3,08,112,Breteuil,3374,130,3504
23,Haute-Normandie,27,2,09,113,Brétigny,173,0,173
23,Haute-Normandie,27,3,26,114,Breuilpont,1168,30,1198
23,Haute-Normandie,27,3,25,115,Breux-sur-Avre,342,7,349
23,Haute-Normandie,27,2,09,116,Brionne,4332,141,4473
23,Haute-Normandie,27,2,10,117,Broglie,1115,22,1137
23,Haute-Normandie,27,3,16,118,Brosville,642,23,665
23,Haute-Normandie,27,3,26,119,Bueil,1490,28,1518
23,Haute-Normandie,27,3,13,416,Buis-sur-Damville,926,21,947
23,Haute-Normandie,27,3,11,120,Burey,332,6,338
23,Haute-Normandie,27,1,14,121,Bus-Saint-Rémy,299,6,305
23,Haute-Normandie,27,1,14,122,Cahaignes,350,6,356
23,Haute-Normandie,27,3,26,123,Caillouet-Orgeville,405,37,442
23,Haute-Normandie,27,1,42,124,Cailly-sur-Eure,237,4,241
23,Haute-Normandie,27,2,09,125,Calleville,617,9,626
23,Haute-Normandie,27,2,27,126,Campigny,913,10,923
23,Haute-Normandie,27,3,24,127,Canappeville,639,14,653
23,Haute-Normandie,27,1,14,128,Cantiers,198,3,201
23,Haute-Normandie,27,2,05,129,Caorches-Saint-Nicolas,582,14,596
23,Haute-Normandie,27,2,10,130,Capelle-les-Grands,388,5,393
23,Haute-Normandie,27,2,41,131,Carsix,262,1,263
23,Haute-Normandie,27,3,38,132,Caugé,823,26,849
23,Haute-Normandie,27,2,30,133,Caumont,1004,16,1020
23,Haute-Normandie,27,2,30,134,Cauverville-en-Roumois,189,3,192
23,Haute-Normandie,27,3,24,135,Cesseville,413,8,421
23,Haute-Normandie,27,3,26,136,Chaignes,293,10,303
23,Haute-Normandie,27,3,31,137,Chaise-Dieu-du-Theil,231,17,248
23,Haute-Normandie,27,2,10,138,Chamblac,360,4,364
23,Haute-Normandie,27,3,31,139,Chambord,171,5,176
23,Haute-Normandie,27,3,36,140,Chambray,461,11,472
23,Haute-Normandie,27,3,11,141,Champ-Dolent,50,2,52
23,Haute-Normandie,27,1,42,142,Champenard,195,7,202
23,Haute-Normandie,27,3,31,143,Champignolles,38,0,38
23,Haute-Normandie,27,3,32,144,Champigny-la-Futelaye,233,5,238
23,Haute-Normandie,27,3,13,145,Chanteloup,86,2,88
23,Haute-Normandie,27,2,12,146,La Chapelle-Bayvel,315,1,316
23,Haute-Normandie,27,3,16,147,La Chapelle-du-Bois-des-Faulx,504,15,519
23,Haute-Normandie,27,2,10,148,La Chapelle-Gauthier,364,9,373
23,Haute-Normandie,27,2,34,149,La Chapelle-Hareng,82,1,83
23,Haute-Normandie,27,3,36,150,La Chapelle-Réanville,1138,15,1153
23,Haute-Normandie,27,1,18,151,Charleval,1836,19,1855
23,Haute-Normandie,27,1,14,152,Château-sur-Epte,577,15,592
23,Haute-Normandie,27,1,15,153,Chauvincourt-Provemont,329,2,331
23,Haute-Normandie,27,3,32,154,Chavigny-Bailleul,510,8,518
23,Haute-Normandie,27,3,35,155,Chennebrun,134,2,136
23,Haute-Normandie,27,3,31,156,Chéronvilliers,486,5,491
23,Haute-Normandie,27,3,08,157,Le Chesne,515,13,528
23,Haute-Normandie,27,3,26,158,Cierrey,680,24,704
23,Haute-Normandie,27,3,08,159,Cintray,408,10,418
23,Haute-Normandie,27,1,14,160,Civières,229,3,232
23,Haute-Normandie,27,3,38,161,Claville,1041,24,1065
23,Haute-Normandie,27,3,11,162,Collandres-Quincarnon,199,2,201
23,Haute-Normandie,27,2,27,163,Colletot,152,2,154
23,Haute-Normandie,27,2,04,164,Combon,737,8,745
23,Haute-Normandie,27,3,11,165,Conches-en-Ouche,5034,85,5119
23,Haute-Normandie,27,3,08,166,Condé-sur-Iton,872,9,881
23,Haute-Normandie,27,2,23,167,Condé-sur-Risle,531,8,539
23,Haute-Normandie,27,1,43,168,Connelles,204,0,204
23,Haute-Normandie,27,2,06,169,Conteville,871,17,888
23,Haute-Normandie,27,2,12,170,Cormeilles,1192,25,1217
23,Haute-Normandie,27,3,26,171,Le Cormier,388,7,395
23,Haute-Normandie,27,3,13,172,Corneuil,459,7,466
23,Haute-Normandie,27,2,41,173,Corneville-la-Fouquetière,103,1,104
23,Haute-Normandie,27,2,27,174,Corneville-sur-Risle,1222,35,1257
23,Haute-Normandie,27,1,02,175,Corny,328,5,333
23,Haute-Normandie,27,1,15,176,Coudray,229,0,229
23,Haute-Normandie,27,3,32,177,Coudres,498,5,503
23,Haute-Normandie,27,2,05,179,Courbépine,674,15,689
23,Haute-Normandie,27,1,02,180,Courcelles-sur-Seine,1626,42,1668
23,Haute-Normandie,27,3,25,181,Courdemanche,525,6,531
23,Haute-Normandie,27,3,35,182,Courteilles,151,5,156
23,Haute-Normandie,27,3,32,183,La Couture-Boussey,2216,44,2260
23,Haute-Normandie,27,1,39,184,Crasville,129,4,133
23,Haute-Normandie,27,3,24,185,Crestot,389,4,393
23,Haute-Normandie,27,3,24,187,Criquebeuf-la-Campagne,222,2,224
23,Haute-Normandie,27,1,28,188,Criquebeuf-sur-Seine,1156,19,1175
23,Haute-Normandie,27,3,11,189,La Croisille,404,15,419
23,Haute-Normandie,27,3,26,190,Croisy-sur-Eure,240,6,246
23,Haute-Normandie,27,1,42,191,La Croix-Saint-Leufroy,1068,29,1097
23,Haute-Normandie,27,3,24,192,Crosville-la-Vieille,562,10,572
23,Haute-Normandie,27,3,32,193,Croth,1276,28,1304
23,Haute-Normandie,27,1,02,194,Cuverville,196,3,199
23,Haute-Normandie,27,3,08,195,Dame-Marie,86,2,88
23,Haute-Normandie,27,1,28,196,Les Damps,1250,11,1261
23,Haute-Normandie,27,1,14,197,Dampsmesnil,205,3,208
23,Haute-Normandie,27,3,13,198,Damville,2031,34,2065
23,Haute-Normandie,27,1,20,199,Dangu,575,10,585
23,Haute-Normandie,27,3,16,200,Dardez,165,2,167
23,Haute-Normandie,27,3,24,201,Daubeuf-la-Campagne,204,4,208
23,Haute-Normandie,27,1,02,202,Daubeuf-près-Vatteville,482,13,495
23,Haute-Normandie,27,3,40,203,Douains,464,12,476
23,Haute-Normandie,27,1,15,204,Doudeauville-en-Vexin,302,9,311
23,Haute-Normandie,27,1,18,205,Douville-sur-Andelle,407,5,412
23,Haute-Normandie,27,3,25,206,Droisy,399,9,408
23,Haute-Normandie,27,2,34,207,Drucourt,608,17,625
23,Haute-Normandie,27,2,34,208,Duranville,165,6,171
23,Haute-Normandie,27,2,23,209,Écaquelon,490,5,495
23,Haute-Normandie,27,2,04,210,Écardenville-la-Campagne,386,2,388
23,Haute-Normandie,27,1,42,211,Écardenville-sur-Eure,528,10,538
23,Haute-Normandie,27,3,24,212,Écauville,116,1,117
23,Haute-Normandie,27,1,14,213,Écos,923,22,945
23,Haute-Normandie,27,1,18,214,Écouis,760,31,791
23,Haute-Normandie,27,3,24,215,Ecquetot,331,8,339
23,Haute-Normandie,27,3,16,216,Émalleville,536,14,550
23,Haute-Normandie,27,3,11,217,Émanville,541,14,555
23,Haute-Normandie,27,2,12,218,Épaignes,1292,7,1299
23,Haute-Normandie,27,3,24,219,Épégard,456,8,464
23,Haute-Normandie,27,3,32,220,Épieds,357,2,359
23,Haute-Normandie,27,2,03,221,Épinay,287,4,291
23,Haute-Normandie,27,2,33,222,Épreville-en-Lieuvin,178,5,183
23,Haute-Normandie,27,2,07,223,Épreville-en-Roumois,372,4,376
23,Haute-Normandie,27,3,24,224,Épreville-près-le-Neubourg,453,5,458
23,Haute-Normandie,27,3,13,225,Les Essarts,366,2,368
23,Haute-Normandie,27,1,15,226,Étrépagny,3676,98,3774
23,Haute-Normandie,27,2,30,227,Étréville,575,6,581
23,Haute-Normandie,27,2,30,228,Éturqueraye,272,6,278
23,Haute-Normandie,27,3,99,229,Évreux,50777,2928,53705
23,Haute-Normandie,27,3,32,230,Ézy-sur-Eure,3170,43,3213
23,Haute-Normandie,27,3,26,231,Fains,421,10,431
23,Haute-Normandie,27,1,15,232,Farceaux,286,2,288
23,Haute-Normandie,27,2,06,233,Fatouville-Grestain,709,5,714
23,Haute-Normandie,27,3,37,234,Fauville,309,14,323
23,Haute-Normandie,27,3,11,235,Faverolles-la-Campagne,148,4,152
23,Haute-Normandie,27,2,34,237,Le Favril,163,0,163
23,Haute-Normandie,27,3,11,240,La Ferrière-sur-Risle,279,8,287
23,Haute-Normandie,27,3,11,238,Ferrières-Haut-Clocher,1055,12,1067
23,Haute-Normandie,27,2,10,239,Ferrières-Saint-Hilaire,396,11,407
23,Haute-Normandie,27,3,24,241,Feuguerolles,186,6,192
23,Haute-Normandie,27,3,11,242,Le Fidelaire,978,19,997
23,Haute-Normandie,27,2,06,243,Fiquefleur-Équainville,641,11,652
23,Haute-Normandie,27,2,07,244,Flancourt-Catelon,462,3,465
23,Haute-Normandie,27,1,22,245,Fleury-la-Forêt,266,2,268
23,Haute-Normandie,27,1,18,246,Fleury-sur-Andelle,1879,17,1896
23,Haute-Normandie,27,1,18,247,Flipou,340,6,346
23,Haute-Normandie,27,2,34,248,Folleville,185,1,186
23,Haute-Normandie,27,1,42,249,Fontaine-Bellenger,974,15,989
23,Haute-Normandie,27,1,42,250,Fontaine-Heudebourg,693,15,708
23,Haute-Normandie,27,2,41,251,Fontaine-l'Abbé,585,14,599
23,Haute-Normandie,27,2,34,252,Fontaine-la-Louvet,295,4,299
23,Haute-Normandie,27,2,04,253,Fontaine-la-Soret,394,10,404
23,Haute-Normandie,27,3,37,254,Fontaine-sous-Jouy,814,57,871
23,Haute-Normandie,27,1,14,255,Fontenay,319,7,326
23,Haute-Normandie,27,3,32,256,La Forêt-du-Parc,510,18,528
23,Haute-Normandie,27,1,14,257,Forêt-la-Folie,447,8,455
23,Haute-Normandie,27,2,06,258,Fort-Moville,381,10,391
23,Haute-Normandie,27,3,32,259,Foucrainville,78,3,81
23,Haute-Normandie,27,2,06,260,Foulbec,520,5,525
23,Haute-Normandie,27,2,01,261,Fouqueville,419,8,427
23,Haute-Normandie,27,1,14,262,Fourges,816,28,844
23,Haute-Normandie,27,2,27,263,Fourmetot,644,10,654
23,Haute-Normandie,27,1,14,264,Fours-en-Vexin,184,9,193
23,Haute-Normandie,27,3,08,265,Francheville,1226,20,1246
23,Haute-Normandie,27,2,09,266,Franqueville,273,6,279
23,Haute-Normandie,27,2,23,267,Freneuse-sur-Risle,337,9,346
23,Haute-Normandie,27,3,11,268,Le Fresne,282,14,296
23,Haute-Normandie,27,2,12,269,Fresne-Cauverville,201,1,202
23,Haute-Normandie,27,1,02,270,Fresne-l'Archevêque,479,9,488
23,Haute-Normandie,27,3,32,271,Fresney,263,6,269
23,Haute-Normandie,27,3,26,273,Gadencourt,393,1,394
23,Haute-Normandie,27,1,18,274,Gaillardbois-Cressenville,377,6,383
23,Haute-Normandie,27,1,19,275,Gaillon,7052,173,7225
23,Haute-Normandie,27,1,15,276,Gamaches-en-Vexin,318,15,333
23,Haute-Normandie,27,3,32,277,Garencières,554,14,568
23,Haute-Normandie,27,3,32,278,Garennes-sur-Eure,1809,23,1832
23,Haute-Normandie,27,1,14,279,Gasny,2876,63,2939
23,Haute-Normandie,27,3,37,280,Gauciel,748,10,758
23,Haute-Normandie,27,3,11,281,Gaudreville-la-Rivière,236,4,240
23,Haute-Normandie,27,3,16,282,Gauville-la-Campagne,515,19,534
23,Haute-Normandie,27,2,03,283,Gisay-la-Coudre,238,4,242
23,Haute-Normandie,27,1,20,284,Gisors,11681,264,11945
23,Haute-Normandie,27,1,14,285,Giverny,502,23,525
23,Haute-Normandie,27,2,34,286,Giverville,313,2,315
23,Haute-Normandie,27,3,11,287,Glisolles,874,28,902
23,Haute-Normandie,27,2,23,288,Glos-sur-Risle,431,6,437
23,Haute-Normandie,27,2,10,289,La Goulafrière,170,2,172
23,Haute-Normandie,27,2,04,290,Goupillières,751,21,772
23,Haute-Normandie,27,3,35,291,Gournay-le-Guérin,156,5,161
23,Haute-Normandie,27,2,03,292,Gouttières,196,0,196
23,Haute-Normandie,27,3,13,293,Gouville,500,140,640
23,Haute-Normandie,27,1,18,294,Grainville,538,12,550
23,Haute-Normandie,27,2,03,296,Granchain,228,4,232
23,Haute-Normandie,27,2,10,295,Grand-Camp,437,9,446
23,Haute-Normandie,27,3,13,297,Grandvilliers,357,8,365
23,Haute-Normandie,27,3,16,298,Graveron-Sémerville,295,12,307
23,Haute-Normandie,27,3,16,299,Gravigny,4032,155,4187
23,Haute-Normandie,27,2,01,302,Le Gros-Theil,915,8,923
23,Haute-Normandie,27,2,04,300,Grosley-sur-Risle,563,3,566
23,Haute-Normandie,27,3,32,301,Grossoeuvre,1049,21,1070
23,Haute-Normandie,27,3,08,303,Guernanville,91,1,92
23,Haute-Normandie,27,1,20,304,Guerny,174,4,178
23,Haute-Normandie,27,3,08,305,La Guéroulde,738,12,750
23,Haute-Normandie,27,3,17,306,Guichainville,2450,105,2555
23,Haute-Normandie,27,1,02,307,Guiseniers,409,7,416
23,Haute-Normandie,27,1,14,308,Guitry,260,10,270
23,Haute-Normandie,27,3,32,309,L' Habit,518,6,524
23,Haute-Normandie,27,1,15,310,Hacqueville,467,16,483
23,Haute-Normandie,27,2,09,311,Harcourt,936,13,949
23,Haute-Normandie,27,3,26,312,Hardencourt-Cocherel,279,7,286
23,Haute-Normandie,27,2,01,313,La Harengère,518,4,522
23,Haute-Normandie,27,1,02,315,Harquency,264,8,272
23,Haute-Normandie,27,2,30,316,Hauville,1275,22,1297
23,Haute-Normandie,27,2,30,317,La Haye-Aubrée,419,7,426
23,Haute-Normandie,27,2,09,318,La Haye-de-Calleville,283,2,285
23,Haute-Normandie,27,2,30,319,La Haye-de-Routot,256,2,258
23,Haute-Normandie,27,2,01,320,La Haye-du-Theil,259,5,264
23,Haute-Normandie,27,1,39,321,La Haye-le-Comte,120,7,127
23,Haute-Normandie,27,1,39,322,La Haye-Malherbe,1478,20,1498
23,Haute-Normandie,27,3,31,323,La Haye-Saint-Sylvestre,232,4,236
23,Haute-Normandie,27,1,20,324,Hébécourt,578,12,590
23,Haute-Normandie,27,2,09,325,Hecmanville,117,3,120
23,Haute-Normandie,27,3,26,326,Hécourt,342,3,345
23,Haute-Normandie,27,3,24,327,Hectomare,223,1,224
23,Haute-Normandie,27,1,02,329,Hennezis,766,21,787
23,Haute-Normandie,27,1,43,330,Herqueville,149,3,152
23,Haute-Normandie,27,1,14,331,Heubécourt-Haricourt,458,12,470
23,Haute-Normandie,27,1,21,332,Heudebouville,782,18,800
23,Haute-Normandie,27,1,15,333,Heudicourt,618,20,638
23,Haute-Normandie,27,2,34,334,Heudreville-en-Lieuvin,105,5,110
23,Haute-Normandie,27,1,42,335,Heudreville-sur-Eure,1024,18,1042
23,Haute-Normandie,27,3,40,336,La Heunière,253,4,257
23,Haute-Normandie,27,1,02,337,Heuqueville,394,8,402
23,Haute-Normandie,27,1,22,338,Les Hogues,634,9,643
23,Haute-Normandie,27,1,39,339,Hondouville,755,14,769
23,Haute-Normandie,27,2,30,340,Honguemare-Guenouville,577,12,589
23,Haute-Normandie,27,3,13,341,L' Hosmes,69,0,69
23,Haute-Normandie,27,3,24,342,Houetteville,218,5,223
23,Haute-Normandie,27,3,40,343,Houlbec-Cocherel,1345,55,1400
23,Haute-Normandie,27,2,01,344,Houlbec-près-le-Gros-Theil,114,0,114
23,Haute-Normandie,27,2,04,345,La Houssaye,203,6,209
23,Haute-Normandie,27,1,18,346,Houville-en-Vexin,207,2,209
23,Haute-Normandie,27,3,37,347,Huest,666,25,691
23,Haute-Normandie,27,1,28,348,Igoville,1485,9,1494
23,Haute-Normandie,27,2,23,349,Illeville-sur-Montfort,824,8,832
23,Haute-Normandie,27,3,25,350,Illiers-l'Évêque,995,27,1022
23,Haute-Normandie,27,1,21,351,Incarville,1334,21,1355
23,Haute-Normandie,27,3,16,353,Irreville,408,9,417
23,Haute-Normandie,27,3,24,354,Iville,465,9,474
23,Haute-Normandie,27,3,32,355,Ivry-la-Bataille,2603,50,2653
23,Haute-Normandie,27,2,03,356,Jonquerets-de-Livet,285,7,292
23,Haute-Normandie,27,3,37,358,Jouy-sur-Eure,573,4,577
23,Haute-Normandie,27,3,31,359,Juignettes,237,7,244
23,Haute-Normandie,27,3,32,360,Jumelles,302,3,305
23,Haute-Normandie,27,2,06,361,La Lande-Saint-Léger,289,5,294
23,Haute-Normandie,27,2,03,362,Landepéreuse,304,10,314
23,Haute-Normandie,27,2,30,363,Le Landin,173,2,175
23,Haute-Normandie,27,2,04,364,Launay,209,7,216
23,Haute-Normandie,27,1,43,365,Léry,2035,45,2080
23,Haute-Normandie,27,1,18,366,Letteguives,199,4,203
23,Haute-Normandie,27,2,33,367,Lieurey,1374,10,1384
23,Haute-Normandie,27,3,32,368,Lignerolles,285,2,287
23,Haute-Normandie,27,1,22,369,Lilly,72,2,74
23,Haute-Normandie,27,1,22,370,Lisors,361,8,369
23,Haute-Normandie,27,2,09,371,Livet-sur-Authou,143,1,144
23,Haute-Normandie,27,1,15,372,Longchamps,576,7,583
23,Haute-Normandie,27,1,22,373,Lorleau,152,7,159
23,Haute-Normandie,27,3,11,374,Louversey,608,10,618
23,Haute-Normandie,27,1,98,375,Louviers,18195,529,18724
23,Haute-Normandie,27,3,25,376,Louye,228,9,237
23,Haute-Normandie,27,1,22,377,Lyons-la-Forêt,754,12,766
23,Haute-Normandie,27,3,25,378,La Madeleine-de-Nonancourt,1193,24,1217
23,Haute-Normandie,27,1,20,379,Mainneville,424,6,430
23,Haute-Normandie,27,2,09,380,Malleville-sur-le-Bec,202,2,204
23,Haute-Normandie,27,2,05,381,Malouy,122,7,129
23,Haute-Normandie,27,2,01,382,Mandeville,302,7,309
23,Haute-Normandie,27,3,35,383,Mandres,344,19,363
23,Haute-Normandie,27,2,06,384,Manneville-la-Raoult,512,6,518
23,Haute-Normandie,27,2,27,385,Manneville-sur-Risle,1398,42,1440
23,Haute-Normandie,27,1,28,386,Le Manoir,1233,12,1245
23,Haute-Normandie,27,3,13,387,Manthelon,292,5,297
23,Haute-Normandie,27,2,29,388,Marais-Vernier,498,10,508
23,Haute-Normandie,27,3,24,389,Marbeuf,346,6,352
23,Haute-Normandie,27,3,25,390,Marcilly-la-Campagne,958,39,997
23,Haute-Normandie,27,3,32,391,Marcilly-sur-Eure,1487,25,1512
23,Haute-Normandie,27,1,20,392,Martagny,143,4,147
23,Haute-Normandie,27,2,06,393,Martainville,286,8,294
23,Haute-Normandie,27,1,28,394,Martot,519,6,525
23,Haute-Normandie,27,2,10,395,Mélicourt,94,0,94
23,Haute-Normandie,27,1,18,396,Ménesqueville,417,4,421
23,Haute-Normandie,27,3,26,397,Ménilles,1516,26,1542
23,Haute-Normandie,27,2,41,398,Menneval,1433,59,1492
23,Haute-Normandie,27,3,40,399,Mercey,55,1,56
23,Haute-Normandie,27,3,26,400,Merey,303,7,310
23,Haute-Normandie,27,3,16,401,Le Mesnil-Fuguet,195,5,200
23,Haute-Normandie,27,3,11,402,Le Mesnil-Hardray,46,0,46
23,Haute-Normandie,27,1,39,403,Le Mesnil-Jourdain,236,9,245
23,Haute-Normandie,27,2,10,404,Mesnil-Rousset,108,1,109
23,Haute-Normandie,27,1,20,405,Mesnil-sous-Vienne,126,3,129
23,Haute-Normandie,27,3,25,406,Mesnil-sur-l'Estrée,973,23,996
23,Haute-Normandie,27,1,18,407,Mesnil-Verclives,272,4,276
23,Haute-Normandie,27,1,14,408,Mézières-en-Vexin,644,13,657
23,Haute-Normandie,27,3,37,410,Miserey,524,7,531
23,Haute-Normandie,27,3,25,411,Moisville,193,5,198
23,Haute-Normandie,27,1,28,412,Montaure,996,20,1016
23,Haute-Normandie,27,2,23,413,Montfort-sur-Risle,833,6,839
23,Haute-Normandie,27,2,10,414,Montreuil-l'Argillé,786,14,800
23,Haute-Normandie,27,2,12,415,Morainville-Jouveaux,361,10,371
23,Haute-Normandie,27,1,15,417,Morgny,544,11,555
23,Haute-Normandie,27,2,09,418,Morsan,119,0,119
23,Haute-Normandie,27,3,32,419,Mouettes,701,14,715
23,Haute-Normandie,27,1,15,420,Mouflaines,152,0,152
23,Haute-Normandie,27,3,32,421,Mousseaux-Neuville,672,13,685
23,Haute-Normandie,27,1,02,422,Muids,883,28,911
23,Haute-Normandie,27,3,25,423,Muzy,808,24,832
23,Haute-Normandie,27,3,11,424,Nagel-Séez-Mesnil,329,2,331
23,Haute-Normandie,27,2,04,425,Nassandres,1392,24,1416
23,Haute-Normandie,27,3,31,427,Neaufles-Auvergny,434,9,443
23,Haute-Normandie,27,1,20,426,Neaufles-Saint-Martin,1183,32,1215
23,Haute-Normandie,27,3,24,428,Le Neubourg,4109,212,4321
23,Haute-Normandie,27,3,26,429,Neuilly,140,1,141
23,Haute-Normandie,27,1,15,430,La Neuve-Grange,304,3,307
23,Haute-Normandie,27,3,31,431,La Neuve-Lyre,608,18,626
23,Haute-Normandie,27,2,09,432,La Neuville-du-Bosc,538,4,542
23,Haute-Normandie,27,2,09,433,Neuville-sur-Authou,189,4,193
23,Haute-Normandie,27,2,33,434,Noards,64,1,65
23,Haute-Normandie,27,2,33,435,La Noë-Poulain,192,0,192
23,Haute-Normandie,27,3,11,436,Nogent-le-Sec,410,4,414
23,Haute-Normandie,27,1,15,437,Nojeon-en-Vexin,316,7,323
23,Haute-Normandie,27,3,25,438,Nonancourt,2188,128,2316
23,Haute-Normandie,27,3,16,439,Normanville,1100,39,1139
23,Haute-Normandie,27,2,09,441,Notre-Dame-d'Épine,76,3,79
23,Haute-Normandie,27,1,02,440,Notre-Dame-de-l'Isle,682,27,709
23,Haute-Normandie,27,2,10,442,Notre-Dame-du-Hamel,222,1,223
23,Haute-Normandie,27,2,03,444,Le Noyer-en-Ouche,184,1,185
23,Haute-Normandie,27,1,20,445,Noyers,296,6,302
23,Haute-Normandie,27,3,11,446,Ormes,456,5,461
23,Haute-Normandie,27,3,11,447,Orvaux,515,9,524
23,Haute-Normandie,27,3,26,448,Pacy-sur-Eure,4806,262,5068
23,Haute-Normandie,27,1,14,449,Panilleuse,465,12,477
23,Haute-Normandie,27,3,16,451,Parville,286,10,296
23,Haute-Normandie,27,2,04,452,Perriers-la-Campagne,357,8,365
23,Haute-Normandie,27,1,18,453,Perriers-sur-Andelle,1782,21,1803
23,Haute-Normandie,27,1,18,454,Perruel,453,2,455
23,Haute-Normandie,27,2,34,455,Piencourt,164,4,168
23,Haute-Normandie,27,1,39,456,Pinterville,810,21,831
23,Haute-Normandie,27,3,35,457,Piseux,658,17,675
23,Haute-Normandie,27,1,28,458,Pîtres,2162,56,2218
23,Haute-Normandie,27,2,34,459,Les Places,78,0,78
23,Haute-Normandie,27,2,05,460,Plainville,190,6,196
23,Haute-Normandie,27,2,34,462,Le Planquay,147,0,147
23,Haute-Normandie,27,2,05,463,Plasnes,624,22,646
23,Haute-Normandie,27,3,17,464,Le Plessis-Grohan,746,3,749
23,Haute-Normandie,27,3,26,465,Le Plessis-Hébert,418,9,427
23,Haute-Normandie,27,2,04,466,Le Plessis-Sainte-Opportune,267,9,276
23,Haute-Normandie,27,2,27,467,Pont-Audemer,8675,290,8965
23,Haute-Normandie,27,2,23,468,Pont-Authou,712,8,720
23,Haute-Normandie,27,1,28,469,Pont-de-l'Arche,4043,42,4085
23,Haute-Normandie,27,1,18,470,Pont-Saint-Pierre,1124,34,1158
23,Haute-Normandie,27,1,02,473,Port-Mort,1009,22,1031
23,Haute-Normandie,27,1,43,471,Porte-Joie,121,1,122
23,Haute-Normandie,27,3,11,472,Portes,264,2,266
23,Haute-Normandie,27,1,43,474,Poses,1129,21,1150
23,Haute-Normandie,27,2,33,475,La Poterie-Mathieu,139,2,141
23,Haute-Normandie,27,2,27,476,Les Préaux,432,12,444
23,Haute-Normandie,27,1,14,477,Pressagny-l'Orgueilleux,713,26,739
23,Haute-Normandie,27,3,32,478,Prey,869,24,893
23,Haute-Normandie,27,1,15,480,Puchay,543,6,549
23,Haute-Normandie,27,3,35,481,Pullay,375,54,429
23,Haute-Normandie,27,2,01,482,La Pyle,161,1,162
23,Haute-Normandie,27,1,39,483,Quatremare,370,8,378
23,Haute-Normandie,27,3,32,484,Quessigny,127,1,128
23,Haute-Normandie,27,2,29,485,Quillebeuf-sur-Seine,1022,4,1026
23,Haute-Normandie,27,3,16,486,Quittebeuf,604,5,609
23,Haute-Normandie,27,1,18,487,Radepont,757,6,763
23,Haute-Normandie,27,1,18,488,Renneville,244,2,246
23,Haute-Normandie,27,3,16,489,Reuilly,557,8,565
23,Haute-Normandie,27,1,15,490,Richeville,277,6,283
23,Haute-Normandie,27,3,13,491,Roman,284,6,290
23,Haute-Normandie,27,2,04,492,Romilly-la-Puthenaye,300,2,302
23,Haute-Normandie,27,1,18,493,Romilly-sur-Andelle,2645,34,2679
23,Haute-Normandie,27,3,13,024,Le Roncenay-Authenay,390,9,399
23,Haute-Normandie,27,1,02,495,La Roquette,225,0,225
23,Haute-Normandie,27,1,22,496,Rosay-sur-Lieure,548,3,551
23,Haute-Normandie,27,2,04,498,Rouge-Perriers,281,6,287
23,Haute-Normandie,27,2,30,497,Rougemontiers,874,10,884
23,Haute-Normandie,27,2,03,499,La Roussière,206,6,212
23,Haute-Normandie,27,2,30,500,Routot,1353,65,1418
23,Haute-Normandie,27,3,40,501,Rouvray,261,2,263
23,Haute-Normandie,27,3,31,502,Rugles,2380,43,2423
23,Haute-Normandie,27,3,13,503,Le Sacq,299,6,305
23,Haute-Normandie,27,3,16,504,Sacquenville,1029,32,1061
23,Haute-Normandie,27,2,10,505,Saint-Agnan-de-Cernières,136,1,137
23,Haute-Normandie,27,2,01,506,Saint-Amand-des-Hautes-Terres,281,7,288
23,Haute-Normandie,27,3,32,507,Saint-André-de-l'Eure,3397,74,3471
23,Haute-Normandie,27,3,31,508,Saint-Antonin-de-Sommaire,173,3,176
23,Haute-Normandie,27,3,26,510,Saint-Aquilin-de-Pacy,557,13,570
23,Haute-Normandie,27,3,24,511,Saint-Aubin-d'Écrosville,647,26,673
23,Haute-Normandie,27,2,34,512,Saint-Aubin-de-Scellon,340,0,340
23,Haute-Normandie,27,2,03,513,Saint-Aubin-des-Hayes,133,1,134
23,Haute-Normandie,27,2,10,514,Saint-Aubin-du-Thenney,355,7,362
23,Haute-Normandie,27,2,03,515,Saint-Aubin-le-Guichard,286,2,288
23,Haute-Normandie,27,2,41,516,Saint-Aubin-le-Vertueux,882,23,905
23,Haute-Normandie,27,1,42,517,Saint-Aubin-sur-Gaillon,1660,44,1704
23,Haute-Normandie,27,2,29,518,Saint-Aubin-sur-Quillebeuf,588,3,591
23,Haute-Normandie,27,2,33,520,Saint-Benoît-des-Ombres,113,4,117
23,Haute-Normandie,27,3,35,521,Saint-Christophe-sur-Avre,150,1,151
23,Haute-Normandie,27,2,33,522,Saint-Christophe-sur-Condé,387,6,393
23,Haute-Normandie,27,2,41,523,Saint-Clair-d'Arcey,318,13,331
23,Haute-Normandie,27,2,09,527,Saint-Cyr-de-Salerne,216,6,222
23,Haute-Normandie,27,2,01,529,Saint-Cyr-la-Campagne,421,11,432
23,Haute-Normandie,27,2,10,530,Saint-Denis-d'Augerons,84,0,84
23,Haute-Normandie,27,2,07,531,Saint-Denis-des-Monts,203,2,205
23,Haute-Normandie,27,3,08,532,Saint-Denis-du-Béhélan,153,2,155
23,Haute-Normandie,27,1,20,533,Saint-Denis-le-Ferment,485,10,495
23,Haute-Normandie,27,2,01,534,Saint-Didier-des-Bois,819,16,835
23,Haute-Normandie,27,3,11,535,Saint-Élier,445,15,460
23,Haute-Normandie,27,2,09,536,Saint-Éloi-de-Fourques,439,9,448
23,Haute-Normandie,27,1,21,537,Saint-Étienne-du-Vauvray,698,16,714
23,Haute-Normandie,27,2,33,538,Saint-Étienne-l'Allier,469,10,479
23,Haute-Normandie,27,1,42,539,Saint-Étienne-sous-Bailleul,378,5,383
23,Haute-Normandie,27,2,33,541,Saint-Georges-du-Mesnil,101,2,103
23,Haute-Normandie,27,2,33,542,Saint-Georges-du-Vièvre,701,7,708
23,Haute-Normandie,27,3,25,543,Saint-Georges-Motel,949,14,963
23,Haute-Normandie,27,3,32,544,Saint-Germain-de-Fresney,179,1,180
23,Haute-Normandie,27,2,01,545,Saint-Germain-de-Pasquier,137,6,143
23,Haute-Normandie,27,3,16,546,Saint-Germain-des-Angles,215,6,221
23,Haute-Normandie,27,2,34,547,Saint-Germain-la-Campagne,813,10,823
23,Haute-Normandie,27,3,25,548,Saint-Germain-sur-Avre,1217,21,1238
23,Haute-Normandie,27,2,27,549,Saint-Germain-Village,1478,31,1509
23,Haute-Normandie,27,2,33,550,Saint-Grégoire-du-Vièvre,336,2,338
23,Haute-Normandie,27,2,33,551,Saint-Jean-de-la-Léqueraye,49,0,49
23,Haute-Normandie,27,2,10,552,Saint-Jean-du-Thenney,203,7,210
23,Haute-Normandie,27,1,42,553,Saint-Julien-de-la-Liègue,310,10,320
23,Haute-Normandie,27,3,36,554,Saint-Just,1333,38,1371
23,Haute-Normandie,27,3,32,555,Saint-Laurent-des-Bois,217,7,224
23,Haute-Normandie,27,2,10,556,Saint-Laurent-du-Tencement,50,1,51
23,Haute-Normandie,27,2,41,557,Saint-Léger-de-Rôtes,420,11,431
23,Haute-Normandie,27,2,07,558,Saint-Léger-du-Gennetey,160,2,162
23,Haute-Normandie,27,3,17,560,Saint-Luc,246,7,253
23,Haute-Normandie,27,2,06,561,Saint-Maclou,552,3,555
23,Haute-Normandie,27,3,36,562,Saint-Marcel,4967,135,5102
23,Haute-Normandie,27,2,27,563,Saint-Mards-de-Blacarville,762,29,791
23,Haute-Normandie,27,2,34,564,Saint-Mards-de-Fresne,349,8,357
23,Haute-Normandie,27,2,05,569,Saint-Martin-du-Tilleul,236,7,243
23,Haute-Normandie,27,3,16,570,Saint-Martin-la-Campagne,99,1,100
23,Haute-Normandie,27,2,33,571,Saint-Martin-Saint-Firmin,235,3,238
23,Haute-Normandie,27,2,01,572,Saint-Meslin-du-Bosc,228,1,229
23,Haute-Normandie,27,3,08,573,Saint-Nicolas-d'Attez,142,1,143
23,Haute-Normandie,27,2,01,574,Saint-Nicolas-du-Bosc,273,8,281
23,Haute-Normandie,27,3,08,578,Saint-Ouen-d'Attez,271,1,272
23,Haute-Normandie,27,2,01,579,Saint-Ouen-de-Pontcheuil,99,2,101
23,Haute-Normandie,27,2,30,580,Saint-Ouen-de-Thouberville,2191,36,2227
23,Haute-Normandie,27,2,29,581,Saint-Ouen-des-Champs,305,6,311
23,Haute-Normandie,27,2,07,582,Saint-Ouen-du-Tilleul,1564,25,1589
23,Haute-Normandie,27,2,09,584,Saint-Paul-de-Fourques,254,3,257
23,Haute-Normandie,27,2,07,586,Saint-Philbert-sur-Boissey,158,1,159
23,Haute-Normandie,27,2,23,587,Saint-Philbert-sur-Risle,799,11,810
23,Haute-Normandie,27,3,36,588,Saint-Pierre-d'Autils,988,34,1022
23,Haute-Normandie,27,1,42,589,Saint-Pierre-de-Bailleul,1016,27,1043
23,Haute-Normandie,27,2,10,590,Saint-Pierre-de-Cernières,224,4,228
23,Haute-Normandie,27,2,12,591,Saint-Pierre-de-Cormeilles,608,9,617
23,Haute-Normandie,27,2,09,592,Saint-Pierre-de-Salerne,249,8,257
23,Haute-Normandie,27,2,01,593,Saint-Pierre-des-Fleurs,1282,16,1298
23,Haute-Normandie,27,2,33,594,Saint-Pierre-des-Ifs,235,0,235
23,Haute-Normandie,27,2,01,595,Saint-Pierre-du-Bosguérard,1026,13,1039
23,Haute-Normandie,27,2,03,596,Saint-Pierre-du-Mesnil,104,2,106
23,Haute-Normandie,27,2,06,597,Saint-Pierre-du-Val,529,6,535
23,Haute-Normandie,27,1,21,598,Saint-Pierre-du-Vauvray,1341,21,1362
23,Haute-Normandie,27,1,42,599,Saint-Pierre-la-Garenne,891,21,912
23,Haute-Normandie,27,2,10,600,Saint-Quentin-des-Isles,236,12,248
23,Haute-Normandie,27,2,29,601,Saint-Samson-de-la-Roque,348,4,352
23,Haute-Normandie,27,3,38,602,Saint-Sébastien-de-Morsent,4567,118,4685
23,Haute-Normandie,27,2,12,603,Saint-Siméon,312,5,317
23,Haute-Normandie,27,2,06,604,Saint-Sulpice-de-Grimbouville,178,3,181
23,Haute-Normandie,27,2,12,605,Saint-Sylvestre-de-Cormeilles,201,3,204
23,Haute-Normandie,27,2,27,606,Saint-Symphorien,402,2,404
23,Haute-Normandie,27,2,29,607,Saint-Thurien,208,4,212
23,Haute-Normandie,27,2,09,609,Saint-Victor-d'Épine,320,7,327
23,Haute-Normandie,27,2,05,608,Saint-Victor-de-Chrétienville,436,6,442
23,Haute-Normandie,27,3,35,610,Saint-Victor-sur-Avre,64,3,67
23,Haute-Normandie,27,3,37,611,Saint-Vigor,311,4,315
23,Haute-Normandie,27,3,40,612,Saint-Vincent-des-Bois,285,5,290
23,Haute-Normandie,27,2,34,613,Saint-Vincent-du-Boulay,296,5,301
23,Haute-Normandie,27,1,42,519,Sainte-Barbe-sur-Gaillon,248,8,256
23,Haute-Normandie,27,3,16,524,Sainte-Colombe-la-Commanderie,659,13,672
23,Haute-Normandie,27,3,36,525,Sainte-Colombe-près-Vernon,253,8,261
23,Haute-Normandie,27,2,29,526,Sainte-Croix-sur-Aizier,254,1,255
23,Haute-Normandie,27,1,14,540,Sainte-Geneviève-lès-Gasny,626,18,644
23,Haute-Normandie,27,3,08,565,Sainte-Marguerite-de-l'Autel,470,5,475
23,Haute-Normandie,27,2,03,566,Sainte-Marguerite-en-Ouche,139,0,139
23,Haute-Normandie,27,1,15,567,Sainte-Marie-de-Vatimesnil,254,4,258
23,Haute-Normandie,27,3,11,568,Sainte-Marthe,453,15,468
23,Haute-Normandie,27,2,04,576,Sainte-Opportune-du-Bosc,628,5,633
23,Haute-Normandie,27,2,29,577,Sainte-Opportune-la-Mare,428,8,436
23,Haute-Normandie,27,1,20,614,Sancourt,145,0,145
23,Haute-Normandie,27,3,37,615,Sassey,163,7,170
23,Haute-Normandie,27,1,15,617,Saussay-la-Campagne,436,8,444
23,Haute-Normandie,27,2,01,616,La Saussaye,1928,53,1981
23,Haute-Normandie,27,3,11,618,Sébécourt,393,5,398
23,Haute-Normandie,27,2,27,620,Selles,423,8,431
23,Haute-Normandie,27,3,32,621,Serez,146,5,151
23,Haute-Normandie,27,2,41,622,Serquigny,2153,43,2196
23,Haute-Normandie,27,1,39,623,Surtauville,413,4,417
23,Haute-Normandie,27,1,39,624,Surville,874,21,895
23,Haute-Normandie,27,1,02,625,Suzay,236,5,241
23,Haute-Normandie,27,3,13,693,Sylvains-les-Moulins,1145,39,1184
23,Haute-Normandie,27,2,34,627,Le Theil-Nolent,212,3,215
23,Haute-Normandie,27,2,07,626,Theillement,369,5,374
23,Haute-Normandie,27,2,03,628,Thevray,280,5,285
23,Haute-Normandie,27,2,34,629,Thiberville,1727,26,1753
23,Haute-Normandie,27,2,04,630,Thibouville,266,43,309
23,Haute-Normandie,27,2,23,631,Thierville,287,1,288
23,Haute-Normandie,27,1,15,632,Le Thil,406,5,411
23,Haute-Normandie,27,1,15,633,Les Thilliers-en-Vexin,467,12,479
23,Haute-Normandie,27,3,13,634,Thomer-la-Sôgne,308,5,313
23,Haute-Normandie,27,1,02,635,Le Thuit,129,3,132
23,Haute-Normandie,27,2,01,636,Le Thuit-Anger,629,7,636
23,Haute-Normandie,27,2,07,637,Thuit-Hébert,306,4,310
23,Haute-Normandie,27,2,01,638,Le Thuit-Signol,2126,33,2159
23,Haute-Normandie,27,2,01,639,Le Thuit-Simer,384,7,391
23,Haute-Normandie,27,2,04,640,Tilleul-Dame-Agnès,224,7,231
23,Haute-Normandie,27,3,16,641,Le Tilleul-Lambert,191,2,193
23,Haute-Normandie,27,2,04,642,Le Tilleul-Othon,394,7,401
23,Haute-Normandie,27,3,35,643,Tillières-sur-Avre,1192,15,1207
23,Haute-Normandie,27,1,14,644,Tilly,554,35,589
23,Haute-Normandie,27,2,29,645,Tocqueville,123,5,128
23,Haute-Normandie,27,2,06,646,Le Torpt,301,7,308
23,Haute-Normandie,27,1,42,647,Tosny,644,9,653
23,Haute-Normandie,27,1,28,648,Tostes,383,4,387
23,Haute-Normandie,27,1,22,649,Touffreville,317,2,319
23,Haute-Normandie,27,3,16,650,Tournedos-Bois-Hubert,360,5,365
23,Haute-Normandie,27,1,43,651,Tournedos-sur-Seine,96,0,96
23,Haute-Normandie,27,3,16,652,Tourneville,343,5,348
23,Haute-Normandie,27,1,14,653,Tourny,909,21,930
23,Haute-Normandie,27,2,01,654,Tourville-la-Campagne,872,20,892
23,Haute-Normandie,27,2,27,655,Tourville-sur-Pont-Audemer,707,151,858
23,Haute-Normandie,27,2,27,656,Toutainville,1158,22,1180
23,Haute-Normandie,27,2,23,657,Touville,137,3,140
23,Haute-Normandie,27,3,24,658,Le Tremblay-Omonville,287,9,296
23,Haute-Normandie,27,3,37,659,La Trinité,98,0,98
23,Haute-Normandie,27,2,10,660,La Trinité-de-Réville,249,1,250
23,Haute-Normandie,27,2,30,661,La Trinité-de-Thouberville,426,12,438
23,Haute-Normandie,27,2,27,662,Triqueville,300,6,306
23,Haute-Normandie,27,3,24,663,Le Troncq,153,1,154
23,Haute-Normandie,27,1,22,664,Le Tronquay,480,12,492
23,Haute-Normandie,27,2,29,665,Trouville-la-Haule,743,14,757
23,Haute-Normandie,27,1,39,666,La Vacherie,542,13,555
23,Haute-Normandie,27,3,37,668,Le Val-David,758,14,772
23,Haute-Normandie,27,1,43,701,Val-de-Reuil,13702,231,13933
23,Haute-Normandie,27,2,05,667,Valailles,377,2,379
23,Haute-Normandie,27,2,30,669,Valletot,332,2,334
23,Haute-Normandie,27,1,18,670,Vandrimare,1032,9,1041
23,Haute-Normandie,27,2,06,671,Vannecrocq,127,3,130
23,Haute-Normandie,27,1,22,672,Vascoeuil,334,1,335
23,Haute-Normandie,27,1,02,673,Vatteville,183,6,189
23,Haute-Normandie,27,1,43,528,Le Vaudreuil,3562,111,3673
23,Haute-Normandie,27,3,26,674,Vaux-sur-Eure,239,5,244
23,Haute-Normandie,27,1,42,676,Venables,775,19,794
23,Haute-Normandie,27,3,24,677,Venon,279,5,284
23,Haute-Normandie,27,3,17,678,Les Ventes,1044,23,1067
23,Haute-Normandie,27,3,35,679,Verneuil-sur-Avre,6538,443,6981
23,Haute-Normandie,27,2,10,680,Verneusses,218,3,221
23,Haute-Normandie,27,3,97,681,Vernon,24998,999,25997
23,Haute-Normandie,27,1,20,682,Vesly,663,13,676
23,Haute-Normandie,27,1,02,683,Vézillon,239,4,243
23,Haute-Normandie,27,3,37,684,Le Vieil-Évreux,738,26,764
23,Haute-Normandie,27,3,31,685,La Vieille-Lyre,626,10,636
23,Haute-Normandie,27,2,29,686,Vieux-Port,61,2,63
23,Haute-Normandie,27,1,42,687,Vieux-Villez,199,2,201
23,Haute-Normandie,27,3,13,688,Villalet,79,2,81
23,Haute-Normandie,27,3,26,689,Villegats,335,7,342
23,Haute-Normandie,27,1,15,690,Villers-en-Vexin,278,4,282
23,Haute-Normandie,27,1,42,691,Villers-sur-le-Roule,683,18,701
23,Haute-Normandie,27,3,24,692,Villettes,172,5,177
23,Haute-Normandie,27,3,36,694,Villez-sous-Bailleul,308,6,314
23,Haute-Normandie,27,3,24,695,Villez-sur-le-Neubourg,280,5,285
23,Haute-Normandie,27,3,26,696,Villiers-en-Désoeuvre,918,14,932
23,Haute-Normandie,27,1,21,697,Vironvay,306,9,315
23,Haute-Normandie,27,3,24,698,Vitot,484,16,500
23,Haute-Normandie,27,2,07,699,Voiscreville,112,2,114
23,Haute-Normandie,27,2,01,700,Vraiville,568,10,578
24,Centre,28,3,01,001,Abondant,2042,49,2091
24,Centre,28,1,16,002,Allaines-Mervilliers,344,10,354
24,Centre,28,3,27,003,Allainville,150,3,153
24,Centre,28,1,24,004,Allonnes,307,9,316
24,Centre,28,2,04,005,Alluyes,702,89,791
24,Centre,28,1,29,006,Amilly,1891,50,1941
24,Centre,28,3,01,007,Anet,2632,111,2743
24,Centre,28,3,10,008,Ardelles,219,1,220
24,Centre,28,1,02,009,Ardelu,74,1,75
24,Centre,28,4,20,010,Argenvilliers,369,14,383
24,Centre,28,2,11,012,Arrou,1683,34,1717
24,Centre,28,1,02,013,Aunay-sous-Auneau,1396,20,1416
24,Centre,28,3,28,014,Aunay-sous-Crécy,564,14,578
24,Centre,28,1,02,015,Auneau,4086,61,4147
24,Centre,28,4,03,016,Les Autels-Villevillon,141,4,145
24,Centre,28,2,11,017,Autheuil,229,9,238
24,Centre,28,4,03,018,Authon-du-Perche,1285,18,1303
24,Centre,28,2,21,019,Baigneaux,221,4,225
24,Centre,28,1,24,020,Baignolet,129,2,131
24,Centre,28,1,18,023,Bailleau-Armenonville,1352,29,1381
24,Centre,28,1,30,022,Bailleau-l'Évêque,1153,22,1175
24,Centre,28,1,15,021,Bailleau-le-Pin,1505,37,1542
24,Centre,28,1,26,024,Barjouville,1607,65,1672
24,Centre,28,1,16,025,Barmainville,127,3,130
24,Centre,28,1,16,026,Baudreville,283,6,289
24,Centre,28,4,03,027,La Bazoche-Gouet,1310,14,1324
24,Centre,28,2,21,028,Bazoches-en-Dunois,259,8,267
24,Centre,28,2,21,029,Bazoches-les-Hautes,308,2,310
24,Centre,28,3,05,030,Beauche,302,7,309
24,Centre,28,4,03,031,Beaumont-les-Autels,505,44,549
24,Centre,28,1,24,032,Beauvilliers,305,10,315
24,Centre,28,4,17,033,Belhomert-Guéhouville,822,28,850
24,Centre,28,1,25,035,Berchères-les-Pierres,959,18,977
24,Centre,28,1,07,034,Berchères-Saint-Germain,782,13,795
24,Centre,28,3,01,036,Berchères-sur-Vesgre,840,22,862
24,Centre,28,3,05,037,Bérou-la-Mulotière,322,5,327
24,Centre,28,4,03,038,Béthonvilliers,138,2,140
24,Centre,28,1,02,039,Béville-le-Comte,1435,35,1470
24,Centre,28,1,12,040,Billancelles,277,9,286
24,Centre,28,1,15,041,Blandainville,261,3,264
24,Centre,28,1,18,042,Bleury,488,7,495
24,Centre,28,2,11,044,Boisgasson,110,5,115
24,Centre,28,3,27,045,Boissy-en-Drouais,243,6,249
24,Centre,28,3,14,046,Boissy-lès-Perche,516,9,525
24,Centre,28,1,24,047,Boisville-la-Saint-Père,714,11,725
24,Centre,28,1,24,049,Boncé,231,1,232
24,Centre,28,3,01,050,Boncourt,275,5,280
24,Centre,28,2,04,051,Bonneval,4432,82,4514
24,Centre,28,1,18,052,Bouglainval,738,22,760
24,Centre,28,3,10,053,Le Boullay-les-Deux-Églises,239,1,240
24,Centre,28,3,19,054,Le Boullay-Mivoye,424,4,428
24,Centre,28,3,19,055,Le Boullay-Thierry,542,11,553
24,Centre,28,1,15,048,La Bourdinière-Saint-Loup,545,12,557
24,Centre,28,3,19,056,Boutigny-Prouais,1711,29,1740
24,Centre,28,2,04,057,Bouville,517,7,524
24,Centre,28,3,19,058,Bréchamps,330,9,339
24,Centre,28,3,05,059,Brezolles,1674,25,1699
24,Centre,28,1,07,060,Briconville,114,2,116
24,Centre,28,2,06,061,Brou,3534,49,3583
24,Centre,28,3,01,062,Broué,917,9,926
24,Centre,28,4,20,063,Brunelles,543,14,557
24,Centre,28,3,01,064,Bû,1824,37,1861
24,Centre,28,2,04,065,Bullainville,109,1,110
24,Centre,28,2,06,066,Bullou,217,7,224
24,Centre,28,1,15,067,Cernay,78,1,79
24,Centre,28,1,07,068,Challet,406,11,417
24,Centre,28,3,01,069,Champagne,241,5,246
24,Centre,28,1,07,070,Champhol,3399,122,3521
24,Centre,28,4,17,071,Champrond-en-Gâtine,488,12,500
24,Centre,28,4,20,072,Champrond-en-Perchet,402,11,413
24,Centre,28,1,02,073,Champseru,301,7,308
24,Centre,28,1,02,074,La Chapelle-d'Aunainville,263,4,267
24,Centre,28,2,09,075,La Chapelle-du-Noyer,1028,145,1173
24,Centre,28,3,13,076,La Chapelle-Forainvilliers,174,2,176
24,Centre,28,3,14,077,La Chapelle-Fortin,176,9,185
24,Centre,28,4,03,078,Chapelle-Guillaume,200,5,205
24,Centre,28,4,03,079,Chapelle-Royale,362,5,367
24,Centre,28,4,03,080,Charbonnières,257,5,262
24,Centre,28,1,15,081,Charonville,255,2,257
24,Centre,28,3,13,082,Charpont,549,29,578
24,Centre,28,2,11,083,Charray,102,3,105
24,Centre,28,1,18,084,Chartainvilliers,764,17,781
24,Centre,28,1,99,085,Chartres,39159,1555,40714
24,Centre,28,4,23,086,Chassant,321,3,324
24,Centre,28,3,05,087,Châtaincourt,240,5,245
24,Centre,28,2,09,088,Châteaudun,13905,434,14339
24,Centre,28,3,10,089,Châteauneuf-en-Thymerais,2549,42,2591
24,Centre,28,3,05,090,Les Châtelets,104,2,106
24,Centre,28,1,15,091,Les Châtelliers-Notre-Dame,126,2,128
24,Centre,28,1,02,092,Châtenay,229,5,234
24,Centre,28,2,11,093,Châtillon-en-Dunois,753,13,766
24,Centre,28,3,19,094,Chaudon,1575,29,1604
24,Centre,28,1,15,095,Chauffours,284,9,293
24,Centre,28,3,01,096,La Chaussée-d'Ivry,1011,14,1025
24,Centre,28,3,13,098,Cherisy,1820,35,1855
24,Centre,28,1,12,099,Chuisnes,988,21,1009
24,Centre,28,1,29,100,Cintray,438,13,451
24,Centre,28,2,09,101,Civry,348,8,356
24,Centre,28,1,07,102,Clévilliers,736,18,754
24,Centre,28,2,11,103,Cloyes-sur-le-Loir,2676,55,2731
24,Centre,28,1,07,104,Coltainville,871,18,889
24,Centre,28,4,23,105,Combres,486,3,489
24,Centre,28,2,09,106,Conie-Molitard,376,14,390
24,Centre,28,1,26,107,Corancez,405,16,421
24,Centre,28,2,21,108,Cormainville,227,5,232
24,Centre,28,4,17,109,Les Corvées-les-Yys,289,4,293
24,Centre,28,1,25,110,Le Coudray,3854,110,3964
24,Centre,28,4,03,111,Coudray-au-Perche,373,7,380
24,Centre,28,4,23,112,Coudreceau,420,5,425
24,Centre,28,3,19,113,Coulombs,1348,26,1374
24,Centre,28,2,21,114,Courbehaye,119,5,124
24,Centre,28,2,11,115,Courtalain,599,12,611
24,Centre,28,1,12,116,Courville-sur-Eure,2758,40,2798
24,Centre,28,3,27,117,Crécy-Couvé,277,14,291
24,Centre,28,3,19,118,Croisilles,446,11,457
24,Centre,28,4,23,119,La Croix-du-Perche,202,1,203
24,Centre,28,3,05,120,Crucey-Villages,500,9,509
24,Centre,28,2,21,121,Dambron,91,2,93
24,Centre,28,1,26,122,Dammarie,1538,36,1574
24,Centre,28,2,06,123,Dampierre-sous-Brou,471,5,476
24,Centre,28,3,05,124,Dampierre-sur-Avre,689,17,706
24,Centre,28,2,04,126,Dancy,205,2,207
24,Centre,28,2,06,127,Dangeau,936,12,948
24,Centre,28,1,12,128,Dangers,412,14,426
24,Centre,28,1,02,129,Denonville,776,24,800
24,Centre,28,3,22,130,Digny,968,11,979
24,Centre,28,2,09,132,Donnemain-Saint-Mamès,644,24,668
24,Centre,28,2,11,133,Douy,502,17,519
24,Centre,28,3,97,134,Dreux,31212,670,31882
24,Centre,28,1,18,135,Droue-sur-Drouette,1246,25,1271
24,Centre,28,3,13,136,Écluzelles,155,4,159
24,Centre,28,1,18,137,Écrosnes,778,17,795
24,Centre,28,1,15,139,Épeautrolles,182,3,185
24,Centre,28,1,18,140,Épernon,5254,78,5332
24,Centre,28,1,15,141,Ermenonville-la-Grande,327,4,331
24,Centre,28,1,15,142,Ermenonville-la-Petite,186,1,187
24,Centre,28,3,05,143,Escorpain,263,8,271
24,Centre,28,4,03,144,Les Étilleux,219,5,224
24,Centre,28,1,24,145,Fains-la-Folie,325,9,334
24,Centre,28,3,19,146,Faverolles,858,14,872
24,Centre,28,3,10,147,Favières,483,15,498
24,Centre,28,1,12,148,Le Favril,324,8,332
24,Centre,28,3,14,149,La Ferté-Vidame,766,19,785
24,Centre,28,2,11,150,La Ferté-Villeneuil,398,13,411
24,Centre,28,3,05,151,Fessanvilliers-Mattanvilliers,168,1,169
24,Centre,28,2,04,153,Flacey,214,3,217
24,Centre,28,1,12,154,Fontaine-la-Guyon,1434,99,1533
24,Centre,28,3,10,155,Fontaine-les-Ribouts,241,2,243
24,Centre,28,4,17,156,Fontaine-Simon,874,33,907
24,Centre,28,2,21,157,Fontenay-sur-Conie,129,6,135
24,Centre,28,1,26,158,Fontenay-sur-Eure,828,27,855
24,Centre,28,3,22,159,La Framboisière,301,8,309
24,Centre,28,1,02,160,Francourville,783,21,804
24,Centre,28,4,23,161,Frazé,519,9,528
24,Centre,28,1,16,164,Fresnay-l'Évêque,657,14,671
24,Centre,28,1,26,162,Fresnay-le-Comte,326,5,331
24,Centre,28,1,07,163,Fresnay-le-Gilmert,201,8,209
24,Centre,28,4,23,165,Frétigny,480,9,489
24,Centre,28,4,17,166,Friaize,216,3,219
24,Centre,28,1,12,167,Fruncé,343,8,351
24,Centre,28,1,18,168,Gallardon,3430,75,3505
24,Centre,28,1,02,169,Garancières-en-Beauce,227,5,232
24,Centre,28,3,27,170,Garancières-en-Drouais,284,10,294
24,Centre,28,3,28,171,Garnay,919,20,939
24,Centre,28,1,18,172,Gas,763,14,777
24,Centre,28,1,07,173,Gasville-Oisème,1200,27,1227
24,Centre,28,4,20,175,La Gaudaine,182,5,187
24,Centre,28,2,04,176,Le Gault-Saint-Denis,686,5,691
24,Centre,28,1,25,177,Gellainville,489,11,500
24,Centre,28,3,13,178,Germainville,309,1,310
24,Centre,28,1,24,179,Germignonville,240,3,243
24,Centre,28,3,01,180,Gilles,571,9,580
24,Centre,28,2,06,182,Gohory,273,5,278
24,Centre,28,1,16,183,Gommerville,575,7,582
24,Centre,28,1,16,184,Gouillons,343,4,347
24,Centre,28,3,01,185,Goussainville,868,8,876
24,Centre,28,3,01,187,Guainville,664,18,682
24,Centre,28,1,02,188,Le Gué-de-Longroi,768,17,785
24,Centre,28,1,16,189,Guilleville,176,2,178
24,Centre,28,2,21,190,Guillonville,452,7,459
24,Centre,28,1,18,191,Hanches,2616,61,2677
24,Centre,28,4,23,192,Happonvilliers,308,0,308
24,Centre,28,3,01,193,Havelu,114,3,117
24,Centre,28,1,02,194,Houville-la-Branche,487,13,500
24,Centre,28,1,18,195,Houx,797,12,809
24,Centre,28,1,15,196,Illiers-Combray,3249,49,3298
24,Centre,28,1,16,197,Intréville,133,5,138
24,Centre,28,2,09,198,Jallans,776,37,813
24,Centre,28,1,16,199,Janville,1799,35,1834
24,Centre,28,3,22,200,Jaudrais,351,3,354
24,Centre,28,1,07,201,Jouy,1889,58,1947
24,Centre,28,3,14,202,Lamblore,400,10,410
24,Centre,28,1,12,203,Landelles,576,9,585
24,Centre,28,2,11,204,Langey,352,6,358
24,Centre,28,2,09,205,Lanneray,550,17,567
24,Centre,28,3,05,206,Laons,726,16,742
24,Centre,28,1,02,207,Léthuin,205,4,209
24,Centre,28,1,02,208,Levainville,378,5,383
24,Centre,28,1,30,209,Lèves,4826,199,5025
24,Centre,28,1,16,210,Levesville-la-Chenard,220,1,221
24,Centre,28,2,09,211,Logron,537,12,549
24,Centre,28,2,21,212,Loigny-la-Bataille,236,3,239
24,Centre,28,3,19,213,Lormaye,642,7,649
24,Centre,28,4,17,214,La Loupe,3465,159,3624
24,Centre,28,1,24,215,Louville-la-Chenard,283,8,291
24,Centre,28,3,27,216,Louvilliers-en-Drouais,203,3,206
24,Centre,28,3,22,217,Louvilliers-lès-Perche,152,5,157
24,Centre,28,1,29,218,Lucé,15716,335,16051
24,Centre,28,4,03,219,Luigny,407,4,411
24,Centre,28,1,26,220,Luisant,6858,292,7150
24,Centre,28,2,21,221,Lumeau,187,4,191
24,Centre,28,1,15,222,Luplanté,400,4,404
24,Centre,28,3,13,223,Luray,1514,18,1532
24,Centre,28,2,09,224,Lutz-en-Dunois,429,11,440
24,Centre,28,1,15,225,Magny,656,9,665
24,Centre,28,3,10,226,Maillebois,990,17,1007
24,Centre,28,1,18,227,Maintenon,4461,98,4559
24,Centre,28,1,30,229,Mainvilliers,10289,293,10582
24,Centre,28,1,02,230,Maisons,318,9,327
24,Centre,28,3,05,231,La Mancelière,159,3,162
24,Centre,28,4,17,232,Manou,564,44,608
24,Centre,28,2,09,233,Marboué,1158,24,1182
24,Centre,28,1,15,234,Marchéville,454,10,464
24,Centre,28,3,01,235,Marchezais,289,6,295
24,Centre,28,4,20,236,Margon,1252,43,1295
24,Centre,28,4,23,237,Marolles-les-Buis,271,6,277
24,Centre,28,3,28,239,Marville-Moutiers-Brûlé,903,24,927
24,Centre,28,4,17,240,Meaucé,513,16,529
24,Centre,28,2,11,241,Le Mée,265,8,273
24,Centre,28,1,15,242,Méréglise,90,1,91
24,Centre,28,1,16,243,Mérouville,228,3,231
24,Centre,28,1,15,245,Meslay-le-Grenet,301,22,323
24,Centre,28,2,04,246,Meslay-le-Vidame,470,51,521
24,Centre,28,3,01,247,Le Mesnil-Simon,502,11,513
24,Centre,28,3,22,248,Le Mesnil-Thomas,328,0,328
24,Centre,28,1,18,249,Mévoisins,643,16,659
24,Centre,28,2,06,250,Mézières-au-Perche,128,0,128
24,Centre,28,3,13,251,Mézières-en-Drouais,1066,21,1087
24,Centre,28,4,03,252,Miermaigne,223,2,225
24,Centre,28,1,26,253,Mignières,743,80,823
24,Centre,28,1,12,254,Mittainvilliers,432,12,444
24,Centre,28,1,02,255,Moinville-la-Jeulin,108,4,112
24,Centre,28,2,09,256,Moléans,487,14,501
24,Centre,28,1,02,257,Mondonville-Saint-Jean,91,4,95
24,Centre,28,1,24,258,Montainville,322,18,340
24,Centre,28,2,04,259,Montboissier,312,2,314
24,Centre,28,2,04,260,Montharville,101,1,102
24,Centre,28,4,23,261,Montigny-le-Chartif,548,4,552
24,Centre,28,2,11,262,Montigny-le-Gannelon,495,17,512
24,Centre,28,3,05,263,Montigny-sur-Avre,255,7,262
24,Centre,28,4,17,264,Montireau,124,2,126
24,Centre,28,4,17,265,Montlandon,275,7,282
24,Centre,28,3,27,267,Montreuil,512,11,523
24,Centre,28,1,02,268,Morainville,24,0,24
24,Centre,28,1,26,269,Morancez,1537,63,1600
24,Centre,28,2,04,270,Moriers,210,7,217
24,Centre,28,3,14,271,Morvilliers,135,3,138
24,Centre,28,2,06,272,Mottereau,159,4,163
24,Centre,28,4,03,273,Moulhard,156,3,159
24,Centre,28,1,24,274,Moutiers,244,11,255
24,Centre,28,3,19,275,Néron,613,22,635
24,Centre,28,1,16,276,Neuvy-en-Beauce,177,4,181
24,Centre,28,2,04,277,Neuvy-en-Dunois,323,7,330
24,Centre,28,1,25,278,Nogent-le-Phaye,1299,39,1338
24,Centre,28,3,19,279,Nogent-le-Roi,4114,53,4167
24,Centre,28,4,20,280,Nogent-le-Rotrou,11124,524,11648
24,Centre,28,1,15,281,Nogent-sur-Eure,489,9,498
24,Centre,28,4,23,282,Nonvilliers-Grandhoux,399,5,404
24,Centre,28,2,21,283,Nottonville,287,5,292
24,Centre,28,1,16,284,Oinville-Saint-Liphard,273,5,278
24,Centre,28,1,02,285,Oinville-sous-Auneau,323,2,325
24,Centre,28,1,15,286,Ollé,586,21,607
24,Centre,28,2,21,287,Orgères-en-Beauce,1097,11,1108
24,Centre,28,1,02,288,Orlu,49,0,49
24,Centre,28,3,19,289,Ormoy,248,8,256
24,Centre,28,1,12,290,Orrouer,273,3,276
24,Centre,28,1,24,291,Ouarville,577,13,590
24,Centre,28,3,13,292,Ouerre,687,18,705
24,Centre,28,3,01,293,Oulins,1118,13,1131
24,Centre,28,1,02,294,Oysonville,493,8,501
24,Centre,28,2,09,295,Ozoir-le-Breuil,420,14,434
24,Centre,28,2,21,296,Péronville,309,3,312
24,Centre,28,1,24,297,Pézy,250,5,255
24,Centre,28,1,18,298,Pierres,2715,43,2758
24,Centre,28,3,19,299,Les Pinthières,171,3,174
24,Centre,28,1,16,300,Poinville,123,1,124
24,Centre,28,1,07,301,Poisvilliers,378,10,388
24,Centre,28,1,12,302,Pontgouin,1015,308,1323
24,Centre,28,2,21,303,Poupry,103,2,105
24,Centre,28,1,24,304,Prasville,339,7,346
24,Centre,28,2,04,305,Pré-Saint-Évroult,315,4,319
24,Centre,28,2,04,306,Pré-Saint-Martin,160,4,164
24,Centre,28,3,05,308,Prudemanche,255,2,257
24,Centre,28,1,25,309,Prunay-le-Gillon,934,16,950
24,Centre,28,3,22,310,La Puisaye,250,4,254
24,Centre,28,1,16,311,Le Puiset,407,17,424
24,Centre,28,3,10,312,Puiseux,111,5,116
24,Centre,28,1,24,313,Réclainville,153,1,154
24,Centre,28,3,14,314,Les Ressuintes,151,1,152
24,Centre,28,3,05,315,Revercourt,35,2,37
24,Centre,28,3,14,316,Rohaire,137,5,142
24,Centre,28,1,02,317,Roinville,355,11,366
24,Centre,28,2,11,318,Romilly-sur-Aigre,461,14,475
24,Centre,28,1,16,319,Rouvray-Saint-Denis,435,4,439
24,Centre,28,1,24,320,Rouvray-Saint-Florentin,196,8,204
24,Centre,28,3,01,321,Rouvres,886,22,908
24,Centre,28,3,05,322,Rueil-la-Gadelière,464,8,472
24,Centre,28,3,10,323,Saint-Ange-et-Torçay,275,11,286
24,Centre,28,1,12,324,Saint-Arnoult-des-Bois,856,8,864
24,Centre,28,1,30,325,Saint-Aubin-des-Bois,944,28,972
24,Centre,28,2,06,326,Saint-Avit-les-Guespières,322,3,325
24,Centre,28,4,03,327,Saint-Bomer,200,0,200
24,Centre,28,2,09,329,Saint-Christophe,145,3,148
24,Centre,28,2,09,330,Saint-Cloud-en-Dunois,225,5,230
24,Centre,28,4,23,331,Saint-Denis-d'Authou,500,10,510
24,Centre,28,1,12,333,Saint-Denis-des-Puits,122,0,122
24,Centre,28,2,09,334,Saint-Denis-les-Ponts,1825,39,1864
24,Centre,28,4,17,335,Saint-Éliph,837,21,858
24,Centre,28,1,15,336,Saint-Éman,115,5,120
24,Centre,28,1,12,337,Saint-Georges-sur-Eure,2508,87,2595
24,Centre,28,1,12,339,Saint-Germain-le-Gaillard,320,9,329
24,Centre,28,2,11,340,Saint-Hilaire-sur-Yerre,499,9,508
24,Centre,28,3,10,341,Saint-Jean-de-Rebervilliers,220,2,222
24,Centre,28,4,20,342,Saint-Jean-Pierre-Fixte,283,12,295
24,Centre,28,3,19,343,Saint-Laurent-la-Gâtine,450,14,464
24,Centre,28,1,02,344,Saint-Léger-des-Aubées,247,3,250
24,Centre,28,3,05,346,Saint-Lubin-de-Cravant,65,1,66
24,Centre,28,3,01,347,Saint-Lubin-de-la-Haye,908,15,923
24,Centre,28,3,05,348,Saint-Lubin-des-Joncherets,4049,47,4096
24,Centre,28,3,19,349,Saint-Lucien,231,5,236
24,Centre,28,1,12,350,Saint-Luperce,883,21,904
24,Centre,28,3,10,351,Saint-Maixme-Hauterive,436,3,439
24,Centre,28,1,18,352,Saint-Martin-de-Nigelles,1586,26,1612
24,Centre,28,2,04,353,Saint-Maur-sur-le-Loir,379,14,393
24,Centre,28,4,17,354,Saint-Maurice-Saint-Germain,401,42,443
24,Centre,28,3,01,355,Saint-Ouen-Marchefroy,336,8,344
24,Centre,28,2,11,356,Saint-Pellerin,364,5,369
24,Centre,28,1,18,357,Saint-Piat,1128,32,1160
24,Centre,28,1,07,358,Saint-Prest,2100,114,2214
24,Centre,28,3,05,359,Saint-Rémy-sur-Avre,3601,86,3687
24,Centre,28,3,10,360,Saint-Sauveur-Marville,944,16,960
24,Centre,28,1,18,361,Saint-Symphorien-le-Château,814,20,834
24,Centre,28,4,17,362,Saint-Victor-de-Buthon,541,9,550
24,Centre,28,3,13,332,Sainte-Gemme-Moronval,912,22,934
24,Centre,28,1,02,363,Sainville,935,25,960
24,Centre,28,2,04,364,Sancheville,778,10,788
24,Centre,28,1,15,365,Sandarville,393,12,405
24,Centre,28,1,02,366,Santeuil,270,0,270
24,Centre,28,1,16,367,Santilly,363,4,367
24,Centre,28,3,22,368,La Saucelle,168,4,172
24,Centre,28,3,27,369,Saulnières,610,13,623
24,Centre,28,2,04,370,Saumeray,412,6,418
24,Centre,28,3,01,371,Saussay,1062,15,1077
24,Centre,28,3,19,372,Senantes,643,9,652
24,Centre,28,3,22,373,Senonches,3225,60,3285
24,Centre,28,3,10,374,Serazereux,487,5,492
24,Centre,28,3,01,375,Serville,365,1,366
24,Centre,28,4,03,376,Soizé,295,2,297
24,Centre,28,3,01,377,Sorel-Moussel,1802,31,1833
24,Centre,28,4,20,378,Souancé-au-Perche,546,11,557
24,Centre,28,1,18,379,Soulaires,429,10,439
24,Centre,28,1,25,380,Sours,1774,186,1960
24,Centre,28,2,21,382,Terminiers,966,13,979
24,Centre,28,1,24,383,Theuville,415,18,433
24,Centre,28,4,17,385,Le Thieulin,392,52,444
24,Centre,28,3,10,386,Thimert-Gâtelles,1085,22,1107
24,Centre,28,4,23,387,Thiron-Gardais,1098,10,1108
24,Centre,28,1,26,388,Thivars,966,29,995
24,Centre,28,2,09,389,Thiville,352,16,368
24,Centre,28,2,21,390,Tillay-le-Péneux,363,12,375
24,Centre,28,1,16,391,Toury,2594,53,2647
24,Centre,28,1,16,392,Trancrainville,161,3,164
24,Centre,28,3,10,393,Tremblay-les-Villages,2177,24,2201
24,Centre,28,3,28,394,Tréon,1333,22,1355
24,Centre,28,4,20,395,Trizay-Coutretot-Saint-Serge,468,15,483
24,Centre,28,2,04,396,Trizay-lès-Bonneval,271,10,281
24,Centre,28,1,02,397,Umpeau,419,3,422
24,Centre,28,2,06,398,Unverre,1172,22,1194
24,Centre,28,2,21,400,Varize,210,3,213
24,Centre,28,4,17,401,Vaupillon,478,11,489
24,Centre,28,1,26,403,Ver-lès-Chartres,783,56,839
24,Centre,28,1,12,402,Vérigny,287,6,293
24,Centre,28,3,28,404,Vernouillet,11794,169,11963
24,Centre,28,3,27,405,Vert-en-Drouais,1050,24,1074
24,Centre,28,1,24,406,Viabon,313,6,319
24,Centre,28,4,20,407,Vichères,314,8,322
24,Centre,28,1,02,408,Vierville,117,1,118
24,Centre,28,2,06,409,Vieuvicq,453,7,460
24,Centre,28,2,09,410,Villampuy,306,3,309
24,Centre,28,1,24,411,Villars,139,2,141
24,Centre,28,1,24,412,Villeau,170,2,172
24,Centre,28,1,12,414,Villebon,81,2,83
24,Centre,28,3,19,415,Villemeux-sur-Eure,1613,33,1646
24,Centre,28,1,24,416,Villeneuve-Saint-Nicolas,128,5,133
24,Centre,28,3,19,417,Villiers-le-Morhier,1347,28,1375
24,Centre,28,2,04,418,Villiers-Saint-Orien,176,5,181
24,Centre,28,2,04,419,Vitray-en-Beauce,324,4,328
24,Centre,28,1,02,421,Voise,280,6,286
24,Centre,28,1,24,422,Voves,2910,60,2970
24,Centre,28,1,18,423,Yermenonville,594,9,603
24,Centre,28,2,06,424,Yèvres,1709,35,1744
24,Centre,28,1,18,425,Ymeray,594,12,606
24,Centre,28,1,24,426,Ymonville,479,19,498
53,Bretagne,29,2,11,001,Argol,815,31,846
53,Bretagne,29,4,01,002,Arzano,1402,48,1450
53,Bretagne,29,4,33,003,Audierne,2319,53,2372
53,Bretagne,29,4,02,004,Bannalec,5226,165,5391
53,Bretagne,29,4,36,005,Baye,1104,45,1149
53,Bretagne,29,4,15,006,Bénodet,3208,89,3297
53,Bretagne,29,2,16,007,Berrien,944,34,978
53,Bretagne,29,4,33,008,Beuzec-Cap-Sizun,1085,26,1111
53,Bretagne,29,3,18,010,Bodilis,1541,27,1568
53,Bretagne,29,1,44,011,Bohars,3308,87,3395
53,Bretagne,29,2,16,012,Bolazec,203,5,208
53,Bretagne,29,2,16,013,Botmeur,229,5,234
53,Bretagne,29,3,30,014,Botsorhel,473,11,484
53,Bretagne,29,1,24,015,Bourg-Blanc,3268,67,3335
53,Bretagne,29,2,25,016,Brasparts,1034,40,1074
53,Bretagne,29,1,27,017,Brélès,819,25,844
53,Bretagne,29,2,25,018,Brennilis,435,8,443
53,Bretagne,29,1,99,019,Brest,142097,4046,146143
53,Bretagne,29,4,06,020,Briec,5244,122,5366
53,Bretagne,29,1,21,021,Brignogan-Plage,844,23,867
53,Bretagne,29,2,11,022,Camaret-sur-Mer,2595,46,2641
53,Bretagne,29,3,43,023,Carantec,3309,148,3457
53,Bretagne,29,2,07,024,Carhaix-Plouguer,7654,502,8156
53,Bretagne,29,2,08,025,Cast,1536,40,1576
53,Bretagne,29,2,08,026,Châteaulin,5247,538,5785
53,Bretagne,29,2,09,027,Châteauneuf-du-Faou,3698,121,3819
53,Bretagne,29,4,33,028,Cléden-Cap-Sizun,992,16,1008
53,Bretagne,29,2,07,029,Cléden-Poher,1062,28,1090
53,Bretagne,29,3,31,030,Cléder,3814,90,3904
53,Bretagne,29,4,36,031,Clohars-Carnoët,3999,135,4134
53,Bretagne,29,4,15,032,Clohars-Fouesnant,2127,51,2178
53,Bretagne,29,2,25,033,Le Cloître-Pleyben,572,18,590
53,Bretagne,29,3,40,034,Le Cloître-Saint-Thégonnec,599,18,617
53,Bretagne,29,1,24,035,Coat-Méal,970,21,991
53,Bretagne,29,2,09,036,Collorec,667,9,676
53,Bretagne,29,4,34,037,Combrit,3469,117,3586
53,Bretagne,29,3,42,038,Commana,1064,31,1095
53,Bretagne,29,4,10,039,Concarneau,20096,700,20796
53,Bretagne,29,4,33,145,Confort-Meilars,843,20,863
53,Bretagne,29,1,39,040,Le Conquet,2604,55,2659
53,Bretagne,29,2,09,041,Coray,1805,35,1840
53,Bretagne,29,2,11,042,Crozon,7680,246,7926
53,Bretagne,29,1,12,043,Daoulas,1754,62,1816
53,Bretagne,29,2,08,044,Dinéault,1720,77,1797
53,Bretagne,29,1,17,045,Dirinon,2467,87,2554
53,Bretagne,29,4,13,046,Douarnenez,15066,576,15642
53,Bretagne,29,1,24,047,Le Drennec,1759,48,1807
53,Bretagne,29,4,06,048,Edern,2085,70,2155
53,Bretagne,29,4,37,049,Elliant,3177,211,3388
53,Bretagne,29,4,48,051,Ergué-Gabéric,7655,242,7897
53,Bretagne,29,4,33,052,Esquibien,1600,46,1646
53,Bretagne,29,2,14,053,Le Faou,1786,36,1822
53,Bretagne,29,2,16,054,La Feuillée,663,22,685
53,Bretagne,29,1,21,055,Le Folgoët,3004,97,3101
53,Bretagne,29,1,17,056,La Forest-Landerneau,1798,33,1831
53,Bretagne,29,4,15,057,La Forêt-Fouesnant,3261,104,3365
53,Bretagne,29,4,15,058,Fouesnant,9557,445,10002
53,Bretagne,29,3,19,059,Garlan,957,20,977
53,Bretagne,29,4,15,060,Gouesnach,2504,83,2587
53,Bretagne,29,1,46,061,Gouesnou,6317,209,6526
53,Bretagne,29,2,25,062,Gouézec,1089,40,1129
53,Bretagne,29,4,33,063,Goulien,417,12,429
53,Bretagne,29,1,21,064,Goulven,454,16,470
53,Bretagne,29,4,26,065,Gourlizon,851,25,876
53,Bretagne,29,4,13,066,Guengat,1651,47,1698
53,Bretagne,29,3,30,067,Guerlesquin,1392,31,1423
53,Bretagne,29,3,43,068,Guiclan,2143,63,2206
53,Bretagne,29,4,26,070,Guiler-sur-Goyen,448,16,464
53,Bretagne,29,1,44,069,Guilers,7350,183,7533
53,Bretagne,29,4,01,071,Guilligomarc'h,678,14,692
53,Bretagne,29,4,49,072,Guilvinec,2998,88,3086
53,Bretagne,29,3,19,073,Guimaëc,937,31,968
53,Bretagne,29,3,18,074,Guimiliau,943,31,974
53,Bretagne,29,1,51,075,Guipavas,13771,386,14157
53,Bretagne,29,1,39,076,Guipronvel,705,8,713
53,Bretagne,29,1,20,077,Guissény,1886,37,1923
53,Bretagne,29,1,12,078,Hanvec,1956,47,2003
53,Bretagne,29,3,43,079,Henvic,1305,45,1350
53,Bretagne,29,1,12,080,Hôpital-Camfrout,1979,48,2027
53,Bretagne,29,2,16,081,Huelgoat,1602,23,1625
53,Bretagne,29,3,38,082,Île-de-Batz,574,20,594
53,Bretagne,29,4,33,083,Île-de-Sein,214,9,223
53,Bretagne,29,1,39,084,Île-Molène,214,4,218
53,Bretagne,29,4,34,085,Île-Tudy,691,28,719
53,Bretagne,29,1,12,086,Irvillac,1318,29,1347
53,Bretagne,29,4,13,087,Le Juch,752,16,768
53,Bretagne,29,2,07,089,Kergloff,916,28,944
53,Bretagne,29,2,08,090,Kerlaz,797,55,852
53,Bretagne,29,1,21,091,Kerlouan,2272,48,2320
53,Bretagne,29,1,24,093,Kernilis,1278,25,1303
53,Bretagne,29,1,21,094,Kernouës,699,18,717
53,Bretagne,29,1,24,095,Kersaint-Plabennec,1270,24,1294
53,Bretagne,29,3,18,097,Lampaul-Guimiliau,2027,68,2095
53,Bretagne,29,1,39,098,Lampaul-Plouarzel,2058,41,2099
53,Bretagne,29,1,27,099,Lampaul-Ploudalmézeau,727,14,741
53,Bretagne,29,1,24,100,Lanarvily,375,8,383
53,Bretagne,29,1,20,101,Landéda,3628,106,3734
53,Bretagne,29,2,09,102,Landeleau,1023,29,1052
53,Bretagne,29,1,17,103,Landerneau,14999,643,15642
53,Bretagne,29,2,11,104,Landévennec,356,9,365
53,Bretagne,29,3,18,105,Landivisiau,8964,337,9301
53,Bretagne,29,4,06,106,Landrévarzec,1595,49,1644
53,Bretagne,29,4,06,107,Landudal,779,21,800
53,Bretagne,29,4,26,108,Landudec,1293,20,1313
53,Bretagne,29,1,27,109,Landunvez,1353,44,1397
53,Bretagne,29,4,06,110,Langolen,822,19,841
53,Bretagne,29,3,29,111,Lanhouarneau,1097,24,1121
53,Bretagne,29,1,27,112,Lanildut,944,22,966
53,Bretagne,29,3,19,113,Lanmeur,2166,57,2223
53,Bretagne,29,3,30,114,Lannéanou,361,9,370
53,Bretagne,29,2,25,115,Lannédern,301,12,313
53,Bretagne,29,1,28,116,Lanneuffret,116,4,120
53,Bretagne,29,1,20,117,Lannilis,5084,105,5189
53,Bretagne,29,1,39,119,Lanrivoaré,1373,37,1410
53,Bretagne,29,2,11,120,Lanvéoc,2214,45,2259
53,Bretagne,29,2,09,122,Laz,743,17,760
53,Bretagne,29,2,25,123,Lennon,765,19,784
53,Bretagne,29,1,21,124,Lesneven,6794,511,7305
53,Bretagne,29,2,09,125,Leuhan,781,20,801
53,Bretagne,29,1,24,126,Loc-Brévalaire,219,4,223
53,Bretagne,29,1,28,128,Loc-Eguiner,326,7,333
53,Bretagne,29,3,40,127,Loc-Eguiner-Saint-Thégonnec,322,6,328
53,Bretagne,29,2,16,129,Locmaria-Berrien,232,7,239
53,Bretagne,29,1,39,130,Locmaria-Plouzané,4841,137,4978
53,Bretagne,29,3,42,131,Locmélar,427,19,446
53,Bretagne,29,3,43,132,Locquénolé,760,34,794
53,Bretagne,29,3,19,133,Locquirec,1437,44,1481
53,Bretagne,29,2,08,134,Locronan,800,38,838
53,Bretagne,29,4,49,135,Loctudy,4161,109,4270
53,Bretagne,29,4,01,136,Locunolé,1031,28,1059
53,Bretagne,29,1,12,137,Logonna-Daoulas,2053,64,2117
53,Bretagne,29,2,14,139,Lopérec,804,197,1001
53,Bretagne,29,1,12,140,Loperhet,3558,121,3679
53,Bretagne,29,2,25,141,Loqueffret,406,12,418
53,Bretagne,29,2,25,142,Lothey,428,12,440
53,Bretagne,29,4,33,143,Mahalon,881,22,903
53,Bretagne,29,1,28,144,La Martyre,769,9,778
53,Bretagne,29,4,02,146,Melgven,3243,83,3326
53,Bretagne,29,4,36,147,Mellac,2603,89,2692
53,Bretagne,29,3,38,148,Mespaul,881,21,902
53,Bretagne,29,1,39,149,Milizac,2961,52,3013
53,Bretagne,29,4,32,150,Moëlan-sur-Mer,6932,198,7130
53,Bretagne,29,3,22,151,Morlaix,15574,1059,16633
53,Bretagne,29,2,07,152,Motreff,731,11,742
53,Bretagne,29,4,32,153,Névez,2679,58,2737
53,Bretagne,29,1,23,155,Ouessant,856,27,883
53,Bretagne,29,1,17,156,Pencran,1573,38,1611
53,Bretagne,29,4,49,158,Penmarch,5633,177,5810
53,Bretagne,29,4,26,159,Peumérit,780,28,808
53,Bretagne,29,1,24,160,Plabennec,7764,364,8128
53,Bretagne,29,4,15,161,Pleuven,2634,96,2730
53,Bretagne,29,2,25,162,Pleyben,3667,314,3981
53,Bretagne,29,3,40,163,Pleyber-Christ,3051,132,3183
53,Bretagne,29,4,49,165,Plobannalec-Lesconil,3321,102,3423
53,Bretagne,29,2,08,166,Ploéven,482,10,492
53,Bretagne,29,4,26,167,Plogastel-Saint-Germain,1790,64,1854
53,Bretagne,29,4,33,168,Plogoff,1374,54,1428
53,Bretagne,29,4,13,169,Plogonnec,3036,73,3109
53,Bretagne,29,4,52,170,Plomelin,4080,182,4262
53,Bretagne,29,4,34,171,Plomeur,3579,109,3688
53,Bretagne,29,2,08,172,Plomodiern,2162,68,2230
53,Bretagne,29,4,26,173,Plonéis,1853,56,1909
53,Bretagne,29,4,26,174,Plonéour-Lanvern,5626,140,5766
53,Bretagne,29,2,09,175,Plonévez-du-Faou,2099,83,2182
53,Bretagne,29,2,08,176,Plonévez-Porzay,1679,43,1722
53,Bretagne,29,1,39,177,Plouarzel,3391,64,3455
53,Bretagne,29,1,27,178,Ploudalmézeau,6070,135,6205
53,Bretagne,29,1,21,179,Ploudaniel,3683,159,3842
53,Bretagne,29,1,28,180,Ploudiry,897,21,918
53,Bretagne,29,1,17,181,Plouédern,2726,79,2805
53,Bretagne,29,3,19,182,Plouégat-Guérand,1060,37,1097
53,Bretagne,29,3,30,183,Plouégat-Moysan,628,9,637
53,Bretagne,29,3,38,184,Plouénan,2422,50,2472
53,Bretagne,29,3,29,185,Plouescat,3736,117,3853
53,Bretagne,29,3,19,186,Plouezoc'h,1608,77,1685
53,Bretagne,29,3,29,187,Plougar,744,21,765
53,Bretagne,29,3,19,188,Plougasnou,3231,117,3348
53,Bretagne,29,1,12,189,Plougastel-Daoulas,13098,384,13482
53,Bretagne,29,1,39,190,Plougonvelin,3625,88,3713
53,Bretagne,29,3,30,191,Plougonven,3236,75,3311
53,Bretagne,29,3,38,192,Plougoulm,1792,63,1855
53,Bretagne,29,3,18,193,Plougourvest,1277,30,1307
53,Bretagne,29,1,20,195,Plouguerneau,6275,121,6396
53,Bretagne,29,1,27,196,Plouguin,2074,46,2120
53,Bretagne,29,4,33,197,Plouhinec,4267,131,4398
53,Bretagne,29,1,21,198,Plouider,1908,52,1960
53,Bretagne,29,3,30,199,Plouigneau,4588,222,4810
53,Bretagne,29,1,39,201,Ploumoguer,1919,55,1974
53,Bretagne,29,3,40,202,Plounéour-Ménez,1212,30,1242
53,Bretagne,29,1,21,203,Plounéour-Trez,1242,39,1281
53,Bretagne,29,3,18,204,Plounéventer,1752,46,1798
53,Bretagne,29,3,29,206,Plounévez-Lochrist,2391,125,2516
53,Bretagne,29,2,07,205,Plounévézel,1122,28,1150
53,Bretagne,29,1,27,208,Plourin,1146,26,1172
53,Bretagne,29,3,22,207,Plourin-lès-Morlaix,4538,270,4808
53,Bretagne,29,1,24,209,Plouvien,3654,71,3725
53,Bretagne,29,3,31,210,Plouvorn,2758,82,2840
53,Bretagne,29,2,16,211,Plouyé,724,14,738
53,Bretagne,29,1,03,212,Plouzané,11662,279,11941
53,Bretagne,29,3,31,213,Plouzévédé,1606,43,1649
53,Bretagne,29,4,26,214,Plovan,693,26,719
53,Bretagne,29,4,26,215,Plozévet,2943,103,3046
53,Bretagne,29,4,52,216,Pluguffan,3385,129,3514
53,Bretagne,29,4,32,217,Pont-Aven,2929,78,3007
53,Bretagne,29,4,33,218,Pont-Croix,1829,42,1871
53,Bretagne,29,2,14,302,Pont-de-Buis-lès-Quimerch,3768,172,3940
53,Bretagne,29,4,34,220,Pont-l'Abbé,8079,444,8523
53,Bretagne,29,3,30,219,Le Ponthou,165,5,170
53,Bretagne,29,1,27,221,Porspoder,1646,56,1702
53,Bretagne,29,2,08,222,Port-Launay,461,56,517
53,Bretagne,29,4,13,224,Pouldergat,1254,32,1286
53,Bretagne,29,4,26,225,Pouldreuzic,1838,44,1882
53,Bretagne,29,4,13,226,Poullan-sur-Mer,1484,174,1658
53,Bretagne,29,2,07,227,Poullaouen,1390,48,1438
53,Bretagne,29,4,33,228,Primelin,743,18,761
53,Bretagne,29,2,08,229,Quéménéven,1141,35,1176
53,Bretagne,29,4,41,230,Querrien,1674,36,1710
53,Bretagne,29,4,98,232,Quimper,63929,3345,67274
53,Bretagne,29,4,36,233,Quimperlé,11088,678,11766
53,Bretagne,29,4,01,234,Rédené,2743,78,2821
53,Bretagne,29,1,51,235,Le Relecq-Kerhuon,10783,293,11076
53,Bretagne,29,4,32,236,Riec-sur-Belon,4162,123,4285
53,Bretagne,29,1,28,237,La Roche-Maurice,1892,54,1946
53,Bretagne,29,2,11,238,Roscanvel,958,32,990
53,Bretagne,29,3,38,239,Roscoff,3648,105,3753
53,Bretagne,29,2,14,240,Rosnoën,977,27,1004
53,Bretagne,29,4,37,241,Rosporden,7026,119,7145
53,Bretagne,29,2,08,243,Saint-Coulitz,416,33,449
53,Bretagne,29,3,18,244,Saint-Derrien,716,2,718
53,Bretagne,29,1,17,245,Saint-Divy,1290,26,1316
53,Bretagne,29,1,12,246,Saint-Eloy,205,1,206
53,Bretagne,29,4,15,247,Saint-Évarzec,3325,90,3415
53,Bretagne,29,1,21,248,Saint-Frégant,626,14,640
53,Bretagne,29,2,09,249,Saint-Goazec,697,18,715
53,Bretagne,29,2,07,250,Saint-Hernin,753,34,787
53,Bretagne,29,3,19,251,Saint-Jean-du-Doigt,629,17,646
53,Bretagne,29,4,34,252,Saint-Jean-Trolimon,981,31,1012
53,Bretagne,29,3,22,254,Saint-Martin-des-Champs,4877,245,5122
53,Bretagne,29,1,21,255,Saint-Méen,710,15,725
53,Bretagne,29,2,08,256,Saint-Nic,743,25,768
53,Bretagne,29,1,27,257,Saint-Pabu,1849,47,1896
53,Bretagne,29,3,38,259,Saint-Pol-de-Léon,7038,294,7332
53,Bretagne,29,1,39,260,Saint-Renan,7341,209,7550
53,Bretagne,29,2,25,261,Saint-Rivoal,171,6,177
53,Bretagne,29,3,42,262,Saint-Sauveur,756,26,782
53,Bretagne,29,2,08,263,Saint-Ségal,963,37,1000
53,Bretagne,29,3,18,264,Saint-Servais,615,18,633
53,Bretagne,29,3,40,266,Saint-Thégonnec,2630,86,2716
53,Bretagne,29,2,09,267,Saint-Thois,724,13,737
53,Bretagne,29,1,17,268,Saint-Thonan,1353,37,1390
53,Bretagne,29,4,41,269,Saint-Thurien,882,21,903
53,Bretagne,29,1,12,270,Saint-Urbain,1452,49,1501
53,Bretagne,29,3,31,271,Saint-Vougay,906,14,920
53,Bretagne,29,4,37,272,Saint-Yvi,2744,76,2820
53,Bretagne,29,3,22,265,Sainte-Sève,867,31,898
53,Bretagne,29,3,38,273,Santec,2280,72,2352
53,Bretagne,29,4,41,274,Scaër,5198,130,5328
53,Bretagne,29,2,16,275,Scrignac,809,29,838
53,Bretagne,29,3,38,276,Sibiril,1274,26,1300
53,Bretagne,29,3,42,277,Sizun,2216,57,2273
53,Bretagne,29,2,07,278,Spézet,1844,54,1898
53,Bretagne,29,3,43,279,Taulé,2895,96,2991
53,Bretagne,29,2,11,280,Telgruc-sur-Mer,2042,81,2123
53,Bretagne,29,4,37,281,Tourch,935,13,948
53,Bretagne,29,1,39,282,Trébabu,371,10,381
53,Bretagne,29,4,49,284,Treffiagat,2313,111,2424
53,Bretagne,29,3,31,285,Tréflaouénan,523,14,537
53,Bretagne,29,1,28,286,Tréflévénez,284,8,292
53,Bretagne,29,3,29,287,Tréflez,901,25,926
53,Bretagne,29,1,21,288,Trégarantec,536,20,556
53,Bretagne,29,2,08,289,Trégarvan,141,5,146
53,Bretagne,29,1,20,290,Tréglonou,589,17,606
53,Bretagne,29,2,09,291,Trégourez,944,15,959
53,Bretagne,29,4,34,292,Tréguennec,339,7,346
53,Bretagne,29,4,10,293,Trégunc,6799,233,7032
53,Bretagne,29,1,28,294,Le Tréhou,539,13,552
53,Bretagne,29,1,17,295,Trémaouézan,470,12,482
53,Bretagne,29,4,34,296,Tréméoc,1181,28,1209
53,Bretagne,29,4,36,297,Tréméven,2132,52,2184
53,Bretagne,29,4,26,298,Tréogat,519,10,529
53,Bretagne,29,1,27,299,Tréouergat,250,3,253
53,Bretagne,29,4,02,300,Le Trévoux,1445,38,1483
53,Bretagne,29,3,31,301,Trézilidé,275,11,286
91,Languedoc-Roussillon,30,2,35,001,Aigaliers,477,6,483
91,Languedoc-Roussillon,30,1,14,002,Aigremont,669,9,678
91,Languedoc-Roussillon,30,2,01,003,Aigues-Mortes,7891,84,7975
91,Languedoc-Roussillon,30,2,32,004,Aigues-Vives,2727,38,2765
91,Languedoc-Roussillon,30,2,20,005,Aiguèze,225,4,229
91,Languedoc-Roussillon,30,2,46,006,Aimargues,4226,33,4259
91,Languedoc-Roussillon,30,1,98,007,Alès,40520,959,41479
91,Languedoc-Roussillon,30,1,24,008,Allègre-les-Fumades,756,16,772
91,Languedoc-Roussillon,30,3,04,009,Alzon,223,9,232
91,Languedoc-Roussillon,30,1,05,010,Anduze,3289,58,3347
91,Languedoc-Roussillon,30,2,40,011,Les Angles,8269,212,8481
91,Languedoc-Roussillon,30,2,06,012,Aramon,3808,89,3897
91,Languedoc-Roussillon,30,2,22,013,Argilliers,331,2,333
91,Languedoc-Roussillon,30,2,35,014,Arpaillargues-et-Aureillac,998,21,1019
91,Languedoc-Roussillon,30,3,39,015,Arphy,162,3,165
91,Languedoc-Roussillon,30,3,39,016,Arre,288,3,291
91,Languedoc-Roussillon,30,3,04,017,Arrigas,191,6,197
91,Languedoc-Roussillon,30,2,32,018,Aspères,464,12,476
91,Languedoc-Roussillon,30,2,32,019,Aubais,2353,54,2407
91,Languedoc-Roussillon,30,2,37,020,Aubord,2416,46,2462
91,Languedoc-Roussillon,30,2,26,021,Aubussargues,335,3,338
91,Languedoc-Roussillon,30,1,11,022,Aujac,183,9,192
91,Languedoc-Roussillon,30,2,32,023,Aujargues,822,16,838
91,Languedoc-Roussillon,30,3,39,024,Aulas,440,15,455
91,Languedoc-Roussillon,30,3,04,025,Aumessas,226,6,232
91,Languedoc-Roussillon,30,3,39,026,Avèze,1075,36,1111
91,Languedoc-Roussillon,30,1,05,027,Bagard,2367,85,2452
91,Languedoc-Roussillon,30,2,07,028,Bagnols-sur-Cèze,18506,473,18979
91,Languedoc-Roussillon,30,1,08,029,Barjac,1530,31,1561
91,Languedoc-Roussillon,30,2,26,030,Baron,324,9,333
91,Languedoc-Roussillon,30,2,15,031,La Bastide-d'Engras,219,4,223
91,Languedoc-Roussillon,30,2,09,032,Beaucaire,15505,225,15730
91,Languedoc-Roussillon,30,2,37,033,Beauvoisin,3523,62,3585
91,Languedoc-Roussillon,30,2,09,034,Bellegarde,6183,119,6302
91,Languedoc-Roussillon,30,2,15,035,Belvézet,235,8,243
91,Languedoc-Roussillon,30,2,37,036,Bernis,3087,40,3127
91,Languedoc-Roussillon,30,1,10,037,Bessèges,3233,49,3282
91,Languedoc-Roussillon,30,3,39,038,Bez-et-Esparon,361,27,388
91,Languedoc-Roussillon,30,2,16,039,Bezouce,2089,27,2116
91,Languedoc-Roussillon,30,3,04,040,Blandas,128,3,131
91,Languedoc-Roussillon,30,2,35,041,Blauzac,1086,20,1106
91,Languedoc-Roussillon,30,1,05,042,Boisset-et-Gaujac,2270,58,2328
91,Languedoc-Roussillon,30,2,32,043,Boissières,514,15,529
91,Languedoc-Roussillon,30,1,11,044,Bonnevaux,93,5,98
91,Languedoc-Roussillon,30,1,10,045,Bordezac,378,8,386
91,Languedoc-Roussillon,30,1,14,046,Boucoiran-et-Nozières,717,10,727
91,Languedoc-Roussillon,30,2,45,047,Bouillargues,5805,122,5927
91,Languedoc-Roussillon,30,1,24,048,Bouquet,190,5,195
91,Languedoc-Roussillon,30,2,26,049,Bourdic,334,4,338
91,Languedoc-Roussillon,30,3,21,050,Bragassargues,133,8,141
91,Languedoc-Roussillon,30,1,12,051,Branoux-les-Taillades,1331,29,1360
91,Languedoc-Roussillon,30,3,39,052,Bréau-et-Salagosse,439,33,472
91,Languedoc-Roussillon,30,1,38,053,Brignon,823,5,828
91,Languedoc-Roussillon,30,1,38,055,Brouzet-lès-Alès,586,7,593
91,Languedoc-Roussillon,30,3,21,054,Brouzet-lès-Quissac,233,8,241
91,Languedoc-Roussillon,30,2,15,056,La Bruguière,284,6,290
91,Languedoc-Roussillon,30,2,16,057,Cabrières,1307,12,1319
91,Languedoc-Roussillon,30,3,28,058,La Cadière-et-Cambo,199,4,203
91,Languedoc-Roussillon,30,2,46,059,Le Cailar,2395,51,2446
91,Languedoc-Roussillon,30,2,45,060,Caissargues,3787,55,3842
91,Languedoc-Roussillon,30,2,26,061,La Calmette,1937,32,1969
91,Languedoc-Roussillon,30,2,32,062,Calvisson,4588,74,4662
91,Languedoc-Roussillon,30,3,04,064,Campestre-et-Luc,113,1,114
91,Languedoc-Roussillon,30,3,31,065,Canaules-et-Argentières,441,5,446
91,Languedoc-Roussillon,30,3,21,066,Cannes-et-Clairan,378,5,383
91,Languedoc-Roussillon,30,2,35,067,La Capelle-et-Masmolène,389,3,392
91,Languedoc-Roussillon,30,1,14,068,Cardet,830,19,849
91,Languedoc-Roussillon,30,3,21,069,Carnas,398,5,403
91,Languedoc-Roussillon,30,2,20,070,Carsan,645,26,671
91,Languedoc-Roussillon,30,1,14,071,Cassagnoles,429,7,436
91,Languedoc-Roussillon,30,1,38,072,Castelnau-Valence,354,1,355
91,Languedoc-Roussillon,30,2,22,073,Castillon-du-Gard,1306,86,1392
91,Languedoc-Roussillon,30,3,34,074,Causse-Bégon,18,1,19
91,Languedoc-Roussillon,30,2,30,075,Caveirac,3754,88,3842
91,Languedoc-Roussillon,30,2,07,076,Cavillargues,772,32,804
91,Languedoc-Roussillon,30,1,03,077,Cendras,1946,61,2007
91,Languedoc-Roussillon,30,1,11,079,Chambon,276,4,280
91,Languedoc-Roussillon,30,1,11,080,Chamborigaud,782,20,802
91,Languedoc-Roussillon,30,2,07,081,Chusclan,991,30,1021
91,Languedoc-Roussillon,30,2,30,082,Clarensac,3628,68,3696
91,Languedoc-Roussillon,30,2,46,083,Codognan,2488,32,2520
91,Languedoc-Roussillon,30,2,07,084,Codolet,691,9,700
91,Languedoc-Roussillon,30,2,22,085,Collias,992,24,1016
91,Languedoc-Roussillon,30,2,26,086,Collorgues,528,7,535
91,Languedoc-Roussillon,30,3,13,087,Colognac,205,7,212
91,Languedoc-Roussillon,30,2,30,088,Combas,546,15,561
91,Languedoc-Roussillon,30,2,06,089,Comps,1609,27,1636
91,Languedoc-Roussillon,30,1,11,090,Concoules,260,1,261
91,Languedoc-Roussillon,30,2,32,091,Congénies,1542,34,1576
91,Languedoc-Roussillon,30,2,07,092,Connaux,1603,39,1642
91,Languedoc-Roussillon,30,3,28,093,Conqueyrac,104,2,106
91,Languedoc-Roussillon,30,1,29,094,Corbès,152,2,154
91,Languedoc-Roussillon,30,3,21,095,Corconne,562,7,569
91,Languedoc-Roussillon,30,2,20,096,Cornillon,869,18,887
91,Languedoc-Roussillon,30,1,24,097,Courry,313,5,318
91,Languedoc-Roussillon,30,2,30,098,Crespian,310,2,312
91,Languedoc-Roussillon,30,3,28,099,Cros,252,14,266
91,Languedoc-Roussillon,30,1,38,100,Cruviers-Lascours,608,8,616
91,Languedoc-Roussillon,30,1,38,101,Deaux,577,6,583
91,Languedoc-Roussillon,30,2,26,102,Dions,557,9,566
91,Languedoc-Roussillon,30,2,06,103,Domazan,880,25,905
91,Languedoc-Roussillon,30,1,14,104,Domessargues,680,10,690
91,Languedoc-Roussillon,30,3,34,105,Dourbies,186,8,194
91,Languedoc-Roussillon,30,3,31,106,Durfort-et-Saint-Martin-de-Sossenac,676,18,694
91,Languedoc-Roussillon,30,2,06,107,Estézargues,448,11,459
91,Languedoc-Roussillon,30,3,25,108,L' Estréchure,169,6,175
91,Languedoc-Roussillon,30,1,38,109,Euzet,386,9,395
91,Languedoc-Roussillon,30,2,35,110,Flaux,325,14,339
91,Languedoc-Roussillon,30,2,26,111,Foissac,348,9,357
91,Languedoc-Roussillon,30,2,30,112,Fons,1102,14,1116
91,Languedoc-Roussillon,30,2,15,113,Fons-sur-Lussan,231,6,237
91,Languedoc-Roussillon,30,2,32,114,Fontanès,616,19,635
91,Languedoc-Roussillon,30,2,15,115,Fontarèches,226,3,229
91,Languedoc-Roussillon,30,2,22,116,Fournès,891,10,901
91,Languedoc-Roussillon,30,2,09,117,Fourques,2888,69,2957
91,Languedoc-Roussillon,30,3,31,119,Fressac,112,5,117
91,Languedoc-Roussillon,30,1,10,120,Gagnières,1080,11,1091
91,Languedoc-Roussillon,30,3,21,121,Gailhan,188,6,194
91,Languedoc-Roussillon,30,2,30,122,Gajan,691,12,703
91,Languedoc-Roussillon,30,2,46,123,Gallargues-le-Montueux,3199,69,3268
91,Languedoc-Roussillon,30,2,20,124,Le Garn,223,6,229
91,Languedoc-Roussillon,30,2,45,125,Garons,4373,54,4427
91,Languedoc-Roussillon,30,2,26,126,Garrigues-Sainte-Eulalie,728,9,737
91,Languedoc-Roussillon,30,2,07,127,Gaujac,939,23,962
91,Languedoc-Roussillon,30,2,27,128,Générac,3805,47,3852
91,Languedoc-Roussillon,30,1,05,129,Générargues,697,19,716
91,Languedoc-Roussillon,30,1,11,130,Génolhac,902,27,929
91,Languedoc-Roussillon,30,2,20,131,Goudargues,1021,26,1047
91,Languedoc-Roussillon,30,1,12,132,La Grand-Combe,5187,154,5341
91,Languedoc-Roussillon,30,2,01,133,Le Grau-du-Roi,8110,103,8213
91,Languedoc-Roussillon,30,2,20,134,Issirac,221,7,228
91,Languedoc-Roussillon,30,2,09,135,Jonquières-Saint-Vincent,3042,31,3073
91,Languedoc-Roussillon,30,2,32,136,Junas,1038,20,1058
91,Languedoc-Roussillon,30,1,12,137,Lamelouze,89,2,91
91,Languedoc-Roussillon,30,2,32,138,Langlade,1993,46,2039
91,Languedoc-Roussillon,30,3,34,139,Lanuéjols,325,7,332
91,Languedoc-Roussillon,30,3,13,140,Lasalle,1063,33,1096
91,Languedoc-Roussillon,30,2,23,141,Laudun-l'Ardoise,5516,115,5631
91,Languedoc-Roussillon,30,1,12,142,Laval-Pradel,1142,21,1163
91,Languedoc-Roussillon,30,2,20,143,Laval-Saint-Roman,230,6,236
91,Languedoc-Roussillon,30,2,32,144,Lecques,371,2,373
91,Languedoc-Roussillon,30,2,16,145,Lédenon,1380,22,1402
91,Languedoc-Roussillon,30,1,14,146,Lédignan,1313,21,1334
91,Languedoc-Roussillon,30,1,14,147,Lézan,1295,22,1317
91,Languedoc-Roussillon,30,3,21,148,Liouc,207,3,210
91,Languedoc-Roussillon,30,2,23,149,Lirac,838,28,866
91,Languedoc-Roussillon,30,3,31,150,Logrian-Florian,263,6,269
91,Languedoc-Roussillon,30,2,15,151,Lussan,465,10,475
91,Languedoc-Roussillon,30,1,24,152,Les Mages,1799,33,1832
91,Languedoc-Roussillon,30,1,11,153,Malons-et-Elze,96,1,97
91,Languedoc-Roussillon,30,3,39,154,Mandagout,367,15,382
91,Languedoc-Roussillon,30,2,16,155,Manduel,5721,82,5803
91,Languedoc-Roussillon,30,2,16,156,Marguerittes,8671,227,8898
91,Languedoc-Roussillon,30,3,39,157,Mars,175,9,184
91,Languedoc-Roussillon,30,1,38,158,Martignargues,383,10,393
91,Languedoc-Roussillon,30,1,24,159,Le Martinet,788,5,793
91,Languedoc-Roussillon,30,1,14,160,Maruéjols-lès-Gardon,206,2,208
91,Languedoc-Roussillon,30,1,14,161,Massanes,178,2,180
91,Languedoc-Roussillon,30,1,05,162,Massillargues-Attuech,685,25,710
91,Languedoc-Roussillon,30,1,14,163,Mauressargues,148,3,151
91,Languedoc-Roussillon,30,1,08,164,Méjannes-le-Clap,448,5,453
91,Languedoc-Roussillon,30,1,41,165,Méjannes-lès-Alès,1057,36,1093
91,Languedoc-Roussillon,30,2,06,166,Meynes,2244,100,2344
91,Languedoc-Roussillon,30,1,24,167,Meyrannes,858,23,881
91,Languedoc-Roussillon,30,1,29,168,Mialet,563,11,574
91,Languedoc-Roussillon,30,2,45,169,Milhaud,5611,150,5761
91,Languedoc-Roussillon,30,3,39,170,Molières-Cavaillac,925,41,966
91,Languedoc-Roussillon,30,1,24,171,Molières-sur-Cèze,1587,26,1613
91,Languedoc-Roussillon,30,3,13,172,Monoblet,609,52,661
91,Languedoc-Roussillon,30,1,41,173,Mons,1451,50,1501
91,Languedoc-Roussillon,30,2,30,354,Montagnac,151,7,158
91,Languedoc-Roussillon,30,2,35,174,Montaren-et-Saint-Médiers,1403,31,1434
91,Languedoc-Roussillon,30,2,20,175,Montclus,151,10,161
91,Languedoc-Roussillon,30,3,39,176,Montdardier,193,8,201
91,Languedoc-Roussillon,30,1,38,177,Monteils,595,24,619
91,Languedoc-Roussillon,30,2,23,178,Montfaucon,1364,26,1390
91,Languedoc-Roussillon,30,2,06,179,Montfrin,2980,46,3026
91,Languedoc-Roussillon,30,2,26,180,Montignargues,598,8,606
91,Languedoc-Roussillon,30,2,30,181,Montmirat,289,4,293
91,Languedoc-Roussillon,30,2,30,182,Montpezat,1065,17,1082
91,Languedoc-Roussillon,30,2,30,183,Moulézan,460,13,473
91,Languedoc-Roussillon,30,2,26,184,Moussac,1183,8,1191
91,Languedoc-Roussillon,30,2,46,185,Mus,1281,24,1305
91,Languedoc-Roussillon,30,2,32,186,Nages-et-Solorgues,1510,37,1547
91,Languedoc-Roussillon,30,1,24,187,Navacelles,285,8,293
91,Languedoc-Roussillon,30,1,38,188,Ners,672,17,689
91,Languedoc-Roussillon,30,2,99,189,Nîmes,140267,2932,143199
91,Languedoc-Roussillon,30,3,36,190,Notre-Dame-de-la-Rouvière,418,14,432
91,Languedoc-Roussillon,30,2,07,191,Orsan,1107,28,1135
91,Languedoc-Roussillon,30,3,21,192,Orthoux-Sérignac-Quilhan,390,7,397
91,Languedoc-Roussillon,30,2,30,193,Parignargues,585,8,593
91,Languedoc-Roussillon,30,1,10,194,Peyremale,272,10,282
91,Languedoc-Roussillon,30,3,25,195,Peyrolles,40,1,41
91,Languedoc-Roussillon,30,2,07,196,Le Pin,333,9,342
91,Languedoc-Roussillon,30,1,41,197,Les Plans,209,2,211
91,Languedoc-Roussillon,30,3,25,198,Les Plantiers,260,11,271
91,Languedoc-Roussillon,30,3,39,199,Pommiers,65,1,66
91,Languedoc-Roussillon,30,3,28,200,Pompignan,799,17,816
91,Languedoc-Roussillon,30,2,20,202,Pont-Saint-Esprit,10046,311,10357
91,Languedoc-Roussillon,30,1,11,201,Ponteils-et-Brésis,327,10,337
91,Languedoc-Roussillon,30,1,11,203,Portes,362,7,369
91,Languedoc-Roussillon,30,1,24,204,Potelières,336,4,340
91,Languedoc-Roussillon,30,2,15,205,Pougnadoresse,190,9,199
91,Languedoc-Roussillon,30,2,16,206,Poulx,4068,100,4168
91,Languedoc-Roussillon,30,2,22,207,Pouzilhac,612,4,616
91,Languedoc-Roussillon,30,3,31,208,Puechredon,37,1,38
91,Languedoc-Roussillon,30,2,40,209,Pujaut,3930,90,4020
91,Languedoc-Roussillon,30,3,21,210,Quissac,2649,44,2693
91,Languedoc-Roussillon,30,2,16,211,Redessan,3403,47,3450
91,Languedoc-Roussillon,30,2,22,212,Remoulins,2381,22,2403
91,Languedoc-Roussillon,30,3,34,213,Revens,29,0,29
91,Languedoc-Roussillon,30,1,05,214,Ribaute-les-Tavernes,1682,31,1713
91,Languedoc-Roussillon,30,1,08,215,Rivières,324,11,335
91,Languedoc-Roussillon,30,1,10,216,Robiac-Rochessadoule,830,15,845
91,Languedoc-Roussillon,30,2,40,217,Rochefort-du-Gard,6930,165,7095
91,Languedoc-Roussillon,30,1,08,218,Rochegude,209,3,212
91,Languedoc-Roussillon,30,2,45,356,Rodilhan,2528,213,2741
91,Languedoc-Roussillon,30,3,39,219,Rogues,109,1,110
91,Languedoc-Roussillon,30,2,07,222,La Roque-sur-Cèze,174,4,178
91,Languedoc-Roussillon,30,3,33,220,Roquedur,221,9,230
91,Languedoc-Roussillon,30,2,23,221,Roquemaure,5238,71,5309
91,Languedoc-Roussillon,30,1,02,223,Rousson,3540,64,3604
91,Languedoc-Roussillon,30,2,26,224,La Rouvière,614,5,619
91,Languedoc-Roussillon,30,2,07,225,Sabran,1737,20,1757
91,Languedoc-Roussillon,30,2,20,226,Saint-Alexandre,1068,46,1114
91,Languedoc-Roussillon,30,1,24,227,Saint-Ambroix,3429,80,3509
91,Languedoc-Roussillon,30,2,15,232,Saint-André-d'Olérargues,412,14,426
91,Languedoc-Roussillon,30,3,36,229,Saint-André-de-Majencoules,581,12,593
91,Languedoc-Roussillon,30,2,20,230,Saint-André-de-Roquepertuis,523,17,540
91,Languedoc-Roussillon,30,3,25,231,Saint-André-de-Valborgne,456,9,465
91,Languedoc-Roussillon,30,2,30,233,Saint-Bauzély,496,7,503
91,Languedoc-Roussillon,30,1,14,234,Saint-Bénézet,275,3,278
91,Languedoc-Roussillon,30,3,13,236,Saint-Bonnet-de-Salendrinque,90,3,93
91,Languedoc-Roussillon,30,2,06,235,Saint-Bonnet-du-Gard,712,12,724
91,Languedoc-Roussillon,30,1,24,237,Saint-Brès,642,12,654
91,Languedoc-Roussillon,30,3,33,238,Saint-Bresson,65,2,67
91,Languedoc-Roussillon,30,1,38,240,Saint-Césaire-de-Gauzignan,269,5,274
91,Languedoc-Roussillon,30,2,26,241,Saint-Chaptes,1550,27,1577
91,Languedoc-Roussillon,30,2,20,242,Saint-Christol-de-Rodières,162,4,166
91,Languedoc-Roussillon,30,1,03,243,Saint-Christol-lès-Alès,6544,196,6740
91,Languedoc-Roussillon,30,2,32,244,Saint-Clément,271,9,280
91,Languedoc-Roussillon,30,2,30,245,Saint-Côme-et-Maruéjols,753,21,774
91,Languedoc-Roussillon,30,1,24,247,Saint-Denis,239,4,243
91,Languedoc-Roussillon,30,2,26,248,Saint-Dézéry,362,9,371
91,Languedoc-Roussillon,30,2,32,249,Saint-Dionizy,871,21,892
91,Languedoc-Roussillon,30,1,38,250,Saint-Étienne-de-l'Olm,345,10,355
91,Languedoc-Roussillon,30,2,07,251,Saint-Étienne-des-Sorts,505,9,514
91,Languedoc-Roussillon,30,3,13,252,Saint-Félix-de-Pallières,228,6,234
91,Languedoc-Roussillon,30,1,24,253,Saint-Florent-sur-Auzonnet,1137,23,1160
91,Languedoc-Roussillon,30,2,23,254,Saint-Geniès-de-Comolas,1841,37,1878
91,Languedoc-Roussillon,30,2,26,255,Saint-Geniès-de-Malgoirès,2608,33,2641
91,Languedoc-Roussillon,30,2,07,256,Saint-Gervais,673,18,691
91,Languedoc-Roussillon,30,2,16,257,Saint-Gervasy,1669,25,1694
91,Languedoc-Roussillon,30,2,27,258,Saint-Gilles,13507,189,13696
91,Languedoc-Roussillon,30,2,22,260,Saint-Hilaire-d'Ozilhan,684,11,695
91,Languedoc-Roussillon,30,1,41,259,Saint-Hilaire-de-Brethmas,4139,125,4264
91,Languedoc-Roussillon,30,1,38,261,Saint-Hippolyte-de-Caton,205,2,207
91,Languedoc-Roussillon,30,2,35,262,Saint-Hippolyte-de-Montaigu,238,3,241
91,Languedoc-Roussillon,30,3,28,263,Saint-Hippolyte-du-Fort,3776,78,3854
91,Languedoc-Roussillon,30,1,38,264,Saint-Jean-de-Ceyrargues,163,4,167
91,Languedoc-Roussillon,30,3,31,265,Saint-Jean-de-Crieulon,212,10,222
91,Languedoc-Roussillon,30,1,08,266,Saint-Jean-de-Maruéjols-et-Avéjan,894,12,906
91,Languedoc-Roussillon,30,1,14,267,Saint-Jean-de-Serres,518,11,529
91,Languedoc-Roussillon,30,1,24,268,Saint-Jean-de-Valériscle,728,17,745
91,Languedoc-Roussillon,30,1,29,269,Saint-Jean-du-Gard,2671,169,2840
91,Languedoc-Roussillon,30,1,03,270,Saint-Jean-du-Pin,1294,23,1317
91,Languedoc-Roussillon,30,1,24,271,Saint-Julien-de-Cassagnas,616,12,628
91,Languedoc-Roussillon,30,3,33,272,Saint-Julien-de-la-Nef,124,7,131
91,Languedoc-Roussillon,30,2,20,273,Saint-Julien-de-Peyrolas,1223,51,1274
91,Languedoc-Roussillon,30,1,02,274,Saint-Julien-les-Rosiers,2868,56,2924
91,Languedoc-Roussillon,30,1,38,275,Saint-Just-et-Vacquières,278,0,278
91,Languedoc-Roussillon,30,2,01,276,Saint-Laurent-d'Aigouze,3224,61,3285
91,Languedoc-Roussillon,30,2,20,277,Saint-Laurent-de-Carnols,463,13,476
91,Languedoc-Roussillon,30,2,23,278,Saint-Laurent-des-Arbres,2289,48,2337
91,Languedoc-Roussillon,30,2,15,279,Saint-Laurent-la-Vernède,701,14,715
91,Languedoc-Roussillon,30,3,33,280,Saint-Laurent-le-Minier,364,10,374
91,Languedoc-Roussillon,30,2,30,281,Saint-Mamert-du-Gard,1389,21,1410
91,Languedoc-Roussillon,30,2,15,282,Saint-Marcel-de-Careiret,693,18,711
91,Languedoc-Roussillon,30,3,33,283,Saint-Martial,194,1,195
91,Languedoc-Roussillon,30,1,02,284,Saint-Martin-de-Valgalgues,4134,98,4232
91,Languedoc-Roussillon,30,1,38,285,Saint-Maurice-de-Cazevieille,650,7,657
91,Languedoc-Roussillon,30,2,35,286,Saint-Maximin,645,20,665
91,Languedoc-Roussillon,30,2,07,287,Saint-Michel-d'Euzet,584,24,608
91,Languedoc-Roussillon,30,2,07,288,Saint-Nazaire,1159,41,1200
91,Languedoc-Roussillon,30,3,31,289,Saint-Nazaire-des-Gardies,76,1,77
91,Languedoc-Roussillon,30,1,03,291,Saint-Paul-la-Coste,269,5,274
91,Languedoc-Roussillon,30,2,07,355,Saint-Paul-les-Fonts,757,15,772
91,Languedoc-Roussillon,30,2,20,290,Saint-Paulet-de-Caisson,1781,54,1835
91,Languedoc-Roussillon,30,2,07,292,Saint-Pons-la-Calm,412,12,424
91,Languedoc-Roussillon,30,1,08,293,Saint-Privat-de-Champclos,305,3,308
91,Languedoc-Roussillon,30,1,41,294,Saint-Privat-des-Vieux,4372,137,4509
91,Languedoc-Roussillon,30,2,35,295,Saint-Quentin-la-Poterie,2914,80,2994
91,Languedoc-Roussillon,30,3,33,296,Saint-Roman-de-Codières,172,9,181
91,Languedoc-Roussillon,30,3,34,297,Saint-Sauveur-Camprieu,268,0,268
91,Languedoc-Roussillon,30,1,05,298,Saint-Sébastien-d'Aigrefeuille,505,26,531
91,Languedoc-Roussillon,30,2,35,299,Saint-Siffret,971,20,991
91,Languedoc-Roussillon,30,3,21,300,Saint-Théodorit,425,6,431
91,Languedoc-Roussillon,30,1,24,303,Saint-Victor-de-Malcap,659,14,673
91,Languedoc-Roussillon,30,2,35,301,Saint-Victor-des-Oules,258,3,261
91,Languedoc-Roussillon,30,2,23,302,Saint-Victor-la-Coste,1845,48,1893
91,Languedoc-Roussillon,30,2,26,228,Sainte-Anastasie,1617,29,1646
91,Languedoc-Roussillon,30,1,12,239,Sainte-Cécile-d'Andorge,559,4,563
91,Languedoc-Roussillon,30,3,13,246,Sainte-Croix-de-Caderle,118,6,124
91,Languedoc-Roussillon,30,2,20,304,Salazac,187,0,187
91,Languedoc-Roussillon,30,1,41,305,Salindres,3068,61,3129
91,Languedoc-Roussillon,30,2,32,306,Salinelles,484,6,490
91,Languedoc-Roussillon,30,1,12,307,Les Salles-du-Gardon,2554,42,2596
91,Languedoc-Roussillon,30,2,35,308,Sanilhac-Sagriès,834,49,883
91,Languedoc-Roussillon,30,3,21,309,Sardan,262,2,264
91,Languedoc-Roussillon,30,3,25,310,Saumane,249,2,251
91,Languedoc-Roussillon,30,3,31,311,Sauve,1879,41,1920
91,Languedoc-Roussillon,30,2,23,312,Sauveterre,1853,35,1888
91,Languedoc-Roussillon,30,2,26,313,Sauzet,708,5,713
91,Languedoc-Roussillon,30,3,31,314,Savignargues,204,3,207
91,Languedoc-Roussillon,30,2,40,315,Saze,1785,34,1819
91,Languedoc-Roussillon,30,1,11,316,Sénéchas,225,17,242
91,Languedoc-Roussillon,30,2,06,317,Sernhac,1513,10,1523
91,Languedoc-Roussillon,30,1,41,318,Servas,197,5,202
91,Languedoc-Roussillon,30,2,35,319,Serviers-et-Labaume,497,7,504
91,Languedoc-Roussillon,30,1,38,320,Seynes,138,5,143
91,Languedoc-Roussillon,30,2,32,321,Sommières,4510,48,4558
91,Languedoc-Roussillon,30,3,13,322,Soudorgues,275,9,284
91,Languedoc-Roussillon,30,1,03,323,Soustelle,150,2,152
91,Languedoc-Roussillon,30,2,32,324,Souvignargues,717,12,729
91,Languedoc-Roussillon,30,3,33,325,Sumène,1555,64,1619
91,Languedoc-Roussillon,30,2,23,326,Tavel,1702,30,1732
91,Languedoc-Roussillon,30,1,08,327,Tharaux,66,5,71
91,Languedoc-Roussillon,30,2,06,328,Théziers,1016,10,1026
91,Languedoc-Roussillon,30,3,13,329,Thoiras,412,7,419
91,Languedoc-Roussillon,30,1,05,330,Tornac,880,17,897
91,Languedoc-Roussillon,30,2,07,331,Tresques,1806,54,1860
91,Languedoc-Roussillon,30,3,34,332,Trèves,106,3,109
91,Languedoc-Roussillon,30,2,46,333,Uchaud,3946,62,4008
91,Languedoc-Roussillon,30,2,35,334,Uzès,8213,389,8602
91,Languedoc-Roussillon,30,3,13,335,Vabres,100,3,103
91,Languedoc-Roussillon,30,2,09,336,Vallabrègues,1298,24,1322
91,Languedoc-Roussillon,30,2,35,337,Vallabrix,370,10,380
91,Languedoc-Roussillon,30,2,15,338,Vallérargues,133,1,134
91,Languedoc-Roussillon,30,3,36,339,Valleraugue,1073,20,1093
91,Languedoc-Roussillon,30,2,22,340,Valliguières,483,6,489
91,Languedoc-Roussillon,30,2,37,341,Vauvert,11247,157,11404
91,Languedoc-Roussillon,30,2,07,342,Vénéjan,1173,48,1221
91,Languedoc-Roussillon,30,2,15,343,Verfeuil,537,10,547
91,Languedoc-Roussillon,30,2,46,344,Vergèze,4033,78,4111
91,Languedoc-Roussillon,30,1,11,345,La Vernarède,360,7,367
91,Languedoc-Roussillon,30,2,22,346,Vers-Pont-du-Gard,1653,49,1702
91,Languedoc-Roussillon,30,2,46,347,Vestric-et-Candiac,1331,19,1350
91,Languedoc-Roussillon,30,1,38,348,Vézénobres,1694,87,1781
91,Languedoc-Roussillon,30,3,21,349,Vic-le-Fesq,372,9,381
91,Languedoc-Roussillon,30,3,39,350,Le Vigan,3964,168,4132
91,Languedoc-Roussillon,30,2,40,351,Villeneuve-lès-Avignon,12756,464,13220
91,Languedoc-Roussillon,30,2,32,352,Villevieille,1618,42,1660
91,Languedoc-Roussillon,30,3,04,353,Vissec,51,0,51
73,Midi-Pyrénées,31,2,16,001,Agassac,121,2,123
73,Midi-Pyrénées,31,1,12,002,Aignes,233,9,242
73,Midi-Pyrénées,31,3,17,003,Aigrefeuille,898,28,926
73,Midi-Pyrénées,31,2,02,005,Alan,306,5,311
73,Midi-Pyrénées,31,3,08,006,Albiac,195,3,198
73,Midi-Pyrénées,31,2,16,007,Ambax,69,0,69
73,Midi-Pyrénées,31,2,16,008,Anan,221,5,226
73,Midi-Pyrénées,31,2,05,009,Antichan-de-Frontignes,81,5,86
73,Midi-Pyrénées,31,2,04,010,Antignac,105,6,111
73,Midi-Pyrénées,31,2,01,011,Arbas,255,3,258
73,Midi-Pyrénées,31,2,01,012,Arbon,76,1,77
73,Midi-Pyrénées,31,2,05,013,Ardiège,413,5,418
73,Midi-Pyrénées,31,2,01,014,Arguenos,51,0,51
73,Midi-Pyrénées,31,2,28,015,Argut-Dessous,30,1,31
73,Midi-Pyrénées,31,2,28,017,Arlos,91,4,95
73,Midi-Pyrénées,31,2,31,018,Arnaud-Guilhem,199,2,201
73,Midi-Pyrénées,31,2,04,019,Artigue,36,2,38
73,Midi-Pyrénées,31,2,01,020,Aspet,948,96,1044
73,Midi-Pyrénées,31,2,29,021,Aspret-Sarrat,144,1,145
73,Midi-Pyrénées,31,3,49,022,Aucamville,7817,83,7900
73,Midi-Pyrénées,31,2,02,023,Aulon,351,2,353
73,Midi-Pyrénées,31,3,24,024,Auragne,402,7,409
73,Midi-Pyrénées,31,3,10,025,Aureville,703,17,720
73,Midi-Pyrénées,31,3,08,026,Auriac-sur-Vendinelle,997,30,1027
73,Midi-Pyrénées,31,1,03,027,Auribail,222,6,228
73,Midi-Pyrénées,31,2,02,028,Aurignac,1171,73,1244
73,Midi-Pyrénées,31,3,17,029,Aurin,284,6,290
73,Midi-Pyrénées,31,2,32,030,Ausseing,68,6,74
73,Midi-Pyrénées,31,2,22,031,Ausson,545,17,562
73,Midi-Pyrénées,31,3,15,032,Aussonne,5923,86,6009
73,Midi-Pyrénées,31,1,03,033,Auterive,8722,136,8858
73,Midi-Pyrénées,31,2,31,034,Auzas,181,2,183
73,Midi-Pyrénées,31,3,10,035,Auzeville-Tolosane,2865,259,3124
73,Midi-Pyrénées,31,3,10,036,Auzielle,1327,51,1378
73,Midi-Pyrénées,31,3,38,037,Avignonet-Lauragais,1262,26,1288
73,Midi-Pyrénées,31,3,21,004,Ayguesvives,2270,34,2304
73,Midi-Pyrénées,31,3,19,038,Azas,506,8,514
73,Midi-Pyrénées,31,2,02,039,Bachas,65,2,67
73,Midi-Pyrénées,31,2,28,040,Bachos,27,0,27
73,Midi-Pyrénées,31,2,05,041,Bagiry,80,4,84
73,Midi-Pyrénées,31,2,04,042,Bagnères-de-Luchon,2622,121,2743
73,Midi-Pyrénées,31,2,22,043,Balesta,174,5,179
73,Midi-Pyrénées,31,3,43,044,Balma,12951,252,13203
73,Midi-Pyrénées,31,2,05,045,Barbazan,448,16,464
73,Midi-Pyrénées,31,2,28,046,Baren,5,0,5
73,Midi-Pyrénées,31,1,27,047,Bax,83,6,89
73,Midi-Pyrénées,31,3,21,048,Baziège,3212,40,3252
73,Midi-Pyrénées,31,3,19,049,Bazus,584,9,593
73,Midi-Pyrénées,31,2,31,050,Beauchalot,507,21,528
73,Midi-Pyrénées,31,1,26,051,Beaufort,369,2,371
73,Midi-Pyrénées,31,1,03,052,Beaumont-sur-Lèze,1485,37,1522
73,Midi-Pyrénées,31,3,43,053,Beaupuy,1296,19,1315
73,Midi-Pyrénées,31,3,38,054,Beauteville,162,2,164
73,Midi-Pyrénées,31,3,08,055,Beauville,128,7,135
73,Midi-Pyrénées,31,3,51,056,Beauzelle,5096,79,5175
73,Midi-Pyrénées,31,3,21,057,Belberaud,1279,39,1318
73,Midi-Pyrénées,31,3,21,058,Belbèze-de-Lauragais,98,0,98
73,Midi-Pyrénées,31,2,32,059,Belbèze-en-Comminges,107,2,109
73,Midi-Pyrénées,31,3,25,060,Bélesta-en-Lauragais,112,2,114
73,Midi-Pyrénées,31,3,07,061,Bellegarde-Sainte-Marie,194,4,198
73,Midi-Pyrénées,31,3,07,062,Bellesserre,84,0,84
73,Midi-Pyrénées,31,2,02,063,Benque,157,1,158
73,Midi-Pyrénées,31,2,04,064,Benque-Dessous-et-Dessus,19,1,20
73,Midi-Pyrénées,31,1,26,065,Bérat,2618,44,2662
73,Midi-Pyrénées,31,3,19,066,Bessières,3120,38,3158
73,Midi-Pyrénées,31,2,28,067,Bezins-Garraux,55,0,55
73,Midi-Pyrénées,31,2,04,068,Billière,23,2,25
73,Midi-Pyrénées,31,2,28,590,Binos,31,1,32
73,Midi-Pyrénées,31,3,51,069,Blagnac,21556,405,21961
73,Midi-Pyrénées,31,2,06,070,Blajan,513,3,516
73,Midi-Pyrénées,31,1,09,071,Bois-de-la-Pierre,421,0,421
73,Midi-Pyrénées,31,2,16,072,Boissède,83,1,84
73,Midi-Pyrénées,31,3,39,073,Bondigoux,438,6,444
73,Midi-Pyrénées,31,3,37,074,Bonrepos-Riquet,234,9,243
73,Midi-Pyrénées,31,1,30,075,Bonrepos-sur-Aussonnelle,814,13,827
73,Midi-Pyrénées,31,2,22,076,Bordes-de-Rivière,460,12,472
73,Midi-Pyrénées,31,3,39,077,Le Born,385,9,394
73,Midi-Pyrénées,31,2,22,078,Boudrac,121,1,122
73,Midi-Pyrénées,31,3,14,079,Bouloc,3974,52,4026
73,Midi-Pyrénées,31,2,06,080,Boulogne-sur-Gesse,1629,75,1704
73,Midi-Pyrénées,31,2,04,081,Bourg-d'Oueil,11,0,11
73,Midi-Pyrénées,31,3,17,082,Bourg-Saint-Bernard,841,14,855
73,Midi-Pyrénées,31,2,02,083,Boussan,206,8,214
73,Midi-Pyrénées,31,1,11,084,Boussens,1052,23,1075
73,Midi-Pyrénées,31,2,28,085,Boutx,270,9,279
73,Midi-Pyrénées,31,2,02,086,Bouzin,82,3,85
73,Midi-Pyrénées,31,1,30,087,Bragayrac,271,3,274
73,Midi-Pyrénées,31,3,18,088,Brax,2418,103,2521
73,Midi-Pyrénées,31,3,15,089,Bretx,527,10,537
73,Midi-Pyrénées,31,3,07,090,Brignemont,376,3,379
73,Midi-Pyrénées,31,3,14,091,Bruguières,4938,57,4995
73,Midi-Pyrénées,31,2,28,092,Burgalays,126,6,132
73,Midi-Pyrénées,31,3,15,093,Le Burgaud,617,6,623
73,Midi-Pyrénées,31,3,19,094,Buzet-sur-Tarn,2167,21,2188
73,Midi-Pyrénées,31,2,01,095,Cabanac-Cazaux,111,5,116
73,Midi-Pyrénées,31,3,07,096,Cabanac-Séguenville,158,1,159
73,Midi-Pyrénées,31,3,08,097,Le Cabanial,344,1,345
73,Midi-Pyrénées,31,3,07,098,Cadours,1045,7,1052
73,Midi-Pyrénées,31,3,24,099,Caignac,257,1,258
73,Midi-Pyrénées,31,3,24,100,Calmont,2051,20,2071
73,Midi-Pyrénées,31,1,30,101,Cambernard,428,7,435
73,Midi-Pyrénées,31,3,08,102,Cambiac,201,3,204
73,Midi-Pyrénées,31,1,20,103,Canens,59,0,59
73,Midi-Pyrénées,31,1,09,104,Capens,483,1,484
73,Midi-Pyrénées,31,3,08,105,Caragoudes,237,12,249
73,Midi-Pyrénées,31,3,08,106,Caraman,2366,26,2392
73,Midi-Pyrénées,31,1,09,107,Carbonne,4952,86,5038
73,Midi-Pyrénées,31,2,06,108,Cardeilhac,256,1,257
73,Midi-Pyrénées,31,2,02,109,Cassagnabère-Tournas,398,8,406
73,Midi-Pyrénées,31,2,32,110,Cassagne,638,12,650
73,Midi-Pyrénées,31,1,20,111,Castagnac,294,5,299
73,Midi-Pyrénées,31,2,32,112,Castagnède,177,4,181
73,Midi-Pyrénées,31,3,10,113,Castanet-Tolosan,10821,216,11037
73,Midi-Pyrénées,31,2,32,114,Castelbiague,227,4,231
73,Midi-Pyrénées,31,2,16,115,Castelgaillard,56,1,57
73,Midi-Pyrénées,31,3,49,116,Castelginest,8588,137,8725
73,Midi-Pyrénées,31,3,50,117,Castelmaurou,3400,96,3496
73,Midi-Pyrénées,31,3,14,118,Castelnau-d'Estrétefonds,5195,57,5252
73,Midi-Pyrénées,31,1,13,119,Castelnau-Picampeau,182,5,187
73,Midi-Pyrénées,31,3,07,120,Le Castéra,746,8,754
73,Midi-Pyrénées,31,2,06,121,Castéra-Vignoles,62,1,63
73,Midi-Pyrénées,31,1,13,122,Casties-Labrande,96,0,96
73,Midi-Pyrénées,31,2,04,123,Castillon-de-Larboust,65,1,66
73,Midi-Pyrénées,31,2,31,124,Castillon-de-Saint-Martory,316,6,322
73,Midi-Pyrénées,31,2,04,125,Cathervielle,35,1,36
73,Midi-Pyrénées,31,3,07,126,Caubiac,241,2,243
73,Midi-Pyrénées,31,2,04,127,Caubous,6,1,7
73,Midi-Pyrénées,31,1,12,128,Caujac,602,6,608
73,Midi-Pyrénées,31,2,16,593,Cazac,81,2,83
73,Midi-Pyrénées,31,2,04,129,Cazaril-Laspènes,22,0,22
73,Midi-Pyrénées,31,2,22,130,Cazaril-Tambourès,79,1,80
73,Midi-Pyrénées,31,2,01,131,Cazaunous,65,1,66
73,Midi-Pyrénées,31,2,28,132,Cazaux-Layrisse,69,1,70
73,Midi-Pyrénées,31,2,04,133,Cazeaux-de-Larboust,92,1,93
73,Midi-Pyrénées,31,2,02,134,Cazeneuve-Montaut,60,3,63
73,Midi-Pyrénées,31,1,11,135,Cazères,4302,107,4409
73,Midi-Pyrénées,31,3,14,136,Cépet,1499,13,1512
73,Midi-Pyrénées,31,3,38,137,Cessales,132,7,139
73,Midi-Pyrénées,31,2,06,138,Charlas,217,5,222
73,Midi-Pyrénées,31,2,28,139,Chaum,209,2,211
73,Midi-Pyrénées,31,2,01,140,Chein-Dessus,196,1,197
73,Midi-Pyrénées,31,2,06,141,Ciadoux,250,2,252
73,Midi-Pyrénées,31,2,04,142,Cier-de-Luchon,243,6,249
73,Midi-Pyrénées,31,2,05,143,Cier-de-Rivière,252,7,259
73,Midi-Pyrénées,31,2,28,144,Cierp-Gaud,917,25,942
73,Midi-Pyrénées,31,1,12,145,Cintegabelle,2577,54,2631
73,Midi-Pyrénées,31,2,04,146,Cirès,12,0,12
73,Midi-Pyrénées,31,2,22,147,Clarac,563,21,584
73,Midi-Pyrénées,31,3,10,148,Clermont-le-Fort,517,16,533
73,Midi-Pyrénées,31,3,48,149,Colomiers,33200,294,33494
73,Midi-Pyrénées,31,3,51,150,Cornebarrieu,5635,53,5688
73,Midi-Pyrénées,31,3,21,151,Corronsac,665,20,685
73,Midi-Pyrénées,31,2,16,152,Coueilles,87,3,90
73,Midi-Pyrénées,31,1,11,153,Couladère,436,6,442
73,Midi-Pyrénées,31,2,01,155,Couret,193,3,196
73,Midi-Pyrénées,31,3,07,156,Cox,329,2,331
73,Midi-Pyrénées,31,3,53,157,Cugnaux,15922,206,16128
73,Midi-Pyrénées,31,2,22,158,Cuguron,186,9,195
73,Midi-Pyrénées,31,2,22,159,Le Cuing,403,3,406
73,Midi-Pyrénées,31,3,15,160,Daux,1734,12,1746
73,Midi-Pyrénées,31,3,21,161,Deyme,871,33,904
73,Midi-Pyrénées,31,3,21,162,Donneville,1039,79,1118
73,Midi-Pyrénées,31,3,43,163,Drémil-Lafage,2584,54,2638
73,Midi-Pyrénées,31,3,07,164,Drudas,182,7,189
73,Midi-Pyrénées,31,1,52,165,Eaunes,4345,88,4433
73,Midi-Pyrénées,31,1,30,166,Empeaux,213,5,218
73,Midi-Pyrénées,31,2,01,167,Encausse-les-Thermes,644,10,654
73,Midi-Pyrénées,31,2,02,168,Eoux,115,2,117
73,Midi-Pyrénées,31,3,21,169,Escalquens,5665,170,5835
73,Midi-Pyrénées,31,2,06,170,Escanecrabe,245,10,255
73,Midi-Pyrénées,31,2,32,591,Escoulis,76,0,76
73,Midi-Pyrénées,31,3,21,171,Espanès,267,9,276
73,Midi-Pyrénées,31,2,02,172,Esparron,51,0,51
73,Midi-Pyrénées,31,1,12,173,Esperce,239,9,248
73,Midi-Pyrénées,31,2,01,174,Estadens,498,5,503
73,Midi-Pyrénées,31,2,29,175,Estancarbon,549,26,575
73,Midi-Pyrénées,31,2,28,176,Esténos,180,3,183
73,Midi-Pyrénées,31,2,28,177,Eup,137,9,146
73,Midi-Pyrénées,31,2,16,178,Fabas,209,8,217
73,Midi-Pyrénées,31,3,08,179,Le Faget,350,6,356
73,Midi-Pyrénées,31,3,25,180,Falga,100,5,105
73,Midi-Pyrénées,31,1,23,181,Le Fauga,1684,30,1714
73,Midi-Pyrénées,31,3,49,182,Fenouillet,5100,44,5144
73,Midi-Pyrénées,31,2,32,183,Figarol,278,8,286
73,Midi-Pyrénées,31,3,43,184,Flourens,1766,29,1795
73,Midi-Pyrénées,31,3,38,185,Folcarde,121,1,122
73,Midi-Pyrénées,31,3,49,186,Fonbeauzard,2812,37,2849
73,Midi-Pyrénées,31,1,30,187,Fonsorbes,11199,174,11373
73,Midi-Pyrénées,31,1,30,188,Fontenilles,3888,91,3979
73,Midi-Pyrénées,31,1,26,189,Forgues,182,3,185
73,Midi-Pyrénées,31,2,28,190,Fos,250,17,267
73,Midi-Pyrénées,31,2,01,191,Fougaron,90,0,90
73,Midi-Pyrénées,31,3,21,192,Fourquevaux,771,23,794
73,Midi-Pyrénées,31,1,13,193,Le Fousseret,1611,36,1647
73,Midi-Pyrénées,31,3,08,194,Francarville,170,0,170
73,Midi-Pyrénées,31,2,32,195,Francazal,22,3,25
73,Midi-Pyrénées,31,1,11,196,Francon,200,5,205
73,Midi-Pyrénées,31,2,22,197,Franquevielle,353,4,357
73,Midi-Pyrénées,31,2,31,198,Le Fréchet,117,1,118
73,Midi-Pyrénées,31,2,28,199,Fronsac,207,8,215
73,Midi-Pyrénées,31,2,05,200,Frontignan-de-Comminges,66,3,69
73,Midi-Pyrénées,31,2,16,201,Frontignan-Savès,57,3,60
73,Midi-Pyrénées,31,3,14,202,Fronton,5384,71,5455
73,Midi-Pyrénées,31,1,23,203,Frouzins,7265,124,7389
73,Midi-Pyrénées,31,1,13,204,Fustignac,74,1,75
73,Midi-Pyrénées,31,3,49,205,Gagnac-sur-Garonne,2930,29,2959
73,Midi-Pyrénées,31,1,12,206,Gaillac-Toulza,1175,21,1196
73,Midi-Pyrénées,31,2,05,207,Galié,86,1,87
73,Midi-Pyrénées,31,2,01,208,Ganties,296,9,305
73,Midi-Pyrénées,31,3,07,209,Garac,166,1,167
73,Midi-Pyrénées,31,3,38,210,Gardouch,1349,26,1375
73,Midi-Pyrénées,31,3,14,211,Gargas,605,9,614
73,Midi-Pyrénées,31,3,19,212,Garidech,1554,8,1562
73,Midi-Pyrénées,31,2,04,213,Garin,135,4,139
73,Midi-Pyrénées,31,3,37,215,Gauré,494,7,501
73,Midi-Pyrénées,31,3,19,216,Gémil,270,0,270
73,Midi-Pyrénées,31,2,05,217,Génos,94,2,96
73,Midi-Pyrénées,31,2,06,218,Gensac-de-Boulogne,107,4,111
73,Midi-Pyrénées,31,1,27,219,Gensac-sur-Garonne,323,8,331
73,Midi-Pyrénées,31,3,24,220,Gibel,280,0,280
73,Midi-Pyrénées,31,2,04,221,Gouaux-de-Larboust,46,0,46
73,Midi-Pyrénées,31,2,04,222,Gouaux-de-Luchon,45,1,46
73,Midi-Pyrénées,31,2,16,223,Goudex,41,0,41
73,Midi-Pyrénées,31,2,05,224,Gourdan-Polignan,1344,237,1581
73,Midi-Pyrénées,31,1,27,225,Goutevernisse,151,2,153
73,Midi-Pyrénées,31,1,20,226,Gouzens,96,5,101
73,Midi-Pyrénées,31,3,10,227,Goyrans,877,34,911
73,Midi-Pyrénées,31,3,37,228,Gragnague,1588,26,1614
73,Midi-Pyrénées,31,1,13,229,Gratens,669,15,684
73,Midi-Pyrénées,31,3,14,230,Gratentour,3626,56,3682
73,Midi-Pyrénées,31,1,12,231,Grazac,496,9,505
73,Midi-Pyrénées,31,3,15,232,Grenade,7431,91,7522
73,Midi-Pyrénées,31,1,03,233,Grépiac,977,18,995
73,Midi-Pyrénées,31,3,07,234,Le Grès,278,5,283
73,Midi-Pyrénées,31,2,28,235,Guran,56,0,56
73,Midi-Pyrénées,31,2,01,236,Herran,73,0,73
73,Midi-Pyrénées,31,2,32,237,His,224,22,246
73,Midi-Pyrénées,31,2,05,238,Huos,466,13,479
73,Midi-Pyrénées,31,2,16,239,L' Isle-en-Dodon,2084,26,2110
73,Midi-Pyrénées,31,3,21,240,Issus,392,2,394
73,Midi-Pyrénées,31,2,01,241,Izaut-de-l'Hôtel,309,10,319
73,Midi-Pyrénées,31,2,04,242,Jurvielle,20,0,20
73,Midi-Pyrénées,31,3,25,243,Juzes,88,2,90
73,Midi-Pyrénées,31,2,01,245,Juzet-d'Izaut,202,4,206
73,Midi-Pyrénées,31,2,04,244,Juzet-de-Luchon,389,11,400
73,Midi-Pyrénées,31,2,29,246,Labarthe-Inard,846,18,864
73,Midi-Pyrénées,31,2,29,247,Labarthe-Rivière,1324,35,1359
73,Midi-Pyrénées,31,1,52,248,Labarthe-sur-Lèze,4703,77,4780
73,Midi-Pyrénées,31,3,21,249,Labastide-Beauvoir,1042,12,1054
73,Midi-Pyrénées,31,1,26,250,Labastide-Clermont,647,14,661
73,Midi-Pyrénées,31,2,16,251,Labastide-Paumès,132,1,133
73,Midi-Pyrénées,31,3,14,252,Labastide-Saint-Sernin,1756,15,1771
73,Midi-Pyrénées,31,1,23,253,Labastidette,2051,22,2073
73,Midi-Pyrénées,31,3,10,254,Labège,3525,102,3627
73,Midi-Pyrénées,31,2,05,255,Labroquère,301,32,333
73,Midi-Pyrénées,31,1,03,256,Labruyère-Dorsa,237,5,242
73,Midi-Pyrénées,31,1,27,258,Lacaugne,192,3,195
73,Midi-Pyrénées,31,3,10,259,Lacroix-Falgarde,1966,43,2009
73,Midi-Pyrénées,31,2,31,260,Laffite-Toupière,82,0,82
73,Midi-Pyrénées,31,1,13,261,Lafitte-Vigordane,1077,10,1087
73,Midi-Pyrénées,31,3,38,262,Lagarde,296,4,300
73,Midi-Pyrénées,31,1,52,263,Lagardelle-sur-Lèze,2446,37,2483
73,Midi-Pyrénées,31,1,03,264,Lagrâce-Dieu,409,5,414
73,Midi-Pyrénées,31,3,07,265,Lagraulet-Saint-Nicolas,220,3,223
73,Midi-Pyrénées,31,1,26,266,Lahage,233,7,240
73,Midi-Pyrénées,31,1,20,267,Lahitère,54,1,55
73,Midi-Pyrénées,31,2,29,268,Lalouret-Laffiteau,126,5,131
73,Midi-Pyrénées,31,1,30,269,Lamasquère,1237,18,1255
73,Midi-Pyrénées,31,2,29,270,Landorthe,937,28,965
73,Midi-Pyrénées,31,3,17,271,Lanta,1542,26,1568
73,Midi-Pyrénées,31,1,20,272,Lapeyrère,78,2,80
73,Midi-Pyrénées,31,3,19,273,Lapeyrouse-Fossat,2599,59,2658
73,Midi-Pyrénées,31,2,29,274,Larcan,177,9,186
73,Midi-Pyrénées,31,3,07,275,Laréole,137,1,138
73,Midi-Pyrénées,31,3,15,592,Larra,1367,25,1392
73,Midi-Pyrénées,31,2,06,276,Larroque,309,4,313
73,Midi-Pyrénées,31,3,18,277,Lasserre,892,9,901
73,Midi-Pyrénées,31,2,02,278,Latoue,308,2,310
73,Midi-Pyrénées,31,1,20,279,Latour,80,1,81
73,Midi-Pyrénées,31,1,27,280,Latrape,346,2,348
73,Midi-Pyrénées,31,3,15,281,Launac,1210,14,1224
73,Midi-Pyrénées,31,3,49,282,Launaguet,6953,87,7040
73,Midi-Pyrénées,31,1,26,283,Lautignac,276,7,283
73,Midi-Pyrénées,31,3,17,284,Lauzerville,1180,21,1201
73,Midi-Pyrénées,31,3,37,285,Lavalette,624,17,641
73,Midi-Pyrénées,31,1,27,286,Lavelanet-de-Comminges,545,17,562
73,Midi-Pyrénées,31,1,23,287,Lavernose-Lacasse,2602,43,2645
73,Midi-Pyrénées,31,3,39,288,Layrac-sur-Tarn,322,6,328
73,Midi-Pyrénées,31,2,22,289,Lécussan,294,2,296
73,Midi-Pyrénées,31,2,28,290,Lège,42,1,43
73,Midi-Pyrénées,31,3,18,291,Léguevin,7853,191,8044
73,Midi-Pyrénées,31,1,11,292,Lescuns,54,0,54
73,Midi-Pyrénées,31,3,14,293,Lespinasse,2446,18,2464
73,Midi-Pyrénées,31,2,29,294,Lespiteau,82,3,85
73,Midi-Pyrénées,31,2,06,295,Lespugue,74,0,74
73,Midi-Pyrénées,31,2,31,296,Lestelle-de-Saint-Martory,404,6,410
73,Midi-Pyrénées,31,3,18,297,Lévignac,2032,43,2075
73,Midi-Pyrénées,31,2,28,298,Lez,60,1,61
73,Midi-Pyrénées,31,1,23,299,Lherm,3277,56,3333
73,Midi-Pyrénées,31,2,29,300,Lieoux,122,3,125
73,Midi-Pyrénées,31,2,16,301,Lilhac,134,1,135
73,Midi-Pyrénées,31,2,29,302,Lodes,273,9,282
73,Midi-Pyrénées,31,1,09,303,Longages,2552,26,2578
73,Midi-Pyrénées,31,3,08,304,Loubens-Lauragais,394,7,401
73,Midi-Pyrénées,31,2,22,305,Loudet,217,25,242
73,Midi-Pyrénées,31,2,05,306,Lourde,99,1,100
73,Midi-Pyrénées,31,2,06,307,Lunax,60,0,60
73,Midi-Pyrénées,31,2,05,308,Luscan,62,3,65
73,Midi-Pyrénées,31,1,13,309,Lussan-Adeilhac,213,3,216
73,Midi-Pyrénées,31,3,38,310,Lux,329,2,331
73,Midi-Pyrénées,31,3,39,311,La Magdelaine-sur-Tarn,990,16,1006
73,Midi-Pyrénées,31,1,27,312,Mailholas,40,1,41
73,Midi-Pyrénées,31,2,05,313,Malvezie,120,4,124
73,Midi-Pyrénées,31,2,31,314,Mancioux,418,13,431
73,Midi-Pyrénées,31,2,32,315,Mane,985,47,1032
73,Midi-Pyrénées,31,2,28,316,Marignac,520,15,535
73,Midi-Pyrénées,31,1,13,317,Marignac-Lasclares,359,5,364
73,Midi-Pyrénées,31,1,11,318,Marignac-Laspeyres,173,4,177
73,Midi-Pyrénées,31,1,12,319,Marliac,104,1,105
73,Midi-Pyrénées,31,1,09,320,Marquefave,1012,85,1097
73,Midi-Pyrénées,31,2,32,321,Marsoulas,141,7,148
73,Midi-Pyrénées,31,2,16,322,Martisserre,62,3,65
73,Midi-Pyrénées,31,2,05,323,Martres-de-Rivière,365,10,375
73,Midi-Pyrénées,31,1,11,324,Martres-Tolosane,2241,44,2285
73,Midi-Pyrénées,31,3,08,325,Mascarville,204,2,206
73,Midi-Pyrénées,31,1,20,326,Massabrac,76,0,76
73,Midi-Pyrénées,31,1,11,327,Mauran,172,4,176
73,Midi-Pyrénées,31,3,38,328,Mauremont,308,2,310
73,Midi-Pyrénées,31,3,25,329,Maurens,204,4,208
73,Midi-Pyrénées,31,1,03,330,Mauressac,385,10,395
73,Midi-Pyrénées,31,3,08,331,Maureville,292,8,300
73,Midi-Pyrénées,31,3,24,332,Mauvaisin,233,8,241
73,Midi-Pyrénées,31,2,16,333,Mauvezin,74,0,74
73,Midi-Pyrénées,31,1,09,334,Mauzac,1049,23,1072
73,Midi-Pyrénées,31,2,04,335,Mayrègne,24,1,25
73,Midi-Pyrénées,31,2,32,336,Mazères-sur-Salat,603,7,610
73,Midi-Pyrénées,31,2,28,337,Melles,109,2,111
73,Midi-Pyrénées,31,3,15,338,Menville,500,10,510
73,Midi-Pyrénées,31,3,18,339,Mérenvielle,470,10,480
73,Midi-Pyrénées,31,3,10,340,Mervilla,256,2,258
73,Midi-Pyrénées,31,3,15,341,Merville,4613,61,4674
73,Midi-Pyrénées,31,2,01,342,Milhas,174,2,176
73,Midi-Pyrénées,31,2,16,343,Mirambeau,53,3,56
73,Midi-Pyrénées,31,2,29,344,Miramont-de-Comminges,841,15,856
73,Midi-Pyrénées,31,1,03,345,Miremont,1963,22,1985
73,Midi-Pyrénées,31,3,39,346,Mirepoix-sur-Tarn,678,8,686
73,Midi-Pyrénées,31,2,16,347,Molas,170,3,173
73,Midi-Pyrénées,31,2,01,348,Moncaup,31,0,31
73,Midi-Pyrénées,31,1,11,349,Mondavezan,771,10,781
73,Midi-Pyrénées,31,2,06,350,Mondilhan,92,1,93
73,Midi-Pyrénées,31,3,51,351,Mondonville,3473,36,3509
73,Midi-Pyrénées,31,3,43,352,Mondouzil,229,5,234
73,Midi-Pyrénées,31,1,26,353,Monès,59,1,60
73,Midi-Pyrénées,31,3,24,354,Monestrol,56,1,57
73,Midi-Pyrénées,31,3,43,355,Mons,1412,20,1432
73,Midi-Pyrénées,31,2,05,369,Mont-de-Galié,40,3,43
73,Midi-Pyrénées,31,3,15,356,Montaigut-sur-Save,1545,23,1568
73,Midi-Pyrénées,31,2,32,357,Montastruc-de-Salies,272,8,280
73,Midi-Pyrénées,31,3,19,358,Montastruc-la-Conseillère,3069,82,3151
73,Midi-Pyrénées,31,1,26,359,Montastruc-Savès,71,2,73
73,Midi-Pyrénées,31,2,04,360,Montauban-de-Luchon,455,18,473
73,Midi-Pyrénées,31,1,09,361,Montaut,511,10,521
73,Midi-Pyrénées,31,1,11,362,Montberaud,206,4,210
73,Midi-Pyrénées,31,2,16,363,Montbernard,211,4,215
73,Midi-Pyrénées,31,3,50,364,Montberon,2796,31,2827
73,Midi-Pyrénées,31,1,20,365,Montbrun-Bocage,447,10,457
73,Midi-Pyrénées,31,3,21,366,Montbrun-Lauragais,549,13,562
73,Midi-Pyrénées,31,1,11,367,Montclar-de-Comminges,75,1,76
73,Midi-Pyrénées,31,3,38,368,Montclar-Lauragais,204,3,207
73,Midi-Pyrénées,31,1,13,370,Montégut-Bourjac,114,4,118
73,Midi-Pyrénées,31,3,25,371,Montégut-Lauragais,455,7,462
73,Midi-Pyrénées,31,2,32,372,Montespan,438,9,447
73,Midi-Pyrénées,31,2,16,373,Montesquieu-Guittaut,125,5,130
73,Midi-Pyrénées,31,3,38,374,Montesquieu-Lauragais,905,18,923
73,Midi-Pyrénées,31,1,20,375,Montesquieu-Volvestre,2765,75,2840
73,Midi-Pyrénées,31,2,32,376,Montgaillard-de-Salies,101,2,103
73,Midi-Pyrénées,31,3,38,377,Montgaillard-Lauragais,644,13,657
73,Midi-Pyrénées,31,2,06,378,Montgaillard-sur-Save,78,0,78
73,Midi-Pyrénées,31,1,09,379,Montgazin,171,5,176
73,Midi-Pyrénées,31,3,24,380,Montgeard,434,2,436
73,Midi-Pyrénées,31,3,21,381,Montgiscard,2060,57,2117
73,Midi-Pyrénées,31,1,26,382,Montgras,92,0,92
73,Midi-Pyrénées,31,3,19,383,Montjoire,1153,10,1163
73,Midi-Pyrénées,31,3,21,384,Montlaur,1217,22,1239
73,Midi-Pyrénées,31,2,06,385,Montmaurin,226,7,233
73,Midi-Pyrénées,31,2,02,386,Montoulieu-Saint-Bernard,171,8,179
73,Midi-Pyrénées,31,1,13,387,Montoussin,114,0,114
73,Midi-Pyrénées,31,3,19,388,Montpitol,384,4,388
73,Midi-Pyrénées,31,3,43,389,Montrabé,3368,67,3435
73,Midi-Pyrénées,31,2,22,390,Montréjeau,2738,61,2799
73,Midi-Pyrénées,31,2,32,391,Montsaunès,403,36,439
73,Midi-Pyrénées,31,3,08,392,Mourvilles-Basses,61,3,64
73,Midi-Pyrénées,31,3,25,393,Mourvilles-Hautes,160,9,169
73,Midi-Pyrénées,31,2,04,394,Moustajon,170,9,179
73,Midi-Pyrénées,31,1,23,395,Muret,23297,703,24000
73,Midi-Pyrénées,31,3,24,396,Nailloux,2358,28,2386
73,Midi-Pyrénées,31,2,06,397,Nénigan,56,0,56
73,Midi-Pyrénées,31,2,06,398,Nizan-Gesse,90,0,90
73,Midi-Pyrénées,31,1,09,399,Noé,2550,31,2581
73,Midi-Pyrénées,31,3,25,400,Nogaret,72,2,74
73,Midi-Pyrénées,31,3,21,401,Noueilles,323,7,330
73,Midi-Pyrénées,31,3,21,402,Odars,705,12,717
73,Midi-Pyrénées,31,3,15,403,Ondes,718,123,841
73,Midi-Pyrénées,31,2,04,404,Oô,108,0,108
73,Midi-Pyrénées,31,2,05,405,Ore,109,4,113
73,Midi-Pyrénées,31,1,11,406,Palaminy,801,28,829
73,Midi-Pyrénées,31,3,19,407,Paulhac,1114,26,1140
73,Midi-Pyrénées,31,2,05,408,Payssous,93,0,93
73,Midi-Pyrénées,31,3,10,409,Péchabou,1742,66,1808
73,Midi-Pyrénées,31,3,50,410,Pechbonnieu,3775,49,3824
73,Midi-Pyrénées,31,3,10,411,Pechbusque,809,25,834
73,Midi-Pyrénées,31,2,06,412,Péguilhan,238,4,242
73,Midi-Pyrénées,31,3,07,413,Pelleport,495,10,505
73,Midi-Pyrénées,31,2,02,414,Peyrissas,98,3,101
73,Midi-Pyrénées,31,2,02,415,Peyrouzet,92,4,96
73,Midi-Pyrénées,31,1,09,416,Peyssies,462,8,470
73,Midi-Pyrénées,31,3,18,417,Pibrac,7997,239,8236
73,Midi-Pyrénées,31,3,43,418,Pin-Balma,926,23,949
73,Midi-Pyrénées,31,1,26,419,Le Pin-Murelet,186,2,188
73,Midi-Pyrénées,31,1,52,421,Pins-Justaret,4489,63,4552
73,Midi-Pyrénées,31,1,52,420,Pinsaguel,2577,50,2627
73,Midi-Pyrénées,31,1,11,422,Plagne,93,1,94
73,Midi-Pyrénées,31,1,26,423,Plagnole,269,6,275
73,Midi-Pyrénées,31,3,18,424,Plaisance-du-Touch,15995,319,16314
73,Midi-Pyrénées,31,1,11,425,Le Plan,453,5,458
73,Midi-Pyrénées,31,2,05,426,Pointis-de-Rivière,854,14,868
73,Midi-Pyrénées,31,2,29,427,Pointis-Inard,804,15,819
73,Midi-Pyrénées,31,1,13,428,Polastron,58,4,62
73,Midi-Pyrénées,31,3,21,429,Pompertuzat,1921,54,1975
73,Midi-Pyrénées,31,2,22,430,Ponlat-Taillebourg,566,13,579
73,Midi-Pyrénées,31,2,01,431,Portet-d'Aspet,73,1,74
73,Midi-Pyrénées,31,2,04,432,Portet-de-Luchon,27,1,28
73,Midi-Pyrénées,31,1,52,433,Portet-sur-Garonne,9760,131,9891
73,Midi-Pyrénées,31,2,04,434,Poubeau,71,2,73
73,Midi-Pyrénées,31,1,26,435,Poucharramet,829,17,846
73,Midi-Pyrénées,31,1,13,436,Pouy-de-Touges,344,9,353
73,Midi-Pyrénées,31,3,21,437,Pouze,99,0,99
73,Midi-Pyrénées,31,3,18,438,Pradère-les-Bourguets,239,3,242
73,Midi-Pyrénées,31,3,17,439,Préserville,602,13,615
73,Midi-Pyrénées,31,2,31,440,Proupiary,67,2,69
73,Midi-Pyrénées,31,3,08,441,Prunet,148,3,151
73,Midi-Pyrénées,31,1,03,442,Puydaniel,393,0,393
73,Midi-Pyrénées,31,2,16,443,Puymaurin,302,1,303
73,Midi-Pyrénées,31,3,07,444,Puysségur,109,0,109
73,Midi-Pyrénées,31,3,43,445,Quint-Fonsegrives,4578,71,4649
73,Midi-Pyrénées,31,3,44,446,Ramonville-Saint-Agne,11554,316,11870
73,Midi-Pyrénées,31,2,01,447,Razecueillé,32,0,32
73,Midi-Pyrénées,31,3,10,448,Rebigue,515,5,520
73,Midi-Pyrénées,31,2,29,449,Régades,132,0,132
73,Midi-Pyrénées,31,3,38,450,Renneville,474,6,480
73,Midi-Pyrénées,31,3,25,451,Revel,9121,422,9543
73,Midi-Pyrénées,31,2,29,452,Rieucazé,46,2,48
73,Midi-Pyrénées,31,3,38,453,Rieumajou,126,2,128
73,Midi-Pyrénées,31,1,26,454,Rieumes,3262,77,3339
73,Midi-Pyrénées,31,1,27,455,Rieux-Volvestre,2401,57,2458
73,Midi-Pyrénées,31,2,16,456,Riolas,49,3,52
73,Midi-Pyrénées,31,2,32,457,Roquefort-sur-Garonne,773,14,787
73,Midi-Pyrénées,31,1,52,458,Roques,3687,74,3761
73,Midi-Pyrénées,31,3,19,459,Roquesérière,671,18,689
73,Midi-Pyrénées,31,1,52,460,Roquettes,3511,49,3560
73,Midi-Pyrénées,31,2,32,461,Rouède,281,9,290
73,Midi-Pyrénées,31,3,50,462,Rouffiac-Tolosan,1715,26,1741
73,Midi-Pyrénées,31,3,25,463,Roumens,231,7,238
73,Midi-Pyrénées,31,1,26,464,Sabonnères,285,3,288
73,Midi-Pyrénées,31,2,04,465,Saccourvielle,12,1,13
73,Midi-Pyrénées,31,1,30,466,Saiguède,689,7,696
73,Midi-Pyrénées,31,3,49,467,Saint-Alban,5603,61,5664
73,Midi-Pyrénées,31,2,02,468,Saint-André,212,4,216
73,Midi-Pyrénées,31,1,13,469,Saint-Araille,146,1,147
73,Midi-Pyrénées,31,2,04,470,Saint-Aventin,88,9,97
73,Midi-Pyrénées,31,2,28,471,Saint-Béat,394,4,398
73,Midi-Pyrénées,31,2,05,472,Saint-Bertrand-de-Comminges,257,4,261
73,Midi-Pyrénées,31,3,15,473,Saint-Cézert,340,6,346
73,Midi-Pyrénées,31,1,20,474,Saint-Christaud,258,5,263
73,Midi-Pyrénées,31,1,23,475,Saint-Clar-de-Rivière,1220,13,1233
73,Midi-Pyrénées,31,1,13,476,Saint-Élix-le-Château,691,8,699
73,Midi-Pyrénées,31,2,02,477,Saint-Élix-Séglan,42,0,42
73,Midi-Pyrénées,31,3,25,478,Saint-Félix-Lauragais,1362,28,1390
73,Midi-Pyrénées,31,2,06,479,Saint-Ferréol-de-Comminges,58,0,58
73,Midi-Pyrénées,31,2,16,482,Saint-Frajou,184,0,184
73,Midi-Pyrénées,31,2,29,483,Saint-Gaudens,11660,482,12142
73,Midi-Pyrénées,31,3,50,484,Saint-Geniès-Bellevue,2166,32,2198
73,Midi-Pyrénées,31,3,38,485,Saint-Germier,97,1,98
73,Midi-Pyrénées,31,1,23,486,Saint-Hilaire,1070,14,1084
73,Midi-Pyrénées,31,2,29,487,Saint-Ignan,268,10,278
73,Midi-Pyrénées,31,3,50,488,Saint-Jean,9968,137,10105
73,Midi-Pyrénées,31,3,19,489,Saint-Jean-Lherm,358,4,362
73,Midi-Pyrénées,31,3,14,490,Saint-Jory,5026,56,5082
73,Midi-Pyrénées,31,3,25,491,Saint-Julia,376,10,386
73,Midi-Pyrénées,31,1,27,492,Saint-Julien-sur-Garonne,459,4,463
73,Midi-Pyrénées,31,2,06,493,Saint-Lary-Boujean,118,2,120
73,Midi-Pyrénées,31,2,16,494,Saint-Laurent,161,1,162
73,Midi-Pyrénées,31,3,24,495,Saint-Léon,1059,8,1067
73,Midi-Pyrénées,31,3,50,497,Saint-Loup-Cammas,1834,19,1853
73,Midi-Pyrénées,31,2,06,498,Saint-Loup-en-Comminges,39,1,40
73,Midi-Pyrénées,31,1,30,499,Saint-Lys,8256,153,8409
73,Midi-Pyrénées,31,2,04,500,Saint-Mamet,607,26,633
73,Midi-Pyrénées,31,3,37,501,Saint-Marcel-Paulel,441,20,461
73,Midi-Pyrénées,31,2,29,502,Saint-Marcet,394,11,405
73,Midi-Pyrénées,31,2,31,503,Saint-Martory,854,8,862
73,Midi-Pyrénées,31,2,31,504,Saint-Médard,204,5,209
73,Midi-Pyrénées,31,1,11,505,Saint-Michel,317,11,328
73,Midi-Pyrénées,31,3,10,506,Saint-Orens-de-Gameville,10800,328,11128
73,Midi-Pyrénées,31,2,04,508,Saint-Paul-d'Oueil,53,0,53
73,Midi-Pyrénées,31,3,15,507,Saint-Paul-sur-Save,1265,25,1290
73,Midi-Pyrénées,31,2,05,509,Saint-Pé-d'Ardet,132,4,136
73,Midi-Pyrénées,31,2,06,510,Saint-Pé-Delbosc,125,0,125
73,Midi-Pyrénées,31,3,37,511,Saint-Pierre,248,5,253
73,Midi-Pyrénées,31,3,17,512,Saint-Pierre-de-Lages,751,12,763
73,Midi-Pyrénées,31,2,22,513,Saint-Plancard,383,5,388
73,Midi-Pyrénées,31,3,38,514,Saint-Rome,59,2,61
73,Midi-Pyrénées,31,3,14,515,Saint-Rustice,432,5,437
73,Midi-Pyrénées,31,3,14,516,Saint-Sauveur,1705,63,1768
73,Midi-Pyrénées,31,1,09,517,Saint-Sulpice-sur-Lèze,1818,53,1871
73,Midi-Pyrénées,31,1,30,518,Saint-Thomas,565,6,571
73,Midi-Pyrénées,31,3,38,519,Saint-Vincent,158,0,158
73,Midi-Pyrénées,31,3,17,480,Sainte-Foy-d'Aigrefeuille,1960,48,2008
73,Midi-Pyrénées,31,1,30,481,Sainte-Foy-de-Peyrolières,1968,33,2001
73,Midi-Pyrénées,31,3,18,496,Sainte-Livrade,283,11,294
73,Midi-Pyrénées,31,1,26,520,Sajas,92,2,94
73,Midi-Pyrénées,31,2,32,521,Saleich,378,6,384
73,Midi-Pyrénées,31,2,16,522,Salerm,54,0,54
73,Midi-Pyrénées,31,2,32,523,Salies-du-Salat,1928,92,2020
73,Midi-Pyrénées,31,2,04,524,Salles-et-Pratviel,132,2,134
73,Midi-Pyrénées,31,1,27,525,Salles-sur-Garonne,488,10,498
73,Midi-Pyrénées,31,3,08,527,La Salvetat-Lauragais,137,6,143
73,Midi-Pyrénées,31,3,18,526,La Salvetat-Saint-Gilles,6658,119,6777
73,Midi-Pyrénées,31,2,06,528,Saman,149,6,155
73,Midi-Pyrénées,31,2,02,529,Samouillan,116,0,116
73,Midi-Pyrénées,31,1,11,530,Sana,210,6,216
73,Midi-Pyrénées,31,2,06,531,Sarrecave,81,2,83
73,Midi-Pyrénées,31,2,06,532,Sarremezan,89,1,90
73,Midi-Pyrénées,31,1,52,533,Saubens,1784,24,1808
73,Midi-Pyrénées,31,3,08,534,Saussens,257,3,260
73,Midi-Pyrénées,31,2,05,535,Sauveterre-de-Comminges,721,20,741
73,Midi-Pyrénées,31,2,29,536,Saux-et-Pomarède,266,18,284
73,Midi-Pyrénées,31,2,29,537,Savarthès,137,5,142
73,Midi-Pyrénées,31,1,26,538,Savères,205,5,210
73,Midi-Pyrénées,31,2,22,539,Sédeilhac,60,5,65
73,Midi-Pyrénées,31,3,08,540,Ségreville,195,3,198
73,Midi-Pyrénées,31,3,15,541,Seilh,2987,91,3078
73,Midi-Pyrénées,31,2,05,542,Seilhan,203,4,207
73,Midi-Pyrénées,31,1,13,543,Sénarens,110,1,111
73,Midi-Pyrénées,31,2,01,544,Sengouagnet,221,8,229
73,Midi-Pyrénées,31,2,31,545,Sepx,182,3,185
73,Midi-Pyrénées,31,3,24,546,Seyre,98,2,100
73,Midi-Pyrénées,31,1,23,547,Seysses,7719,97,7816
73,Midi-Pyrénées,31,2,28,548,Signac,55,0,55
73,Midi-Pyrénées,31,2,04,549,Sode,24,0,24
73,Midi-Pyrénées,31,2,01,550,Soueich,531,12,543
73,Midi-Pyrénées,31,3,17,551,Tarabel,341,7,348
73,Midi-Pyrénées,31,2,02,552,Terrebasse,129,2,131
73,Midi-Pyrénées,31,3,15,553,Thil,1076,15,1091
73,Midi-Pyrénées,31,2,32,554,Touille,269,5,274
73,Midi-Pyrénées,31,3,99,555,Toulouse,439553,6787,446340
73,Midi-Pyrénées,31,3,53,557,Tournefeuille,25574,485,26059
73,Midi-Pyrénées,31,2,22,556,Les Tourreilles,383,7,390
73,Midi-Pyrénées,31,3,08,558,Toutens,174,3,177
73,Midi-Pyrénées,31,2,04,559,Trébons-de-Luchon,7,0,7
73,Midi-Pyrénées,31,3,38,560,Trébons-sur-la-Grasse,405,16,421
73,Midi-Pyrénées,31,3,50,561,L' Union,12194,189,12383
73,Midi-Pyrénées,31,2,32,562,Urau,144,1,145
73,Midi-Pyrénées,31,3,14,563,Vacquiers,1308,12,1320
73,Midi-Pyrénées,31,2,05,564,Valcabrère,164,1,165
73,Midi-Pyrénées,31,2,29,565,Valentine,874,17,891
73,Midi-Pyrénées,31,3,38,566,Vallègue,485,4,489
73,Midi-Pyrénées,31,3,17,567,Vallesvilles,361,8,369
73,Midi-Pyrénées,31,3,21,568,Varennes,253,2,255
73,Midi-Pyrénées,31,3,25,569,Vaudreuille,341,4,345
73,Midi-Pyrénées,31,3,25,570,Vaux,266,0,266
73,Midi-Pyrénées,31,3,08,571,Vendine,234,4,238
73,Midi-Pyrénées,31,1,03,572,Venerque,2632,51,2683
73,Midi-Pyrénées,31,3,37,573,Verfeil,2993,54,3047
73,Midi-Pyrénées,31,1,03,574,Vernet,2087,77,2164
73,Midi-Pyrénées,31,3,10,575,Vieille-Toulouse,1085,45,1130
73,Midi-Pyrénées,31,3,38,576,Vieillevigne,294,4,298
73,Midi-Pyrénées,31,3,07,577,Vignaux,119,2,121
73,Midi-Pyrénées,31,3,10,578,Vigoulet-Auzil,954,30,984
73,Midi-Pyrénées,31,3,14,579,Villariès,805,21,826
73,Midi-Pyrénées,31,1,52,580,Villate,763,11,774
73,Midi-Pyrénées,31,3,14,581,Villaudric,1393,27,1420
73,Midi-Pyrénées,31,3,38,582,Villefranche-de-Lauragais,4012,56,4068
73,Midi-Pyrénées,31,3,39,583,Villematier,971,23,994
73,Midi-Pyrénées,31,3,39,584,Villemur-sur-Tarn,5298,101,5399
73,Midi-Pyrénées,31,2,29,585,Villeneuve-de-Rivière,1533,43,1576
73,Midi-Pyrénées,31,2,22,586,Villeneuve-Lécussan,554,7,561
73,Midi-Pyrénées,31,3,14,587,Villeneuve-lès-Bouloc,1028,14,1042
73,Midi-Pyrénées,31,3,53,588,Villeneuve-Tolosane,8261,140,8401
73,Midi-Pyrénées,31,3,38,589,Villenouvelle,1302,14,1316
73,Midi-Pyrénées,32,3,01,001,Aignan,830,89,919
73,Midi-Pyrénées,32,1,09,002,Ansan,92,4,96
73,Midi-Pyrénées,32,1,11,003,Antras,61,3,64
73,Midi-Pyrénées,32,3,24,004,Arblade-le-Bas,135,4,139
73,Midi-Pyrénées,32,2,22,005,Arblade-le-Haut,275,11,286
73,Midi-Pyrénées,32,1,05,007,Ardizas,194,4,198
73,Midi-Pyrénées,32,3,14,008,Armentieux,81,2,83
73,Midi-Pyrénées,32,3,20,009,Armous-et-Cau,95,4,99
73,Midi-Pyrénées,32,3,15,010,Arrouède,84,5,89
73,Midi-Pyrénées,32,1,09,012,Aubiet,1099,28,1127
73,Midi-Pyrénées,32,1,99,013,Auch,21744,1305,23049
73,Midi-Pyrénées,32,1,02,014,Augnax,81,2,83
73,Midi-Pyrénées,32,3,15,015,Aujan-Mournède,94,2,96
73,Midi-Pyrénées,32,1,10,016,Auradé,580,11,591
73,Midi-Pyrénées,32,3,24,017,Aurensan,128,4,132
73,Midi-Pyrénées,32,1,27,018,Aurimont,184,2,186
73,Midi-Pyrénées,32,3,15,468,Aussos,57,2,59
73,Midi-Pyrénées,32,1,03,019,Auterive,530,14,544
73,Midi-Pyrénées,32,3,17,020,Aux-Aussat,251,8,259
73,Midi-Pyrénées,32,2,16,021,Avensac,60,2,62
73,Midi-Pyrénées,32,3,01,022,Avéron-Bergelle,161,6,167
73,Midi-Pyrénées,32,2,25,023,Avezan,76,3,79
73,Midi-Pyrénées,32,2,28,024,Ayguetinte,180,4,184
73,Midi-Pyrénées,32,2,04,025,Ayzieu,145,2,147
73,Midi-Pyrénées,32,2,16,026,Bajonnette,103,2,105
73,Midi-Pyrénées,32,3,24,027,Barcelonne-du-Gers,1324,44,1368
73,Midi-Pyrénées,32,3,17,028,Barcugnan,139,4,143
73,Midi-Pyrénées,32,1,31,029,Barran,724,19,743
73,Midi-Pyrénées,32,3,20,030,Bars,133,8,141
73,Midi-Pyrénées,32,2,07,031,Bascous,135,2,137
73,Midi-Pyrénées,32,3,20,032,Bassoues,391,10,401
73,Midi-Pyrénées,32,1,29,033,Bazian,112,2,114
73,Midi-Pyrénées,32,3,19,034,Bazugues,58,3,61
73,Midi-Pyrénées,32,2,28,035,Beaucaire,289,10,299
73,Midi-Pyrénées,32,3,23,036,Beaumarchés,666,44,710
73,Midi-Pyrénées,32,2,06,037,Beaumont,126,2,128
73,Midi-Pyrénées,32,1,10,038,Beaupuy,180,5,185
73,Midi-Pyrénées,32,3,14,039,Beccas,82,1,83
73,Midi-Pyrénées,32,1,27,040,Bédéchan,133,1,134
73,Midi-Pyrénées,32,3,15,041,Bellegarde,163,1,164
73,Midi-Pyrénées,32,3,19,042,Belloc-Saint-Clamens,140,7,147
73,Midi-Pyrénées,32,1,29,043,Belmont,151,5,156
73,Midi-Pyrénées,32,2,06,044,Béraut,340,13,353
73,Midi-Pyrénées,32,3,19,045,Berdoues,419,14,433
73,Midi-Pyrénées,32,3,24,046,Bernède,221,2,223
73,Midi-Pyrénées,32,2,12,047,Berrac,100,1,101
73,Midi-Pyrénées,32,1,13,048,Betcave-Aguin,99,2,101
73,Midi-Pyrénées,32,2,22,049,Bétous,91,2,93
73,Midi-Pyrénées,32,3,17,050,Betplan,118,2,120
73,Midi-Pyrénées,32,1,26,051,Bézéril,102,0,102
73,Midi-Pyrénées,32,2,28,052,Bezolles,139,1,140
73,Midi-Pyrénées,32,3,15,053,Bézues-Bajon,211,2,213
73,Midi-Pyrénées,32,1,11,054,Biran,389,14,403
73,Midi-Pyrénées,32,2,25,055,Bivès,135,3,138
73,Midi-Pyrénées,32,1,09,056,Blanquefort,67,1,68
73,Midi-Pyrénées,32,2,06,057,Blaziert,138,5,143
73,Midi-Pyrénées,32,3,14,058,Blousson-Sérian,70,7,77
73,Midi-Pyrénées,32,2,28,059,Bonas,136,1,137
73,Midi-Pyrénées,32,1,03,060,Boucagnères,136,6,142
73,Midi-Pyrénées,32,1,27,061,Boulaur,151,0,151
73,Midi-Pyrénées,32,2,22,062,Bourrouillan,150,10,160
73,Midi-Pyrénées,32,3,01,063,Bouzon-Gellenave,189,4,193
73,Midi-Pyrénées,32,2,07,064,Bretagne-d'Armagnac,388,10,398
73,Midi-Pyrénées,32,1,31,065,Le Brouilh-Monbert,255,7,262
73,Midi-Pyrénées,32,2,08,066,Brugnens,257,8,265
73,Midi-Pyrénées,32,3,15,067,Cabas-Loumassès,50,0,50
73,Midi-Pyrénées,32,2,25,068,Cadeilhan,135,1,136
73,Midi-Pyrénées,32,1,13,069,Cadeillan,74,1,75
73,Midi-Pyrénées,32,3,23,070,Cahuzac-sur-Adour,242,1,243
73,Midi-Pyrénées,32,1,29,071,Caillavet,192,4,196
73,Midi-Pyrénées,32,1,29,072,Callian,51,0,51
73,Midi-Pyrénées,32,2,04,073,Campagne-d'Armagnac,200,7,207
73,Midi-Pyrénées,32,3,23,074,Cannet,55,2,57
73,Midi-Pyrénées,32,2,06,075,Cassaigne,205,1,206
73,Midi-Pyrénées,32,1,27,076,Castelnau-Barbarens,489,19,508
73,Midi-Pyrénées,32,3,20,077,Castelnau-d'Anglès,92,1,93
73,Midi-Pyrénées,32,2,08,078,Castelnau-d'Arbieu,201,3,204
73,Midi-Pyrénées,32,2,21,079,Castelnau-d'Auzan,1091,25,1116
73,Midi-Pyrénées,32,2,06,080,Castelnau-sur-l'Auvignon,159,6,165
73,Midi-Pyrénées,32,3,01,081,Castelnavet,146,3,149
73,Midi-Pyrénées,32,2,12,082,Castéra-Lectourois,298,4,302
73,Midi-Pyrénées,32,2,28,083,Castéra-Verduzan,925,30,955
73,Midi-Pyrénées,32,2,25,084,Castéron,67,3,70
73,Midi-Pyrénées,32,2,18,085,Castet-Arrouy,182,6,188
73,Midi-Pyrénées,32,3,17,086,Castex,93,0,93
73,Midi-Pyrénées,32,2,04,087,Castex-d'Armagnac,111,3,114
73,Midi-Pyrénées,32,1,29,088,Castillon-Debats,321,12,333
73,Midi-Pyrénées,32,1,11,089,Castillon-Massas,248,3,251
73,Midi-Pyrénées,32,1,10,090,Castillon-Savès,295,13,308
73,Midi-Pyrénées,32,1,30,091,Castin,268,15,283
73,Midi-Pyrénées,32,1,05,092,Catonvielle,92,3,95
73,Midi-Pyrénées,32,3,24,093,Caumont,127,2,129
73,Midi-Pyrénées,32,2,22,094,Caupenne-d'Armagnac,437,15,452
73,Midi-Pyrénées,32,2,06,095,Caussens,619,22,641
73,Midi-Pyrénées,32,2,04,096,Cazaubon,1651,43,1694
73,Midi-Pyrénées,32,1,29,097,Cazaux-d'Anglès,153,1,154
73,Midi-Pyrénées,32,1,26,098,Cazaux-Savès,248,4,252
73,Midi-Pyrénées,32,3,14,099,Cazaux-Villecomtal,86,1,87
73,Midi-Pyrénées,32,2,21,100,Cazeneuve,135,5,140
73,Midi-Pyrénées,32,2,08,101,Céran,170,0,170
73,Midi-Pyrénées,32,2,08,102,Cézan,160,4,164
73,Midi-Pyrénées,32,3,15,103,Chélan,191,2,193
73,Midi-Pyrénées,32,3,19,104,Clermont-Pouyguillès,156,4,160
73,Midi-Pyrénées,32,1,10,105,Clermont-Savès,240,7,247
73,Midi-Pyrénées,32,1,05,106,Cologne,804,59,863
73,Midi-Pyrénées,32,2,06,107,Condom,7193,319,7512
73,Midi-Pyrénées,32,3,24,108,Corneillan,139,3,142
73,Midi-Pyrénées,32,3,23,109,Couloumé-Mondebat,205,9,214
73,Midi-Pyrénées,32,2,07,110,Courrensan,380,4,384
73,Midi-Pyrénées,32,3,20,111,Courties,43,3,46
73,Midi-Pyrénées,32,1,02,112,Crastes,233,7,240
73,Midi-Pyrénées,32,2,22,113,Cravencères,103,5,108
73,Midi-Pyrénées,32,3,15,114,Cuélas,105,2,107
73,Midi-Pyrénées,32,2,07,115,Dému,332,7,339
73,Midi-Pyrénées,32,3,17,116,Duffort,134,4,138
73,Midi-Pyrénées,32,1,30,117,Duran,784,40,824
73,Midi-Pyrénées,32,1,31,118,Durban,157,6,163
73,Midi-Pyrénées,32,2,07,119,Eauze,3935,69,4004
73,Midi-Pyrénées,32,1,05,120,Encausse,369,5,374
73,Midi-Pyrénées,32,1,10,121,Endoufielle,551,22,573
73,Midi-Pyrénées,32,3,15,122,Esclassan-Labastide,343,15,358
73,Midi-Pyrénées,32,1,09,123,Escorneboeuf,483,16,499
73,Midi-Pyrénées,32,1,13,124,Espaon,195,4,199
73,Midi-Pyrénées,32,2,22,125,Espas,115,2,117
73,Midi-Pyrénées,32,3,17,126,Estampes,170,6,176
73,Midi-Pyrénées,32,2,04,127,Estang,657,12,669
73,Midi-Pyrénées,32,3,20,128,Estipouy,192,8,200
73,Midi-Pyrénées,32,2,25,129,Estramiac,128,9,137
73,Midi-Pyrénées,32,1,27,130,Faget-Abbatial,229,1,230
73,Midi-Pyrénées,32,2,18,131,Flamarens,117,3,120
73,Midi-Pyrénées,32,2,08,132,Fleurance,6277,109,6386
73,Midi-Pyrénées,32,2,21,133,Fourcès,290,8,298
73,Midi-Pyrénées,32,1,10,134,Frégouville,311,1,312
73,Midi-Pyrénées,32,3,01,135,Fustérouau,129,2,131
73,Midi-Pyrénées,32,3,23,136,Galiax,174,1,175
73,Midi-Pyrénées,32,1,13,138,Garravet,140,1,141
73,Midi-Pyrénées,32,2,25,139,Gaudonville,112,0,112
73,Midi-Pyrénées,32,1,13,140,Gaujac,59,0,59
73,Midi-Pyrénées,32,1,13,141,Gaujan,104,3,107
73,Midi-Pyrénées,32,2,08,142,Gavarret-sur-Aulouste,133,5,138
73,Midi-Pyrénées,32,2,06,143,Gazaupouy,294,5,299
73,Midi-Pyrénées,32,3,20,144,Gazax-et-Baccarisse,91,2,93
73,Midi-Pyrénées,32,3,24,145,Gée-Rivière,48,3,51
73,Midi-Pyrénées,32,2,18,146,Gimbrède,326,5,331
73,Midi-Pyrénées,32,1,09,147,Gimont,2874,67,2941
73,Midi-Pyrénées,32,1,10,148,Giscaro,80,2,82
73,Midi-Pyrénées,32,2,21,149,Gondrin,1158,40,1198
73,Midi-Pyrénées,32,2,08,150,Goutz,184,7,191
73,Midi-Pyrénées,32,3,23,151,Goux,85,0,85
73,Midi-Pyrénées,32,3,17,152,Haget,309,8,317
73,Midi-Pyrénées,32,1,03,153,Haulies,113,2,115
73,Midi-Pyrénées,32,2,16,154,Homps,97,2,99
73,Midi-Pyrénées,32,2,22,155,Le Houga,1141,80,1221
73,Midi-Pyrénées,32,3,19,156,Idrac-Respaillès,211,7,218
73,Midi-Pyrénées,32,1,09,157,L' Isle-Arné,119,2,121
73,Midi-Pyrénées,32,2,25,158,L' Isle-Bouzon,238,5,243
73,Midi-Pyrénées,32,3,20,159,L' Isle-de-Noé,535,17,552
73,Midi-Pyrénées,32,1,10,160,L' Isle-Jourdain,7025,166,7191
73,Midi-Pyrénées,32,3,23,161,Izotges,84,3,87
73,Midi-Pyrénées,32,1,11,162,Jegun,1136,89,1225
73,Midi-Pyrénées,32,3,23,163,Jû-Belloc,317,7,324
73,Midi-Pyrénées,32,3,14,164,Juillac,119,4,123
73,Midi-Pyrénées,32,1,09,165,Juilles,226,6,232
73,Midi-Pyrénées,32,2,28,166,Justian,93,1,94
73,Midi-Pyrénées,32,3,19,167,Laas,287,8,295
73,Midi-Pyrénées,32,2,21,168,Labarrère,219,7,226
73,Midi-Pyrénées,32,1,03,169,Labarthe,165,5,170
73,Midi-Pyrénées,32,3,24,170,Labarthète,145,10,155
73,Midi-Pyrénées,32,1,26,171,Labastide-Savès,133,4,137
73,Midi-Pyrénées,32,3,19,172,Labéjan,314,6,320
73,Midi-Pyrénées,32,2,16,173,Labrihe,204,7,211
73,Midi-Pyrénées,32,3,14,174,Ladevèze-Rivière,221,4,225
73,Midi-Pyrénées,32,3,14,175,Ladevèze-Ville,265,4,269
73,Midi-Pyrénées,32,2,12,176,Lagarde,129,2,131
73,Midi-Pyrénées,32,3,19,177,Lagarde-Hachan,165,2,167
73,Midi-Pyrénées,32,2,28,178,Lagardère,65,0,65
73,Midi-Pyrénées,32,2,21,180,Lagraulet-du-Gers,399,4,403
73,Midi-Pyrénées,32,3,17,181,Laguian-Mazous,277,7,284
73,Midi-Pyrénées,32,1,26,182,Lahas,172,4,176
73,Midi-Pyrénées,32,1,02,183,Lahitte,251,5,256
73,Midi-Pyrénées,32,2,08,184,Lalanne,114,1,115
73,Midi-Pyrénées,32,3,15,185,Lalanne-Arqué,129,6,135
73,Midi-Pyrénées,32,1,27,186,Lamaguère,63,5,68
73,Midi-Pyrénées,32,3,19,187,Lamazère,149,1,150
73,Midi-Pyrénées,32,2,08,188,Lamothe-Goas,65,2,67
73,Midi-Pyrénées,32,2,22,191,Lanne-Soubiran,111,4,115
73,Midi-Pyrénées,32,2,04,189,Lannemaignan,106,0,106
73,Midi-Pyrénées,32,2,07,190,Lannepax,565,12,577
73,Midi-Pyrénées,32,3,24,192,Lannux,216,9,225
73,Midi-Pyrénées,32,2,04,193,Larée,231,3,234
73,Midi-Pyrénées,32,2,06,194,Larressingle,202,3,205
73,Midi-Pyrénées,32,2,12,195,Larroque-Engalin,55,0,55
73,Midi-Pyrénées,32,2,28,196,Larroque-Saint-Sernin,164,8,172
73,Midi-Pyrénées,32,2,21,197,Larroque-sur-l'Osse,208,14,222
73,Midi-Pyrénées,32,1,27,198,Lartigue,145,7,152
73,Midi-Pyrénées,32,3,23,199,Lasserade,202,4,206
73,Midi-Pyrénées,32,1,31,200,Lasséran,329,13,342
73,Midi-Pyrénées,32,1,31,201,Lasseube-Propre,338,4,342
73,Midi-Pyrénées,32,2,22,202,Laujuzan,239,8,247
73,Midi-Pyrénées,32,2,21,203,Lauraët,249,3,252
73,Midi-Pyrénées,32,1,11,204,Lavardens,397,10,407
73,Midi-Pyrénées,32,3,14,205,Laveraët,120,5,125
73,Midi-Pyrénées,32,1,13,206,Laymont,202,5,207
73,Midi-Pyrénées,32,1,02,207,Leboulin,291,7,298
73,Midi-Pyrénées,32,2,12,208,Lectoure,3746,430,4176
73,Midi-Pyrénées,32,3,24,209,Lelin-Lapujolle,220,2,222
73,Midi-Pyrénées,32,1,10,210,Lias,479,11,490
73,Midi-Pyrénées,32,2,04,211,Lias-d'Armagnac,190,10,200
73,Midi-Pyrénées,32,2,06,212,Ligardes,238,6,244
73,Midi-Pyrénées,32,1,13,213,Lombez,1804,41,1845
73,Midi-Pyrénées,32,2,22,214,Loubédat,130,5,135
73,Midi-Pyrénées,32,3,19,215,Loubersan,184,10,194
73,Midi-Pyrénées,32,3,15,216,Lourties-Monbrun,127,6,133
73,Midi-Pyrénées,32,3,20,217,Louslitges,80,2,82
73,Midi-Pyrénées,32,3,01,218,Loussous-Débat,46,2,48
73,Midi-Pyrénées,32,3,01,219,Lupiac,308,5,313
73,Midi-Pyrénées,32,2,22,220,Luppé-Violles,141,2,143
73,Midi-Pyrénées,32,1,09,221,Lussan,229,4,233
73,Midi-Pyrénées,32,2,22,222,Magnan,210,6,216
73,Midi-Pyrénées,32,2,25,223,Magnas,67,24,91
73,Midi-Pyrénées,32,2,28,224,Maignaut-Tauzia,217,4,221
73,Midi-Pyrénées,32,3,17,225,Malabat,97,1,98
73,Midi-Pyrénées,32,3,17,226,Manas-Bastanous,97,2,99
73,Midi-Pyrénées,32,2,22,227,Manciet,795,17,812
73,Midi-Pyrénées,32,3,15,228,Manent-Montané,87,3,90
73,Midi-Pyrénées,32,2,16,229,Mansempuy,78,2,80
73,Midi-Pyrénées,32,2,06,230,Mansencôme,67,0,67
73,Midi-Pyrénées,32,1,29,231,Marambat,387,12,399
73,Midi-Pyrénées,32,2,16,232,Maravat,43,1,44
73,Midi-Pyrénées,32,3,14,233,Marciac,1231,111,1342
73,Midi-Pyrénées,32,1,10,234,Marestaing,218,6,224
73,Midi-Pyrénées,32,3,01,235,Margouët-Meymes,198,6,204
73,Midi-Pyrénées,32,2,04,236,Marguestau,62,2,64
73,Midi-Pyrénées,32,1,09,237,Marsan,416,17,433
73,Midi-Pyrénées,32,3,19,238,Marseillan,80,1,81
73,Midi-Pyrénées,32,2,12,239,Marsolan,434,5,439
73,Midi-Pyrénées,32,2,12,241,Mas-d'Auvignon,147,3,150
73,Midi-Pyrénées,32,3,20,240,Mascaras,60,1,61
73,Midi-Pyrénées,32,3,15,242,Masseube,1594,324,1918
73,Midi-Pyrénées,32,2,04,243,Mauléon-d'Armagnac,281,3,284
73,Midi-Pyrénées,32,3,24,244,Maulichères,161,7,168
73,Midi-Pyrénées,32,3,24,245,Maumusson-Laguian,155,5,160
73,Midi-Pyrénées,32,2,04,246,Maupas,197,1,198
73,Midi-Pyrénées,32,1,09,247,Maurens,300,4,304
73,Midi-Pyrénées,32,2,25,248,Mauroux,141,7,148
73,Midi-Pyrénées,32,2,16,249,Mauvezin,1849,45,1894
73,Midi-Pyrénées,32,1,13,250,Meilhan,90,2,92
73,Midi-Pyrénées,32,1,11,251,Mérens,62,1,63
73,Midi-Pyrénées,32,3,17,252,Miélan,1218,34,1252
73,Midi-Pyrénées,32,2,18,253,Miradoux,530,11,541
73,Midi-Pyrénées,32,3,19,254,Miramont-d'Astarac,373,12,385
73,Midi-Pyrénées,32,2,08,255,Miramont-Latour,151,4,155
73,Midi-Pyrénées,32,3,19,256,Mirande,3725,331,4056
73,Midi-Pyrénées,32,1,29,257,Mirannes,69,2,71
73,Midi-Pyrénées,32,1,30,258,Mirepoix,197,6,203
73,Midi-Pyrénées,32,3,15,260,Monbardon,90,0,90
73,Midi-Pyrénées,32,1,26,261,Monblanc,360,3,363
73,Midi-Pyrénées,32,1,05,262,Monbrun,324,6,330
73,Midi-Pyrénées,32,3,19,263,Moncassin,131,3,134
73,Midi-Pyrénées,32,2,04,264,Monclar,187,3,190
73,Midi-Pyrénées,32,3,20,265,Monclar-sur-Losse,126,2,128
73,Midi-Pyrénées,32,1,27,266,Moncorneil-Grazan,131,5,136
73,Midi-Pyrénées,32,1,27,267,Monferran-Plavès,126,4,130
73,Midi-Pyrénées,32,1,10,268,Monferran-Savès,686,45,731
73,Midi-Pyrénées,32,2,16,269,Monfort,479,3,482
73,Midi-Pyrénées,32,1,13,270,Mongausy,76,3,79
73,Midi-Pyrénées,32,2,22,271,Monguilhem,294,10,304
73,Midi-Pyrénées,32,3,15,272,Monlaur-Bernet,169,2,171
73,Midi-Pyrénées,32,3,14,273,Monlezun,204,5,209
73,Midi-Pyrénées,32,2,22,274,Monlezun-d'Armagnac,189,8,197
73,Midi-Pyrénées,32,3,14,275,Monpardiac,37,2,39
73,Midi-Pyrénées,32,3,15,280,Mont-d'Astarac,96,5,101
73,Midi-Pyrénées,32,3,17,281,Mont-de-Marrast,96,3,99
73,Midi-Pyrénées,32,1,13,276,Montadet,81,5,86
73,Midi-Pyrénées,32,1,13,277,Montamat,106,2,108
73,Midi-Pyrénées,32,3,17,278,Montaut,118,5,123
73,Midi-Pyrénées,32,1,30,279,Montaut-les-Créneaux,626,15,641
73,Midi-Pyrénées,32,1,02,282,Montégut,473,8,481
73,Midi-Pyrénées,32,3,17,283,Montégut-Arros,295,6,301
73,Midi-Pyrénées,32,1,13,284,Montégut-Savès,75,0,75
73,Midi-Pyrénées,32,3,20,285,Montesquiou,605,21,626
73,Midi-Pyrénées,32,2,08,286,Montestruc-sur-Gers,708,13,721
73,Midi-Pyrénées,32,3,15,287,Monties,72,1,73
73,Midi-Pyrénées,32,1,09,288,Montiron,122,9,131
73,Midi-Pyrénées,32,1,13,289,Montpézat,240,1,241
73,Midi-Pyrénées,32,2,21,290,Montréal,1269,17,1286
73,Midi-Pyrénées,32,2,22,291,Mormès,127,2,129
73,Midi-Pyrénées,32,2,06,292,Mouchan,428,10,438
73,Midi-Pyrénées,32,3,20,293,Mouchès,74,0,74
73,Midi-Pyrénées,32,2,07,294,Mourède,82,2,84
73,Midi-Pyrénées,32,1,26,295,Nizas,160,1,161
73,Midi-Pyrénées,32,2,22,296,Nogaro,1975,159,2134
73,Midi-Pyrénées,32,1,26,297,Noilhan,306,2,308
73,Midi-Pyrénées,32,1,02,298,Nougaroulet,332,9,341
73,Midi-Pyrénées,32,2,07,299,Noulens,99,3,102
73,Midi-Pyrénées,32,1,03,300,Orbessan,266,9,275
73,Midi-Pyrénées,32,1,11,301,Ordan-Larroque,893,40,933
73,Midi-Pyrénées,32,1,03,302,Ornézan,246,7,253
73,Midi-Pyrénées,32,3,14,303,Pallanne,66,0,66
73,Midi-Pyrénées,32,3,15,304,Panassac,293,2,295
73,Midi-Pyrénées,32,2,04,305,Panjas,379,7,386
73,Midi-Pyrénées,32,2,08,306,Pauilhac,563,41,604
73,Midi-Pyrénées,32,1,31,307,Pavie,2350,151,2501
73,Midi-Pyrénées,32,1,26,308,Pébées,95,3,98
73,Midi-Pyrénées,32,1,13,309,Pellefigue,120,0,120
73,Midi-Pyrénées,32,2,22,310,Perchède,80,1,81
73,Midi-Pyrénées,32,2,12,311,Pergain-Taillac,317,6,323
73,Midi-Pyrénées,32,1,03,312,Pessan,689,18,707
73,Midi-Pyrénées,32,2,25,313,Pessoulens,146,5,151
73,Midi-Pyrénées,32,2,18,314,Peyrecave,83,4,87
73,Midi-Pyrénées,32,3,20,315,Peyrusse-Grande,178,2,180
73,Midi-Pyrénées,32,1,11,316,Peyrusse-Massas,107,1,108
73,Midi-Pyrénées,32,3,20,317,Peyrusse-Vieille,69,3,72
73,Midi-Pyrénées,32,2,08,318,Pis,91,1,92
73,Midi-Pyrénées,32,3,23,319,Plaisance,1465,43,1508
73,Midi-Pyrénées,32,2,18,320,Plieux,161,4,165
73,Midi-Pyrénées,32,1,26,321,Polastron,242,6,248
73,Midi-Pyrénées,32,1,26,322,Pompiac,176,3,179
73,Midi-Pyrénées,32,3,19,323,Ponsampère,113,3,116
73,Midi-Pyrénées,32,3,15,324,Ponsan-Soubiran,125,4,129
73,Midi-Pyrénées,32,1,27,327,Pouy-Loubrin,102,0,102
73,Midi-Pyrénées,32,2,12,328,Pouy-Roquelaure,141,6,147
73,Midi-Pyrénées,32,3,01,325,Pouydraguin,144,6,150
73,Midi-Pyrénées,32,3,20,326,Pouylebon,155,0,155
73,Midi-Pyrénées,32,2,08,329,Préchac,162,5,167
73,Midi-Pyrénées,32,3,23,330,Préchac-sur-Adour,214,4,218
73,Midi-Pyrénées,32,1,30,331,Preignan,1222,44,1266
73,Midi-Pyrénées,32,1,29,332,Préneron,141,6,147
73,Midi-Pyrénées,32,3,24,333,Projan,150,2,152
73,Midi-Pyrénées,32,1,10,334,Pujaudran,1271,27,1298
73,Midi-Pyrénées,32,1,02,335,Puycasquier,433,7,440
73,Midi-Pyrénées,32,1,13,336,Puylausic,194,4,198
73,Midi-Pyrénées,32,2,08,337,Puységur,73,1,74
73,Midi-Pyrénées,32,2,07,338,Ramouzens,151,12,163
73,Midi-Pyrénées,32,1,10,339,Razengues,179,3,182
73,Midi-Pyrénées,32,2,04,340,Réans,251,7,258
73,Midi-Pyrénées,32,2,08,341,Réjaumont,189,6,195
73,Midi-Pyrénées,32,3,14,342,Ricourt,70,4,74
73,Midi-Pyrénées,32,1,29,343,Riguepeu,218,8,226
73,Midi-Pyrénées,32,3,24,344,Riscle,1707,119,1826
73,Midi-Pyrénées,32,2,06,345,La Romieu,535,12,547
73,Midi-Pyrénées,32,1,29,346,Roquebrune,195,5,200
73,Midi-Pyrénées,32,1,11,347,Roquefort,256,13,269
73,Midi-Pyrénées,32,1,30,348,Roquelaure,544,22,566
73,Midi-Pyrénées,32,1,05,349,Roquelaure-Saint-Aubin,106,2,108
73,Midi-Pyrénées,32,2,28,350,Roquepine,60,0,60
73,Midi-Pyrénées,32,2,28,351,Roques,120,4,124
73,Midi-Pyrénées,32,2,28,352,Rozès,126,5,131
73,Midi-Pyrénées,32,1,13,353,Sabaillan,157,5,162
73,Midi-Pyrénées,32,3,01,354,Sabazan,141,3,144
73,Midi-Pyrénées,32,3,17,355,Sadeillan,80,2,82
73,Midi-Pyrénées,32,1,26,356,Saint-André,89,5,94
73,Midi-Pyrénées,32,2,18,358,Saint-Antoine,194,9,203
73,Midi-Pyrénées,32,2,16,359,Saint-Antonin,136,7,143
73,Midi-Pyrénées,32,1,29,360,Saint-Arailles,133,3,136
73,Midi-Pyrénées,32,3,15,361,Saint-Arroman,137,4,141
73,Midi-Pyrénées,32,3,23,362,Saint-Aunix-Lengros,151,5,156
73,Midi-Pyrénées,32,2,12,364,Saint-Avit-Frandat,106,2,108
73,Midi-Pyrénées,32,3,15,365,Saint-Blancard,334,6,340
73,Midi-Pyrénées,32,2,16,366,Saint-Brès,94,7,101
73,Midi-Pyrénées,32,1,09,467,Saint-Caprais,122,3,125
73,Midi-Pyrénées,32,3,20,367,Saint-Christaud,75,1,76
73,Midi-Pyrénées,32,2,25,370,Saint-Clar,980,85,1065
73,Midi-Pyrénées,32,2,25,371,Saint-Créac,101,1,102
73,Midi-Pyrénées,32,1,05,372,Saint-Cricq,251,7,258
73,Midi-Pyrénées,32,1,13,374,Saint-Élix,186,5,191
73,Midi-Pyrénées,32,3,19,375,Saint-Élix-Theux,111,2,113
73,Midi-Pyrénées,32,1,05,377,Saint-Georges,170,1,171
73,Midi-Pyrénées,32,3,24,378,Saint-Germé,501,8,509
73,Midi-Pyrénées,32,1,05,379,Saint-Germier,200,8,208
73,Midi-Pyrénées,32,2,22,380,Saint-Griède,133,7,140
73,Midi-Pyrénées,32,1,31,381,Saint-Jean-le-Comtal,380,9,389
73,Midi-Pyrénées,32,1,29,382,Saint-Jean-Poutge,291,5,296
73,Midi-Pyrénées,32,3,14,383,Saint-Justin,160,7,167
73,Midi-Pyrénées,32,1,11,384,Saint-Lary,237,6,243
73,Midi-Pyrénées,32,2,25,385,Saint-Léonard,170,0,170
73,Midi-Pyrénées,32,1,13,386,Saint-Lizier-du-Planté,121,2,123
73,Midi-Pyrénées,32,1,13,387,Saint-Loube,90,1,91
73,Midi-Pyrénées,32,3,19,389,Saint-Martin,441,19,460
73,Midi-Pyrénées,32,2,22,390,Saint-Martin-d'Armagnac,216,11,227
73,Midi-Pyrénées,32,2,12,391,Saint-Martin-de-Goyne,126,2,128
73,Midi-Pyrénées,32,1,27,392,Saint-Martin-Gimois,80,4,84
73,Midi-Pyrénées,32,3,19,393,Saint-Maur,124,5,129
73,Midi-Pyrénées,32,3,19,394,Saint-Médard,338,12,350
73,Midi-Pyrénées,32,2,12,396,Saint-Mézard,208,2,210
73,Midi-Pyrénées,32,3,19,397,Saint-Michel,262,9,271
73,Midi-Pyrénées,32,3,24,398,Saint-Mont,299,12,311
73,Midi-Pyrénées,32,2,16,399,Saint-Orens,81,1,82
73,Midi-Pyrénées,32,2,28,400,Saint-Orens-Pouy-Petit,142,2,144
73,Midi-Pyrénées,32,3,19,401,Saint-Ost,81,5,86
73,Midi-Pyrénées,32,2,28,402,Saint-Paul-de-Baïse,111,1,112
73,Midi-Pyrénées,32,3,01,403,Saint-Pierre-d'Aubézies,77,1,78
73,Midi-Pyrénées,32,2,28,404,Saint-Puy,572,8,580
73,Midi-Pyrénées,32,1,09,406,Saint-Sauvy,346,11,357
73,Midi-Pyrénées,32,1,26,407,Saint-Soulan,144,2,146
73,Midi-Pyrénées,32,1,05,357,Sainte-Anne,109,5,114
73,Midi-Pyrénées,32,3,17,363,Sainte-Aurence-Cazaux,121,3,124
73,Midi-Pyrénées,32,1,30,368,Sainte-Christie,539,12,551
73,Midi-Pyrénées,32,2,22,369,Sainte-Christie-d'Armagnac,348,6,354
73,Midi-Pyrénées,32,3,17,373,Sainte-Dode,223,9,232
73,Midi-Pyrénées,32,2,16,376,Sainte-Gemme,132,4,136
73,Midi-Pyrénées,32,1,09,388,Sainte-Marie,351,8,359
73,Midi-Pyrénées,32,2,18,395,Sainte-Mère,198,7,205
73,Midi-Pyrénées,32,2,08,405,Sainte-Radegonde,187,4,191
73,Midi-Pyrénées,32,2,22,408,Salles-d'Armagnac,119,8,127
73,Midi-Pyrénées,32,3,15,409,Samaran,93,5,98
73,Midi-Pyrénées,32,1,26,410,Samatan,2276,89,2365
73,Midi-Pyrénées,32,1,03,411,Sansan,93,3,96
73,Midi-Pyrénées,32,1,27,412,Saramon,782,13,795
73,Midi-Pyrénées,32,3,15,413,Sarcos,73,4,77
73,Midi-Pyrénées,32,3,01,414,Sarragachies,256,11,267
73,Midi-Pyrénées,32,3,17,415,Sarraguzan,95,0,95
73,Midi-Pyrénées,32,2,16,416,Sarrant,329,10,339
73,Midi-Pyrénées,32,2,08,417,La Sauvetat,358,8,366
73,Midi-Pyrénées,32,1,13,418,Sauveterre,226,70,296
73,Midi-Pyrénées,32,3,19,419,Sauviac,110,3,113
73,Midi-Pyrénées,32,1,13,420,Sauvimont,70,2,72
73,Midi-Pyrénées,32,1,26,421,Savignac-Mona,147,0,147
73,Midi-Pyrénées,32,3,14,422,Scieurac-et-Flourès,47,0,47
73,Midi-Pyrénées,32,2,07,423,Séailles,64,1,65
73,Midi-Pyrénées,32,3,24,424,Ségos,254,7,261
73,Midi-Pyrénées,32,1,10,425,Ségoufielle,893,28,921
73,Midi-Pyrénées,32,1,03,426,Seissan,1041,29,1070
73,Midi-Pyrénées,32,3,14,427,Sembouès,62,0,62
73,Midi-Pyrénées,32,1,27,428,Sémézies-Cachan,80,0,80
73,Midi-Pyrénées,32,2,18,429,Sempesserre,300,11,311
73,Midi-Pyrénées,32,3,15,430,Sère,92,1,93
73,Midi-Pyrénées,32,2,16,431,Sérempuy,38,1,39
73,Midi-Pyrénées,32,1,26,432,Seysses-Savès,260,7,267
73,Midi-Pyrénées,32,1,13,433,Simorre,654,16,670
73,Midi-Pyrénées,32,2,22,434,Sion,103,6,109
73,Midi-Pyrénées,32,1,05,435,Sirac,123,2,125
73,Midi-Pyrénées,32,2,16,436,Solomiac,418,9,427
73,Midi-Pyrénées,32,2,22,437,Sorbets,227,3,230
73,Midi-Pyrénées,32,1,27,438,Tachoires,97,7,104
73,Midi-Pyrénées,32,3,24,439,Tarsac,165,1,166
73,Midi-Pyrénées,32,3,23,440,Tasque,232,3,235
73,Midi-Pyrénées,32,2,08,441,Taybosc,55,0,55
73,Midi-Pyrénées,32,3,01,443,Termes-d'Armagnac,197,10,207
73,Midi-Pyrénées,32,2,12,442,Terraube,391,20,411
73,Midi-Pyrénées,32,1,05,444,Thoux,213,7,220
73,Midi-Pyrénées,32,3,23,445,Tieste-Uragnoux,130,4,134
73,Midi-Pyrénées,32,3,14,446,Tillac,254,10,264
73,Midi-Pyrénées,32,1,27,447,Tirent-Pontéjac,87,0,87
73,Midi-Pyrénées,32,1,05,448,Touget,497,14,511
73,Midi-Pyrénées,32,2,22,449,Toujouse,203,5,208
73,Midi-Pyrénées,32,3,14,450,Tourdun,97,9,106
73,Midi-Pyrénées,32,1,13,451,Tournan,198,2,200
73,Midi-Pyrénées,32,2,25,452,Tournecoupe,283,6,289
73,Midi-Pyrénées,32,1,02,453,Tourrenquets,123,1,124
73,Midi-Pyrénées,32,1,27,454,Traversères,77,3,80
73,Midi-Pyrénées,32,3,14,455,Troncens,184,3,187
73,Midi-Pyrénées,32,1,29,456,Tudelle,65,1,66
73,Midi-Pyrénées,32,2,08,457,Urdens,230,8,238
73,Midi-Pyrénées,32,2,22,458,Urgosse,235,7,242
73,Midi-Pyrénées,32,2,28,459,Valence-sur-Baïse,1194,18,1212
73,Midi-Pyrénées,32,3,24,460,Vergoignan,279,4,283
73,Midi-Pyrénées,32,3,24,461,Verlus,99,7,106
73,Midi-Pyrénées,32,1,29,462,Vic-Fezensac,3628,112,3740
73,Midi-Pyrénées,32,3,24,463,Viella,528,31,559
73,Midi-Pyrénées,32,3,17,464,Villecomtal-sur-Arros,816,15,831
73,Midi-Pyrénées,32,1,13,465,Villefranche,163,3,166
73,Midi-Pyrénées,32,3,19,466,Viozan,123,1,124
72,Aquitaine,33,5,22,001,Abzac,1739,49,1788
72,Aquitaine,33,3,03,002,Aillas,736,20,756
72,Aquitaine,33,2,19,003,Ambarès-et-Lagrave,13142,236,13378
72,Aquitaine,33,2,60,004,Ambès,2941,28,2969
72,Aquitaine,33,6,02,005,Andernos-les-Bains,10793,269,11062
72,Aquitaine,33,1,40,006,Anglade,821,18,839
72,Aquitaine,33,3,36,007,Arbanats,1010,10,1020
72,Aquitaine,33,3,48,008,Arbis,286,4,290
72,Aquitaine,33,6,01,009,Arcachon,11789,295,12084
72,Aquitaine,33,4,20,010,Arcins,398,0,398
72,Aquitaine,33,6,02,011,Arès,5520,101,5621
72,Aquitaine,33,4,20,012,Arsac,3023,47,3070
72,Aquitaine,33,5,31,014,Les Artigues-de-Lussac,1024,17,1041
72,Aquitaine,33,2,55,013,Artigues-près-Bordeaux,6754,74,6828
72,Aquitaine,33,5,30,015,Arveyres,1870,37,1907
72,Aquitaine,33,5,24,016,Asques,476,12,488
72,Aquitaine,33,3,04,017,Aubiac,245,7,252
72,Aquitaine,33,1,39,018,Aubie-et-Espessas,1125,12,1137
72,Aquitaine,33,6,02,019,Audenge,5736,96,5832
72,Aquitaine,33,3,34,020,Auriolles,134,6,140
72,Aquitaine,33,3,03,021,Auros,864,23,887
72,Aquitaine,33,4,20,022,Avensan,2138,36,2174
72,Aquitaine,33,2,27,023,Ayguemorte-les-Graves,953,7,960
72,Aquitaine,33,3,38,024,Bagas,248,1,249
72,Aquitaine,33,3,48,025,Baigneaux,333,8,341
72,Aquitaine,33,3,45,026,Balizac,414,7,421
72,Aquitaine,33,3,03,027,Barie,285,5,290
72,Aquitaine,33,5,16,028,Baron,991,14,1005
72,Aquitaine,33,6,05,029,Le Barp,4448,55,4503
72,Aquitaine,33,3,36,030,Barsac,1964,42,2006
72,Aquitaine,33,3,03,031,Bassanne,83,1,84
72,Aquitaine,33,2,60,032,Bassens,6618,48,6666
72,Aquitaine,33,2,23,033,Baurech,771,17,788
72,Aquitaine,33,5,26,034,Bayas,453,8,461
72,Aquitaine,33,1,15,035,Bayon-sur-Gironde,710,13,723
72,Aquitaine,33,3,04,036,Bazas,4607,268,4875
72,Aquitaine,33,2,27,037,Beautiran,2168,23,2191
72,Aquitaine,33,4,29,038,Bégadan,884,20,904
72,Aquitaine,33,2,52,039,Bègles,24999,217,25216
72,Aquitaine,33,3,17,040,Béguey,1099,12,1111
72,Aquitaine,33,6,05,042,Belin-Béliet,4144,67,4211
72,Aquitaine,33,3,48,043,Bellebat,226,1,227
72,Aquitaine,33,3,48,044,Bellefond,230,4,234
72,Aquitaine,33,5,21,045,Belvès-de-Castillon,319,11,330
72,Aquitaine,33,3,04,046,Bernos-Beaulac,1115,26,1141
72,Aquitaine,33,1,07,047,Berson,1727,38,1765
72,Aquitaine,33,3,03,048,Berthez,216,2,218
72,Aquitaine,33,2,55,049,Beychac-et-Caillau,1986,23,2009
72,Aquitaine,33,3,28,050,Bieujac,479,12,491
72,Aquitaine,33,6,02,051,Biganos,9099,140,9239
72,Aquitaine,33,5,30,052,Les Billaux,1044,21,1065
72,Aquitaine,33,3,04,053,Birac,225,6,231
72,Aquitaine,33,3,38,054,Blaignac,257,14,271
72,Aquitaine,33,4,29,055,Blaignan,229,1,230
72,Aquitaine,33,2,06,056,Blanquefort,14814,676,15490
72,Aquitaine,33,3,47,057,Blasimon,861,17,878
72,Aquitaine,33,1,07,058,Blaye,4959,241,5200
72,Aquitaine,33,2,23,059,Blésignac,300,3,303
72,Aquitaine,33,3,28,060,Bommes,473,65,538
72,Aquitaine,33,2,23,061,Bonnetan,815,14,829
72,Aquitaine,33,5,26,062,Bonzac,721,9,730
72,Aquitaine,33,2,99,063,Bordeaux,235891,3751,239642
72,Aquitaine,33,5,37,064,Bossugan,45,1,46
72,Aquitaine,33,2,58,065,Bouliac,3036,87,3123
72,Aquitaine,33,3,38,066,Bourdelles,124,1,125
72,Aquitaine,33,1,15,067,Bourg,2210,42,2252
72,Aquitaine,33,3,50,068,Bourideys,89,0,89
72,Aquitaine,33,2,54,069,Le Bouscat,23193,392,23585
72,Aquitaine,33,4,20,070,Brach,424,1,425
72,Aquitaine,33,5,16,071,Branne,1213,21,1234
72,Aquitaine,33,3,03,072,Brannens,219,4,223
72,Aquitaine,33,1,40,073,Braud-et-Saint-Louis,1374,30,1404
72,Aquitaine,33,2,27,213,La Brède,3722,357,4079
72,Aquitaine,33,3,03,074,Brouqueyran,196,3,199
72,Aquitaine,33,2,54,075,Bruges,14058,178,14236
72,Aquitaine,33,3,36,076,Budos,696,7,703
72,Aquitaine,33,2,27,077,Cabanac-et-Villagrains,2115,27,2142
72,Aquitaine,33,5,16,078,Cabara,350,7,357
72,Aquitaine,33,5,30,079,Cadarsac,251,6,257
72,Aquitaine,33,2,27,080,Cadaujac,4744,169,4913
72,Aquitaine,33,3,17,081,Cadillac,2382,37,2419
72,Aquitaine,33,5,24,082,Cadillac-en-Fronsadais,1101,14,1115
72,Aquitaine,33,2,23,083,Camarsac,931,13,944
72,Aquitaine,33,2,23,084,Cambes,1349,26,1375
72,Aquitaine,33,2,23,085,Camblanes-et-Meynac,2598,127,2725
72,Aquitaine,33,5,16,086,Camiac-et-Saint-Denis,367,6,373
72,Aquitaine,33,3,38,087,Camiran,440,16,456
72,Aquitaine,33,5,22,088,Camps-sur-l'Isle,495,7,502
72,Aquitaine,33,1,07,089,Campugnan,461,21,482
72,Aquitaine,33,2,59,090,Canéjan,5009,94,5103
72,Aquitaine,33,4,20,091,Cantenac,1269,12,1281
72,Aquitaine,33,3,48,092,Cantois,220,4,224
72,Aquitaine,33,3,17,093,Capian,620,8,628
72,Aquitaine,33,5,41,094,Caplong,206,8,214
72,Aquitaine,33,3,18,095,Captieux,1385,14,1399
72,Aquitaine,33,2,19,096,Carbon-Blanc,6936,74,7010
72,Aquitaine,33,4,42,097,Carcans,2139,43,2182
72,Aquitaine,33,3,17,098,Cardan,420,4,424
72,Aquitaine,33,2,23,099,Carignan-de-Bordeaux,3559,103,3662
72,Aquitaine,33,1,07,100,Cars,1171,29,1200
72,Aquitaine,33,1,07,101,Cartelègue,1037,18,1055
72,Aquitaine,33,3,38,102,Casseuil,365,3,368
72,Aquitaine,33,3,32,103,Castelmoron-d'Albret,55,2,57
72,Aquitaine,33,4,20,104,Castelnau-de-Médoc,3768,63,3831
72,Aquitaine,33,3,47,105,Castelviel,181,9,190
72,Aquitaine,33,3,28,106,Castets-en-Dorthe,1240,21,1261
72,Aquitaine,33,3,03,107,Castillon-de-Castets,276,9,285
72,Aquitaine,33,5,21,108,Castillon-la-Bataille,3362,54,3416
72,Aquitaine,33,2,27,109,Castres-Gironde,1953,25,1978
72,Aquitaine,33,3,43,111,Caudrot,1067,18,1085
72,Aquitaine,33,3,34,112,Caumont,159,5,164
72,Aquitaine,33,3,25,113,Cauvignac,134,3,137
72,Aquitaine,33,1,44,114,Cavignac,1569,26,1595
72,Aquitaine,33,3,50,115,Cazalis,219,13,232
72,Aquitaine,33,3,04,116,Cazats,307,5,312
72,Aquitaine,33,3,34,117,Cazaugitat,251,6,257
72,Aquitaine,33,2,23,118,Cénac,1845,56,1901
72,Aquitaine,33,2,55,119,Cenon,22452,273,22725
72,Aquitaine,33,3,36,120,Cérons,1696,24,1720
72,Aquitaine,33,3,48,121,Cessac,184,5,189
72,Aquitaine,33,2,59,122,Cestas,16483,455,16938
72,Aquitaine,33,1,44,123,Cézac,2160,26,2186
72,Aquitaine,33,5,22,124,Chamadelle,656,11,667
72,Aquitaine,33,4,33,125,Cissac-Médoc,1741,20,1761
72,Aquitaine,33,1,44,126,Civrac-de-Blaye,785,6,791
72,Aquitaine,33,4,29,128,Civrac-en-Médoc,551,8,559
72,Aquitaine,33,5,37,127,Civrac-sur-Dordogne,245,3,248
72,Aquitaine,33,3,47,129,Cleyrac,146,0,146
72,Aquitaine,33,3,03,130,Coimères,790,15,805
72,Aquitaine,33,3,47,131,Coirac,200,5,205
72,Aquitaine,33,1,15,132,Comps,458,3,461
72,Aquitaine,33,5,37,133,Coubeyrac,104,1,105
72,Aquitaine,33,4,29,134,Couquèques,243,7,250
72,Aquitaine,33,3,48,135,Courpiac,91,1,92
72,Aquitaine,33,3,32,136,Cours-de-Monségur,274,6,280
72,Aquitaine,33,3,25,137,Cours-les-Bains,216,4,220
72,Aquitaine,33,5,22,138,Coutras,7902,160,8062
72,Aquitaine,33,3,32,139,Coutures,84,0,84
72,Aquitaine,33,2,23,140,Créon,4030,78,4108
72,Aquitaine,33,2,23,141,Croignon,479,7,486
72,Aquitaine,33,1,44,142,Cubnezais,1211,14,1225
72,Aquitaine,33,1,39,143,Cubzac-les-Ponts,1932,15,1947
72,Aquitaine,33,3,04,144,Cudos,814,162,976
72,Aquitaine,33,2,23,145,Cursan,466,4,470
72,Aquitaine,33,4,20,146,Cussac-Fort-Médoc,1794,25,1819
72,Aquitaine,33,5,16,147,Daignac,491,9,500
72,Aquitaine,33,5,16,148,Dardenac,91,1,92
72,Aquitaine,33,3,47,149,Daubèze,152,3,155
72,Aquitaine,33,3,32,150,Dieulivol,262,9,271
72,Aquitaine,33,1,44,151,Donnezac,832,11,843
72,Aquitaine,33,3,17,152,Donzac,125,4,129
72,Aquitaine,33,5,37,153,Doulezon,265,4,269
72,Aquitaine,33,5,22,154,Les Églisottes-et-Chalaures,2118,130,2248
72,Aquitaine,33,3,18,155,Escaudes,142,3,145
72,Aquitaine,33,3,48,156,Escoussans,270,5,275
72,Aquitaine,33,5,16,157,Espiet,708,9,717
72,Aquitaine,33,3,38,158,Les Esseintes,278,5,283
72,Aquitaine,33,1,40,159,Étauliers,1687,55,1742
72,Aquitaine,33,5,41,160,Eynesse,569,18,587
72,Aquitaine,33,1,40,161,Eyrans,667,16,683
72,Aquitaine,33,2,06,162,Eysines,18747,398,19145
72,Aquitaine,33,3,48,163,Faleyras,396,13,409
72,Aquitaine,33,3,28,164,Fargues,1617,58,1675
72,Aquitaine,33,2,23,165,Fargues-Saint-Hilaire,2755,35,2790
72,Aquitaine,33,5,22,166,Le Fieu,479,7,486
72,Aquitaine,33,5,37,168,Flaujagues,522,4,526
72,Aquitaine,33,2,58,167,Floirac,16029,224,16253
72,Aquitaine,33,3,38,169,Floudès,113,9,122
72,Aquitaine,33,3,38,170,Fontet,736,16,752
72,Aquitaine,33,3,38,171,Fossès-et-Baleyssac,192,1,193
72,Aquitaine,33,1,07,172,Fours,289,10,299
72,Aquitaine,33,5,31,173,Francs,208,6,214
72,Aquitaine,33,5,24,174,Fronsac,1046,28,1074
72,Aquitaine,33,3,48,175,Frontenac,710,10,720
72,Aquitaine,33,3,17,176,Gabarnac,297,8,305
72,Aquitaine,33,4,29,177,Gaillan-en-Médoc,2028,49,2077
72,Aquitaine,33,3,04,178,Gajac,395,6,401
72,Aquitaine,33,5,24,179,Galgon,2503,75,2578
72,Aquitaine,33,3,04,180,Gans,186,6,192
72,Aquitaine,33,5,21,181,Gardegan-et-Tourtirac,304,11,315
72,Aquitaine,33,1,15,182,Gauriac,844,14,858
72,Aquitaine,33,1,39,183,Gauriaguet,1095,10,1105
72,Aquitaine,33,1,44,184,Générac,576,9,585
72,Aquitaine,33,5,16,185,Génissac,1644,54,1698
72,Aquitaine,33,5,37,186,Gensac,850,27,877
72,Aquitaine,33,3,38,187,Gironde-sur-Dropt,1133,18,1151
72,Aquitaine,33,3,18,188,Giscos,190,3,193
72,Aquitaine,33,3,47,189,Gornac,374,7,381
72,Aquitaine,33,3,18,190,Goualade,83,6,89
72,Aquitaine,33,5,31,191,Gours,414,5,419
72,Aquitaine,33,2,59,192,Gradignan,23283,467,23750
72,Aquitaine,33,4,46,193,Grayan-et-l'Hôpital,1090,17,1107
72,Aquitaine,33,5,16,194,Grézillac,685,19,704
72,Aquitaine,33,3,25,195,Grignols,1112,27,1139
72,Aquitaine,33,5,16,196,Guillac,186,6,192
72,Aquitaine,33,3,36,197,Guillos,398,6,404
72,Aquitaine,33,5,26,198,Guîtres,1637,30,1667
72,Aquitaine,33,6,49,199,Gujan-Mestras,18461,528,18989
72,Aquitaine,33,2,63,200,Le Haillan,8362,334,8696
72,Aquitaine,33,2,23,201,Haux,771,21,792
72,Aquitaine,33,3,45,202,Hostens,1230,16,1246
72,Aquitaine,33,4,42,203,Hourtin,2767,49,2816
72,Aquitaine,33,3,38,204,Hure,486,15,501
72,Aquitaine,33,3,36,205,Illats,1256,17,1273
72,Aquitaine,33,2,27,206,Isle-Saint-Georges,531,46,577
72,Aquitaine,33,5,30,207,Izon,5279,94,5373
72,Aquitaine,33,4,46,208,Jau-Dignac-et-Loirac,1010,16,1026
72,Aquitaine,33,5,16,209,Jugazan,274,7,281
72,Aquitaine,33,5,37,210,Juillac,262,5,267
72,Aquitaine,33,4,20,211,Labarde,619,6,625
72,Aquitaine,33,3,25,212,Labescau,101,0,101
72,Aquitaine,33,4,20,214,Lacanau,4381,75,4456
72,Aquitaine,33,3,48,215,Ladaux,198,3,201
72,Aquitaine,33,3,03,216,Lados,139,4,143
72,Aquitaine,33,5,26,218,Lagorce,1630,27,1657
72,Aquitaine,33,5,30,222,Lalande-de-Pomerol,679,9,688
72,Aquitaine,33,4,20,220,Lamarque,1127,8,1135
72,Aquitaine,33,3,38,221,Lamothe-Landerron,1095,37,1132
72,Aquitaine,33,5,24,219,La Lande-de-Fronsac,2195,77,2272
72,Aquitaine,33,3,34,223,Landerrouat,179,2,181
72,Aquitaine,33,3,32,224,Landerrouet-sur-Ségur,119,3,122
72,Aquitaine,33,3,36,225,Landiras,1969,51,2020
72,Aquitaine,33,3,17,226,Langoiran,2116,23,2139
72,Aquitaine,33,3,28,227,Langon,7409,462,7871
72,Aquitaine,33,1,15,228,Lansac,632,6,638
72,Aquitaine,33,6,02,229,Lanton,6064,112,6176
72,Aquitaine,33,5,26,230,Lapouyade,445,10,455
72,Aquitaine,33,3,17,231,Laroque,261,2,263
72,Aquitaine,33,3,18,232,Lartigue,59,2,61
72,Aquitaine,33,1,44,233,Laruscade,2277,41,2318
72,Aquitaine,33,2,23,234,Latresne,3274,63,3337
72,Aquitaine,33,3,25,235,Lavazan,222,6,228
72,Aquitaine,33,6,02,236,Lège-Cap-Ferret,7396,134,7530
72,Aquitaine,33,3,28,237,Léogeats,683,14,697
72,Aquitaine,33,2,27,238,Léognan,9021,157,9178
72,Aquitaine,33,3,25,239,Lerm-et-Musset,457,17,474
72,Aquitaine,33,4,29,240,Lesparre-Médoc,5394,215,5609
72,Aquitaine,33,3,17,241,Lestiac-sur-Garonne,664,12,676
72,Aquitaine,33,5,41,242,Les Lèves-et-Thoumeyragues,539,18,557
72,Aquitaine,33,5,30,243,Libourne,23725,670,24395
72,Aquitaine,33,3,04,244,Lignan-de-Bazas,259,9,268
72,Aquitaine,33,2,23,245,Lignan-de-Bordeaux,708,14,722
72,Aquitaine,33,5,41,246,Ligueux,168,4,172
72,Aquitaine,33,3,34,247,Listrac-de-Durèze,178,0,178
72,Aquitaine,33,4,20,248,Listrac-Médoc,2242,34,2276
72,Aquitaine,33,2,60,249,Lormont,19940,356,20296
72,Aquitaine,33,3,38,250,Loubens,305,12,317
72,Aquitaine,33,3,45,251,Louchats,713,8,721
72,Aquitaine,33,2,23,252,Loupes,619,4,623
72,Aquitaine,33,3,17,253,Loupiac,1001,18,1019
72,Aquitaine,33,3,38,254,Loupiac-de-la-Réole,445,2,447
72,Aquitaine,33,3,50,255,Lucmau,229,7,236
72,Aquitaine,33,2,06,256,Ludon-Médoc,3958,37,3995
72,Aquitaine,33,5,16,257,Lugaignac,372,17,389
72,Aquitaine,33,3,48,258,Lugasson,279,17,296
72,Aquitaine,33,5,24,259,Lugon-et-l'Île-du-Carnay,1084,26,1110
72,Aquitaine,33,6,05,260,Lugos,810,15,825
72,Aquitaine,33,5,31,261,Lussac,1312,60,1372
72,Aquitaine,33,2,06,262,Macau,3363,28,3391
72,Aquitaine,33,2,23,263,Madirac,191,1,192
72,Aquitaine,33,5,26,264,Maransin,1075,30,1105
72,Aquitaine,33,1,44,266,Marcenais,676,27,703
72,Aquitaine,33,6,02,555,Marcheprime,3968,122,4090
72,Aquitaine,33,1,40,267,Marcillac,1132,15,1147
72,Aquitaine,33,4,20,268,Margaux,1479,31,1510
72,Aquitaine,33,5,41,269,Margueron,404,10,414
72,Aquitaine,33,3,04,270,Marimbault,151,3,154
72,Aquitaine,33,3,25,271,Marions,190,2,192
72,Aquitaine,33,1,44,272,Marsas,1081,11,1092
72,Aquitaine,33,2,61,273,Martignas-sur-Jalle,6796,117,6913
72,Aquitaine,33,2,27,274,Martillac,2331,40,2371
72,Aquitaine,33,3,48,275,Martres,129,2,131
72,Aquitaine,33,3,25,276,Masseilles,122,1,123
72,Aquitaine,33,3,34,277,Massugas,283,8,291
72,Aquitaine,33,3,47,278,Mauriac,252,5,257
72,Aquitaine,33,3,28,279,Mazères,638,39,677
72,Aquitaine,33,1,07,280,Mazion,480,15,495
72,Aquitaine,33,2,98,281,Mérignac,66095,861,66956
72,Aquitaine,33,3,47,282,Mérignas,275,5,280
72,Aquitaine,33,3,32,283,Mesterrieux,210,8,218
72,Aquitaine,33,6,02,284,Mios,6631,81,6712
72,Aquitaine,33,1,15,285,Mombrier,349,7,356
72,Aquitaine,33,3,38,287,Mongauzy,575,21,596
72,Aquitaine,33,3,17,288,Monprimblanc,275,5,280
72,Aquitaine,33,3,32,289,Monségur,1546,40,1586
72,Aquitaine,33,5,31,290,Montagne,1653,120,1773
72,Aquitaine,33,3,38,291,Montagoudin,164,3,167
72,Aquitaine,33,3,48,292,Montignac,131,3,134
72,Aquitaine,33,2,55,293,Montussan,2620,20,2640
72,Aquitaine,33,3,38,294,Morizès,549,11,560
72,Aquitaine,33,5,24,295,Mouillac,105,2,107
72,Aquitaine,33,5,37,296,Mouliets-et-Villemartin,1070,24,1094
72,Aquitaine,33,4,20,297,Moulis-en-Médoc,1714,17,1731
72,Aquitaine,33,5,16,298,Moulon,951,18,969
72,Aquitaine,33,3,47,299,Mourens,395,8,403
72,Aquitaine,33,4,29,300,Naujac-sur-Mer,777,15,792
72,Aquitaine,33,5,16,301,Naujan-et-Postiac,498,5,503
72,Aquitaine,33,5,31,302,Néac,399,8,407
72,Aquitaine,33,5,16,303,Nérigean,874,21,895
72,Aquitaine,33,3,32,304,Neuffons,169,4,173
72,Aquitaine,33,3,04,305,Le Nizan,417,9,426
72,Aquitaine,33,3,38,306,Noaillac,385,6,391
72,Aquitaine,33,3,50,307,Noaillan,1445,27,1472
72,Aquitaine,33,3,17,308,Omet,240,3,243
72,Aquitaine,33,4,29,309,Ordonnac,414,9,423
72,Aquitaine,33,3,45,310,Origne,165,0,165
72,Aquitaine,33,3,17,311,Paillet,1170,28,1198
72,Aquitaine,33,2,06,312,Parempuyre,7409,73,7482
72,Aquitaine,33,4,33,314,Pauillac,5195,129,5324
72,Aquitaine,33,5,22,315,Les Peintures,1505,21,1526
72,Aquitaine,33,3,34,316,Pellegrue,1019,27,1046
72,Aquitaine,33,5,24,317,Périssac,1051,18,1069
72,Aquitaine,33,2,97,318,Pessac,57632,908,58540
72,Aquitaine,33,5,37,319,Pessac-sur-Dordogne,472,10,482
72,Aquitaine,33,5,31,320,Petit-Palais-et-Cornemps,643,14,657
72,Aquitaine,33,1,39,321,Peujard,1693,21,1714
72,Aquitaine,33,2,06,322,Le Pian-Médoc,5245,154,5399
72,Aquitaine,33,3,43,323,Le Pian-sur-Garonne,686,23,709
72,Aquitaine,33,5,41,324,Pineuilh,4195,135,4330
72,Aquitaine,33,1,07,325,Plassac,906,33,939
72,Aquitaine,33,1,40,326,Pleine-Selve,212,3,215
72,Aquitaine,33,3,36,327,Podensac,2609,34,2643
72,Aquitaine,33,5,30,328,Pomerol,718,24,742
72,Aquitaine,33,3,50,329,Pompéjac,239,12,251
72,Aquitaine,33,2,23,330,Pompignac,2602,46,2648
72,Aquitaine,33,3,03,331,Pondaurat,372,11,383
72,Aquitaine,33,5,22,332,Porchères,882,19,901
72,Aquitaine,33,4,20,333,Le Porge,2360,35,2395
72,Aquitaine,33,3,36,334,Portets,2258,28,2286
72,Aquitaine,33,2,23,335,Le Pout,366,3,369
72,Aquitaine,33,3,50,336,Préchac,1024,5,1029
72,Aquitaine,33,3,36,337,Preignac,2157,61,2218
72,Aquitaine,33,4,29,338,Prignac-en-Médoc,224,5,229
72,Aquitaine,33,1,15,339,Prignac-et-Marcamps,1351,16,1367
72,Aquitaine,33,1,15,341,Pugnac,1972,31,2003
72,Aquitaine,33,5,31,342,Puisseguin,880,24,904
72,Aquitaine,33,5,37,344,Pujols,532,12,544
72,Aquitaine,33,3,36,343,Pujols-sur-Ciron,698,17,715
72,Aquitaine,33,3,32,345,Le Puy,393,13,406
72,Aquitaine,33,3,03,346,Puybarban,410,10,420
72,Aquitaine,33,5,31,347,Puynormand,309,1,310
72,Aquitaine,33,4,29,348,Queyrac,1369,26,1395
72,Aquitaine,33,2,23,349,Quinsac,1999,21,2020
72,Aquitaine,33,5,37,350,Rauzan,1134,30,1164
72,Aquitaine,33,1,40,351,Reignac,1402,53,1455
72,Aquitaine,33,3,38,352,La Réole,4214,130,4344
72,Aquitaine,33,3,32,353,Rimons,200,2,202
72,Aquitaine,33,5,41,354,Riocaud,197,4,201
72,Aquitaine,33,3,17,355,Rions,1549,29,1578
72,Aquitaine,33,5,24,356,La Rivière,316,7,323
72,Aquitaine,33,3,28,357,Roaillan,1186,19,1205
72,Aquitaine,33,3,48,358,Romagne,364,6,370
72,Aquitaine,33,3,32,359,Roquebrune,233,3,236
72,Aquitaine,33,5,41,360,La Roquille,302,6,308
72,Aquitaine,33,3,47,361,Ruch,538,4,542
72,Aquitaine,33,5,26,362,Sablons,1290,36,1326
72,Aquitaine,33,2,23,363,Sadirac,3408,53,3461
72,Aquitaine,33,5,24,364,Saillans,396,5,401
72,Aquitaine,33,5,24,365,Saint-Aignan,232,16,248
72,Aquitaine,33,1,39,366,Saint-André-de-Cubzac,8977,198,9175
72,Aquitaine,33,3,43,367,Saint-André-du-Bois,379,9,388
72,Aquitaine,33,5,41,369,Saint-André-et-Appelles,671,22,693
72,Aquitaine,33,1,07,370,Saint-Androny,598,18,616
72,Aquitaine,33,1,39,371,Saint-Antoine,447,5,452
72,Aquitaine,33,3,34,372,Saint-Antoine-du-Queyret,92,5,97
72,Aquitaine,33,5,22,373,Saint-Antoine-sur-l'Isle,535,7,542
72,Aquitaine,33,1,40,374,Saint-Aubin-de-Blaye,779,29,808
72,Aquitaine,33,5,16,375,Saint-Aubin-de-Branne,363,6,369
72,Aquitaine,33,2,63,376,Saint-Aubin-de-Médoc,5793,159,5952
72,Aquitaine,33,5,41,377,Saint-Avit-de-Soulège,75,5,80
72,Aquitaine,33,5,41,378,Saint-Avit-Saint-Nazaire,1494,63,1557
72,Aquitaine,33,3,47,379,Saint-Brice,307,8,315
72,Aquitaine,33,1,40,380,Saint-Caprais-de-Blaye,540,13,553
72,Aquitaine,33,2,23,381,Saint-Caprais-de-Bordeaux,2729,37,2766
72,Aquitaine,33,1,44,382,Saint-Christoly-de-Blaye,1882,51,1933
72,Aquitaine,33,4,29,383,Saint-Christoly-Médoc,291,7,298
72,Aquitaine,33,5,22,385,Saint-Christophe-de-Double,653,7,660
72,Aquitaine,33,5,31,384,Saint-Christophe-des-Bardes,514,7,521
72,Aquitaine,33,5,31,386,Saint-Cibard,210,1,211
72,Aquitaine,33,5,26,387,Saint-Ciers-d'Abzac,1269,17,1286
72,Aquitaine,33,1,15,388,Saint-Ciers-de-Canesse,782,17,799
72,Aquitaine,33,1,40,389,Saint-Ciers-sur-Gironde,3095,90,3185
72,Aquitaine,33,3,04,391,Saint-Côme,297,6,303
72,Aquitaine,33,5,26,393,Saint-Denis-de-Pile,4940,132,5072
72,Aquitaine,33,5,30,394,Saint-Émilion,2020,68,2088
72,Aquitaine,33,4,33,395,Saint-Estèphe,1695,39,1734
72,Aquitaine,33,5,21,396,Saint-Étienne-de-Lisse,287,9,296
72,Aquitaine,33,3,38,398,Saint-Exupéry,158,5,163
72,Aquitaine,33,3,47,399,Saint-Félix-de-Foncaude,288,4,292
72,Aquitaine,33,3,34,400,Saint-Ferme,361,12,373
72,Aquitaine,33,1,07,405,Saint-Genès-de-Blaye,454,17,471
72,Aquitaine,33,5,21,406,Saint-Genès-de-Castillon,389,6,395
72,Aquitaine,33,5,24,407,Saint-Genès-de-Fronsac,703,9,712
72,Aquitaine,33,2,23,408,Saint-Genès-de-Lombaud,296,9,305
72,Aquitaine,33,3,48,409,Saint-Genis-du-Bois,95,6,101
72,Aquitaine,33,4,29,412,Saint-Germain-d'Esteuil,1187,14,1201
72,Aquitaine,33,3,43,411,Saint-Germain-de-Grave,149,1,150
72,Aquitaine,33,5,24,414,Saint-Germain-de-la-Rivière,333,9,342
72,Aquitaine,33,5,16,413,Saint-Germain-du-Puch,2052,26,2078
72,Aquitaine,33,1,39,415,Saint-Gervais,1461,39,1500
72,Aquitaine,33,1,44,416,Saint-Girons-d'Aiguevives,933,18,951
72,Aquitaine,33,3,38,418,Saint-Hilaire-de-la-Noaille,372,10,382
72,Aquitaine,33,3,47,419,Saint-Hilaire-du-Bois,90,0,90
72,Aquitaine,33,5,21,420,Saint-Hippolyte,165,4,169
72,Aquitaine,33,2,61,422,Saint-Jean-d'Illac,6684,121,6805
72,Aquitaine,33,5,37,421,Saint-Jean-de-Blaignac,356,5,361
72,Aquitaine,33,4,33,423,Saint-Julien-Beychevelle,701,6,707
72,Aquitaine,33,1,39,425,Saint-Laurent-d'Arce,1329,19,1348
72,Aquitaine,33,5,21,426,Saint-Laurent-des-Combes,318,21,339
72,Aquitaine,33,3,43,427,Saint-Laurent-du-Bois,229,5,234
72,Aquitaine,33,3,43,428,Saint-Laurent-du-Plan,84,2,86
72,Aquitaine,33,4,42,424,Saint-Laurent-Médoc,3914,62,3976
72,Aquitaine,33,3,45,429,Saint-Léger-de-Balson,302,5,307
72,Aquitaine,33,2,23,431,Saint-Léon,301,5,306
72,Aquitaine,33,3,28,432,Saint-Loubert,175,0,175
72,Aquitaine,33,2,19,433,Saint-Loubès,7793,109,7902
72,Aquitaine,33,2,60,434,Saint-Louis-de-Montferrand,2052,54,2106
72,Aquitaine,33,3,43,435,Saint-Macaire,1996,138,2134
72,Aquitaine,33,6,05,436,Saint-Magne,993,13,1006
72,Aquitaine,33,5,21,437,Saint-Magne-de-Castillon,1799,23,1822
72,Aquitaine,33,3,43,438,Saint-Maixant,1388,51,1439
72,Aquitaine,33,1,44,439,Saint-Mariens,1458,18,1476
72,Aquitaine,33,3,43,440,Saint-Martial,205,3,208
72,Aquitaine,33,5,26,442,Saint-Martin-de-Laye,484,13,497
72,Aquitaine,33,3,47,443,Saint-Martin-de-Lerm,138,3,141
72,Aquitaine,33,3,43,444,Saint-Martin-de-Sescas,500,8,508
72,Aquitaine,33,5,26,445,Saint-Martin-du-Bois,798,16,814
72,Aquitaine,33,3,47,446,Saint-Martin-du-Puy,205,4,209
72,Aquitaine,33,1,07,441,Saint-Martin-Lacaussade,999,109,1108
72,Aquitaine,33,2,27,448,Saint-Médard-d'Eyrans,2683,102,2785
72,Aquitaine,33,5,22,447,Saint-Médard-de-Guizières,2280,35,2315
72,Aquitaine,33,2,63,449,Saint-Médard-en-Jalles,27427,570,27997
72,Aquitaine,33,3,18,450,Saint-Michel-de-Castelnau,237,7,244
72,Aquitaine,33,5,24,451,Saint-Michel-de-Fronsac,553,13,566
72,Aquitaine,33,3,38,453,Saint-Michel-de-Lapujade,198,3,201
72,Aquitaine,33,3,36,452,Saint-Michel-de-Rieufret,522,9,531
72,Aquitaine,33,2,27,454,Saint-Morillon,1445,17,1462
72,Aquitaine,33,1,40,456,Saint-Palais,481,17,498
72,Aquitaine,33,3,28,457,Saint-Pardon-de-Conques,510,13,523
72,Aquitaine,33,1,07,458,Saint-Paul,916,18,934
72,Aquitaine,33,5,21,459,Saint-Pey-d'Armens,263,2,265
72,Aquitaine,33,5,37,460,Saint-Pey-de-Castets,613,15,628
72,Aquitaine,33,5,21,461,Saint-Philippe-d'Aiguille,419,12,431
72,Aquitaine,33,5,41,462,Saint-Philippe-du-Seignal,458,9,467
72,Aquitaine,33,3,43,463,Saint-Pierre-d'Aurillac,1308,46,1354
72,Aquitaine,33,3,48,464,Saint-Pierre-de-Bat,309,12,321
72,Aquitaine,33,3,28,465,Saint-Pierre-de-Mons,1050,38,1088
72,Aquitaine,33,5,16,466,Saint-Quentin-de-Baron,1543,22,1565
72,Aquitaine,33,5,41,467,Saint-Quentin-de-Caplong,252,3,255
72,Aquitaine,33,5,24,470,Saint-Romain-la-Virvée,782,20,802
72,Aquitaine,33,4,33,471,Saint-Sauveur,1249,27,1276
72,Aquitaine,33,5,31,472,Saint-Sauveur-de-Puynormand,405,6,411
72,Aquitaine,33,1,44,473,Saint-Savin,2684,34,2718
72,Aquitaine,33,2,27,474,Saint-Selve,1939,18,1957
72,Aquitaine,33,1,15,475,Saint-Seurin-de-Bourg,326,10,336
72,Aquitaine,33,4,33,476,Saint-Seurin-de-Cadourne,706,15,721
72,Aquitaine,33,1,07,477,Saint-Seurin-de-Cursac,736,29,765
72,Aquitaine,33,5,22,478,Saint-Seurin-sur-l'Isle,2844,66,2910
72,Aquitaine,33,3,38,479,Saint-Sève,209,7,216
72,Aquitaine,33,5,30,480,Saint-Sulpice-de-Faleyrens,1504,107,1611
72,Aquitaine,33,3,32,481,Saint-Sulpice-de-Guilleragues,221,2,223
72,Aquitaine,33,3,47,482,Saint-Sulpice-de-Pommiers,225,1,226
72,Aquitaine,33,2,19,483,Saint-Sulpice-et-Cameyrac,4271,74,4345
72,Aquitaine,33,3,45,484,Saint-Symphorien,1662,34,1696
72,Aquitaine,33,1,15,486,Saint-Trojan,307,6,313
72,Aquitaine,33,2,19,487,Saint-Vincent-de-Paul,1080,16,1096
72,Aquitaine,33,5,37,488,Saint-Vincent-de-Pertignas,344,8,352
72,Aquitaine,33,1,44,489,Saint-Vivien-de-Blaye,328,6,334
72,Aquitaine,33,4,46,490,Saint-Vivien-de-Médoc,1513,22,1535
72,Aquitaine,33,3,32,491,Saint-Vivien-de-Monségur,380,8,388
72,Aquitaine,33,1,44,492,Saint-Yzan-de-Soudiac,2060,11,2071
72,Aquitaine,33,4,29,493,Saint-Yzans-de-Médoc,399,65,464
72,Aquitaine,33,5,21,390,Sainte-Colombe,417,3,420
72,Aquitaine,33,3,17,392,Sainte-Croix-du-Mont,869,24,893
72,Aquitaine,33,2,19,397,Sainte-Eulalie,4735,61,4796
72,Aquitaine,33,5,37,401,Sainte-Florence,125,2,127
72,Aquitaine,33,5,41,402,Sainte-Foy-la-Grande,2550,52,2602
72,Aquitaine,33,3,43,403,Sainte-Foy-la-Longue,134,4,138
72,Aquitaine,33,3,32,404,Sainte-Gemme,228,1,229
72,Aquitaine,33,4,20,417,Sainte-Hélène,2494,25,2519
72,Aquitaine,33,5,37,468,Sainte-Radegonde,463,15,478
72,Aquitaine,33,5,21,485,Sainte-Terre,1772,38,1810
72,Aquitaine,33,4,20,494,Salaunes,720,8,728
72,Aquitaine,33,1,39,495,Salignac,1333,23,1356
72,Aquitaine,33,2,23,496,Salleboeuf,2105,17,2122
72,Aquitaine,33,6,05,498,Salles,5917,97,6014
72,Aquitaine,33,5,21,499,Les Salles-de-Castillon,371,3,374
72,Aquitaine,33,1,15,500,Samonac,405,6,411
72,Aquitaine,33,2,27,501,Saucats,2030,30,2060
72,Aquitaine,33,1,44,502,Saugon,397,3,400
72,Aquitaine,33,4,20,503,Saumos,507,2,509
72,Aquitaine,33,3,28,504,Sauternes,706,9,715
72,Aquitaine,33,2,23,505,La Sauve,1391,57,1448
72,Aquitaine,33,3,47,506,Sauveterre-de-Guyenne,1801,35,1836
72,Aquitaine,33,3,04,507,Sauviac,329,4,333
72,Aquitaine,33,3,03,508,Savignac,552,11,563
72,Aquitaine,33,5,26,509,Savignac-de-l'Isle,515,12,527
72,Aquitaine,33,3,43,510,Semens,194,7,201
72,Aquitaine,33,3,25,511,Sendets,301,3,304
72,Aquitaine,33,3,03,512,Sigalens,311,12,323
72,Aquitaine,33,3,25,513,Sillas,121,2,123
72,Aquitaine,33,4,46,514,Soulac-sur-Mer,2714,47,2761
72,Aquitaine,33,3,48,515,Soulignac,455,6,461
72,Aquitaine,33,3,34,516,Soussac,182,4,186
72,Aquitaine,33,4,20,517,Soussans,1553,29,1582
72,Aquitaine,33,2,23,518,Tabanac,1058,15,1073
72,Aquitaine,33,2,63,519,Le Taillan-Médoc,8819,112,8931
72,Aquitaine,33,3,32,520,Taillecavat,298,10,308
72,Aquitaine,33,4,46,521,Talais,639,9,648
72,Aquitaine,33,2,56,522,Talence,40576,1401,41977
72,Aquitaine,33,3,48,523,Targon,1882,23,1905
72,Aquitaine,33,5,24,524,Tarnès,278,4,282
72,Aquitaine,33,1,15,525,Tauriac,1283,15,1298
72,Aquitaine,33,5,31,526,Tayac,159,3,162
72,Aquitaine,33,6,49,527,Le Teich,6385,121,6506
72,Aquitaine,33,4,20,528,Le Temple,519,7,526
72,Aquitaine,33,6,49,529,La Teste-de-Buch,24384,497,24881
72,Aquitaine,33,1,15,530,Teuillac,721,15,736
72,Aquitaine,33,5,16,531,Tizac-de-Curton,270,7,277
72,Aquitaine,33,5,26,532,Tizac-de-Lapouyade,478,12,490
72,Aquitaine,33,3,28,533,Toulenne,2566,68,2634
72,Aquitaine,33,2,23,534,Le Tourne,760,9,769
72,Aquitaine,33,2,58,535,Tresses,4027,73,4100
72,Aquitaine,33,3,45,536,Le Tuzan,212,0,212
72,Aquitaine,33,3,50,537,Uzeste,446,15,461
72,Aquitaine,33,4,29,538,Valeyrac,483,2,485
72,Aquitaine,33,5,30,539,Vayres,3280,46,3326
72,Aquitaine,33,4,29,540,Vendays-Montalivet,2167,41,2208
72,Aquitaine,33,4,46,541,Vensac,790,9,799
72,Aquitaine,33,5,24,542,Vérac,787,9,796
72,Aquitaine,33,3,43,543,Verdelais,898,23,921
72,Aquitaine,33,4,46,544,Le Verdon-sur-Mer,1357,39,1396
72,Aquitaine,33,4,33,545,Vertheuil,1181,21,1202
72,Aquitaine,33,5,21,546,Vignonet,524,26,550
72,Aquitaine,33,3,50,547,Villandraut,935,21,956
72,Aquitaine,33,5,24,548,Villegouge,1198,23,1221
72,Aquitaine,33,2,57,550,Villenave-d'Ornon,28762,416,29178
72,Aquitaine,33,3,17,549,Villenave-de-Rions,286,7,293
72,Aquitaine,33,1,15,551,Villeneuve,375,11,386
72,Aquitaine,33,3,36,552,Virelade,896,16,912
72,Aquitaine,33,1,39,553,Virsac,969,26,995
72,Aquitaine,33,2,55,554,Yvrac,2342,38,2380
91,Languedoc-Roussillon,34,1,35,001,Abeilhan,1290,26,1316
91,Languedoc-Roussillon,34,1,21,002,Adissan,912,15,927
91,Languedoc-Roussillon,34,1,01,003,Agde,22487,442,22929
91,Languedoc-Roussillon,34,1,30,004,Agel,205,7,212
91,Languedoc-Roussillon,34,2,13,005,Agonès,233,9,242
91,Languedoc-Roussillon,34,1,27,006,Aigne,262,4,266
91,Languedoc-Roussillon,34,1,30,007,Aigues-Vives,417,2,419
91,Languedoc-Roussillon,34,1,31,008,Les Aires,561,16,577
91,Languedoc-Roussillon,34,1,35,009,Alignan-du-Vent,1451,19,1470
91,Languedoc-Roussillon,34,2,02,010,Aniane,2727,65,2792
91,Languedoc-Roussillon,34,2,14,011,Arboras,91,2,93
91,Languedoc-Roussillon,34,2,02,012,Argelliers,842,14,856
91,Languedoc-Roussillon,34,2,10,013,Aspiran,1280,26,1306
91,Languedoc-Roussillon,34,3,07,014,Assas,1527,27,1554
91,Languedoc-Roussillon,34,1,30,015,Assignan,186,6,192
91,Languedoc-Roussillon,34,2,14,016,Aumelas,469,7,476
91,Languedoc-Roussillon,34,1,21,017,Aumes,420,13,433
91,Languedoc-Roussillon,34,1,25,018,Autignac,808,16,824
91,Languedoc-Roussillon,34,2,16,019,Avène,293,5,298
91,Languedoc-Roussillon,34,1,27,020,Azillanet,407,14,421
91,Languedoc-Roussillon,34,1,30,021,Babeau-Bouldoux,296,6,302
91,Languedoc-Roussillon,34,3,07,022,Baillargues,6054,98,6152
91,Languedoc-Roussillon,34,3,12,024,Balaruc-le-Vieux,2026,30,2056
91,Languedoc-Roussillon,34,3,12,023,Balaruc-les-Bains,6376,79,6455
91,Languedoc-Roussillon,34,1,05,025,Bassan,1548,33,1581
91,Languedoc-Roussillon,34,1,27,026,Beaufort,168,1,169
91,Languedoc-Roussillon,34,3,07,027,Beaulieu,1616,16,1632
91,Languedoc-Roussillon,34,1,03,028,Bédarieux,6637,235,6872
91,Languedoc-Roussillon,34,2,14,029,Bélarga,432,5,437
91,Languedoc-Roussillon,34,1,26,030,Berlou,189,3,192
91,Languedoc-Roussillon,34,1,01,031,Bessan,4435,68,4503
91,Languedoc-Roussillon,34,1,98,032,Béziers,71672,1643,73315
91,Languedoc-Roussillon,34,3,17,033,Boisseron,1479,31,1510
91,Languedoc-Roussillon,34,1,33,034,Boisset,26,0,26
91,Languedoc-Roussillon,34,2,02,035,La Boissière,882,12,894
91,Languedoc-Roussillon,34,2,15,036,Le Bosc,1134,27,1161
91,Languedoc-Roussillon,34,1,05,037,Boujan-sur-Libron,2966,90,3056
91,Languedoc-Roussillon,34,2,16,038,Le Bousquet-d'Orb,1596,28,1624
91,Languedoc-Roussillon,34,3,20,039,Bouzigues,1536,18,1554
91,Languedoc-Roussillon,34,2,16,040,Brenas,43,2,45
91,Languedoc-Roussillon,34,2,10,041,Brignac,565,15,580
91,Languedoc-Roussillon,34,2,13,042,Brissac,609,23,632
91,Languedoc-Roussillon,34,3,07,043,Buzignargues,255,5,260
91,Languedoc-Roussillon,34,1,25,044,Cabrerolles,345,3,348
91,Languedoc-Roussillon,34,1,21,045,Cabrières,456,17,473
91,Languedoc-Roussillon,34,1,26,046,Cambon-et-Salvergues,72,0,72
91,Languedoc-Roussillon,34,2,14,047,Campagnan,536,10,546
91,Languedoc-Roussillon,34,3,09,048,Campagne,266,3,269
91,Languedoc-Roussillon,34,1,03,049,Camplong,236,6,242
91,Languedoc-Roussillon,34,3,19,050,Candillargues,1269,16,1285
91,Languedoc-Roussillon,34,2,10,051,Canet,3224,51,3275
91,Languedoc-Roussillon,34,1,06,052,Capestang,3010,51,3061
91,Languedoc-Roussillon,34,1,03,053,Carlencas-et-Levas,118,0,118
91,Languedoc-Roussillon,34,1,27,054,Cassagnoles,84,4,88
91,Languedoc-Roussillon,34,1,31,055,Castanet-le-Haut,191,2,193
91,Languedoc-Roussillon,34,1,11,056,Castelnau-de-Guers,1087,18,1105
91,Languedoc-Roussillon,34,3,47,057,Castelnau-le-Lez,14999,346,15345
91,Languedoc-Roussillon,34,3,07,058,Castries,5519,78,5597
91,Languedoc-Roussillon,34,1,27,059,La Caunette,325,5,330
91,Languedoc-Roussillon,34,2,32,060,Causse-de-la-Selle,324,3,327
91,Languedoc-Roussillon,34,1,25,061,Causses-et-Veyran,600,8,608
91,Languedoc-Roussillon,34,1,25,062,Caussiniojouls,122,4,126
91,Languedoc-Roussillon,34,1,28,063,Caux,2546,51,2597
91,Languedoc-Roussillon,34,2,08,064,Le Caylar,437,5,442
91,Languedoc-Roussillon,34,1,30,065,Cazedarnes,499,8,507
91,Languedoc-Roussillon,34,3,18,066,Cazevieille,176,7,183
91,Languedoc-Roussillon,34,2,13,067,Cazilhac,1263,41,1304
91,Languedoc-Roussillon,34,1,21,068,Cazouls-d'Hérault,312,9,321
91,Languedoc-Roussillon,34,1,38,069,Cazouls-lès-Béziers,4181,70,4251
91,Languedoc-Roussillon,34,1,30,070,Cébazan,501,7,508
91,Languedoc-Roussillon,34,2,16,071,Ceilhes-et-Rocozels,307,7,314
91,Languedoc-Roussillon,34,2,10,072,Celles,24,1,25
91,Languedoc-Roussillon,34,1,05,073,Cers,2215,25,2240
91,Languedoc-Roussillon,34,1,30,074,Cessenon-sur-Orb,2002,28,2030
91,Languedoc-Roussillon,34,1,27,075,Cesseras,411,11,422
91,Languedoc-Roussillon,34,2,10,076,Ceyras,1008,24,1032
91,Languedoc-Roussillon,34,3,23,077,Clapiers,5073,127,5200
91,Languedoc-Roussillon,34,3,09,078,Claret,1364,28,1392
91,Languedoc-Roussillon,34,2,10,079,Clermont-l'Hérault,7395,128,7523
91,Languedoc-Roussillon,34,1,26,080,Colombières-sur-Orb,452,16,468
91,Languedoc-Roussillon,34,1,38,081,Colombiers,2363,52,2415
91,Languedoc-Roussillon,34,3,18,082,Combaillaux,1451,36,1487
91,Languedoc-Roussillon,34,1,31,083,Combes,311,7,318
91,Languedoc-Roussillon,34,1,38,084,Corneilhan,1544,47,1591
91,Languedoc-Roussillon,34,1,35,085,Coulobres,302,7,309
91,Languedoc-Roussillon,34,1,33,086,Courniou,620,20,640
91,Languedoc-Roussillon,34,3,49,087,Cournonsec,2149,33,2182
91,Languedoc-Roussillon,34,3,49,088,Cournonterral,5664,54,5718
91,Languedoc-Roussillon,34,1,06,089,Creissan,1232,27,1259
91,Languedoc-Roussillon,34,3,47,090,Le Crès,7259,103,7362
91,Languedoc-Roussillon,34,2,08,091,Le Cros,44,3,47
91,Languedoc-Roussillon,34,1,30,092,Cruzy,953,11,964
91,Languedoc-Roussillon,34,2,16,093,Dio-et-Valquières,158,7,165
91,Languedoc-Roussillon,34,1,35,094,Espondeilhan,922,27,949
91,Languedoc-Roussillon,34,3,49,095,Fabrègues,6193,70,6263
91,Languedoc-Roussillon,34,1,03,096,Faugères,501,12,513
91,Languedoc-Roussillon,34,1,27,097,Félines-Minervois,386,16,402
91,Languedoc-Roussillon,34,1,27,098,Ferrals-les-Montagnes,153,10,163
91,Languedoc-Roussillon,34,3,09,099,Ferrières-les-Verreries,61,2,63
91,Languedoc-Roussillon,34,1,26,100,Ferrières-Poussarou,59,2,61
91,Languedoc-Roussillon,34,1,11,101,Florensac,4731,109,4840
91,Languedoc-Roussillon,34,3,09,102,Fontanès,249,10,259
91,Languedoc-Roussillon,34,1,21,103,Fontès,920,22,942
91,Languedoc-Roussillon,34,1,29,104,Fos,103,0,103
91,Languedoc-Roussillon,34,1,29,105,Fouzilhon,202,3,205
91,Languedoc-Roussillon,34,2,15,106,Fozières,162,4,166
91,Languedoc-Roussillon,34,1,34,107,Fraisse-sur-Agout,352,6,358
91,Languedoc-Roussillon,34,3,12,108,Frontignan,23169,211,23380
91,Languedoc-Roussillon,34,1,29,109,Gabian,802,14,816
91,Languedoc-Roussillon,34,3,07,110,Galargues,629,12,641
91,Languedoc-Roussillon,34,2,13,111,Ganges,4003,116,4119
91,Languedoc-Roussillon,34,3,09,112,Garrigues,152,6,158
91,Languedoc-Roussillon,34,3,20,113,Gigean,5362,58,5420
91,Languedoc-Roussillon,34,2,14,114,Gignac,5165,87,5252
91,Languedoc-Roussillon,34,2,13,115,Gorniès,115,2,117
91,Languedoc-Roussillon,34,3,46,116,Grabels,6092,136,6228
91,Languedoc-Roussillon,34,1,03,117,Graissessac,690,7,697
91,Languedoc-Roussillon,34,3,19,344,La Grande-Motte,8352,117,8469
91,Languedoc-Roussillon,34,3,07,118,Guzargues,423,6,429
91,Languedoc-Roussillon,34,1,31,119,Hérépian,1469,19,1488
91,Languedoc-Roussillon,34,3,07,120,Jacou,4882,115,4997
91,Languedoc-Roussillon,34,2,16,121,Joncels,276,6,282
91,Languedoc-Roussillon,34,2,14,122,Jonquières,381,7,388
91,Languedoc-Roussillon,34,3,46,123,Juvignac,6451,104,6555
91,Languedoc-Roussillon,34,2,10,124,Lacoste,280,7,287
91,Languedoc-Roussillon,34,2,14,125,Lagamas,120,6,126
91,Languedoc-Roussillon,34,1,31,126,Lamalou-les-Bains,2280,44,2324
91,Languedoc-Roussillon,34,3,19,127,Lansargues,2648,28,2676
91,Languedoc-Roussillon,34,2,13,128,Laroque,1398,39,1437
91,Languedoc-Roussillon,34,3,48,129,Lattes,16319,267,16586
91,Languedoc-Roussillon,34,1,25,130,Laurens,1304,13,1317
91,Languedoc-Roussillon,34,3,09,131,Lauret,564,10,574
91,Languedoc-Roussillon,34,2,15,132,Lauroux,201,4,205
91,Languedoc-Roussillon,34,2,16,133,Lavalette,50,0,50
91,Languedoc-Roussillon,34,3,44,134,Lavérune,2715,47,2762
91,Languedoc-Roussillon,34,1,38,135,Lespignan,3089,50,3139
91,Languedoc-Roussillon,34,1,21,136,Lézignan-la-Cèbe,1317,11,1328
91,Languedoc-Roussillon,34,2,10,137,Liausson,126,4,130
91,Languedoc-Roussillon,34,1,21,138,Lieuran-Cabrières,266,5,271
91,Languedoc-Roussillon,34,1,05,139,Lieuran-lès-Béziers,1193,23,1216
91,Languedoc-Roussillon,34,1,38,140,Lignan-sur-Orb,2917,89,3006
91,Languedoc-Roussillon,34,1,27,141,La Livinière,549,8,557
91,Languedoc-Roussillon,34,2,15,142,Lodève,7345,217,7562
91,Languedoc-Roussillon,34,3,20,143,Loupian,2085,38,2123
91,Languedoc-Roussillon,34,2,16,144,Lunas,650,20,670
91,Languedoc-Roussillon,34,3,17,145,Lunel,24417,235,24652
91,Languedoc-Roussillon,34,3,17,146,Lunel-Viel,3581,41,3622
91,Languedoc-Roussillon,34,1,29,147,Magalas,2692,50,2742
91,Languedoc-Roussillon,34,1,38,148,Maraussan,3448,59,3507
91,Languedoc-Roussillon,34,1,29,149,Margon,396,3,399
91,Languedoc-Roussillon,34,1,01,150,Marseillan,7738,117,7855
91,Languedoc-Roussillon,34,3,17,151,Marsillargues,6006,76,6082
91,Languedoc-Roussillon,34,2,32,152,Mas-de-Londres,381,4,385
91,Languedoc-Roussillon,34,3,18,153,Les Matelles,1537,56,1593
91,Languedoc-Roussillon,34,3,19,154,Mauguio,15833,175,16008
91,Languedoc-Roussillon,34,1,06,155,Maureilhan,1776,33,1809
91,Languedoc-Roussillon,34,2,16,156,Mérifons,47,3,50
91,Languedoc-Roussillon,34,3,20,157,Mèze,10507,146,10653
91,Languedoc-Roussillon,34,1,27,158,Minerve,122,1,123
91,Languedoc-Roussillon,34,3,12,159,Mireval,3273,53,3326
91,Languedoc-Roussillon,34,1,26,160,Mons,567,3,570
91,Languedoc-Roussillon,34,1,06,161,Montady,3869,54,3923
91,Languedoc-Roussillon,34,1,21,162,Montagnac,3570,53,3623
91,Languedoc-Roussillon,34,2,02,163,Montarnaud,2468,54,2522
91,Languedoc-Roussillon,34,3,07,164,Montaud,857,17,874
91,Languedoc-Roussillon,34,3,20,165,Montbazin,2846,30,2876
91,Languedoc-Roussillon,34,1,35,166,Montblanc,2530,41,2571
91,Languedoc-Roussillon,34,1,06,167,Montels,230,3,233
91,Languedoc-Roussillon,34,1,29,168,Montesquieu,60,3,63
91,Languedoc-Roussillon,34,3,23,169,Montferrier-sur-Lez,3408,123,3531
91,Languedoc-Roussillon,34,1,30,170,Montouliers,233,5,238
91,Languedoc-Roussillon,34,2,13,171,Montoulieu,146,5,151
91,Languedoc-Roussillon,34,3,99,172,Montpellier,252998,3346,256344
91,Languedoc-Roussillon,34,2,14,173,Montpeyroux,1195,43,1238
91,Languedoc-Roussillon,34,2,13,174,Moulès-et-Baucels,803,18,821
91,Languedoc-Roussillon,34,2,10,175,Mourèze,171,3,174
91,Languedoc-Roussillon,34,3,19,176,Mudaison,2506,22,2528
91,Languedoc-Roussillon,34,3,18,177,Murles,282,9,291
91,Languedoc-Roussillon,34,1,25,178,Murviel-lès-Béziers,2693,53,2746
91,Languedoc-Roussillon,34,3,49,179,Murviel-lès-Montpellier,1749,27,1776
91,Languedoc-Roussillon,34,2,10,180,Nébian,1142,28,1170
91,Languedoc-Roussillon,34,1,29,181,Neffiès,907,19,926
91,Languedoc-Roussillon,34,1,28,182,Nézignan-l'Évêque,1322,24,1346
91,Languedoc-Roussillon,34,1,06,183,Nissan-lez-Enserune,3410,48,3458
91,Languedoc-Roussillon,34,1,21,184,Nizas,567,14,581
91,Languedoc-Roussillon,34,2,32,185,Notre-Dame-de-Londres,490,12,502
91,Languedoc-Roussillon,34,2,16,186,Octon,427,7,434
91,Languedoc-Roussillon,34,1,26,187,Olargues,603,13,616
91,Languedoc-Roussillon,34,2,15,188,Olmet-et-Villecun,147,3,150
91,Languedoc-Roussillon,34,1,27,189,Olonzac,1653,31,1684
91,Languedoc-Roussillon,34,1,27,190,Oupia,291,2,293
91,Languedoc-Roussillon,34,1,25,191,Pailhès,469,9,478
91,Languedoc-Roussillon,34,3,48,192,Palavas-les-Flots,6034,70,6104
91,Languedoc-Roussillon,34,1,33,193,Pardailhan,179,7,186
91,Languedoc-Roussillon,34,2,10,194,Paulhan,3440,52,3492
91,Languedoc-Roussillon,34,2,32,195,Pégairolles-de-Buèges,49,0,49
91,Languedoc-Roussillon,34,2,08,196,Pégairolles-de-l'Escalette,148,5,153
91,Languedoc-Roussillon,34,1,21,197,Péret,779,20,799
91,Languedoc-Roussillon,34,3,48,198,Pérols,8484,135,8619
91,Languedoc-Roussillon,34,1,28,199,Pézenas,8439,410,8849
91,Languedoc-Roussillon,34,1,03,200,Pézènes-les-Mines,214,4,218
91,Languedoc-Roussillon,34,1,30,201,Pierrerue,286,0,286
91,Languedoc-Roussillon,34,3,49,202,Pignan,6124,88,6212
91,Languedoc-Roussillon,34,1,11,203,Pinet,1300,14,1314
91,Languedoc-Roussillon,34,2,14,204,Plaissan,890,14,904
91,Languedoc-Roussillon,34,2,15,205,Les Plans,283,18,301
91,Languedoc-Roussillon,34,1,06,206,Poilhes,514,9,523
91,Languedoc-Roussillon,34,1,11,207,Pomérols,2089,29,2118
91,Languedoc-Roussillon,34,2,14,208,Popian,343,13,356
91,Languedoc-Roussillon,34,1,05,209,Portiragnes,3098,62,3160
91,Languedoc-Roussillon,34,2,14,210,Le Pouget,1794,44,1838
91,Languedoc-Roussillon,34,1,31,211,Le Poujol-sur-Orb,1038,30,1068
91,Languedoc-Roussillon,34,2,15,212,Poujols,155,1,156
91,Languedoc-Roussillon,34,3,20,213,Poussan,4821,71,4892
91,Languedoc-Roussillon,34,1,29,214,Pouzolles,1029,15,1044
91,Languedoc-Roussillon,34,2,14,215,Pouzols,824,19,843
91,Languedoc-Roussillon,34,1,03,216,Le Pradal,265,10,275
91,Languedoc-Roussillon,34,3,18,217,Prades-le-Lez,4525,121,4646
91,Languedoc-Roussillon,34,1,30,218,Prades-sur-Vernazobre,269,1,270
91,Languedoc-Roussillon,34,1,26,219,Prémian,511,18,529
91,Languedoc-Roussillon,34,2,15,220,Le Puech,221,8,229
91,Languedoc-Roussillon,34,2,02,221,Puéchabon,449,15,464
91,Languedoc-Roussillon,34,2,14,222,Puilacher,319,11,330
91,Languedoc-Roussillon,34,1,25,223,Puimisson,974,20,994
91,Languedoc-Roussillon,34,1,35,224,Puissalicon,1045,20,1065
91,Languedoc-Roussillon,34,1,06,225,Puisserguier,2767,46,2813
91,Languedoc-Roussillon,34,1,06,226,Quarante,1572,21,1593
91,Languedoc-Roussillon,34,3,07,227,Restinclières,1521,13,1534
91,Languedoc-Roussillon,34,1,33,228,Rieussec,94,1,95
91,Languedoc-Roussillon,34,1,33,229,Riols,705,26,731
91,Languedoc-Roussillon,34,2,08,230,Les Rives,124,1,125
91,Languedoc-Roussillon,34,2,16,231,Romiguières,23,0,23
91,Languedoc-Roussillon,34,1,26,232,Roquebrun,535,15,550
91,Languedoc-Roussillon,34,2,16,233,Roqueredonde,190,0,190
91,Languedoc-Roussillon,34,1,29,234,Roquessels,129,3,132
91,Languedoc-Roussillon,34,1,31,235,Rosis,304,2,306
91,Languedoc-Roussillon,34,2,32,236,Rouet,61,2,63
91,Languedoc-Roussillon,34,1,29,237,Roujan,1946,27,1973
91,Languedoc-Roussillon,34,2,32,238,Saint-André-de-Buèges,51,2,53
91,Languedoc-Roussillon,34,2,14,239,Saint-André-de-Sangonis,5030,81,5111
91,Languedoc-Roussillon,34,3,19,240,Saint-Aunès,3037,63,3100
91,Languedoc-Roussillon,34,2,14,241,Saint-Bauzille-de-la-Sylve,811,21,832
91,Languedoc-Roussillon,34,3,18,242,Saint-Bauzille-de-Montmel,926,23,949
91,Languedoc-Roussillon,34,2,13,243,Saint-Bauzille-de-Putois,1402,27,1429
91,Languedoc-Roussillon,34,3,07,244,Saint-Brès,2638,32,2670
91,Languedoc-Roussillon,34,1,30,245,Saint-Chinian,1831,22,1853
91,Languedoc-Roussillon,34,3,17,246,Saint-Christol,1363,21,1384
91,Languedoc-Roussillon,34,3,18,247,Saint-Clément-de-Rivière,5097,271,5368
91,Languedoc-Roussillon,34,3,07,249,Saint-Drézéry,2117,45,2162
91,Languedoc-Roussillon,34,1,26,250,Saint-Étienne-d'Albagnan,291,6,297
91,Languedoc-Roussillon,34,2,15,251,Saint-Étienne-de-Gourgas,449,3,452
91,Languedoc-Roussillon,34,1,03,252,Saint-Étienne-Estréchoux,244,8,252
91,Languedoc-Roussillon,34,2,08,253,Saint-Félix-de-l'Héras,36,0,36
91,Languedoc-Roussillon,34,2,10,254,Saint-Félix-de-Lodez,1114,16,1130
91,Languedoc-Roussillon,34,3,18,255,Saint-Gély-du-Fesc,8495,274,8769
91,Languedoc-Roussillon,34,1,25,258,Saint-Geniès-de-Fontedit,1296,15,1311
91,Languedoc-Roussillon,34,1,31,257,Saint-Geniès-de-Varensal,210,5,215
91,Languedoc-Roussillon,34,3,07,256,Saint-Geniès-des-Mourgues,1608,27,1635
91,Languedoc-Roussillon,34,3,49,259,Saint-Georges-d'Orques,5169,86,5255
91,Languedoc-Roussillon,34,1,31,260,Saint-Gervais-sur-Mare,824,19,843
91,Languedoc-Roussillon,34,2,02,261,Saint-Guilhem-le-Désert,256,2,258
91,Languedoc-Roussillon,34,2,14,262,Saint-Guiraud,218,3,221
91,Languedoc-Roussillon,34,3,07,263,Saint-Hilaire-de-Beauvoir,351,13,364
91,Languedoc-Roussillon,34,2,32,264,Saint-Jean-de-Buèges,190,1,191
91,Languedoc-Roussillon,34,3,07,265,Saint-Jean-de-Cornies,663,11,674
91,Languedoc-Roussillon,34,3,18,266,Saint-Jean-de-Cuculles,443,6,449
91,Languedoc-Roussillon,34,2,14,267,Saint-Jean-de-Fos,1505,24,1529
91,Languedoc-Roussillon,34,2,15,268,Saint-Jean-de-la-Blaquière,516,11,527
91,Languedoc-Roussillon,34,1,33,269,Saint-Jean-de-Minervois,139,1,140
91,Languedoc-Roussillon,34,3,44,270,Saint-Jean-de-Védas,8761,160,8921
91,Languedoc-Roussillon,34,1,26,271,Saint-Julien,202,3,205
91,Languedoc-Roussillon,34,3,17,272,Saint-Just,2718,39,2757
91,Languedoc-Roussillon,34,1,26,273,Saint-Martin-de-l'Arçon,142,5,147
91,Languedoc-Roussillon,34,2,32,274,Saint-Martin-de-Londres,2205,35,2240
91,Languedoc-Roussillon,34,3,18,276,Saint-Mathieu-de-Tréviers,4660,103,4763
91,Languedoc-Roussillon,34,2,08,277,Saint-Maurice-Navacelles,160,6,166
91,Languedoc-Roussillon,34,2,08,278,Saint-Michel,56,3,59
91,Languedoc-Roussillon,34,1,25,279,Saint-Nazaire-de-Ladarez,350,7,357
91,Languedoc-Roussillon,34,3,17,280,Saint-Nazaire-de-Pézan,559,11,570
91,Languedoc-Roussillon,34,2,14,281,Saint-Pargoire,1847,27,1874
91,Languedoc-Roussillon,34,2,02,282,Saint-Paul-et-Valmalle,904,17,921
91,Languedoc-Roussillon,34,2,15,283,Saint-Pierre-de-la-Fage,119,1,120
91,Languedoc-Roussillon,34,1,21,285,Saint-Pons-de-Mauchiens,619,6,625
91,Languedoc-Roussillon,34,1,33,284,Saint-Pons-de-Thomières,2121,180,2301
91,Languedoc-Roussillon,34,2,15,286,Saint-Privat,388,11,399
91,Languedoc-Roussillon,34,2,14,287,Saint-Saturnin-de-Lucian,298,4,302
91,Languedoc-Roussillon,34,3,17,288,Saint-Sériès,880,13,893
91,Languedoc-Roussillon,34,1,28,289,Saint-Thibéry,2320,41,2361
91,Languedoc-Roussillon,34,1,26,291,Saint-Vincent-d'Olargues,328,6,334
91,Languedoc-Roussillon,34,3,18,290,Saint-Vincent-de-Barbeyrargues,660,23,683
91,Languedoc-Roussillon,34,3,18,248,Sainte-Croix-de-Quintillargues,575,19,594
91,Languedoc-Roussillon,34,2,10,292,Salasc,255,1,256
91,Languedoc-Roussillon,34,1,34,293,La Salvetat-sur-Agout,1219,36,1255
91,Languedoc-Roussillon,34,3,17,294,Saturargues,867,12,879
91,Languedoc-Roussillon,34,3,49,295,Saussan,1491,26,1517
91,Languedoc-Roussillon,34,3,17,296,Saussines,906,13,919
91,Languedoc-Roussillon,34,3,09,297,Sauteyrargues,325,10,335
91,Languedoc-Roussillon,34,1,39,298,Sauvian,4101,65,4166
91,Languedoc-Roussillon,34,1,39,299,Sérignan,6584,124,6708
91,Languedoc-Roussillon,34,1,35,300,Servian,4136,73,4209
91,Languedoc-Roussillon,34,3,97,301,Sète,42786,692,43478
91,Languedoc-Roussillon,34,1,27,302,Siran,642,7,649
91,Languedoc-Roussillon,34,2,08,303,Sorbs,34,0,34
91,Languedoc-Roussillon,34,2,15,304,Soubès,871,19,890
91,Languedoc-Roussillon,34,1,34,305,Le Soulié,116,6,122
91,Languedoc-Roussillon,34,2,15,306,Soumont,135,3,138
91,Languedoc-Roussillon,34,3,07,307,Sussargues,2424,59,2483
91,Languedoc-Roussillon,34,1,31,308,Taussac-la-Billière,438,16,454
91,Languedoc-Roussillon,34,3,07,309,Teyran,4289,112,4401
91,Languedoc-Roussillon,34,1,25,310,Thézan-lès-Béziers,2547,41,2588
91,Languedoc-Roussillon,34,1,03,312,La Tour-sur-Orb,1172,31,1203
91,Languedoc-Roussillon,34,1,28,311,Tourbes,1462,177,1639
91,Languedoc-Roussillon,34,2,14,313,Tressan,505,9,514
91,Languedoc-Roussillon,34,3,18,314,Le Triadou,378,8,386
91,Languedoc-Roussillon,34,1,21,315,Usclas-d'Hérault,271,4,275
91,Languedoc-Roussillon,34,2,15,316,Usclas-du-Bosc,114,5,119
91,Languedoc-Roussillon,34,2,15,317,La Vacquerie-et-Saint-Martin-de-Castries,138,2,140
91,Languedoc-Roussillon,34,3,09,318,Vacquières,418,5,423
91,Languedoc-Roussillon,34,1,29,319,Vailhan,164,0,164
91,Languedoc-Roussillon,34,3,18,320,Vailhauquès,2153,38,2191
91,Languedoc-Roussillon,34,3,17,321,Valergues,1996,27,2023
91,Languedoc-Roussillon,34,3,09,322,Valflaunès,714,14,728
91,Languedoc-Roussillon,34,2,10,323,Valmascle,44,0,44
91,Languedoc-Roussillon,34,1,39,324,Valras-Plage,4485,59,4544
91,Languedoc-Roussillon,34,1,35,325,Valros,1252,16,1268
91,Languedoc-Roussillon,34,1,33,326,Vélieux,61,1,62
91,Languedoc-Roussillon,34,3,07,327,Vendargues,5491,77,5568
91,Languedoc-Roussillon,34,2,14,328,Vendémian,997,15,1012
91,Languedoc-Roussillon,34,1,39,329,Vendres,2110,64,2174
91,Languedoc-Roussillon,34,3,17,330,Vérargues,696,8,704
91,Languedoc-Roussillon,34,1,33,331,Verreries-de-Moussans,95,0,95
91,Languedoc-Roussillon,34,1,01,332,Vias,5422,102,5524
91,Languedoc-Roussillon,34,3,12,333,Vic-la-Gardiole,2820,41,2861
91,Languedoc-Roussillon,34,1,26,334,Vieussan,269,3,272
91,Languedoc-Roussillon,34,1,31,335,Villemagne-l'Argentière,425,14,439
91,Languedoc-Roussillon,34,1,05,336,Villeneuve-lès-Béziers,3806,64,3870
91,Languedoc-Roussillon,34,3,12,337,Villeneuve-lès-Maguelone,8763,84,8847
91,Languedoc-Roussillon,34,2,10,338,Villeneuvette,65,5,70
91,Languedoc-Roussillon,34,1,30,339,Villespassans,140,3,143
91,Languedoc-Roussillon,34,3,17,340,Villetelle,1357,19,1376
91,Languedoc-Roussillon,34,3,20,341,Villeveyrac,2905,40,2945
91,Languedoc-Roussillon,34,2,32,342,Viols-en-Laval,202,3,205
91,Languedoc-Roussillon,34,2,32,343,Viols-le-Fort,1054,17,1071
53,Bretagne,35,3,53,001,Acigné,6143,151,6294
53,Bretagne,35,3,18,002,Amanlis,1583,33,1616
53,Bretagne,35,3,34,003,Andouillé-Neuville,737,13,750
53,Bretagne,35,1,01,004,Antrain,1415,34,1449
53,Bretagne,35,3,33,005,Arbrissel,268,5,273
53,Bretagne,35,3,02,006,Argentré-du-Plessis,4138,111,4249
53,Bretagne,35,3,34,007,Aubigné,356,1,357
53,Bretagne,35,3,15,008,Availles-sur-Seiche,685,16,701
53,Bretagne,35,4,11,009,Baguer-Morvan,1519,23,1542
53,Bretagne,35,4,11,010,Baguer-Pican,1277,22,1299
53,Bretagne,35,1,36,011,Baillé,320,5,325
53,Bretagne,35,2,03,012,Bain-de-Bretagne,7162,116,7278
53,Bretagne,35,2,28,013,Bains-sur-Oust,3361,110,3471
53,Bretagne,35,3,15,014,Bais,2050,35,2085
53,Bretagne,35,3,42,015,Balazé,2132,47,2179
53,Bretagne,35,2,16,016,Baulon,1902,38,1940
53,Bretagne,35,4,41,017,La Baussaine,616,3,619
53,Bretagne,35,1,20,018,La Bazouge-du-Désert,1053,21,1074
53,Bretagne,35,1,01,019,Bazouges-la-Pérouse,1867,40,1907
53,Bretagne,35,1,12,021,Beaucé,1172,47,1219
53,Bretagne,35,3,04,022,Bécherel,739,18,757
53,Bretagne,35,3,23,023,Bédée,3857,59,3916
53,Bretagne,35,3,52,024,Betton,10166,284,10450
53,Bretagne,35,1,13,025,Billé,1027,17,1044
53,Bretagne,35,3,38,026,Bléruais,96,6,102
53,Bretagne,35,3,22,027,Boisgervilly,1447,38,1485
53,Bretagne,35,3,18,028,Boistrudan,671,10,681
53,Bretagne,35,4,09,029,Bonnemain,1270,27,1297
53,Bretagne,35,2,40,030,La Bosse-de-Bretagne,572,5,577
53,Bretagne,35,3,19,031,La Bouëxière,3845,73,3918
53,Bretagne,35,2,16,033,Bourg-des-Comptes,2460,38,2498
53,Bretagne,35,3,47,032,Bourgbarré,3135,50,3185
53,Bretagne,35,4,26,034,La Boussac,1127,22,1149
53,Bretagne,35,2,21,035,Bovel,547,3,550
53,Bretagne,35,3,27,037,Bréal-sous-Montfort,4841,75,4916
53,Bretagne,35,3,42,038,Bréal-sous-Vitré,643,9,652
53,Bretagne,35,3,07,039,Brécé,1828,34,1862
53,Bretagne,35,3,23,040,Breteil,3367,68,3435
53,Bretagne,35,3,18,041,Brie,786,25,811
53,Bretagne,35,3,02,042,Brielles,661,5,666
53,Bretagne,35,4,26,044,Broualan,314,4,318
53,Bretagne,35,2,25,045,Bruc-sur-Aff,833,17,850
53,Bretagne,35,2,21,046,Les Brulais,458,6,464
53,Bretagne,35,3,47,047,Bruz,15587,358,15945
53,Bretagne,35,2,21,048,Campel,513,5,518
53,Bretagne,35,4,05,049,Cancale,5341,146,5487
53,Bretagne,35,3,04,050,Cardroc,494,10,504
53,Bretagne,35,3,53,051,Cesson-Sévigné,15239,663,15902
53,Bretagne,35,3,43,052,Champeaux,469,9,478
53,Bretagne,35,3,07,053,Chancé,302,8,310
53,Bretagne,35,2,40,054,Chanteloup,1516,13,1529
53,Bretagne,35,3,46,055,Chantepie,8154,277,8431
53,Bretagne,35,4,41,056,La Chapelle-aux-Filtzméens,686,8,694
53,Bretagne,35,2,21,057,La Chapelle-Bouëxic,1161,13,1174
53,Bretagne,35,3,04,058,La Chapelle-Chaussée,1079,20,1099
53,Bretagne,35,2,28,064,La Chapelle-de-Brain,911,16,927
53,Bretagne,35,3,52,059,La Chapelle-des-Fougeretz,3699,90,3789
53,Bretagne,35,3,22,060,La Chapelle-du-Lou,603,13,616
53,Bretagne,35,3,42,061,La Chapelle-Erbrée,601,13,614
53,Bretagne,35,1,12,062,La Chapelle-Janson,1279,32,1311
53,Bretagne,35,1,35,063,La Chapelle-Saint-Aubert,411,4,415
53,Bretagne,35,3,23,065,La Chapelle-Thouarault,1937,34,1971
53,Bretagne,35,3,47,066,Chartres-de-Bretagne,7006,154,7160
53,Bretagne,35,3,19,067,Chasné-sur-Illet,1418,25,1443
53,Bretagne,35,3,06,068,Châteaubourg,5886,159,6045
53,Bretagne,35,3,07,069,Châteaugiron,6376,162,6538
53,Bretagne,35,4,08,070,Châteauneuf-d'Ille-et-Vilaine,1126,9,1135
53,Bretagne,35,1,36,071,Le Châtellier,380,16,396
53,Bretagne,35,3,42,072,Châtillon-en-Vendelais,1695,41,1736
53,Bretagne,35,1,01,075,Chauvigné,750,15,765
53,Bretagne,35,3,24,076,Chavagne,3737,65,3802
53,Bretagne,35,3,15,077,Chelun,322,8,330
53,Bretagne,35,4,11,078,Cherrueix,1155,24,1179
53,Bretagne,35,3,34,079,Chevaigné,1856,50,1906
53,Bretagne,35,3,24,080,Cintré,2069,44,2113
53,Bretagne,35,3,23,081,Clayes,710,12,722
53,Bretagne,35,3,33,082,Coësmes,1379,10,1389
53,Bretagne,35,1,36,083,Coglès,633,10,643
53,Bretagne,35,2,21,084,Comblessac,621,11,632
53,Bretagne,35,4,09,085,Combourg,5514,135,5649
53,Bretagne,35,1,13,086,Combourtillé,547,11,558
53,Bretagne,35,3,43,087,Cornillé,833,9,842
53,Bretagne,35,3,18,088,Corps-Nuds,2874,47,2921
53,Bretagne,35,2,40,089,La Couyère,483,6,489
53,Bretagne,35,2,03,090,Crevin,2578,21,2599
53,Bretagne,35,3,38,091,Le Crouais,466,14,480
53,Bretagne,35,4,09,092,Cuguen,792,8,800
53,Bretagne,35,4,10,093,Dinard,11033,550,11583
53,Bretagne,35,3,17,094,Dingé,1519,21,1540
53,Bretagne,35,4,11,095,Dol-de-Bretagne,4991,269,5260
53,Bretagne,35,3,06,096,Domagné,2056,39,2095
53,Bretagne,35,3,02,097,Domalain,1900,31,1931
53,Bretagne,35,2,14,098,La Dominelais,1203,25,1228
53,Bretagne,35,3,07,099,Domloup,3019,53,3072
53,Bretagne,35,1,13,100,Dompierre-du-Chemin,550,7,557
53,Bretagne,35,3,19,101,Dourdain,1006,14,1020
53,Bretagne,35,3,15,102,Drouges,485,11,496
53,Bretagne,35,3,15,103,Eancé,370,13,383
53,Bretagne,35,4,11,104,Epiniac,1284,22,1306
53,Bretagne,35,3,42,105,Erbrée,1672,54,1726
53,Bretagne,35,2,03,106,Ercé-en-Lamée,1353,37,1390
53,Bretagne,35,3,19,107,Ercé-près-Liffré,1790,35,1825
53,Bretagne,35,3,33,108,Essé,1070,17,1087
53,Bretagne,35,3,02,109,Étrelles,2502,67,2569
53,Bretagne,35,3,34,110,Feins,788,20,808
53,Bretagne,35,1,20,111,Le Ferré,619,9,628
53,Bretagne,35,1,12,112,Fleurigné,1026,29,1055
53,Bretagne,35,1,01,113,La Fontenelle,536,13,549
53,Bretagne,35,3,33,114,Forges-la-Forêt,275,3,278
53,Bretagne,35,1,97,115,Fougères,20078,824,20902
53,Bretagne,35,4,05,116,La Fresnais,2127,56,2183
53,Bretagne,35,3,38,117,Gaël,1564,23,1587
53,Bretagne,35,3,34,118,Gahard,1171,10,1181
53,Bretagne,35,3,02,119,Gennes-sur-Seiche,795,19,814
53,Bretagne,35,3,31,120,Gévezé,3772,75,3847
53,Bretagne,35,1,35,121,Gosné,1652,24,1676
53,Bretagne,35,4,39,122,La Gouesnière,1645,47,1692
53,Bretagne,35,2,16,123,Goven,3890,104,3994
53,Bretagne,35,2,14,124,Grand-Fougeray,2279,39,2318
53,Bretagne,35,3,15,125,La Guerche-de-Bretagne,4220,159,4379
53,Bretagne,35,2,16,126,Guichen,7237,115,7352
53,Bretagne,35,2,16,127,Guignen,3227,55,3282
53,Bretagne,35,3,17,128,Guipel,1551,44,1595
53,Bretagne,35,2,25,129,Guipry,3518,65,3583
53,Bretagne,35,3,17,130,Hédé,1771,25,1796
53,Bretagne,35,3,24,131,L' Hermitage,3723,82,3805
53,Bretagne,35,4,05,132,Hirel,1360,28,1388
53,Bretagne,35,3,23,133,Iffendic,4119,90,4209
53,Bretagne,35,3,04,134,Les Iffs,256,9,265
53,Bretagne,35,3,04,135,Irodouër,1932,37,1969
53,Bretagne,35,3,18,136,Janzé,8091,170,8261
53,Bretagne,35,1,13,137,Javené,1852,48,1900
53,Bretagne,35,1,12,138,Laignelet,871,46,917
53,Bretagne,35,2,16,139,Laillé,4380,93,4473
53,Bretagne,35,2,40,140,Lalleu,563,9,572
53,Bretagne,35,3,43,141,Landavran,575,11,586
53,Bretagne,35,1,12,142,Landéan,1259,38,1297
53,Bretagne,35,3,22,143,Landujan,902,25,927
53,Bretagne,35,3,04,144,Langan,900,16,916
53,Bretagne,35,2,28,145,Langon,1440,27,1467
53,Bretagne,35,3,17,146,Langouet,545,14,559
53,Bretagne,35,4,09,147,Lanhélin,868,19,887
53,Bretagne,35,3,17,148,Lanrigan,128,2,130
53,Bretagne,35,2,16,149,Lassy,1353,30,1383
53,Bretagne,35,1,13,150,Lécousse,2923,137,3060
53,Bretagne,35,2,25,151,Lieuron,694,14,708
53,Bretagne,35,3,19,152,Liffré,6684,148,6832
53,Bretagne,35,4,08,153,Lillemer,265,5,270
53,Bretagne,35,3,19,154,Livré-sur-Changeon,1555,26,1581
53,Bretagne,35,2,25,155,Lohéac,685,9,694
53,Bretagne,35,4,41,156,Longaulnay,589,9,598
53,Bretagne,35,1,12,157,Le Loroux,557,9,566
53,Bretagne,35,3,22,158,Le Lou-du-Lac,101,2,103
53,Bretagne,35,4,09,159,Lourmais,310,4,314
53,Bretagne,35,2,21,160,Loutehel,208,5,213
53,Bretagne,35,3,06,161,Louvigné-de-Bais,1736,45,1781
53,Bretagne,35,1,20,162,Louvigné-du-Désert,3761,113,3874
53,Bretagne,35,1,12,163,Luitré,1291,38,1329
53,Bretagne,35,1,01,164,Marcillé-Raoul,819,17,836
53,Bretagne,35,3,33,165,Marcillé-Robert,927,24,951
53,Bretagne,35,3,43,166,Marpiré,999,6,1005
53,Bretagne,35,3,33,167,Martigné-Ferchaud,2624,84,2708
53,Bretagne,35,2,21,168,Maure-de-Bretagne,3080,54,3134
53,Bretagne,35,3,27,169,Maxent,1263,17,1280
53,Bretagne,35,3,43,170,Mecé,550,7,557
53,Bretagne,35,3,22,171,Médréac,1865,31,1896
53,Bretagne,35,4,09,172,Meillac,1630,25,1655
53,Bretagne,35,3,34,173,Melesse,5462,153,5615
53,Bretagne,35,1,20,174,Mellé,670,10,680
53,Bretagne,35,2,21,175,Mernel,958,15,973
53,Bretagne,35,2,03,176,Messac,2666,108,2774
53,Bretagne,35,3,17,177,La Mézière,4176,77,4253
53,Bretagne,35,1,35,178,Mézières-sur-Couesnon,1216,19,1235
53,Bretagne,35,4,08,179,Miniac-Morvan,3462,60,3522
53,Bretagne,35,3,04,180,Miniac-sous-Bécherel,673,12,685
53,Bretagne,35,4,10,181,Le Minihic-sur-Rance,1362,54,1416
53,Bretagne,35,3,42,183,Mondevert,755,9,764
53,Bretagne,35,4,11,186,Mont-Dol,1216,34,1250
53,Bretagne,35,3,22,184,Montauban-de-Bretagne,4511,195,4706
53,Bretagne,35,3,42,185,Montautour,253,9,262
53,Bretagne,35,3,27,187,Monterfil,1208,22,1230
53,Bretagne,35,3,23,188,Montfort-sur-Meu,6186,136,6322
53,Bretagne,35,3,52,189,Montgermont,3062,74,3136
53,Bretagne,35,1,20,190,Monthault,252,7,259
53,Bretagne,35,1,36,191,Montours,960,16,976
53,Bretagne,35,3,43,192,Montreuil-des-Landes,219,3,222
53,Bretagne,35,3,34,193,Montreuil-le-Gast,1925,21,1946
53,Bretagne,35,3,43,194,Montreuil-sous-Pérouse,1078,41,1119
53,Bretagne,35,3,34,195,Montreuil-sur-Ille,1989,33,2022
53,Bretagne,35,3,24,196,Mordelles,7102,151,7253
53,Bretagne,35,3,34,197,Mouazé,980,18,998
53,Bretagne,35,3,15,198,Moulins,640,15,655
53,Bretagne,35,3,15,199,Moussé,324,9,333
53,Bretagne,35,3,15,200,Moutiers,843,15,858
53,Bretagne,35,3,38,201,Muel,794,14,808
53,Bretagne,35,2,03,202,La Noë-Blanche,983,16,999
53,Bretagne,35,3,23,203,La Nouaye,260,5,265
53,Bretagne,35,3,07,204,Nouvoitou,2940,60,3000
53,Bretagne,35,3,47,206,Noyal-Châtillon-sur-Seiche,5830,90,5920
53,Bretagne,35,1,01,205,Noyal-sous-Bazouges,373,10,383
53,Bretagne,35,3,07,207,Noyal-sur-Vilaine,5093,123,5216
53,Bretagne,35,3,47,208,Orgères,3690,61,3751
53,Bretagne,35,3,06,209,Ossé,1160,11,1171
53,Bretagne,35,3,31,210,Pacé,9110,256,9366
53,Bretagne,35,3,27,211,Paimpont,1654,37,1691
53,Bretagne,35,2,03,212,Pancé,1112,20,1132
53,Bretagne,35,1,13,214,Parcé,646,4,650
53,Bretagne,35,1,12,215,Parigné,1301,28,1329
53,Bretagne,35,3,31,216,Parthenay-de-Bretagne,1293,24,1317
53,Bretagne,35,3,02,217,Le Pertre,1414,27,1441
53,Bretagne,35,2,40,218,Le Petit-Fougeray,760,12,772
53,Bretagne,35,2,25,219,Pipriac,3355,60,3415
53,Bretagne,35,3,18,220,Piré-sur-Seiche,2183,40,2223
53,Bretagne,35,2,03,221,Pléchâtel,2654,58,2712
53,Bretagne,35,4,26,222,Pleine-Fougères,1836,46,1882
53,Bretagne,35,3,27,223,Plélan-le-Grand,3511,80,3591
53,Bretagne,35,4,08,224,Plerguer,2195,40,2235
53,Bretagne,35,4,41,225,Plesder,664,14,678
53,Bretagne,35,4,41,226,Pleugueneuc,1584,16,1600
53,Bretagne,35,3,23,227,Pleumeleuc,2706,36,2742
53,Bretagne,35,4,10,228,Pleurtuit,5565,133,5698
53,Bretagne,35,3,43,229,Pocé-les-Bois,1044,21,1065
53,Bretagne,35,1,20,230,Poilley,407,2,409
53,Bretagne,35,2,03,231,Poligné,1099,13,1112
53,Bretagne,35,3,47,363,Pont-Péan,3692,98,3790
53,Bretagne,35,3,42,232,Princé,361,1,362
53,Bretagne,35,3,17,233,Québriac,1421,21,1442
53,Bretagne,35,3,38,234,Quédillac,1094,30,1124
53,Bretagne,35,3,15,235,Rannée,1165,33,1198
53,Bretagne,35,2,28,236,Redon,9555,797,10352
53,Bretagne,35,2,28,237,Renac,923,40,963
53,Bretagne,35,3,98,238,Rennes,206655,5123,211778
53,Bretagne,35,3,33,239,Retiers,3620,93,3713
53,Bretagne,35,3,24,240,Le Rheu,7694,221,7915
53,Bretagne,35,4,10,241,La Richardais,2327,80,2407
53,Bretagne,35,1,01,242,Rimou,351,11,362
53,Bretagne,35,1,13,243,Romagné,2029,53,2082
53,Bretagne,35,3,34,244,Romazy,261,7,268
53,Bretagne,35,3,04,245,Romillé,3493,61,3554
53,Bretagne,35,4,11,246,Roz-Landrieux,1198,25,1223
53,Bretagne,35,4,26,247,Roz-sur-Couesnon,1024,24,1048
53,Bretagne,35,4,26,248,Sains,483,5,488
53,Bretagne,35,3,07,250,Saint-Armel,1740,19,1759
53,Bretagne,35,3,34,251,Saint-Aubin-d'Aubigné,3105,82,3187
53,Bretagne,35,3,43,252,Saint-Aubin-des-Landes,905,17,922
53,Bretagne,35,1,35,253,Saint-Aubin-du-Cormier,3653,128,3781
53,Bretagne,35,3,07,254,Saint-Aubin-du-Pavail,757,14,771
53,Bretagne,35,4,05,255,Saint-Benoît-des-Ondes,1125,27,1152
53,Bretagne,35,4,10,256,Saint-Briac-sur-Mer,1952,75,2027
53,Bretagne,35,1,36,257,Saint-Brice-en-Coglès,2729,49,2778
53,Bretagne,35,3,04,258,Saint-Brieuc-des-Iffs,358,10,368
53,Bretagne,35,4,26,259,Saint-Broladre,1067,17,1084
53,Bretagne,35,1,35,261,Saint-Christophe-de-Valains,186,5,191
53,Bretagne,35,3,43,260,Saint-Christophe-des-Bois,505,11,516
53,Bretagne,35,4,05,263,Saint-Coulomb,2427,101,2528
53,Bretagne,35,3,06,264,Saint-Didier,1688,32,1720
53,Bretagne,35,4,41,265,Saint-Domineuc,2112,21,2133
53,Bretagne,35,3,47,266,Saint-Erblon,2500,58,2558
53,Bretagne,35,1,36,267,Saint-Étienne-en-Coglès,1643,28,1671
53,Bretagne,35,2,25,268,Saint-Ganton,418,5,423
53,Bretagne,35,1,35,269,Saint-Georges-de-Chesné,547,11,558
53,Bretagne,35,4,26,270,Saint-Georges-de-Gréhaigne,353,5,358
53,Bretagne,35,1,20,271,Saint-Georges-de-Reintembault,1640,29,1669
53,Bretagne,35,3,02,272,Saint-Germain-du-Pinel,836,11,847
53,Bretagne,35,1,36,273,Saint-Germain-en-Coglès,2012,62,2074
53,Bretagne,35,3,34,274,Saint-Germain-sur-Ille,914,17,931
53,Bretagne,35,3,24,275,Saint-Gilles,3590,77,3667
53,Bretagne,35,3,17,276,Saint-Gondran,519,8,527
53,Bretagne,35,3,23,277,Saint-Gonlay,341,6,347
53,Bretagne,35,3,52,278,Saint-Grégoire,8279,460,8739
53,Bretagne,35,4,08,279,Saint-Guinoux,915,12,927
53,Bretagne,35,1,36,280,Saint-Hilaire-des-Landes,990,17,1007
53,Bretagne,35,3,49,281,Saint-Jacques-de-la-Lande,10175,134,10309
53,Bretagne,35,1,35,282,Saint-Jean-sur-Couesnon,1042,14,1056
53,Bretagne,35,3,06,283,Saint-Jean-sur-Vilaine,1068,32,1100
53,Bretagne,35,4,39,284,Saint-Jouan-des-Guérets,2713,105,2818
53,Bretagne,35,2,25,285,Saint-Just,1021,15,1036
53,Bretagne,35,4,09,286,Saint-Léger-des-Prés,221,4,225
53,Bretagne,35,4,10,287,Saint-Lunaire,2323,88,2411
53,Bretagne,35,3,42,300,Saint-M'Hervé,1360,31,1391
53,Bretagne,35,3,22,301,Saint-M'Hervon,426,8,434
53,Bretagne,35,4,96,288,Saint-Malo,48211,1612,49823
53,Bretagne,35,2,25,289,Saint-Malo-de-Phily,822,7,829
53,Bretagne,35,3,38,290,Saint-Malon-sur-Mel,577,10,587
53,Bretagne,35,1,36,292,Saint-Marc-le-Blanc,1230,22,1252
53,Bretagne,35,1,35,293,Saint-Marc-sur-Couesnon,482,2,484
53,Bretagne,35,4,26,291,Saint-Marcan,441,10,451
53,Bretagne,35,3,38,295,Saint-Maugan,536,13,549
53,Bretagne,35,3,34,296,Saint-Médard-sur-Ille,1285,26,1311
53,Bretagne,35,3,38,297,Saint-Méen-le-Grand,4274,169,4443
53,Bretagne,35,4,05,299,Saint-Méloir-des-Ondes,3567,82,3649
53,Bretagne,35,3,38,302,Saint-Onen-la-Chapelle,1021,18,1039
53,Bretagne,35,1,35,304,Saint-Ouen-des-Alleux,1255,15,1270
53,Bretagne,35,1,01,303,Saint-Ouen-la-Rouërie,788,16,804
53,Bretagne,35,3,27,305,Saint-Péran,324,9,333
53,Bretagne,35,4,08,306,Saint-Père,2229,127,2356
53,Bretagne,35,3,04,307,Saint-Pern,919,10,929
53,Bretagne,35,4,09,308,Saint-Pierre-de-Plesguen,2520,51,2571
53,Bretagne,35,1,01,309,Saint-Rémy-du-Plain,729,12,741
53,Bretagne,35,1,13,310,Saint-Sauveur-des-Landes,1369,28,1397
53,Bretagne,35,2,21,311,Saint-Séglin,462,8,470
53,Bretagne,35,2,16,312,Saint-Senoux,1635,27,1662
53,Bretagne,35,4,08,314,Saint-Suliac,933,37,970
53,Bretagne,35,2,14,316,Saint-Sulpice-des-Landes,816,14,830
53,Bretagne,35,3,19,315,Saint-Sulpice-la-Forêt,1404,34,1438
53,Bretagne,35,3,17,317,Saint-Symphorien,523,78,601
53,Bretagne,35,4,41,318,Saint-Thual,677,7,684
53,Bretagne,35,3,27,319,Saint-Thurial,1847,29,1876
53,Bretagne,35,3,22,320,Saint-Uniac,506,6,512
53,Bretagne,35,2,14,249,Sainte-Anne-sur-Vilaine,982,20,1002
53,Bretagne,35,3,33,262,Sainte-Colombe,309,10,319
53,Bretagne,35,2,28,294,Sainte-Marie,2204,62,2266
53,Bretagne,35,2,40,321,Saulnières,687,10,697
53,Bretagne,35,2,40,322,Le Sel-de-Bretagne,822,14,836
53,Bretagne,35,1,36,323,La Selle-en-Coglès,572,8,580
53,Bretagne,35,1,12,324,La Selle-en-Luitré,537,21,558
53,Bretagne,35,3,15,325,La Selle-Guerchaise,148,6,154
53,Bretagne,35,3,34,326,Sens-de-Bretagne,2288,19,2307
53,Bretagne,35,3,07,327,Servon-sur-Vilaine,3465,71,3536
53,Bretagne,35,2,25,328,Sixt-sur-Aff,2088,41,2129
53,Bretagne,35,4,26,329,Sougéal,619,11,630
53,Bretagne,35,3,43,330,Taillis,967,20,987
53,Bretagne,35,3,23,331,Talensac,2317,34,2351
53,Bretagne,35,2,03,332,Teillay,972,14,986
53,Bretagne,35,3,33,333,Le Theil-de-Bretagne,1534,29,1563
53,Bretagne,35,3,19,334,Thorigné-Fouillard,7019,253,7272
53,Bretagne,35,3,33,335,Thourie,684,15,699
53,Bretagne,35,1,36,336,Le Tiercent,174,8,182
53,Bretagne,35,4,41,337,Tinténiac,3247,163,3410
53,Bretagne,35,3,02,338,Torcé,1144,19,1163
53,Bretagne,35,4,26,339,Trans-la-Forêt,570,15,585
53,Bretagne,35,3,27,340,Treffendel,1252,24,1276
53,Bretagne,35,1,01,341,Tremblay,1511,49,1560
53,Bretagne,35,4,09,342,Trémeheuc,351,4,355
53,Bretagne,35,2,40,343,Tresboeuf,1176,12,1188
53,Bretagne,35,4,09,344,Tressé,339,10,349
53,Bretagne,35,4,41,345,Trévérien,770,10,780
53,Bretagne,35,4,41,346,Trimer,175,1,176
53,Bretagne,35,4,08,362,Le Tronchet,996,20,1016
53,Bretagne,35,3,43,347,Val-d'Izé,2412,64,2476
53,Bretagne,35,1,35,348,Vendel,430,5,435
53,Bretagne,35,3,02,350,Vergéal,713,13,726
53,Bretagne,35,3,23,351,Le Verger,1547,27,1574
53,Bretagne,35,3,46,352,Vern-sur-Seiche,7977,199,8176
53,Bretagne,35,3,49,353,Vezin-le-Coquet,3840,93,3933
53,Bretagne,35,4,26,354,Vieux-Viel,289,2,291
53,Bretagne,35,3,34,355,Vieux-Vy-sur-Couesnon,1082,7,1089
53,Bretagne,35,3,17,356,Vignoc,1814,23,1837
53,Bretagne,35,1,20,357,Villamée,323,3,326
53,Bretagne,35,4,08,358,La Ville-ès-Nonais,1025,34,1059
53,Bretagne,35,3,15,359,Visseiche,841,8,849
53,Bretagne,35,3,99,360,Vitré,16688,563,17251
53,Bretagne,35,4,11,361,Le Vivier-sur-Mer,1030,25,1055
24,Centre,36,3,01,001,Aigurande,1633,26,1659
24,Centre,36,4,23,002,Aize,129,3,132
24,Centre,36,4,13,003,Ambrault,865,11,876
24,Centre,36,4,18,004,Anjouin,348,5,353
24,Centre,36,2,02,005,Ardentes,3739,86,3825
24,Centre,36,2,03,006,Argenton-sur-Creuse,5177,236,5413
24,Centre,36,2,06,007,Argy,610,17,627
24,Centre,36,2,08,008,Arpheuilles,252,11,263
24,Centre,36,2,02,009,Arthon,1117,54,1171
24,Centre,36,1,15,010,Azay-le-Ferron,933,27,960
24,Centre,36,3,11,158,Badecon-le-Pin,733,6,739
24,Centre,36,4,18,011,Bagneux,191,2,193
24,Centre,36,3,11,012,Baraize,314,9,323
24,Centre,36,2,14,013,Baudres,511,10,521
24,Centre,36,3,11,014,Bazaiges,233,6,239
24,Centre,36,1,17,015,Beaulieu,85,0,85
24,Centre,36,1,04,016,Bélâbre,979,30,1009
24,Centre,36,3,09,017,La Berthenoux,464,12,476
24,Centre,36,1,05,018,Le Blanc,6936,380,7316
24,Centre,36,4,13,019,Bommiers,287,4,291
24,Centre,36,1,17,020,Bonneuil,89,1,90
24,Centre,36,4,12,021,Les Bordes,937,28,965
24,Centre,36,2,03,022,Bouesse,387,9,396
24,Centre,36,2,14,023,Bouges-le-Château,274,6,280
24,Centre,36,2,14,024,Bretagne,116,1,117
24,Centre,36,3,09,025,Briantes,602,18,620
24,Centre,36,2,14,026,Brion,493,7,500
24,Centre,36,4,13,027,Brives,273,4,277
24,Centre,36,3,01,028,La Buxerette,111,0,111
24,Centre,36,4,23,029,Buxeuil,219,6,225
24,Centre,36,2,02,030,Buxières-d'Aillac,219,6,225
24,Centre,36,2,06,031,Buzançais,4525,60,4585
24,Centre,36,3,11,032,Ceaulmont,706,8,714
24,Centre,36,2,03,033,Celon,391,3,394
24,Centre,36,4,18,034,Chabris,2768,45,2813
24,Centre,36,1,17,035,Chaillac,1153,25,1178
24,Centre,36,1,04,036,Chalais,167,6,173
24,Centre,36,4,12,037,La Champenoise,305,5,310
24,Centre,36,3,09,038,Champillet,158,3,161
24,Centre,36,2,06,040,La Chapelle-Orthemale,121,3,124
24,Centre,36,4,23,041,La Chapelle-Saint-Laurian,141,4,145
24,Centre,36,2,03,042,Chasseneuil,651,18,669
24,Centre,36,3,09,043,Chassignolles,575,15,590
24,Centre,36,2,98,044,Châteauroux,46026,2115,48141
24,Centre,36,2,08,045,Châtillon-sur-Indre,2859,58,2917
24,Centre,36,3,09,046,La Châtre,4465,144,4609
24,Centre,36,1,17,047,La Châtre-Langlin,574,3,577
24,Centre,36,2,03,048,Chavin,291,6,297
24,Centre,36,1,17,049,Chazelet,119,5,124
24,Centre,36,2,06,050,Chezelles,413,5,418
24,Centre,36,1,19,051,Chitray,160,7,167
24,Centre,36,4,13,052,Chouday,167,1,168
24,Centre,36,1,05,053,Ciron,513,20,533
24,Centre,36,2,08,054,Cléré-du-Bois,288,3,291
24,Centre,36,2,08,055,Clion,1128,17,1145
24,Centre,36,3,16,056,Cluis,1027,24,1051
24,Centre,36,2,14,057,Coings,870,22,892
24,Centre,36,1,05,058,Concremiers,637,25,662
24,Centre,36,4,13,059,Condé,226,7,233
24,Centre,36,3,01,060,Crevant,730,9,739
24,Centre,36,3,01,061,Crozon-sur-Vauvre,372,12,384
24,Centre,36,3,11,062,Cuzion,453,4,457
24,Centre,36,2,24,063,Déols,8677,218,8895
24,Centre,36,2,02,064,Diors,745,23,768
24,Centre,36,4,12,065,Diou,280,5,285
24,Centre,36,1,05,066,Douadic,423,11,434
24,Centre,36,4,18,068,Dun-le-Poëlier,473,6,479
24,Centre,36,1,17,067,Dunet,112,1,113
24,Centre,36,2,10,069,Écueillé,1324,23,1347
24,Centre,36,3,11,070,Éguzon-Chantôme,1386,33,1419
24,Centre,36,2,02,071,Étrechet,862,25,887
24,Centre,36,2,22,072,Faverolles,343,6,349
24,Centre,36,3,20,073,Feusines,202,2,204
24,Centre,36,2,08,074,Fléré-la-Rivière,603,12,615
24,Centre,36,4,23,075,Fontenay,81,0,81
24,Centre,36,1,21,076,Fontgombault,272,8,280
24,Centre,36,2,22,077,Fontguenand,243,5,248
24,Centre,36,3,16,078,Fougerolles,320,5,325
24,Centre,36,2,14,079,Francillon,72,3,75
24,Centre,36,2,10,080,Frédille,63,0,63
24,Centre,36,3,11,081,Gargilesse-Dampierre,328,6,334
24,Centre,36,2,10,082,Gehée,294,5,299
24,Centre,36,4,23,083,Giroux,120,3,123
24,Centre,36,3,16,084,Gournay,336,7,343
24,Centre,36,4,23,085,Guilly,247,3,250
24,Centre,36,2,10,086,Heugnes,406,14,420
24,Centre,36,1,05,087,Ingrandes,331,12,343
24,Centre,36,4,99,088,Issoudun,13477,391,13868
24,Centre,36,2,02,089,Jeu-les-Bois,392,4,396
24,Centre,36,2,10,090,Jeu-Maloches,130,6,136
24,Centre,36,3,09,091,Lacs,654,17,671
24,Centre,36,2,22,092,Langé,299,3,302
24,Centre,36,2,14,093,Levroux,2824,48,2872
24,Centre,36,1,04,094,Lignac,584,21,605
24,Centre,36,3,20,095,Lignerolles,113,1,114
24,Centre,36,1,21,096,Lingé,270,4,274
24,Centre,36,4,23,097,Liniez,320,4,324
24,Centre,36,4,12,098,Lizeray,106,4,110
24,Centre,36,3,01,099,Lourdoueix-Saint-Michel,369,8,377
24,Centre,36,3,09,100,Lourouer-Saint-Laurent,233,6,239
24,Centre,36,2,02,101,Luant,1364,47,1411
24,Centre,36,1,21,104,Lurais,236,8,244
24,Centre,36,1,21,105,Lureuil,274,3,277
24,Centre,36,1,19,106,Luzeret,147,4,151
24,Centre,36,4,23,102,Luçay-le-Libre,111,1,112
24,Centre,36,2,22,103,Luçay-le-Mâle,1512,38,1550
24,Centre,36,2,22,107,Lye,807,26,833
24,Centre,36,3,16,108,Lys-Saint-Georges,223,9,232
24,Centre,36,3,09,109,Le Magny,1001,29,1030
24,Centre,36,3,16,110,Maillet,261,4,265
24,Centre,36,3,16,111,Malicornay,182,1,183
24,Centre,36,2,02,112,Mâron,731,27,758
24,Centre,36,1,21,113,Martizay,1041,27,1068
24,Centre,36,1,04,114,Mauvières,329,2,331
24,Centre,36,4,18,115,Menetou-sur-Nahon,114,2,116
24,Centre,36,4,23,116,Ménétréols-sous-Vatan,119,6,125
24,Centre,36,2,03,117,Le Menoux,450,18,468
24,Centre,36,2,06,118,Méobecq,365,7,372
24,Centre,36,1,21,119,Mérigny,562,9,571
24,Centre,36,3,16,120,Mers-sur-Indre,566,26,592
24,Centre,36,4,13,121,Meunet-Planches,197,1,198
24,Centre,36,4,23,122,Meunet-sur-Vatan,194,8,202
24,Centre,36,1,15,123,Mézières-en-Brenne,1081,29,1110
24,Centre,36,1,19,124,Migné,272,9,281
24,Centre,36,4,12,125,Migny,120,3,123
24,Centre,36,3,01,126,Montchevrier,512,12,524
24,Centre,36,3,09,127,Montgivray,1714,52,1766
24,Centre,36,2,24,128,Montierchaume,1654,48,1702
24,Centre,36,3,16,129,Montipouret,566,9,575
24,Centre,36,3,09,130,Montlevicq,103,2,105
24,Centre,36,2,03,131,Mosnay,472,9,481
24,Centre,36,3,09,132,La Motte-Feuilly,31,1,32
24,Centre,36,3,16,133,Mouhers,245,4,249
24,Centre,36,1,17,134,Mouhet,507,15,522
24,Centre,36,2,14,135,Moulins-sur-Céphons,336,15,351
24,Centre,36,2,08,136,Murs,123,3,126
24,Centre,36,1,21,137,Néons-sur-Creuse,395,14,409
24,Centre,36,3,09,138,Néret,209,5,214
24,Centre,36,2,06,139,Neuillay-les-Bois,652,9,661
24,Centre,36,4,13,140,Neuvy-Pailloux,1305,8,1313
24,Centre,36,3,16,141,Neuvy-Saint-Sépulchre,1676,37,1713
24,Centre,36,2,25,142,Niherne,1562,193,1755
24,Centre,36,3,09,143,Nohant-Vic,476,5,481
24,Centre,36,1,19,144,Nuret-le-Ferron,325,7,332
24,Centre,36,1,15,145,Obterre,234,6,240
24,Centre,36,3,01,146,Orsennes,808,5,813
24,Centre,36,4,18,147,Orville,127,2,129
24,Centre,36,1,19,148,Oulches,416,7,423
24,Centre,36,2,08,149,Palluau-sur-Indre,785,16,801
24,Centre,36,1,17,150,Parnac,519,15,534
24,Centre,36,4,18,151,Parpeçay,248,2,250
24,Centre,36,4,12,152,Paudy,459,11,470
24,Centre,36,1,15,153,Paulnay,357,4,361
24,Centre,36,2,03,154,Le Pêchereau,2010,45,2055
24,Centre,36,2,10,155,Pellevoisin,860,61,921
24,Centre,36,3,20,156,Pérassay,392,5,397
24,Centre,36,2,02,157,La Pérouille,418,5,423
24,Centre,36,2,02,159,Le Poinçonnet,5773,194,5967
24,Centre,36,3,11,160,Pommiers,271,2,273
24,Centre,36,2,03,161,Le Pont-Chrétien-Chabenet,946,34,980
24,Centre,36,4,18,162,Poulaines,874,16,890
24,Centre,36,3,20,163,Pouligny-Notre-Dame,624,16,640
24,Centre,36,3,20,164,Pouligny-Saint-Martin,245,10,255
24,Centre,36,1,05,165,Pouligny-Saint-Pierre,1034,40,1074
24,Centre,36,2,10,166,Préaux,165,1,166
24,Centre,36,1,21,167,Preuilly-la-Ville,166,5,171
24,Centre,36,1,04,168,Prissac,688,17,705
24,Centre,36,4,13,169,Pruniers,529,8,537
24,Centre,36,4,23,170,Reboursin,115,0,115
24,Centre,36,4,12,171,Reuilly,2025,25,2050
24,Centre,36,1,19,172,Rivarennes,576,12,588
24,Centre,36,1,05,173,Rosnay,616,21,637
24,Centre,36,1,17,174,Roussines,383,21,404
24,Centre,36,2,14,175,Rouvres-les-Bois,335,12,347
24,Centre,36,1,05,176,Ruffec,653,45,698
24,Centre,36,1,17,177,Sacierges-Saint-Martin,321,7,328
24,Centre,36,1,05,178,Saint-Aigny,294,1,295
24,Centre,36,4,12,179,Saint-Aoustrille,163,3,166
24,Centre,36,3,09,180,Saint-Août,856,11,867
24,Centre,36,4,13,181,Saint-Aubin,176,4,180
24,Centre,36,1,17,182,Saint-Benoît-du-Sault,703,19,722
24,Centre,36,3,09,184,Saint-Chartier,607,7,614
24,Centre,36,4,18,185,Saint-Christophe-en-Bazelle,379,10,389
24,Centre,36,3,09,186,Saint-Christophe-en-Boucherie,256,5,261
24,Centre,36,1,17,187,Saint-Civran,181,5,186
24,Centre,36,2,08,188,Saint-Cyran-du-Jambot,207,202,409
24,Centre,36,3,01,189,Saint-Denis-de-Jouhet,955,9,964
24,Centre,36,4,23,191,Saint-Florentin,495,7,502
24,Centre,36,1,19,192,Saint-Gaultier,1963,82,2045
24,Centre,36,2,06,194,Saint-Genou,1013,13,1026
24,Centre,36,4,12,195,Saint-Georges-sur-Arnon,524,13,537
24,Centre,36,1,17,196,Saint-Gilles,100,4,104
24,Centre,36,1,04,197,Saint-Hilaire-sur-Benaize,359,7,366
24,Centre,36,2,06,198,Saint-Lactencin,397,11,408
24,Centre,36,2,03,200,Saint-Marcel,1606,88,1694
24,Centre,36,2,14,201,Saint-Martin-de-Lamps,154,2,156
24,Centre,36,2,25,202,Saint-Maur,3387,94,3481
24,Centre,36,2,08,203,Saint-Médard,44,0,44
24,Centre,36,1,15,204,Saint-Michel-en-Brenne,322,3,325
24,Centre,36,4,23,205,Saint-Pierre-de-Jards,123,6,129
24,Centre,36,2,14,206,Saint-Pierre-de-Lamps,43,1,44
24,Centre,36,3,01,207,Saint-Plantaire,549,5,554
24,Centre,36,4,12,209,Saint-Valentin,273,7,280
24,Centre,36,4,18,183,Sainte-Cécile,108,1,109
24,Centre,36,4,13,190,Sainte-Fauste,281,7,288
24,Centre,36,1,15,193,Sainte-Gemme,264,8,272
24,Centre,36,4,12,199,Sainte-Lizaigne,1227,36,1263
24,Centre,36,3,20,208,Sainte-Sévère-sur-Indre,865,18,883
24,Centre,36,3,16,210,Sarzay,318,7,325
24,Centre,36,2,02,211,Sassierges-Saint-Germain,456,8,464
24,Centre,36,1,15,212,Saulnay,185,9,194
24,Centre,36,1,21,213,Sauzelles,243,10,253
24,Centre,36,3,20,214,Sazeray,327,13,340
24,Centre,36,4,13,215,Ségry,515,12,527
24,Centre,36,2,10,216,Selles-sur-Nahon,61,1,62
24,Centre,36,4,18,217,Sembleçay,111,2,113
24,Centre,36,2,06,218,Sougé,159,3,162
24,Centre,36,2,03,219,Tendu,559,9,568
24,Centre,36,1,19,220,Thenay,886,11,897
24,Centre,36,3,09,221,Thevet-Saint-Julien,480,3,483
24,Centre,36,4,13,222,Thizay,255,4,259
24,Centre,36,1,04,223,Tilly,167,6,173
24,Centre,36,1,21,224,Tournon-Saint-Martin,1223,18,1241
24,Centre,36,2,08,225,Le Tranger,181,10,191
24,Centre,36,3,16,226,Tranzault,318,8,326
24,Centre,36,3,20,227,Urciers,267,1,268
24,Centre,36,2,22,228,Valençay,2642,119,2761
24,Centre,36,4,18,229,Varennes-sur-Fouzon,710,10,720
24,Centre,36,4,23,230,Vatan,2029,34,2063
24,Centre,36,2,02,231,Velles,852,25,877
24,Centre,36,2,06,232,Vendoeuvres,1110,20,1130
24,Centre,36,2,22,233,La Vernelle,800,11,811
24,Centre,36,3,09,234,Verneuil-sur-Igneraie,346,8,354
24,Centre,36,2,22,235,Veuil,376,5,381
24,Centre,36,3,09,236,Vicq-Exemplet,331,10,341
24,Centre,36,2,22,237,Vicq-sur-Nahon,755,8,763
24,Centre,36,3,20,238,Vigoulant,133,0,133
24,Centre,36,1,17,239,Vigoux,467,6,473
24,Centre,36,3,20,240,Vijon,310,9,319
24,Centre,36,2,06,241,Villedieu-sur-Indre,2723,46,2769
24,Centre,36,2,14,242,Villegongis,142,2,144
24,Centre,36,2,10,243,Villegouin,404,5,409
24,Centre,36,2,22,244,Villentrois,620,15,635
24,Centre,36,2,25,245,Villers-les-Ormes,421,12,433
24,Centre,36,1,15,246,Villiers,190,5,195
24,Centre,36,2,14,247,Vineuil,1151,27,1178
24,Centre,36,4,13,248,Vouillon,264,9,273
24,Centre,37,3,09,001,Abilly,1088,23,1111
24,Centre,37,2,05,002,Ambillou,1732,27,1759
24,Centre,37,2,01,003,Amboise,12436,321,12757
24,Centre,37,1,10,004,Anché,418,7,425
24,Centre,37,1,20,005,Antogny-le-Tillac,539,5,544
24,Centre,37,2,14,006,Artannes-sur-Indre,2509,47,2556
24,Centre,37,1,19,007,Assay,178,3,181
24,Centre,37,2,03,008,Athée-sur-Cher,2376,46,2422
24,Centre,37,2,06,009,Autrèche,377,6,383
24,Centre,37,2,06,010,Auzouer-en-Touraine,1972,103,2075
24,Centre,37,1,07,011,Avoine,1854,51,1905
24,Centre,37,1,10,012,Avon-les-Roches,530,8,538
24,Centre,37,1,11,013,Avrillé-les-Ponceaux,447,5,452
24,Centre,37,1,02,014,Azay-le-Rideau,3418,100,3518
24,Centre,37,2,03,015,Azay-sur-Cher,2952,75,3027
24,Centre,37,3,13,016,Azay-sur-Indre,380,9,389
24,Centre,37,2,31,018,Ballan-Miré,7888,204,8092
24,Centre,37,3,08,019,Barrou,483,16,499
24,Centre,37,3,13,020,Beaulieu-lès-Loches,1719,47,1766
24,Centre,37,1,07,022,Beaumont-en-Véron,2845,137,2982
24,Centre,37,2,16,021,Beaumont-la-Ronce,1148,13,1161
24,Centre,37,3,15,023,Beaumont-Village,252,4,256
24,Centre,37,1,04,024,Benais,901,33,934
24,Centre,37,2,31,025,Berthenay,730,10,740
24,Centre,37,3,08,026,Betz-le-Château,576,22,598
24,Centre,37,2,03,027,Bléré,5110,92,5202
24,Centre,37,3,18,028,Bossay-sur-Claise,827,25,852
24,Centre,37,3,12,029,Bossée,336,2,338
24,Centre,37,2,06,030,Le Boulay,608,8,616
24,Centre,37,1,04,031,Bourgueil,3929,132,4061
24,Centre,37,3,12,032,Bournan,251,6,257
24,Centre,37,3,18,033,Boussay,245,12,257
24,Centre,37,1,19,034,Braslou,353,6,359
24,Centre,37,1,19,035,Braye-sous-Faye,323,6,329
24,Centre,37,2,05,036,Braye-sur-Maulne,220,6,226
24,Centre,37,2,05,037,Brèches,286,5,291
24,Centre,37,1,02,038,Bréhémont,803,11,814
24,Centre,37,3,13,039,Bridoré,518,12,530
24,Centre,37,1,10,040,Brizay,324,2,326
24,Centre,37,2,17,041,Bueil-en-Touraine,359,15,374
24,Centre,37,1,07,042,Candes-Saint-Martin,221,2,223
24,Centre,37,2,01,043,Cangey,1053,12,1065
24,Centre,37,3,08,044,La Celle-Guenand,385,5,390
24,Centre,37,3,09,045,La Celle-Saint-Avant,1037,20,1057
24,Centre,37,2,03,046,Céré-la-Ronde,428,10,438
24,Centre,37,2,16,047,Cerelles,1223,25,1248
24,Centre,37,3,18,048,Chambon,298,10,308
24,Centre,37,3,13,049,Chambourg-sur-Indre,1295,37,1332
24,Centre,37,2,34,050,Chambray-lès-Tours,10979,266,11245
24,Centre,37,1,19,051,Champigny-sur-Veude,861,27,888
24,Centre,37,3,13,053,Chanceaux-près-Loches,148,2,150
24,Centre,37,2,24,054,Chanceaux-sur-Choisille,3572,50,3622
24,Centre,37,2,05,055,Channay-sur-Lathan,800,13,813
24,Centre,37,2,24,052,Chançay,1052,14,1066
24,Centre,37,1,02,056,La Chapelle-aux-Naux,529,9,538
24,Centre,37,3,12,057,La Chapelle-Blanche-Saint-Martin,633,19,652
24,Centre,37,1,04,058,La Chapelle-sur-Loire,1538,33,1571
24,Centre,37,2,16,059,Charentilly,1070,23,1093
24,Centre,37,2,01,060,Chargé,1094,13,1107
24,Centre,37,3,18,061,Charnizay,483,20,503
24,Centre,37,2,05,062,Château-la-Vallière,1597,24,1621
24,Centre,37,2,06,063,Château-Renault,5225,96,5321
24,Centre,37,3,18,064,Chaumussay,256,5,261
24,Centre,37,1,19,065,Chaveignes,549,13,562
24,Centre,37,3,13,066,Chédigny,530,29,559
24,Centre,37,1,02,067,Cheillé,1558,25,1583
24,Centre,37,2,17,068,Chemillé-sur-Dême,666,17,683
24,Centre,37,3,15,069,Chemillé-sur-Indrois,218,17,235
24,Centre,37,2,03,070,Chenonceaux,353,6,359
24,Centre,37,1,10,071,Chezelles,144,1,145
24,Centre,37,1,07,072,Chinon,8078,464,8542
24,Centre,37,2,03,073,Chisseaux,627,8,635
24,Centre,37,1,04,074,Chouzé-sur-Loire,2081,35,2116
24,Centre,37,2,03,075,Cigogné,319,8,327
24,Centre,37,1,07,076,Cinais,437,16,453
24,Centre,37,1,11,077,Cinq-Mars-la-Pile,3226,37,3263
24,Centre,37,3,12,078,Ciran,435,11,446
24,Centre,37,2,03,079,Civray-de-Touraine,1763,57,1820
24,Centre,37,3,09,080,Civray-sur-Esves,203,10,213
24,Centre,37,1,11,081,Cléré-les-Pins,1237,19,1256
24,Centre,37,1,04,082,Continvoir,460,3,463
24,Centre,37,2,34,083,Cormery,1656,23,1679
24,Centre,37,2,05,084,Couesmes,549,5,554
24,Centre,37,2,05,086,Courcelles-de-Touraine,441,4,445
24,Centre,37,1,19,087,Courcoué,251,3,254
24,Centre,37,2,03,085,Courçay,792,16,808
24,Centre,37,1,07,088,Couziers,108,3,111
24,Centre,37,1,10,089,Cravant-les-Côteaux,712,20,732
24,Centre,37,1,10,090,Crissay-sur-Manse,118,6,124
24,Centre,37,2,03,091,La Croix-en-Touraine,2192,80,2272
24,Centre,37,2,06,092,Crotelles,627,8,635
24,Centre,37,1,10,093,Crouzilles,556,6,562
24,Centre,37,3,09,094,Cussay,580,15,595
24,Centre,37,2,06,095,Dame-Marie-les-Bois,326,9,335
24,Centre,37,3,09,115,Descartes,3829,64,3893
24,Centre,37,2,03,096,Dierre,573,11,584
24,Centre,37,3,13,097,Dolus-le-Sec,664,17,681
24,Centre,37,3,09,098,Draché,682,10,692
24,Centre,37,2,31,099,Druye,883,25,908
24,Centre,37,2,03,100,Épeigné-les-Bois,422,7,429
24,Centre,37,2,17,101,Épeigné-sur-Dême,158,0,158
24,Centre,37,1,11,102,Les Essards,157,0,157
24,Centre,37,3,12,103,Esves-le-Moutier,142,3,145
24,Centre,37,2,34,104,Esvres,4439,103,4542
24,Centre,37,1,19,105,Faye-la-Vineuse,314,3,317
24,Centre,37,2,06,106,La Ferrière,288,0,288
24,Centre,37,3,08,107,Ferrière-Larçon,279,9,288
24,Centre,37,3,13,108,Ferrière-sur-Beaulieu,674,9,683
24,Centre,37,2,36,109,Fondettes,10270,416,10686
24,Centre,37,2,03,110,Francueil,1275,28,1303
24,Centre,37,3,15,111,Genillé,1526,44,1570
24,Centre,37,1,04,112,Gizeux,451,42,493
24,Centre,37,3,08,113,Le Grand-Pressigny,1029,26,1055
24,Centre,37,3,08,114,La Guerche,212,5,217
24,Centre,37,2,06,116,Les Hermites,549,11,560
24,Centre,37,2,05,117,Hommes,836,11,847
24,Centre,37,1,07,118,Huismes,1519,37,1556
24,Centre,37,1,10,119,L' Île-Bouchard,1754,39,1793
24,Centre,37,1,11,120,Ingrandes-de-Touraine,502,12,514
24,Centre,37,1,19,121,Jaulnay,253,7,260
24,Centre,37,2,98,122,Joué-lès-Tours,35839,582,36421
24,Centre,37,1,11,123,Langeais,3992,62,4054
24,Centre,37,2,37,124,Larçay,2316,42,2358
24,Centre,37,1,19,125,Lémeré,405,12,417
24,Centre,37,1,07,126,Lerné,330,24,354
24,Centre,37,3,15,127,Le Liège,338,4,342
24,Centre,37,1,02,128,Lignières-de-Touraine,1058,13,1071
24,Centre,37,1,19,129,Ligré,1035,32,1067
24,Centre,37,3,12,130,Ligueil,2193,32,2225
24,Centre,37,2,01,131,Limeray,1113,22,1135
24,Centre,37,3,15,133,Loché-sur-Indrois,512,41,553
24,Centre,37,3,13,132,Loches,6450,654,7104
24,Centre,37,3,12,134,Louans,605,8,613
24,Centre,37,2,17,135,Louestault,366,4,370
24,Centre,37,3,12,136,Le Louroux,468,13,481
24,Centre,37,2,05,137,Lublé,130,2,132
24,Centre,37,2,01,138,Lussault-sur-Loire,714,13,727
24,Centre,37,2,36,139,Luynes,5025,111,5136
24,Centre,37,1,19,140,Luzé,271,4,275
24,Centre,37,2,03,141,Luzillé,891,11,902
24,Centre,37,1,20,142,Maillé,614,8,622
24,Centre,37,3,12,143,Manthelan,1332,33,1365
24,Centre,37,3,09,145,Marcé-sur-Esves,234,4,238
24,Centre,37,2,05,146,Marcilly-sur-Maulne,236,4,240
24,Centre,37,1,20,147,Marcilly-sur-Vienne,555,11,566
24,Centre,37,1,19,148,Marigny-Marmande,622,4,626
24,Centre,37,2,17,149,Marray,406,14,420
24,Centre,37,1,07,144,Marçay,457,22,479
24,Centre,37,1,11,150,Mazières-de-Touraine,1180,4,1184
24,Centre,37,2,36,151,La Membrolle-sur-Choisille,3029,60,3089
24,Centre,37,2,36,152,Mettray,2021,99,2120
24,Centre,37,2,24,153,Monnaie,3906,58,3964
24,Centre,37,2,14,154,Montbazon,3920,81,4001
24,Centre,37,2,06,155,Monthodon,628,7,635
24,Centre,37,2,37,156,Montlouis-sur-Loire,10444,290,10734
24,Centre,37,3,15,157,Montrésor,346,17,363
24,Centre,37,2,01,158,Montreuil-en-Touraine,717,11,728
24,Centre,37,2,14,159,Monts,6934,118,7052
24,Centre,37,2,06,160,Morand,293,6,299
24,Centre,37,2,01,161,Mosnes,745,6,751
24,Centre,37,3,12,162,Mouzay,478,19,497
24,Centre,37,2,01,163,Nazelles-Négron,3580,57,3637
24,Centre,37,1,20,165,Neuil,433,13,446
24,Centre,37,2,24,166,Neuillé-le-Lierre,726,14,740
24,Centre,37,2,16,167,Neuillé-Pont-Pierre,1989,34,2023
24,Centre,37,3,09,168,Neuilly-le-Brignon,312,13,325
24,Centre,37,2,06,169,Neuville-sur-Brenne,739,16,755
24,Centre,37,2,17,170,Neuvy-le-Roi,1159,83,1242
24,Centre,37,2,24,171,Noizay,1123,23,1146
24,Centre,37,2,24,172,Notre-Dame-d'Oé,3532,65,3597
24,Centre,37,3,15,173,Nouans-les-Fontaines,786,32,818
24,Centre,37,1,20,174,Nouâtre,836,9,845
24,Centre,37,2,06,175,Nouzilly,1219,78,1297
24,Centre,37,1,20,176,Noyant-de-Touraine,903,16,919
24,Centre,37,3,15,177,Orbigny,753,21,774
24,Centre,37,1,10,178,Panzoult,569,25,594
24,Centre,37,2,24,179,Parçay-Meslay,2317,44,2361
24,Centre,37,1,10,180,Parçay-sur-Vienne,643,12,655
24,Centre,37,3,08,181,Paulmy,258,4,262
24,Centre,37,2,16,182,Pernay,1012,18,1030
24,Centre,37,3,13,183,Perrusson,1518,49,1567
24,Centre,37,3,08,184,Le Petit-Pressigny,314,12,326
24,Centre,37,2,01,185,Pocé-sur-Cisse,1570,93,1663
24,Centre,37,2,14,186,Pont-de-Ruan,821,13,834
24,Centre,37,1,20,187,Ports,356,5,361
24,Centre,37,1,20,188,Pouzay,797,8,805
24,Centre,37,3,18,189,Preuilly-sur-Claise,1089,18,1107
24,Centre,37,1,20,190,Pussigny,201,3,204
24,Centre,37,1,19,191,Razines,242,1,243
24,Centre,37,3,13,192,Reignac-sur-Indre,1201,24,1225
24,Centre,37,1,04,193,Restigné,1184,41,1225
24,Centre,37,2,24,194,Reugny,1565,37,1602
24,Centre,37,2,31,195,La Riche,10080,166,10246
24,Centre,37,1,19,196,Richelieu,1950,43,1993
24,Centre,37,1,02,197,Rigny-Ussé,519,6,525
24,Centre,37,2,05,198,Rillé,294,6,300
24,Centre,37,1,10,199,Rilly-sur-Vienne,457,6,463
24,Centre,37,1,02,200,Rivarennes,937,5,942
24,Centre,37,1,07,201,Rivière,674,25,699
24,Centre,37,1,07,202,La Roche-Clermault,496,12,508
24,Centre,37,2,24,203,Rochecorbon,3275,64,3339
24,Centre,37,2,16,204,Rouziers-de-Touraine,1209,19,1228
24,Centre,37,1,02,205,Saché,1230,19,1249
24,Centre,37,2,16,206,Saint-Antoine-du-Rocher,1413,28,1441
24,Centre,37,2,17,207,Saint-Aubin-le-Dépeint,337,6,343
24,Centre,37,2,32,208,Saint-Avertin,14002,447,14449
24,Centre,37,3,13,209,Saint-Bauld,201,3,204
24,Centre,37,1,02,210,Saint-Benoît-la-Forêt,843,11,854
24,Centre,37,2,34,211,Saint-Branchs,2356,50,2406
24,Centre,37,2,17,213,Saint-Christophe-sur-le-Nais,1109,15,1124
24,Centre,37,2,29,214,Saint-Cyr-sur-Loire,15841,442,16283
24,Centre,37,1,20,216,Saint-Épain,1535,34,1569
24,Centre,37,2,36,217,Saint-Étienne-de-Chigny,1369,28,1397
24,Centre,37,3,08,218,Saint-Flovier,602,34,636
24,Centre,37,2,31,219,Saint-Genouph,1010,21,1031
24,Centre,37,1,07,220,Saint-Germain-sur-Vienne,361,7,368
24,Centre,37,3,13,221,Saint-Hippolyte,566,44,610
24,Centre,37,3,13,222,Saint-Jean-Saint-Germain,688,29,717
24,Centre,37,2,05,223,Saint-Laurent-de-Lin,262,6,268
24,Centre,37,2,06,224,Saint-Laurent-en-Gâtines,900,13,913
24,Centre,37,2,03,225,Saint-Martin-le-Beau,2697,51,2748
24,Centre,37,1,11,227,Saint-Michel-sur-Loire,597,10,607
24,Centre,37,1,04,228,Saint-Nicolas-de-Bourgueil,1226,35,1261
24,Centre,37,2,06,229,Saint-Nicolas-des-Motets,260,1,261
24,Centre,37,2,01,230,Saint-Ouen-les-Vignes,1032,29,1061
24,Centre,37,2,17,231,Saint-Paterne-Racan,1663,27,1690
24,Centre,37,1,11,232,Saint-Patrice,678,15,693
24,Centre,37,2,30,233,Saint-Pierre-des-Corps,15528,388,15916
24,Centre,37,3,13,234,Saint-Quentin-sur-Indrois,447,11,458
24,Centre,37,2,01,236,Saint-Règle,422,9,431
24,Centre,37,2,16,237,Saint-Roch,1234,25,1259
24,Centre,37,3,12,238,Saint-Senoch,464,14,478
24,Centre,37,1,20,212,Sainte-Catherine-de-Fierbois,658,5,663
24,Centre,37,1,20,226,Sainte-Maure-de-Touraine,4019,52,4071
24,Centre,37,2,06,240,Saunay,652,11,663
24,Centre,37,2,05,241,Savigné-sur-Lathan,1370,10,1380
24,Centre,37,1,07,242,Savigny-en-Véron,1449,40,1489
24,Centre,37,2,31,243,Savonnières,3021,71,3092
24,Centre,37,1,10,244,Sazilly,254,5,259
24,Centre,37,2,16,245,Semblançay,2029,37,2066
24,Centre,37,3,13,246,Sennevières,229,4,233
24,Centre,37,3,09,247,Sepmes,665,73,738
24,Centre,37,1,07,248,Seuilly,379,50,429
24,Centre,37,2,16,249,Sonzay,1271,30,1301
24,Centre,37,2,14,250,Sorigny,2137,78,2215
24,Centre,37,2,05,251,Souvigné,740,7,747
24,Centre,37,2,01,252,Souvigny-de-Touraine,369,4,373
24,Centre,37,2,03,253,Sublaines,175,2,177
24,Centre,37,3,13,254,Tauxigny,1237,31,1268
24,Centre,37,1,10,255,Tavant,250,2,252
24,Centre,37,1,10,256,Theneuil,273,3,276
24,Centre,37,1,02,257,Thilouze,1476,13,1489
24,Centre,37,1,07,258,Thizay,262,4,266
24,Centre,37,1,19,260,La Tour-Saint-Gelin,553,4,557
24,Centre,37,3,18,259,Tournon-Saint-Pierre,508,16,524
24,Centre,37,2,99,261,Tours,135480,3303,138783
24,Centre,37,1,10,262,Trogues,332,6,338
24,Centre,37,2,34,263,Truyes,2064,37,2101
24,Centre,37,1,02,264,Vallères,1053,20,1073
24,Centre,37,3,12,265,Varennes,229,6,235
24,Centre,37,2,14,266,Veigné,5990,137,6127
24,Centre,37,2,37,267,Véretz,4056,165,4221
24,Centre,37,1,19,268,Verneuil-le-Château,139,2,141
24,Centre,37,3,13,269,Verneuil-sur-Indre,510,37,547
24,Centre,37,2,24,270,Vernou-sur-Brenne,2757,50,2807
24,Centre,37,1,02,271,Villaines-les-Rochers,941,13,954
24,Centre,37,2,31,272,Villandry,1084,11,1095
24,Centre,37,2,37,273,La Ville-aux-Dames,4832,165,4997
24,Centre,37,2,17,274,Villebourg,276,5,281
24,Centre,37,3,15,275,Villedômain,120,1,121
24,Centre,37,2,06,276,Villedômer,1294,66,1360
24,Centre,37,3,15,277,Villeloin-Coulangé,641,22,663
24,Centre,37,2,14,278,Villeperdue,943,9,952
24,Centre,37,2,05,279,Villiers-au-Bouin,781,9,790
24,Centre,37,3,12,280,Vou,206,6,212
24,Centre,37,2,24,281,Vouvray,3088,83,3171
24,Centre,37,3,18,282,Yzeures-sur-Creuse,1466,38,1504
82,Rhône-Alpes,38,2,21,001,Les Abrets,3030,76,3106
82,Rhône-Alpes,38,1,10,002,Les Adrets,796,19,815
82,Rhône-Alpes,38,3,24,003,Agnin,927,17,944
82,Rhône-Alpes,38,1,42,004,L' Albenc,1078,22,1100
82,Rhône-Alpes,38,1,03,005,Allemond,880,35,915
82,Rhône-Alpes,38,1,01,006,Allevard,3796,80,3876
82,Rhône-Alpes,38,1,06,008,Ambel,26,0,26
82,Rhône-Alpes,38,3,24,009,Anjou,954,17,971
82,Rhône-Alpes,38,2,08,010,Annoisin-Chatelans,620,14,634
82,Rhône-Alpes,38,3,46,011,Anthon,946,14,960
82,Rhône-Alpes,38,2,21,012,Aoste,2307,36,2343
82,Rhône-Alpes,38,2,11,013,Apprieu,3045,60,3105
82,Rhône-Alpes,38,2,19,014,Arandon,549,7,556
82,Rhône-Alpes,38,3,28,015,Artas,1601,21,1622
82,Rhône-Alpes,38,3,07,016,Arzay,213,4,217
82,Rhône-Alpes,38,3,24,017,Assieu,1277,24,1301
82,Rhône-Alpes,38,1,22,018,Auberives-en-Royans,353,12,365
82,Rhône-Alpes,38,3,24,019,Auberives-sur-Varèze,1439,14,1453
82,Rhône-Alpes,38,1,03,020,Auris,203,4,207
82,Rhône-Alpes,38,1,41,021,Autrans,1681,75,1756
82,Rhône-Alpes,38,2,19,022,Les Avenières,5152,118,5270
82,Rhône-Alpes,38,1,18,023,Avignonet,219,1,220
82,Rhône-Alpes,38,2,04,024,Badinières,572,19,591
82,Rhône-Alpes,38,3,07,025,Balbins,391,20,411
82,Rhône-Alpes,38,2,08,026,La Balme-les-Grottes,902,21,923
82,Rhône-Alpes,38,1,34,027,Barraux,1820,49,1869
82,Rhône-Alpes,38,2,27,028,La Bâtie-Divisin,858,17,875
82,Rhône-Alpes,38,2,21,029,La Bâtie-Montgascon,1710,40,1750
82,Rhône-Alpes,38,1,23,030,Beaucroissant,1408,21,1429
82,Rhône-Alpes,38,1,06,031,Beaufin,24,1,25
82,Rhône-Alpes,38,1,25,032,Beaufort,543,10,553
82,Rhône-Alpes,38,1,30,033,Beaulieu,612,9,621
82,Rhône-Alpes,38,3,02,034,Beaurepaire,4509,118,4627
82,Rhône-Alpes,38,3,28,035,Beauvoir-de-Marc,1025,20,1045
82,Rhône-Alpes,38,1,22,036,Beauvoir-en-Royans,67,1,68
82,Rhône-Alpes,38,3,02,037,Bellegarde-Poussieu,916,17,933
82,Rhône-Alpes,38,2,11,038,Belmont,432,6,438
82,Rhône-Alpes,38,1,60,039,Bernin,3020,84,3104
82,Rhône-Alpes,38,1,03,040,Besse,143,1,144
82,Rhône-Alpes,38,1,30,041,Bessins,127,2,129
82,Rhône-Alpes,38,2,11,042,Bévenais,840,25,865
82,Rhône-Alpes,38,2,43,043,Bilieu,1192,28,1220
82,Rhône-Alpes,38,2,11,044,Biol,1327,40,1367
82,Rhône-Alpes,38,1,60,045,Biviers,2348,146,2494
82,Rhône-Alpes,38,2,11,046,Bizonnes,746,9,755
82,Rhône-Alpes,38,2,43,047,Blandin,148,3,151
82,Rhône-Alpes,38,2,37,048,Bonnefamille,1026,25,1051
82,Rhône-Alpes,38,3,07,049,Bossieu,277,8,285
82,Rhône-Alpes,38,2,19,050,Le Bouchage,570,16,586
82,Rhône-Alpes,38,3,24,051,Bougé-Chambalud,1225,25,1250
82,Rhône-Alpes,38,1,03,052,Le Bourg-d'Oisans,3377,105,3482
82,Rhône-Alpes,38,2,94,053,Bourgoin-Jallieu,24669,723,25392
82,Rhône-Alpes,38,2,19,054,Bouvesse-Quirieu,1361,17,1378
82,Rhône-Alpes,38,2,19,055,Brangues,572,12,584
82,Rhône-Alpes,38,1,26,056,Bressieux,87,24,111
82,Rhône-Alpes,38,1,47,057,Bresson,695,33,728
82,Rhône-Alpes,38,1,26,058,Brézins,1631,33,1664
82,Rhône-Alpes,38,1,44,059,Brié-et-Angonnes,2343,35,2378
82,Rhône-Alpes,38,1,26,060,Brion,129,1,130
82,Rhône-Alpes,38,1,45,061,La Buisse,2671,70,2741
82,Rhône-Alpes,38,1,34,062,La Buissière,662,21,683
82,Rhône-Alpes,38,2,11,063,Burcin,445,9,454
82,Rhône-Alpes,38,2,33,064,Cessieu,2599,48,2647
82,Rhône-Alpes,38,2,11,065,Châbons,1763,55,1818
82,Rhône-Alpes,38,3,02,066,Châlons,157,8,165
82,Rhône-Alpes,38,2,08,067,Chamagnieu,1492,37,1529
82,Rhône-Alpes,38,1,10,070,Le Champ-près-Froges,1214,12,1226
82,Rhône-Alpes,38,1,44,071,Champ-sur-Drac,3143,36,3179
82,Rhône-Alpes,38,1,44,068,Champagnier,1163,30,1193
82,Rhône-Alpes,38,3,07,069,Champier,1161,9,1170
82,Rhône-Alpes,38,1,93,567,Chamrousse,466,7,473
82,Rhône-Alpes,38,3,24,072,Chanas,2335,50,2385
82,Rhône-Alpes,38,1,36,073,Chantelouve,73,1,74
82,Rhône-Alpes,38,1,42,074,Chantesse,299,5,304
82,Rhône-Alpes,38,1,34,075,Chapareillan,2597,48,2645
82,Rhône-Alpes,38,2,33,076,La Chapelle-de-la-Tour,1620,41,1661
82,Rhône-Alpes,38,3,24,077,La Chapelle-de-Surieu,652,11,663
82,Rhône-Alpes,38,1,01,078,La Chapelle-du-Bard,467,15,482
82,Rhône-Alpes,38,2,27,080,Charancieu,699,9,708
82,Rhône-Alpes,38,3,15,081,Charantonnay,1871,38,1909
82,Rhône-Alpes,38,2,43,082,Charavines,1728,27,1755
82,Rhône-Alpes,38,2,19,083,Charette,410,5,415
82,Rhône-Alpes,38,1,23,084,Charnècles,1458,38,1496
82,Rhône-Alpes,38,3,46,085,Charvieu-Chavagneux,7705,98,7803
82,Rhône-Alpes,38,3,38,087,Chasse-sur-Rhône,5024,52,5076
82,Rhône-Alpes,38,1,42,086,Chasselay,423,9,432
82,Rhône-Alpes,38,2,43,089,Chassignieu,203,6,209
82,Rhône-Alpes,38,1,18,090,Château-Bernard,277,5,282
82,Rhône-Alpes,38,2,04,091,Châteauvilain,600,7,607
82,Rhône-Alpes,38,1,22,092,Châtelus,87,1,88
82,Rhône-Alpes,38,1,25,093,Châtenay,412,7,419
82,Rhône-Alpes,38,3,28,094,Châtonnay,1781,27,1808
82,Rhône-Alpes,38,1,30,095,Chatte,2456,160,2616
82,Rhône-Alpes,38,3,46,097,Chavanoz,4180,64,4244
82,Rhône-Alpes,38,2,43,098,Chélieu,648,13,661
82,Rhône-Alpes,38,1,30,099,Chevrières,666,16,682
82,Rhône-Alpes,38,1,10,100,Le Cheylas,2661,30,2691
82,Rhône-Alpes,38,3,24,101,Cheyssieu,1001,18,1019
82,Rhône-Alpes,38,2,37,102,Chèzeneuve,483,8,491
82,Rhône-Alpes,38,1,05,103,Chichilianne,273,3,276
82,Rhône-Alpes,38,2,21,104,Chimilin,1323,29,1352
82,Rhône-Alpes,38,1,45,105,Chirens,1983,58,2041
82,Rhône-Alpes,38,1,20,106,Cholonge,311,3,314
82,Rhône-Alpes,38,3,39,107,Chonas-l'Amballan,1523,40,1563
82,Rhône-Alpes,38,1,22,108,Choranche,133,1,134
82,Rhône-Alpes,38,2,08,109,Chozeau,1015,24,1039
82,Rhône-Alpes,38,3,38,110,Chuzelles,2057,30,2087
82,Rhône-Alpes,38,1,40,111,Claix,7571,184,7755
82,Rhône-Alpes,38,1,03,112,Clavans-en-Haut-Oisans,113,0,113
82,Rhône-Alpes,38,1,05,113,Clelles,491,14,505
82,Rhône-Alpes,38,3,24,114,Clonas-sur-Varèze,1444,36,1480
82,Rhône-Alpes,38,1,20,116,Cognet,49,0,49
82,Rhône-Alpes,38,1,42,117,Cognin-les-Gorges,639,18,657
82,Rhône-Alpes,38,2,11,118,Colombe,1435,45,1480
82,Rhône-Alpes,38,1,09,120,La Combe-de-Lancey,686,15,701
82,Rhône-Alpes,38,3,07,121,Commelle,737,15,752
82,Rhône-Alpes,38,2,21,124,Corbelin,2054,58,2112
82,Rhône-Alpes,38,1,16,125,Cordéac,205,6,211
82,Rhône-Alpes,38,1,50,126,Corenc,3790,151,3941
82,Rhône-Alpes,38,1,16,127,Cornillon-en-Trièves,173,8,181
82,Rhône-Alpes,38,1,06,128,Corps,474,8,482
82,Rhône-Alpes,38,1,41,129,Corrençon-en-Vercors,362,17,379
82,Rhône-Alpes,38,3,07,130,La Côte-Saint-André,4749,336,5085
82,Rhône-Alpes,38,3,39,131,Les Côtes-d'Arey,1838,42,1880
82,Rhône-Alpes,38,1,06,132,Les Côtes-de-Corps,63,1,64
82,Rhône-Alpes,38,1,45,133,Coublevie,4224,299,4523
82,Rhône-Alpes,38,3,02,134,Cour-et-Buis,851,7,858
82,Rhône-Alpes,38,2,19,135,Courtenay,1128,19,1147
82,Rhône-Alpes,38,2,04,136,Crachier,470,17,487
82,Rhône-Alpes,38,1,35,137,Cras,432,8,440
82,Rhône-Alpes,38,2,08,138,Crémieu,3327,70,3397
82,Rhône-Alpes,38,2,19,139,Creys-Mépieu,1335,31,1366
82,Rhône-Alpes,38,1,34,140,Crolles,8601,234,8835
82,Rhône-Alpes,38,3,28,141,Culin,643,15,658
82,Rhône-Alpes,38,3,15,144,Diémoz,2604,31,2635
82,Rhône-Alpes,38,1,30,145,Dionay,127,1,128
82,Rhône-Alpes,38,2,08,146,Dizimieu,609,27,636
82,Rhône-Alpes,38,2,43,147,Doissin,809,12,821
82,Rhône-Alpes,38,2,33,148,Dolomieu,2852,83,2935
82,Rhône-Alpes,38,2,04,149,Domarin,1411,49,1460
82,Rhône-Alpes,38,1,09,150,Domène,6633,72,6705
82,Rhône-Alpes,38,1,95,151,Échirolles,35688,357,36045
82,Rhône-Alpes,38,3,28,152,Eclose,718,12,730
82,Rhône-Alpes,38,1,41,153,Engins,486,9,495
82,Rhône-Alpes,38,1,36,154,Entraigues,247,7,254
82,Rhône-Alpes,38,1,29,155,Entre-deux-Guiers,1705,31,1736
82,Rhône-Alpes,38,2,04,156,Les Éparres,927,28,955
82,Rhône-Alpes,38,3,39,157,Estrablin,3295,85,3380
82,Rhône-Alpes,38,1,55,158,Eybens,9397,154,9551
82,Rhône-Alpes,38,2,11,159,Eydoche,442,7,449
82,Rhône-Alpes,38,3,39,160,Eyzin-Pinet,2123,120,2243
82,Rhône-Alpes,38,3,07,161,Faramans,878,18,896
82,Rhône-Alpes,38,2,33,162,Faverges-de-la-Tour,1307,33,1340
82,Rhône-Alpes,38,1,01,163,La Ferrière,226,6,232
82,Rhône-Alpes,38,2,21,165,Fitilieu,1584,45,1629
82,Rhône-Alpes,38,1,34,166,La Flachère,431,7,438
82,Rhône-Alpes,38,2,11,167,Flachères,481,7,488
82,Rhône-Alpes,38,1,96,169,Fontaine,22068,175,22243
82,Rhône-Alpes,38,1,51,170,Fontanil-Cornillon,2735,42,2777
82,Rhône-Alpes,38,1,26,171,La Forteresse,293,5,298
82,Rhône-Alpes,38,2,37,172,Four,986,24,1010
82,Rhône-Alpes,38,1,03,173,Le Freney-d'Oisans,273,3,276
82,Rhône-Alpes,38,1,26,174,La Frette,1052,23,1075
82,Rhône-Alpes,38,1,10,175,Froges,3472,38,3510
82,Rhône-Alpes,38,2,08,176,Frontonas,1830,59,1889
82,Rhône-Alpes,38,1,03,177,La Garde,106,3,109
82,Rhône-Alpes,38,1,55,179,Gières,6105,92,6197
82,Rhône-Alpes,38,3,07,180,Gillonnay,948,24,972
82,Rhône-Alpes,38,1,10,181,Goncelin,2176,45,2221
82,Rhône-Alpes,38,2,11,182,Le Grand-Lemps,2938,53,2991
82,Rhône-Alpes,38,2,21,183,Granieu,419,9,428
82,Rhône-Alpes,38,3,15,184,Grenay,1435,17,1452
82,Rhône-Alpes,38,1,98,185,Grenoble,156659,2648,159307
82,Rhône-Alpes,38,1,18,186,Gresse-en-Vercors,382,8,390
82,Rhône-Alpes,38,1,40,187,Le Gua,1909,26,1935
82,Rhône-Alpes,38,1,55,188,Herbeys,1315,26,1341
82,Rhône-Alpes,38,3,15,189,Heyrieux,4705,57,4762
82,Rhône-Alpes,38,2,08,190,Hières-sur-Amby,1153,17,1170
82,Rhône-Alpes,38,1,03,191,Huez,1311,34,1345
82,Rhône-Alpes,38,1,10,192,Hurtières,174,5,179
82,Rhône-Alpes,38,2,58,193,L' Isle-d'Abeau,15329,317,15646
82,Rhône-Alpes,38,1,23,194,Izeaux,2122,34,2156
82,Rhône-Alpes,38,1,22,195,Izeron,742,18,760
82,Rhône-Alpes,38,3,46,197,Janneyrias,1426,29,1455
82,Rhône-Alpes,38,3,02,198,Jarcieu,989,21,1010
82,Rhône-Alpes,38,3,39,199,Jardin,2195,97,2292
82,Rhône-Alpes,38,1,44,200,Jarrie,3829,64,3893
82,Rhône-Alpes,38,1,44,203,Laffrey,361,6,367
82,Rhône-Alpes,38,1,05,204,Lalley,199,2,201
82,Rhône-Alpes,38,1,41,205,Lans-en-Vercors,2474,124,2598
82,Rhône-Alpes,38,1,09,206,Laval,950,21,971
82,Rhône-Alpes,38,1,36,207,Lavaldens,152,4,156
82,Rhône-Alpes,38,1,16,208,Lavars,131,4,135
82,Rhône-Alpes,38,1,25,209,Lentiol,207,4,211
82,Rhône-Alpes,38,2,08,210,Leyrieu,714,9,723
82,Rhône-Alpes,38,3,28,211,Lieudieu,262,5,267
82,Rhône-Alpes,38,1,03,212,Livet-et-Gavet,1306,9,1315
82,Rhône-Alpes,38,2,11,213,Longechenal,520,13,533
82,Rhône-Alpes,38,1,34,214,Lumbin,1928,49,1977
82,Rhône-Alpes,38,3,38,215,Luzinay,2257,54,2311
82,Rhône-Alpes,38,1,42,216,Malleval-en-Vercors,54,1,55
82,Rhône-Alpes,38,1,20,217,Marcieu,67,0,67
82,Rhône-Alpes,38,1,25,218,Marcilloles,948,15,963
82,Rhône-Alpes,38,1,25,219,Marcollin,613,12,625
82,Rhône-Alpes,38,1,25,221,Marnans,135,3,138
82,Rhône-Alpes,38,2,27,222,Massieu,757,17,774
82,Rhône-Alpes,38,2,04,223,Maubec,1580,42,1622
82,Rhône-Alpes,38,1,20,224,Mayres-Savel,100,0,100
82,Rhône-Alpes,38,1,41,225,Méaudre,1281,125,1406
82,Rhône-Alpes,38,1,16,226,Mens,1421,45,1466
82,Rhône-Alpes,38,2,27,228,Merlas,479,15,494
82,Rhône-Alpes,38,1,50,229,Meylan,17207,520,17727
82,Rhône-Alpes,38,2,04,230,Meyrié,932,34,966
82,Rhône-Alpes,38,3,28,231,Meyrieu-les-Étangs,809,46,855
82,Rhône-Alpes,38,3,28,232,Meyssiès,609,1,610
82,Rhône-Alpes,38,1,18,235,Miribel-Lanchâtre,356,6,362
82,Rhône-Alpes,38,1,29,236,Miribel-les-Échelles,1743,54,1797
82,Rhône-Alpes,38,1,03,237,Mizoën,180,1,181
82,Rhône-Alpes,38,3,39,238,Moidieu-Détourbe,1739,38,1777
82,Rhône-Alpes,38,1,23,239,Moirans,7779,122,7901
82,Rhône-Alpes,38,3,02,240,Moissieu-sur-Dolon,684,11,695
82,Rhône-Alpes,38,1,06,241,Monestier-d'Ambel,22,0,22
82,Rhône-Alpes,38,1,18,242,Monestier-de-Clermont,1156,9,1165
82,Rhône-Alpes,38,1,05,243,Le Monestier-du-Percy,222,2,224
82,Rhône-Alpes,38,3,02,244,Monsteroux-Milieu,735,12,747
82,Rhône-Alpes,38,1,03,253,Mont-de-Lans,1130,17,1147
82,Rhône-Alpes,38,1,51,258,Mont-Saint-Martin,93,2,95
82,Rhône-Alpes,38,1,30,245,Montagne,261,15,276
82,Rhône-Alpes,38,2,33,246,Montagnieu,829,26,855
82,Rhône-Alpes,38,2,19,247,Montalieu-Vercieu,2852,131,2983
82,Rhône-Alpes,38,1,35,248,Montaud,533,11,544
82,Rhône-Alpes,38,1,60,249,Montbonnot-Saint-Martin,4486,531,5017
82,Rhône-Alpes,38,2,33,250,Montcarra,456,10,466
82,Rhône-Alpes,38,1,44,252,Montchaboud,354,12,366
82,Rhône-Alpes,38,1,20,254,Monteynard,471,13,484
82,Rhône-Alpes,38,1,25,255,Montfalcon,127,3,130
82,Rhône-Alpes,38,2,27,256,Montferrat,1515,31,1546
82,Rhône-Alpes,38,2,43,257,Montrevel,465,7,472
82,Rhône-Alpes,38,3,02,259,Montseveroux,865,18,883
82,Rhône-Alpes,38,2,08,260,Moras,468,5,473
82,Rhône-Alpes,38,2,19,261,Morestel,4090,81,4171
82,Rhône-Alpes,38,1,10,262,Morêtel-de-Mailles,370,6,376
82,Rhône-Alpes,38,1,35,263,Morette,394,12,406
82,Rhône-Alpes,38,1,36,264,La Morte,147,3,150
82,Rhône-Alpes,38,1,20,265,La Motte-d'Aveillans,1827,33,1860
82,Rhône-Alpes,38,1,20,266,La Motte-Saint-Martin,406,11,417
82,Rhône-Alpes,38,3,07,267,Mottier,657,8,665
82,Rhône-Alpes,38,1,01,268,Le Moutaret,211,11,222
82,Rhône-Alpes,38,1,20,269,La Mure,5069,241,5310
82,Rhône-Alpes,38,1,23,270,La Murette,1765,46,1811
82,Rhône-Alpes,38,1,09,271,Murianette,779,13,792
82,Rhône-Alpes,38,1,30,272,Murinais,388,7,395
82,Rhône-Alpes,38,1,20,273,Nantes-en-Ratier,469,26,495
82,Rhône-Alpes,38,3,07,274,Nantoin,436,11,447
82,Rhône-Alpes,38,2,04,276,Nivolas-Vermelle,2275,39,2314
82,Rhône-Alpes,38,1,44,277,Notre-Dame-de-Commiers,468,7,475
82,Rhône-Alpes,38,1,42,278,Notre-Dame-de-l'Osier,505,9,514
82,Rhône-Alpes,38,1,44,279,Notre-Dame-de-Mésage,1217,19,1236
82,Rhône-Alpes,38,1,20,280,Notre-Dame-de-Vaulx,562,18,580
82,Rhône-Alpes,38,1,32,281,Noyarey,2206,102,2308
82,Rhône-Alpes,38,2,08,282,Optevoz,696,4,700
82,Rhône-Alpes,38,1,36,283,Oris-en-Rattier,99,2,101
82,Rhône-Alpes,38,3,07,284,Ornacieux,382,10,392
82,Rhône-Alpes,38,1,03,285,Ornon,138,14,152
82,Rhône-Alpes,38,1,03,286,Oulles,11,0,11
82,Rhône-Alpes,38,2,43,287,Oyeu,903,13,916
82,Rhône-Alpes,38,3,15,288,Oytier-Saint-Oblas,1536,21,1557
82,Rhône-Alpes,38,1,03,289,Oz,212,10,222
82,Rhône-Alpes,38,3,02,290,Pact,804,19,823
82,Rhône-Alpes,38,3,07,291,Pajay,1007,32,1039
82,Rhône-Alpes,38,2,27,292,Paladru,1004,17,1021
82,Rhône-Alpes,38,2,43,293,Panissage,431,6,437
82,Rhône-Alpes,38,2,08,294,Panossas,568,11,579
82,Rhône-Alpes,38,2,08,295,Parmilieu,630,8,638
82,Rhône-Alpes,38,2,43,296,Le Passage,755,25,780
82,Rhône-Alpes,38,2,19,297,Passins,1006,11,1017
82,Rhône-Alpes,38,3,24,298,Le Péage-de-Roussillon,6624,82,6706
82,Rhône-Alpes,38,1,06,299,Pellafol,134,8,142
82,Rhône-Alpes,38,3,07,300,Penol,311,11,322
82,Rhône-Alpes,38,1,05,301,Percy,120,7,127
82,Rhône-Alpes,38,1,36,302,Le Périer,139,2,141
82,Rhône-Alpes,38,1,10,303,La Pierre,437,4,441
82,Rhône-Alpes,38,1,20,304,Pierre-Châtel,1248,36,1284
82,Rhône-Alpes,38,2,43,305,Le Pin,1227,34,1261
82,Rhône-Alpes,38,1,01,306,Pinsot,194,3,197
82,Rhône-Alpes,38,3,02,307,Pisieu,523,7,530
82,Rhône-Alpes,38,1,26,308,Plan,232,3,235
82,Rhône-Alpes,38,1,55,309,Poisat,2081,33,2114
82,Rhône-Alpes,38,1,35,310,Poliénas,1103,22,1125
82,Rhône-Alpes,38,3,02,311,Pommier-de-Beaurepaire,682,21,703
82,Rhône-Alpes,38,1,45,312,Pommiers-la-Placette,595,26,621
82,Rhône-Alpes,38,1,20,313,Ponsonnas,279,12,291
82,Rhône-Alpes,38,2,21,315,Le Pont-de-Beauvoisin,3318,139,3457
82,Rhône-Alpes,38,3,46,316,Pont-de-Chéruy,4908,54,4962
82,Rhône-Alpes,38,1,40,317,Le Pont-de-Claix,11475,115,11590
82,Rhône-Alpes,38,1,22,319,Pont-en-Royans,873,31,904
82,Rhône-Alpes,38,3,38,318,Pont-Évêque,5110,76,5186
82,Rhône-Alpes,38,1,10,314,Pontcharra,7283,156,7439
82,Rhône-Alpes,38,2,19,320,Porcieu-Amblagnieu,1519,30,1549
82,Rhône-Alpes,38,1,16,321,Prébois,157,7,164
82,Rhône-Alpes,38,1,22,322,Presles,101,2,103
82,Rhône-Alpes,38,2,21,323,Pressins,1065,28,1093
82,Rhône-Alpes,38,3,02,324,Primarette,707,15,722
82,Rhône-Alpes,38,1,51,325,Proveysieux,520,10,530
82,Rhône-Alpes,38,1,20,326,Prunières,373,11,384
82,Rhône-Alpes,38,1,51,328,Quaix-en-Chartreuse,904,18,922
82,Rhône-Alpes,38,1,06,329,Quet-en-Beaumont,66,0,66
82,Rhône-Alpes,38,1,35,330,Quincieu,71,2,73
82,Rhône-Alpes,38,1,23,331,Réaumont,913,24,937
82,Rhône-Alpes,38,1,23,332,Renage,3695,57,3752
82,Rhône-Alpes,38,1,22,333,Rencurel,312,7,319
82,Rhône-Alpes,38,1,09,334,Revel,1318,23,1341
82,Rhône-Alpes,38,3,02,335,Revel-Tourdan,983,25,1008
82,Rhône-Alpes,38,3,39,336,Reventin-Vaugris,1710,60,1770
82,Rhône-Alpes,38,1,23,337,Rives,6106,97,6203
82,Rhône-Alpes,38,1,35,338,La Rivière,557,10,567
82,Rhône-Alpes,38,2,37,339,Roche,1834,35,1869
82,Rhône-Alpes,38,3,39,340,Les Roches-de-Condrieu,1946,44,1990
82,Rhône-Alpes,38,2,33,341,Rochetoirin,988,34,1022
82,Rhône-Alpes,38,1,18,342,Roissard,236,2,238
82,Rhône-Alpes,38,2,21,343,Romagnieu,1374,38,1412
82,Rhône-Alpes,38,3,24,344,Roussillon,7959,166,8125
82,Rhône-Alpes,38,1,42,345,Rovon,591,12,603
82,Rhône-Alpes,38,3,28,346,Royas,364,8,372
82,Rhône-Alpes,38,1,25,347,Roybon,1299,46,1345
82,Rhône-Alpes,38,2,53,348,Ruy,4087,141,4228
82,Rhône-Alpes,38,3,24,349,Sablons,1836,30,1866
82,Rhône-Alpes,38,3,28,351,Saint-Agnin-sur-Bion,784,16,800
82,Rhône-Alpes,38,2,04,352,Saint-Alban-de-Roche,1832,52,1884
82,Rhône-Alpes,38,3,24,353,Saint-Alban-du-Rhône,888,31,919
82,Rhône-Alpes,38,2,21,354,Saint-Albin-de-Vaulserre,350,7,357
82,Rhône-Alpes,38,1,18,355,Saint-Andéol,115,6,121
82,Rhône-Alpes,38,1,22,356,Saint-André-en-Royans,325,8,333
82,Rhône-Alpes,38,2,21,357,Saint-André-le-Gaz,2366,167,2533
82,Rhône-Alpes,38,1,30,359,Saint-Antoine-l'Abbaye,983,42,1025
82,Rhône-Alpes,38,1,30,360,Saint-Appolinard,394,1,395
82,Rhône-Alpes,38,1,20,361,Saint-Arey,78,1,79
82,Rhône-Alpes,38,1,45,362,Saint-Aupre,1053,34,1087
82,Rhône-Alpes,38,3,02,363,Saint-Barthélemy,936,78,1014
82,Rhône-Alpes,38,1,44,364,Saint-Barthélemy-de-Séchilienne,455,3,458
82,Rhône-Alpes,38,2,08,365,Saint-Baudille-de-la-Tour,720,15,735
82,Rhône-Alpes,38,1,16,366,Saint-Baudille-et-Pipet,255,8,263
82,Rhône-Alpes,38,1,34,367,Saint-Bernard,602,34,636
82,Rhône-Alpes,38,1,23,368,Saint-Blaise-du-Buis,974,39,1013
82,Rhône-Alpes,38,1,30,370,Saint-Bonnet-de-Chavagne,615,6,621
82,Rhône-Alpes,38,2,27,372,Saint-Bueil,699,19,718
82,Rhône-Alpes,38,1,23,373,Saint-Cassien,1075,24,1099
82,Rhône-Alpes,38,2,53,374,Saint-Chef,3372,104,3476
82,Rhône-Alpes,38,1,03,375,Saint-Christophe-en-Oisans,134,8,142
82,Rhône-Alpes,38,1,29,376,Saint-Christophe-sur-Guiers,768,11,779
82,Rhône-Alpes,38,2,33,377,Saint-Clair-de-la-Tour,3184,45,3229
82,Rhône-Alpes,38,3,24,378,Saint-Clair-du-Rhône,3877,65,3942
82,Rhône-Alpes,38,1,25,379,Saint-Clair-sur-Galaure,260,7,267
82,Rhône-Alpes,38,2,11,380,Saint-Didier-de-Bizonnes,257,4,261
82,Rhône-Alpes,38,2,33,381,Saint-Didier-de-la-Tour,1742,45,1787
82,Rhône-Alpes,38,1,51,382,Saint-Égrève,15752,310,16062
82,Rhône-Alpes,38,1,45,383,Saint-Étienne-de-Crossey,2516,131,2647
82,Rhône-Alpes,38,1,26,384,Saint-Étienne-de-Saint-Geoirs,2681,50,2731
82,Rhône-Alpes,38,2,27,386,Saint-Geoire-en-Valdaine,2348,64,2412
82,Rhône-Alpes,38,1,26,387,Saint-Geoirs,482,3,485
82,Rhône-Alpes,38,3,15,389,Saint-Georges-d'Espéranche,3053,53,3106
82,Rhône-Alpes,38,1,44,388,Saint-Georges-de-Commiers,2037,41,2078
82,Rhône-Alpes,38,1,42,390,Saint-Gervais,551,6,557
82,Rhône-Alpes,38,1,18,391,Saint-Guillaume,261,3,264
82,Rhône-Alpes,38,1,34,395,Saint-Hilaire,1569,41,1610
82,Rhône-Alpes,38,2,08,392,Saint-Hilaire-de-Brens,508,9,517
82,Rhône-Alpes,38,3,07,393,Saint-Hilaire-de-la-Côte,1378,44,1422
82,Rhône-Alpes,38,1,30,394,Saint-Hilaire-du-Rosier,1869,50,1919
82,Rhône-Alpes,38,1,20,396,Saint-Honoré,813,24,837
82,Rhône-Alpes,38,1,60,397,Saint-Ismier,6249,345,6594
82,Rhône-Alpes,38,2,21,398,Saint-Jean-d'Avelanne,824,18,842
82,Rhône-Alpes,38,1,16,403,Saint-Jean-d'Hérans,297,7,304
82,Rhône-Alpes,38,3,28,399,Saint-Jean-de-Bournay,4281,96,4377
82,Rhône-Alpes,38,1,23,400,Saint-Jean-de-Moirans,2994,40,3034
82,Rhône-Alpes,38,2,33,401,Saint-Jean-de-Soudain,1376,31,1407
82,Rhône-Alpes,38,1,44,402,Saint-Jean-de-Vaulx,531,9,540
82,Rhône-Alpes,38,1,09,404,Saint-Jean-le-Vieux,222,5,227
82,Rhône-Alpes,38,1,29,405,Saint-Joseph-de-Rivière,1100,30,1130
82,Rhône-Alpes,38,3,02,406,Saint-Julien-de-l'Herms,149,2,151
82,Rhône-Alpes,38,1,45,407,Saint-Julien-de-Raz,429,9,438
82,Rhône-Alpes,38,3,15,408,Saint-Just-Chaleyssin,2450,34,2484
82,Rhône-Alpes,38,1,22,409,Saint-Just-de-Claix,1189,14,1203
82,Rhône-Alpes,38,1,30,410,Saint-Lattier,1237,30,1267
82,Rhône-Alpes,38,1,29,412,Saint-Laurent-du-Pont,4508,80,4588
82,Rhône-Alpes,38,1,06,413,Saint-Laurent-en-Beaumont,415,4,419
82,Rhône-Alpes,38,2,53,415,Saint-Marcel-Bel-Accueil,1288,45,1333
82,Rhône-Alpes,38,1,30,416,Saint-Marcellin,7895,217,8112
82,Rhône-Alpes,38,1,97,421,Saint-Martin-d'Hères,35565,292,35857
82,Rhône-Alpes,38,1,09,422,Saint-Martin-d'Uriage,5329,169,5498
82,Rhône-Alpes,38,1,05,419,Saint-Martin-de-Clelles,154,9,163
82,Rhône-Alpes,38,1,18,115,Saint-Martin-de-la-Cluze,607,13,620
82,Rhône-Alpes,38,2,21,420,Saint-Martin-de-Vaulserre,236,13,249
82,Rhône-Alpes,38,1,51,423,Saint-Martin-le-Vinoux,5365,79,5444
82,Rhône-Alpes,38,1,05,424,Saint-Maurice-en-Trièves,184,7,191
82,Rhône-Alpes,38,3,24,425,Saint-Maurice-l'Exil,5682,134,5816
82,Rhône-Alpes,38,1,10,426,Saint-Maximin,620,16,636
82,Rhône-Alpes,38,1,26,427,Saint-Michel-de-Saint-Geoirs,299,14,313
82,Rhône-Alpes,38,1,06,428,Saint-Michel-en-Beaumont,36,1,37
82,Rhône-Alpes,38,1,05,429,Saint-Michel-les-Portes,206,5,211
82,Rhône-Alpes,38,1,09,430,Saint-Mury-Monteymond,350,5,355
82,Rhône-Alpes,38,1,60,431,Saint-Nazaire-les-Eymes,2874,69,2943
82,Rhône-Alpes,38,1,45,432,Saint-Nicolas-de-Macherin,890,32,922
82,Rhône-Alpes,38,1,41,433,Saint-Nizier-du-Moucherotte,1010,37,1047
82,Rhône-Alpes,38,2,43,434,Saint-Ondras,583,6,589
82,Rhône-Alpes,38,1,34,435,Saint-Pancrasse,445,19,464
82,Rhône-Alpes,38,1,35,437,Saint-Paul-d'Izeaux,317,5,322
82,Rhône-Alpes,38,1,40,436,Saint-Paul-de-Varces,2022,38,2060
82,Rhône-Alpes,38,1,18,438,Saint-Paul-lès-Monestier,284,5,289
82,Rhône-Alpes,38,1,01,439,Saint-Pierre-d'Allevard,2770,49,2819
82,Rhône-Alpes,38,1,29,446,Saint-Pierre-d'Entremont,565,11,576
82,Rhône-Alpes,38,1,26,440,Saint-Pierre-de-Bressieux,687,21,708
82,Rhône-Alpes,38,1,29,442,Saint-Pierre-de-Chartreuse,950,22,972
82,Rhône-Alpes,38,1,22,443,Saint-Pierre-de-Chérennes,461,10,471
82,Rhône-Alpes,38,1,06,444,Saint-Pierre-de-Méaroz,133,3,136
82,Rhône-Alpes,38,1,44,445,Saint-Pierre-de-Mésage,713,11,724
82,Rhône-Alpes,38,3,24,448,Saint-Prim,1118,19,1137
82,Rhône-Alpes,38,2,37,449,Saint-Quentin-Fallavier,6077,65,6142
82,Rhône-Alpes,38,1,35,450,Saint-Quentin-sur-Isère,1298,24,1322
82,Rhône-Alpes,38,2,08,451,Saint-Romain-de-Jalionas,3067,48,3115
82,Rhône-Alpes,38,3,24,452,Saint-Romain-de-Surieu,303,3,306
82,Rhône-Alpes,38,1,22,453,Saint-Romans,1721,26,1747
82,Rhône-Alpes,38,1,30,454,Saint-Sauveur,1904,43,1947
82,Rhône-Alpes,38,2,53,455,Saint-Savin,3422,71,3493
82,Rhône-Alpes,38,1,16,456,Saint-Sébastien,235,7,242
82,Rhône-Alpes,38,1,26,457,Saint-Siméon-de-Bressieux,2740,111,2851
82,Rhône-Alpes,38,2,19,458,Saint-Sorlin-de-Morestel,544,22,566
82,Rhône-Alpes,38,3,39,459,Saint-Sorlin-de-Vienne,803,16,819
82,Rhône-Alpes,38,2,27,460,Saint-Sulpice-des-Rivoires,416,14,430
82,Rhône-Alpes,38,1,20,462,Saint-Théoffrey,439,9,448
82,Rhône-Alpes,38,1,30,463,Saint-Vérand,1812,44,1856
82,Rhône-Alpes,38,2,33,464,Saint-Victor-de-Cessieu,2115,37,2152
82,Rhône-Alpes,38,2,19,465,Saint-Victor-de-Morestel,1132,30,1162
82,Rhône-Alpes,38,1,34,466,Saint-Vincent-de-Mercuze,1398,37,1435
82,Rhône-Alpes,38,1,09,350,Sainte-Agnès,527,10,537
82,Rhône-Alpes,38,3,28,358,Sainte-Anne-sur-Gervonde,586,7,593
82,Rhône-Alpes,38,2,33,369,Sainte-Blandine,909,28,937
82,Rhône-Alpes,38,1,06,414,Sainte-Luce,36,0,36
82,Rhône-Alpes,38,1,34,417,Sainte-Marie-d'Alloix,560,19,579
82,Rhône-Alpes,38,1,34,418,Sainte-Marie-du-Mont,229,1,230
82,Rhône-Alpes,38,2,53,467,Salagnon,1174,17,1191
82,Rhône-Alpes,38,3,24,468,Salaise-sur-Sanne,4147,79,4226
82,Rhône-Alpes,38,1,06,469,La Salette-Fallavaux,69,5,74
82,Rhône-Alpes,38,1,06,470,La Salle-en-Beaumont,286,6,292
82,Rhône-Alpes,38,1,50,471,Le Sappey-en-Chartreuse,1048,35,1083
82,Rhône-Alpes,38,1,51,472,Sarcenas,191,8,199
82,Rhône-Alpes,38,3,07,473,Sardieu,895,7,902
82,Rhône-Alpes,38,1,32,474,Sassenage,10634,284,10918
82,Rhône-Alpes,38,2,37,475,Satolas-et-Bonce,2029,35,2064
82,Rhône-Alpes,38,3,28,476,Savas-Mépin,805,6,811
82,Rhône-Alpes,38,1,44,478,Séchilienne,872,7,879
82,Rhône-Alpes,38,3,07,479,Semons,363,6,369
82,Rhône-Alpes,38,3,38,480,Septème,1751,33,1784
82,Rhône-Alpes,38,2,04,481,Sérézin-de-la-Tour,818,20,838
82,Rhône-Alpes,38,2,19,483,Sermérieu,1461,33,1494
82,Rhône-Alpes,38,3,38,484,Serpaize,1418,42,1460
82,Rhône-Alpes,38,1,42,275,Serre-Nerpol,292,29,321
82,Rhône-Alpes,38,1,56,485,Seyssinet-Pariset,12245,219,12464
82,Rhône-Alpes,38,1,56,486,Seyssins,6978,150,7128
82,Rhône-Alpes,38,3,38,487,Seyssuel,1968,55,2023
82,Rhône-Alpes,38,2,08,488,Siccieu-Saint-Julien-et-Carisieu,559,14,573
82,Rhône-Alpes,38,1,36,489,Siévoz,127,4,131
82,Rhône-Alpes,38,1,26,490,Sillans,1812,34,1846
82,Rhône-Alpes,38,1,18,492,Sinard,638,18,656
82,Rhône-Alpes,38,2,08,494,Soleymieu,683,17,700
82,Rhône-Alpes,38,1,30,495,La Sône,628,12,640
82,Rhône-Alpes,38,3,24,496,Sonnay,1282,22,1304
82,Rhône-Alpes,38,1,20,497,Sousville,141,3,144
82,Rhône-Alpes,38,2,04,498,Succieu,688,10,698
82,Rhône-Alpes,38,1,20,499,Susville,1419,27,1446
82,Rhône-Alpes,38,1,30,500,Têche,538,19,557
82,Rhône-Alpes,38,1,10,501,Tencin,1191,7,1198
82,Rhône-Alpes,38,1,34,503,La Terrasse,2292,104,2396
82,Rhône-Alpes,38,1,10,504,Theys,1934,73,2007
82,Rhône-Alpes,38,1,25,505,Thodure,674,30,704
82,Rhône-Alpes,38,2,08,507,Tignieu-Jameyzieu,5624,91,5715
82,Rhône-Alpes,38,2,33,508,Torchefelon,584,15,599
82,Rhône-Alpes,38,2,33,509,La Tour-du-Pin,7652,241,7893
82,Rhône-Alpes,38,1,34,511,Le Touvet,2998,57,3055
82,Rhône-Alpes,38,3,28,512,Tramolé,524,14,538
82,Rhône-Alpes,38,1,18,513,Treffort,228,8,236
82,Rhône-Alpes,38,1,16,514,Tréminis,164,5,169
82,Rhône-Alpes,38,2,08,515,Trept,1711,24,1735
82,Rhône-Alpes,38,1,50,516,La Tronche,6050,177,6227
82,Rhône-Alpes,38,1,35,517,Tullins,7649,150,7799
82,Rhône-Alpes,38,1,36,518,Valbonnais,497,12,509
82,Rhône-Alpes,38,3,15,519,Valencin,2447,29,2476
82,Rhône-Alpes,38,2,43,520,Valencogne,588,11,599
82,Rhône-Alpes,38,1,36,521,La Valette,74,0,74
82,Rhône-Alpes,38,1,36,522,Valjouffrey,135,2,137
82,Rhône-Alpes,38,1,42,523,Varacieux,779,21,800
82,Rhône-Alpes,38,1,40,524,Varces-Allières-et-Risset,6513,161,6674
82,Rhône-Alpes,38,2,19,525,Vasselin,389,13,402
82,Rhône-Alpes,38,1,35,526,Vatilieu,377,9,386
82,Rhône-Alpes,38,1,03,527,Vaujany,319,6,325
82,Rhône-Alpes,38,1,44,528,Vaulnaveys-le-Bas,1137,24,1161
82,Rhône-Alpes,38,1,44,529,Vaulnaveys-le-Haut,3405,76,3481
82,Rhône-Alpes,38,2,58,530,Vaulx-Milieu,2261,41,2302
82,Rhône-Alpes,38,2,27,531,Velanne,477,25,502
82,Rhône-Alpes,38,2,08,532,Vénérieu,552,9,561
82,Rhône-Alpes,38,1,55,533,Venon,699,11,710
82,Rhône-Alpes,38,1,03,534,Vénosc,830,18,848
82,Rhône-Alpes,38,2,08,535,Vernas,222,3,225
82,Rhône-Alpes,38,3,24,536,Vernioz,1140,29,1169
82,Rhône-Alpes,38,2,37,537,La Verpillière,6177,115,6292
82,Rhône-Alpes,38,1,09,538,Le Versoud,4432,56,4488
82,Rhône-Alpes,38,2,08,539,Vertrieu,654,10,664
82,Rhône-Alpes,38,1,32,540,Veurey-Voroize,1379,17,1396
82,Rhône-Alpes,38,2,19,541,Veyrins-Thuellin,1808,49,1857
82,Rhône-Alpes,38,2,08,542,Veyssilieu,297,7,304
82,Rhône-Alpes,38,2,19,543,Vézeronce-Curtin,1696,34,1730
82,Rhône-Alpes,38,3,99,544,Vienne,29905,543,30448
82,Rhône-Alpes,38,1,40,545,Vif,8088,181,8269
82,Rhône-Alpes,38,2,33,546,Vignieu,871,69,940
82,Rhône-Alpes,38,1,09,547,Villard-Bonnot,7297,69,7366
82,Rhône-Alpes,38,1,41,548,Villard-de-Lans,4035,202,4237
82,Rhône-Alpes,38,1,03,549,Villard-Notre-Dame,29,0,29
82,Rhône-Alpes,38,1,03,550,Villard-Reculas,63,0,63
82,Rhône-Alpes,38,1,03,551,Villard-Reymond,43,1,44
82,Rhône-Alpes,38,1,20,552,Villard-Saint-Christophe,350,8,358
82,Rhône-Alpes,38,3,24,556,Ville-sous-Anjou,1119,29,1148
82,Rhône-Alpes,38,2,58,553,Villefontaine,18897,312,19209
82,Rhône-Alpes,38,2,08,554,Villemoirieu,1763,83,1846
82,Rhône-Alpes,38,3,28,555,Villeneuve-de-Marc,1164,19,1183
82,Rhône-Alpes,38,3,46,557,Villette-d'Anthon,4121,67,4188
82,Rhône-Alpes,38,3,38,558,Villette-de-Vienne,1500,26,1526
82,Rhône-Alpes,38,1,42,559,Vinay,3949,59,4008
82,Rhône-Alpes,38,2,43,560,Virieu,973,27,1000
82,Rhône-Alpes,38,1,25,561,Viriville,1372,20,1392
82,Rhône-Alpes,38,1,44,562,Vizille,7653,181,7834
82,Rhône-Alpes,38,1,45,563,Voiron,20400,655,21055
82,Rhône-Alpes,38,2,27,564,Voissant,210,3,213
82,Rhône-Alpes,38,1,45,565,Voreppe,9696,293,9989
82,Rhône-Alpes,38,1,23,566,Vourey,1643,40,1683
43,Franche-Comté,39,1,33,001,Abergement-la-Ronce,744,14,758
43,Franche-Comté,39,2,01,002,Abergement-le-Grand,62,5,67
43,Franche-Comté,39,2,23,003,Abergement-le-Petit,39,1,40
43,Franche-Comté,39,2,29,004,Abergement-lès-Thésy,61,3,64
43,Franche-Comté,39,2,29,006,Aiglepierre,413,18,431
43,Franche-Comté,39,2,21,007,Alièze,153,1,154
43,Franche-Comté,39,1,24,008,Amange,348,65,413
43,Franche-Comté,39,2,06,009,Andelot-en-Montagne,548,4,552
43,Franche-Comté,39,2,27,010,Andelot-Morval,89,3,92
43,Franche-Comté,39,1,09,011,Annoire,405,17,422
43,Franche-Comté,39,2,01,013,Arbois,3471,165,3636
43,Franche-Comté,39,1,24,014,Archelange,237,16,253
43,Franche-Comté,39,2,06,015,Ardon,124,5,129
43,Franche-Comté,39,2,29,586,Aresches,43,2,45
43,Franche-Comté,39,2,02,016,Arinthod,1165,40,1205
43,Franche-Comté,39,2,04,017,Arlay,711,21,732
43,Franche-Comté,39,2,02,018,Aromas,521,19,540
43,Franche-Comté,39,2,20,020,Arsure-Arsurette,90,2,92
43,Franche-Comté,39,2,01,019,Les Arsures,233,7,240
43,Franche-Comté,39,2,21,021,Arthenas,153,4,157
43,Franche-Comté,39,1,08,022,Asnans-Beauvoisin,683,19,702
43,Franche-Comté,39,2,25,023,L' Aubépin,139,1,140
43,Franche-Comté,39,1,24,024,Audelange,222,6,228
43,Franche-Comté,39,2,03,025,Augea,278,4,282
43,Franche-Comté,39,1,17,026,Augerans,143,6,149
43,Franche-Comté,39,2,03,027,Augisey,181,11,192
43,Franche-Comté,39,2,23,028,Aumont,405,9,414
43,Franche-Comté,39,1,09,029,Aumur,362,10,372
43,Franche-Comté,39,1,24,030,Authume,798,24,822
43,Franche-Comté,39,1,14,031,Auxange,181,9,190
43,Franche-Comté,39,3,26,032,Avignon-lès-Saint-Claude,353,6,359
43,Franche-Comté,39,1,08,034,Balaiseaux,258,4,262
43,Franche-Comté,39,2,25,035,Balanod,312,8,320
43,Franche-Comté,39,2,27,036,La Balme-d'Épy,47,2,49
43,Franche-Comté,39,1,17,037,Bans,195,5,200
43,Franche-Comté,39,2,10,038,Barésia-sur-l'Ain,145,2,147
43,Franche-Comté,39,1,12,039,La Barre,234,3,237
43,Franche-Comté,39,2,23,040,Barretaine,202,8,210
43,Franche-Comté,39,2,32,041,Baume-les-Messieurs,197,11,208
43,Franche-Comté,39,1,24,042,Baverans,406,9,415
43,Franche-Comté,39,2,03,043,Beaufort,1005,24,1029
43,Franche-Comté,39,2,21,045,Beffia,87,2,89
43,Franche-Comté,39,3,05,046,Bellecombe,88,8,96
43,Franche-Comté,39,3,19,047,Bellefontaine,555,17,572
43,Franche-Comté,39,1,17,048,Belmont,239,12,251
43,Franche-Comté,39,2,23,049,Bersaillin,371,2,373
43,Franche-Comté,39,2,23,050,Besain,166,7,173
43,Franche-Comté,39,1,13,051,Biarne,363,10,373
43,Franche-Comté,39,2,22,052,Bief-des-Maisons,70,3,73
43,Franche-Comté,39,2,20,053,Bief-du-Fourg,159,6,165
43,Franche-Comté,39,2,23,054,Biefmorin,75,4,79
43,Franche-Comté,39,2,20,055,Billecul,30,0,30
43,Franche-Comté,39,2,04,056,Bletterans,1389,20,1409
43,Franche-Comté,39,2,32,057,Blois-sur-Seille,99,4,103
43,Franche-Comté,39,2,11,058,Blye,146,5,151
43,Franche-Comté,39,3,19,059,Bois-d'Amont,1652,49,1701
43,Franche-Comté,39,2,07,060,Bois-de-Gand,65,1,66
43,Franche-Comté,39,2,10,061,Boissia,140,6,146
43,Franche-Comté,39,2,02,062,La Boissière,65,0,65
43,Franche-Comté,39,3,28,063,Bonlieu,242,8,250
43,Franche-Comté,39,2,03,064,Bonnaud,39,0,39
43,Franche-Comté,39,2,23,065,Bonnefontaine,94,6,100
43,Franche-Comté,39,2,34,066,Bornay,180,8,188
43,Franche-Comté,39,3,05,068,Les Bouchoux,321,13,334
43,Franche-Comté,39,2,27,069,Bourcia,120,4,124
43,Franche-Comté,39,2,06,070,Bourg-de-Sirod,99,1,100
43,Franche-Comté,39,2,29,072,Bracon,291,8,299
43,Franche-Comté,39,2,23,073,Brainans,171,2,173
43,Franche-Comté,39,1,18,074,Brans,223,7,230
43,Franche-Comté,39,2,30,075,Bréry,228,11,239
43,Franche-Comté,39,1,12,076,La Bretenière,190,9,199
43,Franche-Comté,39,1,08,077,Bretenières,38,0,38
43,Franche-Comté,39,1,24,078,Brevans,622,20,642
43,Franche-Comté,39,2,11,079,Briod,208,8,216
43,Franche-Comté,39,2,27,080,Broissia,50,0,50
43,Franche-Comté,39,2,23,081,Buvilly,359,8,367
43,Franche-Comté,39,2,20,083,Censeau,305,7,312
43,Franche-Comté,39,2,29,084,Cernans,138,9,147
43,Franche-Comté,39,2,20,085,Cerniébaud,65,3,68
43,Franche-Comté,39,2,02,086,Cernon,258,7,265
43,Franche-Comté,39,2,03,088,Cesancey,404,14,418
43,Franche-Comté,39,2,02,089,Cézia,70,2,72
43,Franche-Comté,39,1,08,090,Chaînée-des-Coupis,175,2,177
43,Franche-Comté,39,2,22,091,Les Chalesmes,91,9,100
43,Franche-Comté,39,2,21,092,Chambéria,163,6,169
43,Franche-Comté,39,1,31,093,Chamblay,411,13,424
43,Franche-Comté,39,2,23,094,Chamole,161,3,164
43,Franche-Comté,39,1,31,095,Champagne-sur-Loue,130,4,134
43,Franche-Comté,39,1,18,096,Champagney,345,6,351
43,Franche-Comté,39,2,06,097,Champagnole,8098,436,8534
43,Franche-Comté,39,1,09,099,Champdivers,438,16,454
43,Franche-Comté,39,2,23,100,Champrougier,97,4,101
43,Franche-Comté,39,1,13,101,Champvans,1390,49,1439
43,Franche-Comté,39,3,16,102,Chancia,234,11,245
43,Franche-Comté,39,2,29,103,La Chapelle-sur-Furieuse,320,9,329
43,Franche-Comté,39,2,04,104,Chapelle-Voland,613,15,628
43,Franche-Comté,39,2,06,105,Chapois,205,3,208
43,Franche-Comté,39,3,16,106,Charchilla,217,6,223
43,Franche-Comté,39,2,10,107,Charcier,118,2,120
43,Franche-Comté,39,2,20,108,Charency,53,0,53
43,Franche-Comté,39,2,10,109,Charézier,157,5,162
43,Franche-Comté,39,2,30,110,La Charme,45,3,48
43,Franche-Comté,39,2,02,111,Charnod,46,2,48
43,Franche-Comté,39,2,07,112,La Chassagne,119,4,123
43,Franche-Comté,39,3,26,113,Chassal,494,12,506
43,Franche-Comté,39,2,32,114,Château-Chalon,168,7,175
43,Franche-Comté,39,3,28,115,Château-des-Prés,178,5,183
43,Franche-Comté,39,3,16,118,Châtel-de-Joux,55,6,61
43,Franche-Comté,39,2,01,116,La Châtelaine,130,8,138
43,Franche-Comté,39,1,17,117,Chatelay,94,2,96
43,Franche-Comté,39,2,23,119,Le Chateley,84,0,84
43,Franche-Comté,39,2,06,120,Châtelneuf,140,7,147
43,Franche-Comté,39,1,24,121,Châtenois,337,12,349
43,Franche-Comté,39,2,11,122,Châtillon,120,2,122
43,Franche-Comté,39,2,02,123,Chatonnay,63,1,64
43,Franche-Comté,39,2,07,124,Chaumergy,465,6,471
43,Franche-Comté,39,3,28,126,La Chaumusse,343,24,367
43,Franche-Comté,39,2,23,127,Chaussenans,112,2,114
43,Franche-Comté,39,1,08,128,Chaussin,1604,49,1653
43,Franche-Comté,39,2,29,133,Chaux-Champagny,65,6,71
43,Franche-Comté,39,2,22,129,Chaux-des-Crotenay,410,11,421
43,Franche-Comté,39,3,28,130,Chaux-des-Prés,187,10,197
43,Franche-Comté,39,3,28,131,La Chaux-du-Dombief,529,40,569
43,Franche-Comté,39,2,07,132,La Chaux-en-Bresse,34,0,34
43,Franche-Comté,39,2,21,134,Chavéria,206,3,209
43,Franche-Comté,39,2,25,135,Chazelles,114,0,114
43,Franche-Comté,39,2,23,136,Chemenot,38,0,38
43,Franche-Comté,39,2,02,137,Chemilla,97,10,107
43,Franche-Comté,39,1,09,138,Chemin,361,9,370
43,Franche-Comté,39,1,08,139,Chêne-Bernard,72,0,72
43,Franche-Comté,39,2,07,140,Chêne-Sec,37,0,37
43,Franche-Comté,39,1,18,141,Chevigny,280,12,292
43,Franche-Comté,39,2,25,142,Chevreaux,142,6,148
43,Franche-Comté,39,2,10,143,Chevrotaine,34,0,34
43,Franche-Comté,39,2,15,145,Chille,334,15,349
43,Franche-Comté,39,2,34,146,Chilly-le-Vignoble,527,17,544
43,Franche-Comté,39,2,29,147,Chilly-sur-Salins,107,9,116
43,Franche-Comté,39,2,02,148,Chisséria,83,1,84
43,Franche-Comté,39,1,17,149,Chissey-sur-Loue,363,7,370
43,Franche-Comté,39,1,33,150,Choisey,1023,20,1043
43,Franche-Comté,39,3,05,151,Choux,138,6,144
43,Franche-Comté,39,2,06,153,Cize,820,25,845
43,Franche-Comté,39,2,10,154,Clairvaux-les-Lacs,1485,46,1531
43,Franche-Comté,39,2,29,155,Clucy,73,1,74
43,Franche-Comté,39,2,10,156,Cogna,251,4,255
43,Franche-Comté,39,3,05,157,Coiserette,43,0,43
43,Franche-Comté,39,2,02,158,Coisia,148,5,153
43,Franche-Comté,39,2,23,159,Colonne,259,7,266
43,Franche-Comté,39,2,07,160,Commenailles,748,15,763
43,Franche-Comté,39,2,20,161,Communailles-en-Montagne,47,3,50
43,Franche-Comté,39,2,15,162,Condamine,242,7,249
43,Franche-Comté,39,2,02,163,Condes,117,5,122
43,Franche-Comté,39,2,11,164,Conliège,711,15,726
43,Franche-Comté,39,2,20,165,Conte,62,0,62
43,Franche-Comté,39,2,02,166,Cornod,227,6,233
43,Franche-Comté,39,2,04,167,Cosges,309,8,317
43,Franche-Comté,39,2,11,168,Courbette,41,0,41
43,Franche-Comté,39,2,34,169,Courbouzon,594,23,617
43,Franche-Comté,39,2,15,170,Courlans,985,17,1002
43,Franche-Comté,39,2,15,171,Courlaoux,939,23,962
43,Franche-Comté,39,1,12,172,Courtefontaine,212,29,241
43,Franche-Comté,39,2,03,173,Cousance,1219,24,1243
43,Franche-Comté,39,3,05,174,Coyrière,61,6,67
43,Franche-Comté,39,3,16,175,Coyron,72,1,73
43,Franche-Comté,39,1,31,176,Cramans,478,17,495
43,Franche-Comté,39,2,22,178,Crans,71,1,72
43,Franche-Comté,39,2,11,177,Crançot,493,24,517
43,Franche-Comté,39,3,16,179,Crenans,250,10,260
43,Franche-Comté,39,2,21,180,Cressia,272,109,381
43,Franche-Comté,39,1,33,182,Crissey,655,18,673
43,Franche-Comté,39,2,06,183,Crotenay,639,79,718
43,Franche-Comté,39,3,16,184,Les Crozets,214,8,222
43,Franche-Comté,39,2,03,185,Cuisia,409,11,420
43,Franche-Comté,39,3,26,186,Cuttura,361,20,381
43,Franche-Comté,39,2,20,187,Cuvier,217,8,225
43,Franche-Comté,39,1,18,188,Dammartin-Marpain,262,4,266
43,Franche-Comté,39,1,33,189,Damparis,2826,55,2881
43,Franche-Comté,39,1,12,190,Dampierre,1196,28,1224
43,Franche-Comté,39,2,30,191,Darbonnay,88,3,91
43,Franche-Comté,39,3,28,192,Denezières,80,11,91
43,Franche-Comté,39,1,08,193,Le Deschaux,918,15,933
43,Franche-Comté,39,2,04,194,Desnes,474,8,482
43,Franche-Comté,39,2,27,195,Dessia,81,1,82
43,Franche-Comté,39,2,07,196,Les Deux-Fays,121,2,123
43,Franche-Comté,39,2,25,197,Digna,355,7,362
43,Franche-Comté,39,1,96,198,Dole,25384,1102,26486
43,Franche-Comté,39,2,32,199,Domblans,923,17,940
43,Franche-Comté,39,2,21,200,Dompierre-sur-Mont,234,9,243
43,Franche-Comté,39,2,10,201,Doucier,291,24,315
43,Franche-Comté,39,2,29,202,Dournon,122,3,125
43,Franche-Comté,39,2,20,203,Doye,82,3,85
43,Franche-Comté,39,2,02,204,Dramelay,32,1,33
43,Franche-Comté,39,1,24,205,Éclans-Nenon,406,14,420
43,Franche-Comté,39,1,31,206,Écleux,185,3,188
43,Franche-Comté,39,2,21,207,Écrille,73,2,75
43,Franche-Comté,39,2,22,208,Entre-deux-Monts,161,6,167
43,Franche-Comté,39,2,06,210,Équevillon,600,24,624
43,Franche-Comté,39,1,08,211,Les Essards-Taignevaux,240,6,246
43,Franche-Comté,39,2,20,213,Esserval-Combe,15,0,15
43,Franche-Comté,39,2,20,214,Esserval-Tartre,80,0,80
43,Franche-Comté,39,2,21,215,Essia,63,3,66
43,Franche-Comté,39,3,16,216,Étival,311,4,315
43,Franche-Comté,39,2,15,217,L' Étoile,544,34,578
43,Franche-Comté,39,1,12,218,Étrepigney,388,7,395
43,Franche-Comté,39,1,12,219,Évans,611,6,617
43,Franche-Comté,39,1,24,220,Falletans,392,11,403
43,Franche-Comté,39,2,20,221,La Favière,32,0,32
43,Franche-Comté,39,2,23,222,Fay-en-Montagne,74,10,84
43,Franche-Comté,39,2,01,223,La Ferté,189,5,194
43,Franche-Comté,39,2,02,224,Fétigny,94,3,97
43,Franche-Comté,39,2,32,225,Le Fied,201,9,210
43,Franche-Comté,39,2,27,226,Florentia,34,0,34
43,Franche-Comté,39,2,22,227,Foncine-le-Bas,219,5,224
43,Franche-Comté,39,2,22,228,Foncine-le-Haut,1029,30,1059
43,Franche-Comté,39,2,04,229,Fontainebrux,184,7,191
43,Franche-Comté,39,2,10,230,Fontenu,54,0,54
43,Franche-Comté,39,3,28,232,Fort-du-Plasne,423,12,435
43,Franche-Comté,39,1,13,233,Foucherans,1717,60,1777
43,Franche-Comté,39,2,07,234,Foulenay,83,4,87
43,Franche-Comté,39,1,12,235,Fraisans,1218,27,1245
43,Franche-Comté,39,2,07,236,Francheville,38,0,38
43,Franche-Comté,39,2,20,237,Fraroz,49,2,51
43,Franche-Comté,39,1,18,238,Frasne-les-Meulières,114,5,119
43,Franche-Comté,39,2,10,239,La Frasnée,39,2,41
43,Franche-Comté,39,2,10,240,Le Frasnois,154,4,158
43,Franche-Comté,39,2,34,241,Frébuans,349,11,360
43,Franche-Comté,39,2,07,243,Froideville,77,0,77
43,Franche-Comté,39,2,32,244,Frontenay,163,1,164
43,Franche-Comté,39,1,08,245,Gatey,323,2,325
43,Franche-Comté,39,1,14,246,Gendrey,376,11,387
43,Franche-Comté,39,2,02,247,Genod,67,1,68
43,Franche-Comté,39,2,29,248,Geraise,41,1,42
43,Franche-Comté,39,1,17,249,Germigney,84,1,85
43,Franche-Comté,39,2,34,250,Geruge,163,11,174
43,Franche-Comté,39,2,34,251,Gevingey,466,73,539
43,Franche-Comté,39,1,33,252,Gevry,637,13,650
43,Franche-Comté,39,2,27,253,Gigny,294,5,299
43,Franche-Comté,39,2,20,254,Gillois,148,2,150
43,Franche-Comté,39,2,03,255,Gizia,223,1,224
43,Franche-Comté,39,3,28,258,Grande-Rivière,411,22,433
43,Franche-Comté,39,1,31,259,Grange-de-Vaivre,57,1,58
43,Franche-Comté,39,2,32,260,Granges-sur-Baume,134,1,135
43,Franche-Comté,39,2,25,261,Graye-et-Charnay,140,2,142
43,Franche-Comté,39,1,24,262,Gredisans,146,2,148
43,Franche-Comté,39,2,23,263,Grozon,481,3,484
43,Franche-Comté,39,2,03,264,Grusse,187,8,195
43,Franche-Comté,39,2,10,265,Hautecour,166,9,175
43,Franche-Comté,39,1,08,266,Les Hays,270,3,273
43,Franche-Comté,39,2,29,267,Ivory,81,1,82
43,Franche-Comté,39,2,29,268,Ivrey,56,1,57
43,Franche-Comté,39,3,16,269,Jeurre,248,7,255
43,Franche-Comté,39,1,24,270,Jouhe,515,62,577
43,Franche-Comté,39,3,28,271,Lac-des-Rouges-Truites,353,19,372
43,Franche-Comté,39,2,32,272,Ladoye-sur-Seille,61,2,63
43,Franche-Comté,39,2,27,273,Lains,80,1,81
43,Franche-Comté,39,3,26,274,Lajoux,252,10,262
43,Franche-Comté,39,3,26,275,Lamoura,543,22,565
43,Franche-Comté,39,2,06,277,Le Larderet,71,4,75
43,Franche-Comté,39,2,10,278,Largillay-Marsonnay,191,2,193
43,Franche-Comté,39,2,04,279,Larnaud,522,26,548
43,Franche-Comté,39,3,05,280,Larrivoire,96,10,106
43,Franche-Comté,39,2,06,281,Le Latet,75,2,77
43,Franche-Comté,39,2,20,282,La Latette,68,2,70
43,Franche-Comté,39,3,26,283,Lavancia-Epercy,652,22,674
43,Franche-Comté,39,1,24,284,Lavangeot,116,5,121
43,Franche-Comté,39,1,24,285,Lavans-lès-Dole,330,16,346
43,Franche-Comté,39,3,26,286,Lavans-lès-Saint-Claude,1873,105,1978
43,Franche-Comté,39,2,02,287,Lavans-sur-Valouse,138,1,139
43,Franche-Comté,39,2,32,288,Lavigny,356,9,365
43,Franche-Comté,39,3,16,289,Lect,384,10,394
43,Franche-Comté,39,2,02,290,Légna,184,2,186
43,Franche-Comté,39,2,29,291,Lemuy,243,8,251
43,Franche-Comté,39,2,06,292,Lent,125,2,127
43,Franche-Comté,39,3,26,293,Leschères,216,3,219
43,Franche-Comté,39,3,19,294,Lézat,189,5,194
43,Franche-Comté,39,2,25,295,Loisia,179,5,184
43,Franche-Comté,39,2,30,296,Lombard,176,7,183
43,Franche-Comté,39,3,19,297,Longchaumois,1141,48,1189
43,Franche-Comté,39,2,20,298,Longcochon,41,1,42
43,Franche-Comté,39,1,09,299,Longwy-sur-le-Doubs,556,7,563
43,Franche-Comté,39,2,97,300,Lons-le-Saunier,18122,931,19053
43,Franche-Comté,39,2,06,301,Loulle,170,5,175
43,Franche-Comté,39,1,14,302,Louvatange,112,0,112
43,Franche-Comté,39,2,27,303,Louvenne,143,1,144
43,Franche-Comté,39,2,32,304,Le Louverot,265,29,294
43,Franche-Comté,39,1,17,305,La Loye,541,13,554
43,Franche-Comté,39,2,34,306,Macornay,1014,54,1068
43,Franche-Comté,39,3,16,307,Maisod,316,8,324
43,Franche-Comté,39,1,14,308,Malange,275,7,282
43,Franche-Comté,39,2,03,309,Mallerey,64,2,66
43,Franche-Comté,39,2,30,310,Mantry,450,11,461
43,Franche-Comté,39,2,02,312,Marigna-sur-Valouse,105,4,109
43,Franche-Comté,39,2,10,313,Marigny,178,9,187
43,Franche-Comté,39,2,21,314,Marnézia,87,2,89
43,Franche-Comté,39,2,29,315,Marnoz,387,11,398
43,Franche-Comté,39,2,32,317,La Marre,330,5,335
43,Franche-Comté,39,3,16,318,Martigna,207,6,213
43,Franche-Comté,39,2,01,319,Mathenay,113,1,114
43,Franche-Comté,39,2,03,320,Maynal,290,12,302
43,Franche-Comté,39,2,32,321,Menétru-le-Vignoble,156,6,162
43,Franche-Comté,39,2,10,322,Menétrux-en-Joux,49,0,49
43,Franche-Comté,39,1,24,323,Menotey,278,17,295
43,Franche-Comté,39,2,21,324,Mérona,11,0,11
43,Franche-Comté,39,2,01,325,Mesnay,554,13,567
43,Franche-Comté,39,2,10,326,Mesnois,197,10,207
43,Franche-Comté,39,2,34,327,Messia-sur-Sorne,842,30,872
43,Franche-Comté,39,3,16,328,Meussia,381,10,391
43,Franche-Comté,39,2,20,329,Mièges,99,1,100
43,Franche-Comté,39,2,23,330,Miéry,138,0,138
43,Franche-Comté,39,2,20,331,Mignovillard,611,26,637
43,Franche-Comté,39,2,11,332,Mirebel,237,4,241
43,Franche-Comté,39,3,16,333,Moirans-en-Montagne,2284,134,2418
43,Franche-Comté,39,2,34,334,Moiron,134,4,138
43,Franche-Comté,39,1,18,335,Moissey,566,15,581
43,Franche-Comté,39,2,23,336,Molain,123,1,124
43,Franche-Comté,39,2,01,337,Molamboz,96,1,97
43,Franche-Comté,39,1,09,338,Molay,479,10,489
43,Franche-Comté,39,3,26,339,Molinges,676,27,703
43,Franche-Comté,39,2,20,340,Molpré,29,1,30
43,Franche-Comté,39,3,26,341,Les Molunes,137,7,144
43,Franche-Comté,39,2,30,342,Monay,144,4,148
43,Franche-Comté,39,2,06,344,Monnet-la-Ville,372,18,390
43,Franche-Comté,39,2,27,343,Monnetay,15,2,17
43,Franche-Comté,39,1,13,345,Monnières,449,11,460
43,Franche-Comté,39,1,17,365,Mont-sous-Vaudrey,1267,32,1299
43,Franche-Comté,39,2,06,366,Mont-sur-Monnet,199,5,204
43,Franche-Comté,39,2,25,346,Montagna-le-Reconduit,112,2,114
43,Franche-Comté,39,2,27,347,Montagna-le-Templier,87,5,92
43,Franche-Comté,39,2,11,348,Montaigu,500,67,567
43,Franche-Comté,39,2,32,349,Montain,496,21,517
43,Franche-Comté,39,1,17,350,Montbarrey,338,8,346
43,Franche-Comté,39,3,16,351,Montcusel,175,3,178
43,Franche-Comté,39,1,12,352,Monteplain,156,6,162
43,Franche-Comté,39,2,27,353,Montfleur,164,1,165
43,Franche-Comté,39,2,23,354,Montholier,317,11,328
43,Franche-Comté,39,2,01,355,Montigny-lès-Arsures,272,5,277
43,Franche-Comté,39,2,06,356,Montigny-sur-l'Ain,196,8,204
43,Franche-Comté,39,2,29,359,Montmarlon,33,1,34
43,Franche-Comté,39,1,18,360,Montmirey-la-Ville,185,4,189
43,Franche-Comté,39,1,18,361,Montmirey-le-Château,191,8,199
43,Franche-Comté,39,2,15,362,Montmorot,3109,246,3355
43,Franche-Comté,39,2,27,363,Montrevel,89,0,89
43,Franche-Comté,39,2,06,364,Montrond,461,16,477
43,Franche-Comté,39,3,19,367,Morbier,2244,127,2371
43,Franche-Comté,39,3,19,368,Morez,5508,220,5728
43,Franche-Comté,39,1,31,370,Mouchard,1200,162,1362
43,Franche-Comté,39,3,19,371,La Mouille,297,12,309
43,Franche-Comté,39,2,20,372,Mournans-Charbonny,84,5,89
43,Franche-Comté,39,3,05,373,Les Moussières,192,1,193
43,Franche-Comté,39,2,21,375,Moutonne,113,0,113
43,Franche-Comté,39,2,06,376,Moutoux,58,1,59
43,Franche-Comté,39,1,18,377,Mutigney,149,2,151
43,Franche-Comté,39,2,25,378,Nanc-lès-Saint-Amour,281,22,303
43,Franche-Comté,39,2,04,379,Nance,483,7,490
43,Franche-Comté,39,2,21,380,Nancuise,45,5,50
43,Franche-Comté,39,2,06,381,Les Nans,90,3,93
43,Franche-Comté,39,2,25,382,Nantey,75,0,75
43,Franche-Comté,39,1,08,385,Neublans-Abergement,480,13,493
43,Franche-Comté,39,2,23,386,Neuvilley,70,1,71
43,Franche-Comté,39,1,33,387,Nevy-lès-Dole,244,4,248
43,Franche-Comté,39,2,32,388,Nevy-sur-Seille,237,9,246
43,Franche-Comté,39,2,06,389,Ney,579,22,601
43,Franche-Comté,39,2,11,390,Nogna,232,5,237
43,Franche-Comté,39,2,20,391,Nozeroy,405,9,414
43,Franche-Comté,39,1,18,392,Offlanges,194,5,199
43,Franche-Comté,39,2,20,393,Onglières,74,2,76
43,Franche-Comté,39,2,21,394,Onoz,84,4,88
43,Franche-Comté,39,2,03,395,Orbagna,174,5,179
43,Franche-Comté,39,1,12,396,Orchamps,1039,27,1066
43,Franche-Comté,39,2,21,397,Orgelet,1733,47,1780
43,Franche-Comté,39,1,14,398,Ougney,306,6,312
43,Franche-Comté,39,1,31,399,Ounans,357,9,366
43,Franche-Comté,39,1,12,400,Our,159,5,164
43,Franche-Comté,39,2,23,401,Oussières,223,1,224
43,Franche-Comté,39,1,14,402,Pagney,334,4,338
43,Franche-Comté,39,1,31,403,Pagnoz,234,7,241
43,Franche-Comté,39,2,11,404,Pannessières,442,20,462
43,Franche-Comté,39,1,33,405,Parcey,941,29,970
43,Franche-Comté,39,2,06,406,Le Pasquier,251,10,261
43,Franche-Comté,39,2,30,407,Passenans,318,7,325
43,Franche-Comté,39,2,10,408,Patornay,139,1,140
43,Franche-Comté,39,1,18,409,Peintre,135,12,147
43,Franche-Comté,39,2,11,411,Perrigny,1529,65,1594
43,Franche-Comté,39,1,09,412,Peseux,275,6,281
43,Franche-Comté,39,3,05,413,La Pesse,347,13,360
43,Franche-Comté,39,1,14,414,Le Petit-Mercey,111,3,114
43,Franche-Comté,39,1,09,415,Petit-Noir,1157,24,1181
43,Franche-Comté,39,3,28,417,Les Piards,180,5,185
43,Franche-Comté,39,2,23,418,Picarreau,85,1,86
43,Franche-Comté,39,2,06,419,Pillemoine,62,2,64
43,Franche-Comté,39,2,21,420,Pimorin,185,5,190
43,Franche-Comté,39,2,32,421,Le Pin,264,15,279
43,Franche-Comté,39,2,32,422,Plainoiseau,532,23,555
43,Franche-Comté,39,2,21,423,Plaisia,115,10,125
43,Franche-Comté,39,2,22,424,Les Planches-en-Montagne,150,2,152
43,Franche-Comté,39,2,01,425,Les Planches-près-Arbois,94,9,103
43,Franche-Comté,39,2,23,426,Plasne,256,22,278
43,Franche-Comté,39,2,20,427,Plénise,53,5,58
43,Franche-Comté,39,2,20,428,Plénisette,33,0,33
43,Franche-Comté,39,1,08,429,Pleure,414,13,427
43,Franche-Comté,39,1,12,430,Plumont,91,0,91
43,Franche-Comté,39,2,11,431,Poids-de-Fiole,301,11,312
43,Franche-Comté,39,1,18,432,Pointre,105,3,108
43,Franche-Comté,39,2,23,434,Poligny,4254,329,4583
43,Franche-Comté,39,2,29,436,Pont-d'Héry,254,12,266
43,Franche-Comté,39,2,10,435,Pont-de-Poitte,646,19,665
43,Franche-Comté,39,2,06,437,Pont-du-Navoy,241,6,247
43,Franche-Comté,39,3,26,438,Ponthoux,88,2,90
43,Franche-Comté,39,1,31,439,Port-Lesney,530,65,595
43,Franche-Comté,39,3,16,440,Pratz,572,26,598
43,Franche-Comté,39,3,19,441,Prémanon,1006,20,1026
43,Franche-Comté,39,3,28,442,Prénovel,305,11,316
43,Franche-Comté,39,2,21,443,Présilly,107,2,109
43,Franche-Comté,39,2,29,444,Pretin,58,2,60
43,Franche-Comté,39,2,11,445,Publy,285,9,294
43,Franche-Comté,39,2,01,446,Pupillin,253,15,268
43,Franche-Comté,39,2,04,447,Quintigny,225,7,232
43,Franche-Comté,39,1,08,448,Rahon,526,12,538
43,Franche-Comté,39,1,24,449,Rainans,205,4,209
43,Franche-Comté,39,1,12,451,Ranchot,474,8,482
43,Franche-Comté,39,1,12,452,Rans,461,5,466
43,Franche-Comté,39,3,26,453,Ravilloles,491,14,505
43,Franche-Comté,39,2,07,454,Recanoz,69,0,69
43,Franche-Comté,39,2,21,455,Reithouse,52,3,55
43,Franche-Comté,39,2,04,456,Relans,328,6,334
43,Franche-Comté,39,2,04,457,Les Repôts,32,0,32
43,Franche-Comté,39,2,11,458,Revigny,262,29,291
43,Franche-Comté,39,2,20,461,Rix,72,5,77
43,Franche-Comté,39,3,26,460,La Rixouse,208,9,217
43,Franche-Comté,39,1,24,462,Rochefort-sur-Nenon,570,27,597
43,Franche-Comté,39,3,05,463,Rogna,207,10,217
43,Franche-Comté,39,1,14,464,Romain,207,9,216
43,Franche-Comté,39,1,24,465,Romange,206,5,211
43,Franche-Comté,39,2,03,466,Rosay,130,3,133
43,Franche-Comté,39,2,03,467,Rotalier,169,4,173
43,Franche-Comté,39,2,21,468,Rothonay,116,5,121
43,Franche-Comté,39,1,14,469,Rouffange,95,0,95
43,Franche-Comté,39,3,19,470,Les Rousses,3028,96,3124
43,Franche-Comté,39,2,04,471,Ruffey-sur-Seille,770,14,784
43,Franche-Comté,39,2,07,472,Rye,171,1,172
43,Franche-Comté,39,2,10,473,Saffloz,99,4,103
43,Franche-Comté,39,2,25,475,Saint-Amour,2291,92,2383
43,Franche-Comté,39,1,09,476,Saint-Aubin,1737,70,1807
43,Franche-Comté,39,1,08,477,Saint-Baraing,227,1,228
43,Franche-Comté,39,3,26,478,Saint-Claude,11523,476,11999
43,Franche-Comté,39,2,01,479,Saint-Cyr-Montmalin,177,6,183
43,Franche-Comté,39,2,15,480,Saint-Didier,318,9,327
43,Franche-Comté,39,2,06,481,Saint-Germain-en-Montagne,400,10,410
43,Franche-Comté,39,2,32,482,Saint-Germain-lès-Arlay,529,12,541
43,Franche-Comté,39,2,02,483,Saint-Hymetière,74,5,79
43,Franche-Comté,39,2,25,484,Saint-Jean-d'Étreux,142,2,144
43,Franche-Comté,39,2,27,485,Saint-Julien,451,10,461
43,Franche-Comté,39,2,30,486,Saint-Lamain,121,5,126
43,Franche-Comté,39,3,28,487,Saint-Laurent-en-Grandvaux,1745,102,1847
43,Franche-Comté,39,2,03,488,Saint-Laurent-la-Roche,345,14,359
43,Franche-Comté,39,2,30,489,Saint-Lothain,434,22,456
43,Franche-Comté,39,1,09,490,Saint-Loup,267,6,273
43,Franche-Comté,39,3,26,491,Saint-Lupicin,2200,89,2289
43,Franche-Comté,39,2,11,492,Saint-Maur,195,7,202
43,Franche-Comté,39,3,28,493,Saint-Maurice-Crillat,205,7,212
43,Franche-Comté,39,3,28,494,Saint-Pierre,320,8,328
43,Franche-Comté,39,2,29,495,Saint-Thiébaud,65,1,66
43,Franche-Comté,39,2,03,474,Sainte-Agnès,302,6,308
43,Franche-Comté,39,2,29,497,Saizenay,110,1,111
43,Franche-Comté,39,1,12,498,Salans,579,17,596
43,Franche-Comté,39,1,14,499,Saligney,164,7,171
43,Franche-Comté,39,2,29,500,Salins-les-Bains,2987,200,3187
43,Franche-Comté,39,1,13,501,Sampans,839,21,860
43,Franche-Comté,39,1,17,502,Santans,326,4,330
43,Franche-Comté,39,2,06,503,Sapois,330,14,344
43,Franche-Comté,39,2,21,504,Sarrogna,217,8,225
43,Franche-Comté,39,3,28,505,Saugeot,57,2,59
43,Franche-Comté,39,2,02,506,Savigna,106,6,112
43,Franche-Comté,39,1,08,507,Séligney,89,4,93
43,Franche-Comté,39,2,30,508,Sellières,808,18,826
43,Franche-Comté,39,2,25,509,Senaud,50,0,50
43,Franche-Comté,39,3,26,510,Septmoncel,673,27,700
43,Franche-Comté,39,2,07,511,Sergenaux,54,0,54
43,Franche-Comté,39,2,07,512,Sergenon,36,3,39
43,Franche-Comté,39,1,14,513,Sermange,268,6,274
43,Franche-Comté,39,1,14,514,Serre-les-Moulières,190,5,195
43,Franche-Comté,39,2,06,517,Sirod,559,15,574
43,Franche-Comté,39,2,10,518,Songeson,70,2,72
43,Franche-Comté,39,2,10,519,Soucia,141,2,143
43,Franche-Comté,39,1,17,520,Souvans,488,11,499
43,Franche-Comté,39,2,06,522,Supt,97,0,97
43,Franche-Comté,39,2,06,523,Syam,203,5,208
43,Franche-Comté,39,1,08,525,Tassenières,368,6,374
43,Franche-Comté,39,1,09,526,Tavaux,4056,133,4189
43,Franche-Comté,39,1,14,527,Taxenne,95,1,96
43,Franche-Comté,39,1,18,528,Thervay,377,10,387
43,Franche-Comté,39,2,29,529,Thésy,66,4,70
43,Franche-Comté,39,2,02,530,Thoirette,646,21,667
43,Franche-Comté,39,2,10,531,Thoiria,160,3,163
43,Franche-Comté,39,2,25,532,Thoissia,36,3,39
43,Franche-Comté,39,2,30,533,Toulouse-le-Château,210,4,214
43,Franche-Comté,39,2,21,534,La Tour-du-Meix,224,5,229
43,Franche-Comté,39,2,23,535,Tourmont,482,15,497
43,Franche-Comté,39,2,34,537,Trenal,362,22,384
43,Franche-Comté,39,2,10,538,Uxelles,52,2,54
43,Franche-Comté,39,2,01,539,Vadans,265,16,281
43,Franche-Comté,39,2,25,209,Val-d'Épy,142,3,145
43,Franche-Comté,39,2,06,540,Valempoulières,211,3,214
43,Franche-Comté,39,2,02,542,Valfin-sur-Valouse,86,4,90
43,Franche-Comté,39,2,06,543,Vannoz,216,8,224
43,Franche-Comté,39,2,21,544,Varessia,36,0,36
43,Franche-Comté,39,2,06,545,Le Vaudioux,161,4,165
43,Franche-Comté,39,1,17,546,Vaudrey,373,12,385
43,Franche-Comté,39,3,26,547,Vaux-lès-Saint-Claude,708,32,740
43,Franche-Comté,39,2,23,548,Vaux-sur-Poligny,99,91,190
43,Franche-Comté,39,2,03,549,Vercia,300,3,303
43,Franche-Comté,39,2,11,550,Verges,172,4,176
43,Franche-Comté,39,2,25,551,Véria,138,5,143
43,Franche-Comté,39,2,34,552,Vernantois,318,10,328
43,Franche-Comté,39,2,32,553,Le Vernois,272,11,283
43,Franche-Comté,39,2,06,554,Vers-en-Montagne,199,3,202
43,Franche-Comté,39,2,30,555,Vers-sous-Sellières,219,2,221
43,Franche-Comté,39,2,10,556,Vertamboz,93,0,93
43,Franche-Comté,39,2,02,557,Vescles,215,8,223
43,Franche-Comté,39,2,11,558,Vevy,249,11,260
43,Franche-Comté,39,1,17,559,La Vieille-Loye,372,9,381
43,Franche-Comté,39,3,26,560,Villard-Saint-Sauveur,643,43,686
43,Franche-Comté,39,3,26,562,Villard-sur-Bienne,195,4,199
43,Franche-Comté,39,3,16,561,Villards-d'Héria,455,18,473
43,Franche-Comté,39,2,27,564,Villechantria,129,3,132
43,Franche-Comté,39,1,31,565,Villeneuve-d'Aval,81,2,83
43,Franche-Comté,39,2,27,566,Villeneuve-lès-Charnod,88,3,91
43,Franche-Comté,39,2,15,567,Villeneuve-sous-Pymont,262,14,276
43,Franche-Comté,39,1,31,569,Villers-Farlay,505,15,520
43,Franche-Comté,39,2,23,570,Villers-les-Bois,198,5,203
43,Franche-Comté,39,1,08,571,Villers-Robert,199,7,206
43,Franche-Comté,39,2,30,568,Villerserine,40,1,41
43,Franche-Comté,39,2,01,572,Villette-lès-Arbois,402,11,413
43,Franche-Comté,39,1,13,573,Villette-lès-Dole,746,22,768
43,Franche-Comté,39,2,04,574,Villevieux,717,14,731
43,Franche-Comté,39,2,07,575,Le Villey,75,0,75
43,Franche-Comté,39,2,03,576,Vincelles,356,7,363
43,Franche-Comté,39,2,07,577,Vincent,323,14,337
43,Franche-Comté,39,3,05,579,Viry,902,30,932
43,Franche-Comté,39,1,14,581,Vitreux,280,4,284
43,Franche-Comté,39,2,32,582,Voiteur,770,40,810
43,Franche-Comté,39,2,02,583,Vosbles,109,9,118
43,Franche-Comté,39,1,24,584,Vriange,129,9,138
43,Franche-Comté,39,3,05,585,Vulvoz,17,0,17
72,Aquitaine,40,2,01,001,Aire-sur-l'Adour,6092,561,6653
72,Aquitaine,40,1,02,002,Amou,1573,44,1617
72,Aquitaine,40,1,04,003,Angoumé,253,11,264
72,Aquitaine,40,1,25,004,Angresse,1434,28,1462
72,Aquitaine,40,2,06,005,Arboucave,193,5,198
72,Aquitaine,40,2,13,006,Arengosse,710,18,728
72,Aquitaine,40,1,02,007,Argelos,175,6,181
72,Aquitaine,40,2,24,008,Argelouse,88,1,89
72,Aquitaine,40,2,13,009,Arjuzanx,203,1,204
72,Aquitaine,40,1,02,011,Arsague,316,10,326
72,Aquitaine,40,2,07,012,Artassenx,248,7,255
72,Aquitaine,40,2,28,013,Arthez-d'Armagnac,130,2,132
72,Aquitaine,40,2,19,014,Arue,302,17,319
72,Aquitaine,40,2,05,015,Arx,66,1,67
72,Aquitaine,40,2,08,016,Aubagnan,237,9,246
72,Aquitaine,40,2,22,017,Audignon,338,7,345
72,Aquitaine,40,1,26,018,Audon,331,3,334
72,Aquitaine,40,2,10,019,Aureilhan,884,31,915
72,Aquitaine,40,2,22,020,Aurice,645,16,661
72,Aquitaine,40,1,25,021,Azur,549,8,557
72,Aquitaine,40,2,01,022,Bahus-Soubiran,356,11,367
72,Aquitaine,40,1,14,023,Baigts,346,10,356
72,Aquitaine,40,2,22,024,Banos,239,2,241
72,Aquitaine,40,2,22,026,Bas-Mauco,296,12,308
72,Aquitaine,40,2,07,025,Bascons,933,28,961
72,Aquitaine,40,1,02,027,Bassercles,110,2,112
72,Aquitaine,40,1,02,028,Bastennes,259,4,263
72,Aquitaine,40,2,06,029,Bats,273,6,279
72,Aquitaine,40,2,05,030,Baudignan,45,3,48
72,Aquitaine,40,1,27,031,Bégaar,1060,27,1087
72,Aquitaine,40,2,17,032,Belhade,171,3,174
72,Aquitaine,40,2,09,033,Bélis,139,5,144
72,Aquitaine,40,1,16,034,Bélus,608,9,617
72,Aquitaine,40,1,29,035,Bénesse-lès-Dax,508,16,524
72,Aquitaine,40,1,23,036,Bénesse-Maremne,2166,56,2222
72,Aquitaine,40,2,30,037,Benquet,1449,52,1501
72,Aquitaine,40,1,14,038,Bergouey,111,4,115
72,Aquitaine,40,2,05,039,Betbezer-d'Armagnac,139,0,139
72,Aquitaine,40,1,27,040,Beylongue,344,6,350
72,Aquitaine,40,1,02,041,Beyries,97,3,100
72,Aquitaine,40,1,21,042,Biarrotte,245,9,254
72,Aquitaine,40,2,10,043,Bias,719,16,735
72,Aquitaine,40,1,21,044,Biaudos,736,20,756
72,Aquitaine,40,2,15,046,Biscarrosse,12355,279,12634
72,Aquitaine,40,1,02,047,Bonnegarde,264,10,274
72,Aquitaine,40,1,27,048,Boos,281,2,283
72,Aquitaine,40,2,07,049,Bordères-et-Lamensans,351,12,363
72,Aquitaine,40,2,11,050,Bostens,175,11,186
72,Aquitaine,40,2,30,051,Bougue,571,27,598
72,Aquitaine,40,2,28,052,Bourdalat,212,6,218
72,Aquitaine,40,2,19,053,Bourriot-Bergonce,316,9,325
72,Aquitaine,40,1,02,054,Brassempouy,295,14,309
72,Aquitaine,40,2,30,055,Bretagne-de-Marsan,1259,34,1293
72,Aquitaine,40,2,09,056,Brocas,804,23,827
72,Aquitaine,40,2,01,057,Buanes,271,9,280
72,Aquitaine,40,2,19,058,Cachen,221,8,229
72,Aquitaine,40,1,18,059,Cagnotte,669,22,691
72,Aquitaine,40,2,24,060,Callen,141,3,144
72,Aquitaine,40,2,30,061,Campagne,918,32,950
72,Aquitaine,40,2,11,062,Campet-et-Lamolère,341,10,351
72,Aquitaine,40,1,29,063,Candresse,818,28,846
72,Aquitaine,40,2,09,064,Canenx-et-Réaut,166,4,170
72,Aquitaine,40,1,23,065,Capbreton,7763,277,8040
72,Aquitaine,40,1,26,066,Carcarès-Sainte-Croix,478,22,500
72,Aquitaine,40,1,27,067,Carcen-Ponson,602,24,626
72,Aquitaine,40,1,12,068,Cassen,468,15,483
72,Aquitaine,40,1,02,069,Castaignos-Souslens,367,2,369
72,Aquitaine,40,2,07,070,Castandet,404,12,416
72,Aquitaine,40,1,02,074,Castel-Sarrazin,486,15,501
72,Aquitaine,40,1,02,071,Castelnau-Chalosse,536,20,556
72,Aquitaine,40,2,06,072,Castelnau-Tursan,184,3,187
72,Aquitaine,40,2,08,073,Castelner,128,2,130
72,Aquitaine,40,1,03,075,Castets,1915,45,1960
72,Aquitaine,40,2,22,076,Cauna,408,8,416
72,Aquitaine,40,1,16,077,Cauneille,784,22,806
72,Aquitaine,40,1,14,078,Caupenne,402,6,408
72,Aquitaine,40,2,08,079,Cazalis,141,3,144
72,Aquitaine,40,2,07,080,Cazères-sur-l'Adour,1130,28,1158
72,Aquitaine,40,2,09,081,Cère,408,14,422
72,Aquitaine,40,2,01,082,Classun,238,8,246
72,Aquitaine,40,2,06,083,Clèdes,120,6,126
72,Aquitaine,40,1,12,084,Clermont,832,23,855
72,Aquitaine,40,2,20,085,Commensacq,387,6,393
72,Aquitaine,40,2,22,086,Coudures,444,4,448
72,Aquitaine,40,2,05,087,Créon-d'Armagnac,310,2,312
72,Aquitaine,40,1,97,088,Dax,20528,963,21491
72,Aquitaine,40,1,14,089,Doazit,918,27,945
72,Aquitaine,40,1,02,090,Donzacq,438,8,446
72,Aquitaine,40,2,01,091,Duhort-Bachen,621,17,638
72,Aquitaine,40,2,22,092,Dumes,265,5,270
72,Aquitaine,40,2,05,093,Escalans,252,6,258
72,Aquitaine,40,2,20,094,Escource,596,21,617
72,Aquitaine,40,1,18,095,Estibeaux,597,7,604
72,Aquitaine,40,2,05,096,Estigarde,77,5,82
72,Aquitaine,40,2,01,097,Eugénie-les-Bains,494,18,512
72,Aquitaine,40,2,22,098,Eyres-Moncube,375,10,385
72,Aquitaine,40,2,22,099,Fargues,314,10,324
72,Aquitaine,40,2,28,100,Le Frêche,394,12,406
72,Aquitaine,40,1,18,101,Gaas,474,13,487
72,Aquitaine,40,2,05,102,Gabarret,1222,140,1362
72,Aquitaine,40,2,11,103,Gaillères,574,13,587
72,Aquitaine,40,1,12,104,Gamarde-les-Bains,1007,26,1033
72,Aquitaine,40,2,09,105,Garein,426,7,433
72,Aquitaine,40,1,12,106,Garrey,180,8,188
72,Aquitaine,40,2,13,107,Garrosse,323,7,330
72,Aquitaine,40,2,15,108,Gastes,571,12,583
72,Aquitaine,40,1,02,109,Gaujacq,448,6,454
72,Aquitaine,40,2,06,110,Geaune,729,16,745
72,Aquitaine,40,2,11,111,Geloux,695,6,701
72,Aquitaine,40,1,12,112,Gibret,99,6,105
72,Aquitaine,40,1,12,113,Goos,524,23,547
72,Aquitaine,40,1,04,114,Gourbera,292,9,301
72,Aquitaine,40,1,12,115,Gousse,269,7,276
72,Aquitaine,40,1,26,116,Gouts,241,6,247
72,Aquitaine,40,2,07,117,Grenade-sur-l'Adour,2468,54,2522
72,Aquitaine,40,1,18,118,Habas,1469,20,1489
72,Aquitaine,40,2,08,119,Hagetmau,4544,131,4675
72,Aquitaine,40,1,16,120,Hastingues,559,22,581
72,Aquitaine,40,1,14,121,Hauriet,249,6,255
72,Aquitaine,40,2,30,122,Haut-Mauco,793,28,821
72,Aquitaine,40,1,04,123,Herm,1001,29,1030
72,Aquitaine,40,2,05,124,Herré,134,3,137
72,Aquitaine,40,1,29,125,Heugas,1233,46,1279
72,Aquitaine,40,1,12,126,Hinx,1542,40,1582
72,Aquitaine,40,2,28,127,Hontanx,561,8,569
72,Aquitaine,40,2,08,128,Horsarrieu,627,23,650
72,Aquitaine,40,1,23,129,Josse,769,18,787
72,Aquitaine,40,2,08,130,Labastide-Chalosse,126,4,130
72,Aquitaine,40,2,19,131,Labastide-d'Armagnac,688,21,709
72,Aquitaine,40,1,18,132,Labatut,1334,28,1362
72,Aquitaine,40,1,23,133,Labenne,4543,109,4652
72,Aquitaine,40,2,20,134,Labouheyre,2542,77,2619
72,Aquitaine,40,2,09,135,Labrit,860,15,875
72,Aquitaine,40,2,06,136,Lacajunte,131,4,135
72,Aquitaine,40,2,28,137,Lacquy,224,5,229
72,Aquitaine,40,2,08,138,Lacrabe,237,7,244
72,Aquitaine,40,2,30,139,Laglorieuse,563,23,586
72,Aquitaine,40,2,05,140,Lagrange,207,5,212
72,Aquitaine,40,1,14,141,Lahosse,281,11,292
72,Aquitaine,40,1,27,142,Laluque,715,24,739
72,Aquitaine,40,1,26,143,Lamothe,288,10,298
72,Aquitaine,40,1,14,144,Larbey,244,7,251
72,Aquitaine,40,2,07,145,Larrivière-Saint-Savin,586,8,594
72,Aquitaine,40,2,01,146,Latrille,165,6,171
72,Aquitaine,40,1,14,147,Laurède,364,14,378
72,Aquitaine,40,2,06,148,Lauret,77,0,77
72,Aquitaine,40,2,19,149,Lencouacq,395,11,406
72,Aquitaine,40,1,03,150,Léon,1766,39,1805
72,Aquitaine,40,1,27,151,Lesgor,384,10,394
72,Aquitaine,40,2,13,152,Lesperon,981,31,1012
72,Aquitaine,40,1,26,153,Le Leuy,216,1,217
72,Aquitaine,40,1,03,154,Lévignacq,353,8,361
72,Aquitaine,40,1,03,155,Linxe,1198,28,1226
72,Aquitaine,40,2,17,156,Liposthey,401,7,408
72,Aquitaine,40,1,03,157,Lit-et-Mixe,1475,51,1526
72,Aquitaine,40,2,05,158,Losse,265,8,273
72,Aquitaine,40,1,12,159,Louer,239,5,244
72,Aquitaine,40,1,12,160,Lourquen,217,7,224
72,Aquitaine,40,2,05,161,Lubbon,105,1,106
72,Aquitaine,40,2,11,162,Lucbardez-et-Bargues,432,15,447
72,Aquitaine,40,2,20,163,Lüe,498,14,512
72,Aquitaine,40,2,20,165,Luglon,323,16,339
72,Aquitaine,40,2,07,166,Lussagnet,79,0,79
72,Aquitaine,40,2,24,167,Luxey,675,8,683
72,Aquitaine,40,1,25,168,Magescq,1688,35,1723
72,Aquitaine,40,2,19,169,Maillas,113,1,114
72,Aquitaine,40,2,09,170,Maillères,200,3,203
72,Aquitaine,40,2,17,171,Mano,102,4,106
72,Aquitaine,40,2,08,172,Mant,283,11,294
72,Aquitaine,40,1,02,173,Marpaps,138,2,140
72,Aquitaine,40,2,06,174,Mauries,86,3,89
72,Aquitaine,40,2,07,175,Maurrin,453,8,461
72,Aquitaine,40,2,05,176,Mauvezin-d'Armagnac,104,0,104
72,Aquitaine,40,1,14,177,Maylis,334,10,344
72,Aquitaine,40,2,30,178,Mazerolles,696,27,723
72,Aquitaine,40,1,04,179,Mées,1679,50,1729
72,Aquitaine,40,1,26,180,Meilhan,1090,34,1124
72,Aquitaine,40,1,25,181,Messanges,953,39,992
72,Aquitaine,40,2,10,182,Mézos,863,18,881
72,Aquitaine,40,1,18,183,Mimbaste,1008,23,1031
72,Aquitaine,40,2,10,184,Mimizan,6903,191,7094
72,Aquitaine,40,2,06,185,Miramont-Sensacq,366,11,377
72,Aquitaine,40,1,18,186,Misson,704,22,726
72,Aquitaine,40,1,25,187,Moliets-et-Maa,821,12,833
72,Aquitaine,40,2,08,188,Momuy,444,10,454
72,Aquitaine,40,2,08,189,Monget,78,1,79
72,Aquitaine,40,2,08,190,Monségur,368,11,379
72,Aquitaine,40,2,98,192,Mont-de-Marsan,30162,1910,32072
72,Aquitaine,40,2,22,191,Montaut,556,21,577
72,Aquitaine,40,2,28,193,Montégut,71,2,73
72,Aquitaine,40,1,12,194,Montfort-en-Chalosse,1145,32,1177
72,Aquitaine,40,2,22,195,Montgaillard,566,8,574
72,Aquitaine,40,2,22,196,Montsoué,559,11,570
72,Aquitaine,40,2,13,197,Morcenx,4600,332,4932
72,Aquitaine,40,2,08,198,Morganx,179,7,186
72,Aquitaine,40,1,18,199,Mouscardès,279,3,282
72,Aquitaine,40,2,17,200,Moustey,662,6,668
72,Aquitaine,40,1,14,201,Mugron,1395,108,1503
72,Aquitaine,40,1,29,202,Narrosse,2851,92,2943
72,Aquitaine,40,1,02,203,Nassiet,308,9,317
72,Aquitaine,40,1,14,204,Nerbis,238,6,244
72,Aquitaine,40,1,12,205,Nousse,268,5,273
72,Aquitaine,40,1,16,206,Oeyregave,345,7,352
72,Aquitaine,40,1,29,207,Oeyreluy,1552,202,1754
72,Aquitaine,40,1,12,208,Onard,325,8,333
72,Aquitaine,40,1,21,209,Ondres,4362,101,4463
72,Aquitaine,40,2,13,210,Onesse-et-Laharie,943,22,965
72,Aquitaine,40,1,16,211,Orist,658,12,670
72,Aquitaine,40,1,16,212,Orthevielle,857,16,873
72,Aquitaine,40,1,23,213,Orx,469,13,482
72,Aquitaine,40,1,18,214,Ossages,462,17,479
72,Aquitaine,40,2,13,215,Ousse-Suzan,239,10,249
72,Aquitaine,40,1,12,216,Ozourt,188,3,191
72,Aquitaine,40,2,15,217,Parentis-en-Born,5051,225,5276
72,Aquitaine,40,2,05,218,Parleboscq,504,12,516
72,Aquitaine,40,2,06,219,Payros-Cazautets,88,6,94
72,Aquitaine,40,2,06,220,Pécorade,150,9,159
72,Aquitaine,40,2,28,221,Perquie,370,7,377
72,Aquitaine,40,1,16,222,Pey,701,13,714
72,Aquitaine,40,2,08,223,Peyre,194,1,195
72,Aquitaine,40,1,16,224,Peyrehorade,3465,136,3601
72,Aquitaine,40,2,06,225,Philondenx,211,0,211
72,Aquitaine,40,2,06,226,Pimbo,186,7,193
72,Aquitaine,40,2,17,227,Pissos,1275,24,1299
72,Aquitaine,40,1,02,228,Pomarez,1487,45,1532
72,Aquitaine,40,2,10,229,Pontenx-les-Forges,1387,32,1419
72,Aquitaine,40,1,27,230,Pontonx-sur-l'Adour,2427,149,2576
72,Aquitaine,40,1,16,231,Port-de-Lanne,886,12,898
72,Aquitaine,40,2,08,232,Poudenx,211,2,213
72,Aquitaine,40,1,18,233,Pouillon,2789,69,2858
72,Aquitaine,40,2,19,234,Pouydesseaux,887,22,909
72,Aquitaine,40,1,12,235,Poyanne,571,14,585
72,Aquitaine,40,1,12,236,Poyartin,697,23,720
72,Aquitaine,40,1,12,237,Préchacq-les-Bains,598,8,606
72,Aquitaine,40,2,28,238,Pujo-le-Plan,578,9,587
72,Aquitaine,40,2,06,239,Puyol-Cazalet,108,2,110
72,Aquitaine,40,2,01,240,Renung,484,20,504
72,Aquitaine,40,2,19,164,Retjons,317,8,325
72,Aquitaine,40,2,05,242,Rimbez-et-Baudiets,96,1,97
72,Aquitaine,40,1,27,243,Rion-des-Landes,2330,54,2384
72,Aquitaine,40,1,04,244,Rivière-Saas-et-Gourby,1147,32,1179
72,Aquitaine,40,2,19,245,Roquefort,1920,28,1948
72,Aquitaine,40,2,20,246,Sabres,1196,105,1301
72,Aquitaine,40,2,01,247,Saint-Agnet,190,6,196
72,Aquitaine,40,1,21,248,Saint-André-de-Seignanx,1518,32,1550
72,Aquitaine,40,1,14,249,Saint-Aubin,488,20,508
72,Aquitaine,40,2,11,250,Saint-Avit,635,29,664
72,Aquitaine,40,1,21,251,Saint-Barthélemy,351,5,356
72,Aquitaine,40,2,08,253,Saint-Cricq-Chalosse,620,19,639
72,Aquitaine,40,1,16,254,Saint-Cricq-du-Gave,355,4,359
72,Aquitaine,40,2,28,255,Saint-Cricq-Villeneuve,434,12,446
72,Aquitaine,40,1,16,256,Saint-Étienne-d'Orthe,562,7,569
72,Aquitaine,40,2,28,259,Saint-Gein,445,7,452
72,Aquitaine,40,1,12,260,Saint-Geours-d'Auribat,325,6,331
72,Aquitaine,40,1,25,261,Saint-Geours-de-Maremne,2054,34,2088
72,Aquitaine,40,2,19,262,Saint-Gor,283,6,289
72,Aquitaine,40,1,12,263,Saint-Jean-de-Lier,347,24,371
72,Aquitaine,40,1,23,264,Saint-Jean-de-Marsacq,1287,25,1312
72,Aquitaine,40,2,05,265,Saint-Julien-d'Armagnac,118,3,121
72,Aquitaine,40,1,03,266,Saint-Julien-en-Born,1427,67,1494
72,Aquitaine,40,2,19,267,Saint-Justin,897,22,919
72,Aquitaine,40,1,21,268,Saint-Laurent-de-Gosse,522,15,537
72,Aquitaine,40,1,16,269,Saint-Lon-les-Mines,1148,37,1185
72,Aquitaine,40,2,01,270,Saint-Loubouer,439,6,445
72,Aquitaine,40,2,11,274,Saint-Martin-d'Oney,1199,20,1219
72,Aquitaine,40,1,23,272,Saint-Martin-de-Hinx,1157,25,1182
72,Aquitaine,40,1,21,273,Saint-Martin-de-Seignanx,4719,104,4823
72,Aquitaine,40,2,07,275,Saint-Maurice-sur-Adour,607,23,630
72,Aquitaine,40,1,03,276,Saint-Michel-Escalus,286,11,297
72,Aquitaine,40,1,29,277,Saint-Pandelon,746,65,811
72,Aquitaine,40,2,10,278,Saint-Paul-en-Born,772,22,794
72,Aquitaine,40,1,04,279,Saint-Paul-lès-Dax,12544,377,12921
72,Aquitaine,40,2,30,280,Saint-Perdon,1390,40,1430
72,Aquitaine,40,2,30,281,Saint-Pierre-du-Mont,8664,373,9037
72,Aquitaine,40,2,22,282,Saint-Sever,4852,153,5005
72,Aquitaine,40,1,04,283,Saint-Vincent-de-Paul,2944,329,3273
72,Aquitaine,40,1,23,284,Saint-Vincent-de-Tyrosse,7161,195,7356
72,Aquitaine,40,1,27,285,Saint-Yaguen,525,11,536
72,Aquitaine,40,2,08,252,Sainte-Colombe,623,21,644
72,Aquitaine,40,2,15,257,Sainte-Eulalie-en-Born,1062,26,1088
72,Aquitaine,40,2,28,258,Sainte-Foy,233,6,239
72,Aquitaine,40,1,23,271,Sainte-Marie-de-Gosse,1044,23,1067
72,Aquitaine,40,2,06,286,Samadet,1024,25,1049
72,Aquitaine,40,2,15,287,Sanguinet,3092,83,3175
72,Aquitaine,40,2,19,288,Sarbazan,1083,27,1110
72,Aquitaine,40,2,22,289,Sarraziet,197,6,203
72,Aquitaine,40,2,01,290,Sarron,106,2,108
72,Aquitaine,40,1,23,291,Saubion,1302,21,1323
72,Aquitaine,40,1,23,292,Saubrigues,1306,52,1358
72,Aquitaine,40,1,04,293,Saubusse,792,20,812
72,Aquitaine,40,1,29,294,Saugnac-et-Cambran,1554,51,1605
72,Aquitaine,40,2,17,295,Saugnacq-et-Muret,873,19,892
72,Aquitaine,40,1,25,296,Seignosse,3131,69,3200
72,Aquitaine,40,2,09,297,Le Sen,203,8,211
72,Aquitaine,40,2,08,298,Serres-Gaston,357,8,365
72,Aquitaine,40,2,08,299,Serreslous-et-Arribans,211,5,216
72,Aquitaine,40,1,29,300,Seyresse,789,41,830
72,Aquitaine,40,1,29,301,Siest,109,2,111
72,Aquitaine,40,2,13,302,Sindères,186,3,189
72,Aquitaine,40,2,20,303,Solférino,351,11,362
72,Aquitaine,40,1,25,304,Soorts-Hossegor,3672,89,3761
72,Aquitaine,40,2,06,305,Sorbets,189,7,196
72,Aquitaine,40,1,16,306,Sorde-l'Abbaye,642,23,665
72,Aquitaine,40,2,24,307,Sore,1005,17,1022
72,Aquitaine,40,1,12,308,Sort-en-Chalosse,841,35,876
72,Aquitaine,40,1,26,309,Souprosse,1024,27,1051
72,Aquitaine,40,1,25,310,Soustons,7090,151,7241
72,Aquitaine,40,1,03,311,Taller,397,7,404
72,Aquitaine,40,1,21,312,Tarnos,11563,227,11790
72,Aquitaine,40,1,99,313,Tartas,2963,81,3044
72,Aquitaine,40,1,29,314,Tercis-les-Bains,1154,36,1190
72,Aquitaine,40,1,04,315,Téthieu,633,23,656
72,Aquitaine,40,1,18,316,Tilh,810,15,825
72,Aquitaine,40,1,25,317,Tosse,2199,48,2247
72,Aquitaine,40,1,14,318,Toulouzette,270,8,278
72,Aquitaine,40,2,20,319,Trensacq,274,7,281
72,Aquitaine,40,2,11,320,Uchacq-et-Parentis,582,20,602
72,Aquitaine,40,2,06,321,Urgons,260,9,269
72,Aquitaine,40,1,03,322,Uza,157,13,170
72,Aquitaine,40,2,09,323,Vert,237,3,240
72,Aquitaine,40,1,12,324,Vicq-d'Auribat,259,10,269
72,Aquitaine,40,1,03,326,Vielle-Saint-Girons,1139,35,1174
72,Aquitaine,40,2,19,327,Vielle-Soubiran,242,7,249
72,Aquitaine,40,2,01,325,Vielle-Tursan,298,4,302
72,Aquitaine,40,1,25,328,Vieux-Boucau-les-Bains,1591,61,1652
72,Aquitaine,40,2,07,329,Le Vignau,465,9,474
72,Aquitaine,40,1,27,330,Villenave,254,8,262
72,Aquitaine,40,2,28,331,Villeneuve-de-Marsan,2346,64,2410
72,Aquitaine,40,2,15,332,Ychoux,1807,39,1846
72,Aquitaine,40,2,13,333,Ygos-Saint-Saturnin,1155,18,1173
72,Aquitaine,40,1,29,334,Yzosse,413,10,423
24,Centre,41,2,19,001,Ambloy,174,3,177
24,Centre,41,1,13,002,Angé,799,18,817
24,Centre,41,2,28,003,Areines,585,222,807
24,Centre,41,2,12,004,Artins,290,11,301
24,Centre,41,2,11,005,Arville,119,4,123
24,Centre,41,1,08,006,Autainville,359,14,373
24,Centre,41,2,19,007,Authon,624,20,644
24,Centre,41,1,10,008,Avaray,737,11,748
24,Centre,41,1,06,009,Averdon,712,14,726
24,Centre,41,2,24,010,Azé,1119,18,1137
24,Centre,41,2,23,011,Baigneaux,52,2,54
24,Centre,41,2,11,012,Baillou,248,6,254
24,Centre,41,1,03,013,Bauzy,263,3,266
24,Centre,41,2,11,014,Beauchêne,163,2,165
24,Centre,41,1,08,015,Beauvilliers,58,1,59
24,Centre,41,3,22,016,Billy,798,27,825
24,Centre,41,1,16,017,Binas,717,15,732
24,Centre,41,1,99,018,Blois,46834,2198,49032
24,Centre,41,1,08,019,Boisseau,98,3,101
24,Centre,41,2,21,020,Bonneveau,510,16,526
24,Centre,41,2,05,022,Bouffry,147,2,149
24,Centre,41,1,13,023,Bourré,752,12,764
24,Centre,41,2,05,024,Boursay,218,11,229
24,Centre,41,1,03,025,Bracieux,1258,32,1290
24,Centre,41,2,14,026,Brévainville,172,2,174
24,Centre,41,1,08,027,Briou,112,3,115
24,Centre,41,2,14,028,Busloup,443,9,452
24,Centre,41,1,04,029,Candé-sur-Beuvron,1471,33,1504
24,Centre,41,2,21,030,Cellé,257,8,265
24,Centre,41,1,02,031,Cellettes,2266,66,2332
24,Centre,41,1,02,032,Chailles,2477,44,2521
24,Centre,41,1,06,033,Chambon-sur-Cisse,698,43,741
24,Centre,41,1,03,034,Chambord,145,9,154
24,Centre,41,1,06,035,Champigny-en-Beauce,653,19,672
24,Centre,41,3,07,036,Chaon,435,17,452
24,Centre,41,2,23,037,La Chapelle-Enchérie,165,6,171
24,Centre,41,3,09,038,La Chapelle-Montmartin,402,7,409
24,Centre,41,1,10,039,La Chapelle-Saint-Martin-en-Plaine,637,21,658
24,Centre,41,1,06,040,La Chapelle-Vendômoise,748,22,770
24,Centre,41,2,05,041,La Chapelle-Vicomtesse,185,6,191
24,Centre,41,3,18,042,Châteauvieux,546,13,559
24,Centre,41,3,18,043,Châtillon-sur-Cher,1639,46,1685
24,Centre,41,3,09,044,Châtres-sur-Cher,1071,13,1084
24,Centre,41,1,13,045,Chaumont-sur-Loire,1019,19,1038
24,Centre,41,3,07,046,Chaumont-sur-Tharonne,1076,33,1109
24,Centre,41,1,01,047,La Chaussée-Saint-Victor,4185,127,4312
24,Centre,41,2,05,048,Chauvigny-du-Perche,227,7,234
24,Centre,41,3,18,049,Chémery,924,65,989
24,Centre,41,1,04,050,Cheverny,936,27,963
24,Centre,41,1,13,051,Chissay-en-Touraine,1113,40,1153
24,Centre,41,1,04,052,Chitenay,1020,28,1048
24,Centre,41,2,11,053,Choue,530,10,540
24,Centre,41,3,18,054,Choussy,320,5,325
24,Centre,41,1,06,055,Chouzy-sur-Cisse,1839,71,1910
24,Centre,41,1,16,056,La Colombe,183,7,190
24,Centre,41,1,08,057,Conan,192,1,193
24,Centre,41,1,08,058,Concriers,159,3,162
24,Centre,41,1,04,059,Contres,3407,86,3493
24,Centre,41,2,11,060,Cormenon,690,14,704
24,Centre,41,1,04,061,Cormeray,1422,23,1445
24,Centre,41,3,18,062,Couddes,516,4,520
24,Centre,41,3,18,063,Couffy,560,23,583
24,Centre,41,1,06,064,Coulanges,307,3,310
24,Centre,41,2,23,065,Coulommiers-la-Tour,526,14,540
24,Centre,41,1,04,067,Cour-Cheverny,2676,90,2766
24,Centre,41,1,10,069,Cour-sur-Loire,280,13,293
24,Centre,41,1,10,066,Courbouzon,471,7,478
24,Centre,41,3,17,068,Courmemin,521,8,529
24,Centre,41,2,12,070,Couture-sur-Loir,425,5,430
24,Centre,41,1,03,071,Crouy-sur-Cosson,506,45,551
24,Centre,41,2,19,072,Crucheray,395,12,407
24,Centre,41,2,14,073,Danzé,729,20,749
24,Centre,41,3,15,074,Dhuizon,1398,21,1419
24,Centre,41,2,05,075,Droué,1097,19,1116
24,Centre,41,2,23,077,Épiais,124,3,127
24,Centre,41,2,21,078,Épuisay,700,15,715
24,Centre,41,2,12,079,Les Essarts,103,3,106
24,Centre,41,1,13,080,Faverolles-sur-Cher,1266,66,1332
24,Centre,41,2,23,081,Faye,201,1,202
24,Centre,41,1,04,082,Feings,665,11,676
24,Centre,41,3,15,083,La Ferté-Beauharnais,519,6,525
24,Centre,41,3,20,084,La Ferté-Imbault,966,19,985
24,Centre,41,3,15,085,La Ferté-Saint-Cyr,975,29,1004
24,Centre,41,2,21,087,Fontaine-les-Coteaux,383,14,397
24,Centre,41,2,05,088,Fontaine-Raoul,227,4,231
24,Centre,41,1,03,086,Fontaines-en-Sologne,598,7,605
24,Centre,41,2,05,089,La Fontenelle,187,9,196
24,Centre,41,2,21,090,Fortan,260,8,268
24,Centre,41,1,27,091,Fossé,981,19,1000
24,Centre,41,1,04,092,Fougères-sur-Bièvre,763,49,812
24,Centre,41,1,06,093,Françay,293,8,301
24,Centre,41,1,04,094,Fresnes,986,26,1012
24,Centre,41,2,14,095,Fréteval,1047,14,1061
24,Centre,41,2,05,096,Le Gault-Perche,259,8,267
24,Centre,41,3,22,097,Gièvres,2217,48,2265
24,Centre,41,2,19,098,Gombergean,166,3,169
24,Centre,41,3,22,099,Gy-en-Sologne,513,4,517
24,Centre,41,2,12,100,Les Hayes,194,6,200
24,Centre,41,1,06,101,Herbault,1222,74,1296
24,Centre,41,2,12,102,Houssay,368,4,372
24,Centre,41,2,19,103,Huisseau-en-Beauce,406,11,417
24,Centre,41,1,03,104,Huisseau-sur-Cosson,2113,54,2167
24,Centre,41,1,08,105,Josnes,925,14,939
24,Centre,41,3,07,106,Lamotte-Beuvron,4610,94,4704
24,Centre,41,2,19,107,Lancé,437,7,444
24,Centre,41,1,06,108,Lancôme,145,1,146
24,Centre,41,1,06,109,Landes-le-Gaulois,669,15,684
24,Centre,41,3,09,110,Langon,837,15,852
24,Centre,41,3,22,112,Lassay-sur-Croisne,234,9,243
24,Centre,41,2,12,113,Lavardin,217,5,222
24,Centre,41,1,10,114,Lestiou,255,8,263
24,Centre,41,2,14,115,Lignières,402,13,415
24,Centre,41,2,14,116,Lisle,217,5,222
24,Centre,41,3,29,118,Loreux,245,9,254
24,Centre,41,1,08,119,Lorges,355,6,361
24,Centre,41,2,21,120,Lunay,1344,40,1384
24,Centre,41,1,08,121,La Madeleine-Villefrouin,24,3,27
24,Centre,41,3,09,122,Maray,229,5,234
24,Centre,41,1,08,123,Marchenoir,692,6,698
24,Centre,41,2,28,124,Marcilly-en-Beauce,362,5,367
24,Centre,41,3,20,125,Marcilly-en-Gault,742,21,763
24,Centre,41,3,18,126,Mareuil-sur-Cher,1079,48,1127
24,Centre,41,3,15,127,La Marolle-en-Sologne,391,4,395
24,Centre,41,1,27,128,Marolles,691,18,709
24,Centre,41,1,03,129,Maslives,646,14,660
24,Centre,41,1,10,130,Maves,614,10,624
24,Centre,41,2,24,131,Mazangé,915,26,941
24,Centre,41,3,18,132,Méhers,312,7,319
24,Centre,41,1,16,133,Membrolles,251,9,260
24,Centre,41,1,10,134,Menars,611,40,651
24,Centre,41,3,09,135,Mennetou-sur-Cher,874,17,891
24,Centre,41,1,10,136,Mer,5949,134,6083
24,Centre,41,1,06,137,Mesland,547,14,561
24,Centre,41,2,28,138,Meslay,294,15,309
24,Centre,41,3,18,139,Meusnes,1023,18,1041
24,Centre,41,3,17,140,Millançay,757,12,769
24,Centre,41,1,16,141,Moisy,301,6,307
24,Centre,41,1,06,142,Molineuf,800,35,835
24,Centre,41,2,11,143,Mondoubleau,1496,37,1533
24,Centre,41,1,03,150,Mont-près-Chambord,3296,107,3403
24,Centre,41,1,06,144,Monteaux,768,23,791
24,Centre,41,1,04,145,Monthou-sur-Bièvre,709,16,725
24,Centre,41,1,13,146,Monthou-sur-Cher,948,17,965
24,Centre,41,1,04,147,Les Montils,1670,45,1715
24,Centre,41,1,30,148,Montlivault,1327,31,1358
24,Centre,41,2,12,149,Montoire-sur-le-Loir,4087,218,4305
24,Centre,41,1,13,151,Montrichard,3430,69,3499
24,Centre,41,3,15,152,Montrieux-en-Sologne,620,5,625
24,Centre,41,2,12,153,Montrouveau,124,1,125
24,Centre,41,2,14,154,Morée,1093,23,1116
24,Centre,41,1,03,155,Muides-sur-Loire,1336,31,1367
24,Centre,41,1,10,156,Mulsans,436,10,446
24,Centre,41,3,22,157,Mur-de-Sologne,1347,19,1366
24,Centre,41,2,24,158,Naveil,2072,68,2140
24,Centre,41,3,15,159,Neung-sur-Beuvron,1208,30,1238
24,Centre,41,1,03,160,Neuvy,329,4,333
24,Centre,41,3,07,161,Nouan-le-Fuzelier,2496,80,2576
24,Centre,41,2,19,163,Nourray,113,9,122
24,Centre,41,3,18,164,Noyers-sur-Cher,2833,131,2964
24,Centre,41,2,11,165,Oigny,93,2,95
24,Centre,41,1,04,166,Oisly,337,8,345
24,Centre,41,1,06,167,Onzain,3432,159,3591
24,Centre,41,1,06,169,Orchaise,890,28,918
24,Centre,41,3,20,168,Orçay,235,2,237
24,Centre,41,1,04,170,Ouchamps,815,24,839
24,Centre,41,1,08,171,Oucques,1459,29,1488
24,Centre,41,1,16,172,Ouzouer-le-Doyen,215,2,217
24,Centre,41,1,16,173,Ouzouer-le-Marché,1800,61,1861
24,Centre,41,2,23,174,Périgny,198,9,207
24,Centre,41,2,14,175,Pezou,1114,25,1139
24,Centre,41,3,20,176,Pierrefitte-sur-Sauldre,853,11,864
24,Centre,41,2,11,177,Le Plessis-Dorin,187,3,190
24,Centre,41,1,08,178,Le Plessis-l'Échelle,70,1,71
24,Centre,41,2,05,179,Le Poislay,212,0,212
24,Centre,41,1,13,180,Pontlevoy,1564,130,1694
24,Centre,41,3,18,181,Pouillé,802,22,824
24,Centre,41,2,23,182,Pray,290,4,294
24,Centre,41,1,16,183,Prénouvellon,220,10,230
24,Centre,41,2,19,184,Prunay-Cassereau,644,24,668
24,Centre,41,3,29,185,Pruniers-en-Sologne,2288,58,2346
24,Centre,41,2,14,186,Rahart,270,7,277
24,Centre,41,2,23,187,Renay,172,5,177
24,Centre,41,2,23,188,Rhodon,98,4,102
24,Centre,41,1,13,189,Rilly-sur-Loire,449,8,457
24,Centre,41,2,23,190,Rocé,181,6,187
24,Centre,41,1,08,191,Roches,73,2,75
24,Centre,41,2,12,192,Les Roches-l'Évêque,299,10,309
24,Centre,41,2,05,193,Romilly,131,7,138
24,Centre,41,3,97,194,Romorantin-Lanthenay,17395,683,18078
24,Centre,41,3,22,195,Rougeou,120,1,121
24,Centre,41,2,05,196,Ruan-sur-Egvonne,89,0,89
24,Centre,41,2,11,197,Saint-Agil,275,5,280
24,Centre,41,3,18,198,Saint-Aignan,3162,144,3306
24,Centre,41,2,19,199,Saint-Amand-Longpré,1194,23,1217
24,Centre,41,2,12,201,Saint-Arnoult,328,5,333
24,Centre,41,2,11,202,Saint-Avit,110,6,116
24,Centre,41,1,27,203,Saint-Bohaire,377,31,408
24,Centre,41,1,30,204,Saint-Claude-de-Diray,1660,67,1727
24,Centre,41,1,06,205,Saint-Cyr-du-Gault,179,4,183
24,Centre,41,1,01,206,Saint-Denis-sur-Loire,835,35,870
24,Centre,41,1,03,207,Saint-Dyé-sur-Loire,1104,23,1127
24,Centre,41,1,06,208,Saint-Étienne-des-Guérets,99,3,102
24,Centre,41,2,14,209,Saint-Firmin-des-Prés,789,73,862
24,Centre,41,1,13,211,Saint-Georges-sur-Cher,2343,77,2420
24,Centre,41,1,02,212,Saint-Gervais-la-Forêt,3355,126,3481
24,Centre,41,2,19,213,Saint-Gourgon,122,0,122
24,Centre,41,2,14,214,Saint-Hilaire-la-Gravelle,690,11,701
24,Centre,41,2,12,215,Saint-Jacques-des-Guérets,88,4,92
24,Centre,41,2,14,216,Saint-Jean-Froidmentel,500,9,509
24,Centre,41,1,13,217,Saint-Julien-de-Chédon,724,14,738
24,Centre,41,3,09,218,Saint-Julien-sur-Cher,754,17,771
24,Centre,41,1,08,219,Saint-Laurent-des-Bois,268,8,276
24,Centre,41,1,03,220,Saint-Laurent-Nouan,4190,102,4292
24,Centre,41,1,08,221,Saint-Léonard-en-Beauce,613,18,631
24,Centre,41,3,09,222,Saint-Loup,337,11,348
24,Centre,41,1,27,223,Saint-Lubin-en-Vergonnois,685,21,706
24,Centre,41,2,11,224,Saint-Marc-du-Cor,185,4,189
24,Centre,41,2,12,225,Saint-Martin-des-Bois,589,19,608
24,Centre,41,2,28,226,Saint-Ouen,3453,98,3551
24,Centre,41,2,12,228,Saint-Rimay,291,9,300
24,Centre,41,3,18,229,Saint-Romain-sur-Cher,1468,30,1498
24,Centre,41,1,27,230,Saint-Sulpice-de-Pommeray,1811,56,1867
24,Centre,41,3,20,231,Saint-Viâtre,1282,17,1299
24,Centre,41,2,28,200,Sainte-Anne,367,13,380
24,Centre,41,2,23,210,Sainte-Gemmes,100,4,104
24,Centre,41,3,20,232,Salbris,5724,132,5856
24,Centre,41,1,04,233,Sambin,892,24,916
24,Centre,41,1,06,234,Santenay,266,4,270
24,Centre,41,2,11,235,Sargé-sur-Braye,935,35,970
24,Centre,41,2,19,236,Sasnières,100,2,102
24,Centre,41,1,04,237,Sassay,882,16,898
24,Centre,41,2,21,238,Savigny-sur-Braye,2195,34,2229
24,Centre,41,3,18,239,Seigy,1109,20,1129
24,Centre,41,1,06,240,Seillac,79,4,83
24,Centre,41,3,20,241,Selles-Saint-Denis,1210,41,1251
24,Centre,41,3,22,242,Selles-sur-Cher,4599,112,4711
24,Centre,41,2,23,243,Selommes,858,17,875
24,Centre,41,1,16,244,Semerville,97,1,98
24,Centre,41,1,08,245,Séris,368,3,371
24,Centre,41,1,04,246,Seur,459,13,472
24,Centre,41,3,22,247,Soings-en-Sologne,1506,29,1535
24,Centre,41,2,11,248,Souday,537,7,544
24,Centre,41,3,20,249,Souesmes,1116,33,1149
24,Centre,41,2,21,250,Sougé,480,3,483
24,Centre,41,3,07,251,Souvigny-en-Sologne,489,13,502
24,Centre,41,1,10,252,Suèvres,1464,39,1503
24,Centre,41,1,08,253,Talcy,251,8,259
24,Centre,41,2,11,254,Le Temple,179,4,183
24,Centre,41,2,12,255,Ternay,301,7,308
24,Centre,41,3,20,256,Theillay,1260,26,1286
24,Centre,41,1,13,257,Thenay,847,11,858
24,Centre,41,3,18,258,Thésée,1194,39,1233
24,Centre,41,2,24,259,Thoré-la-Rochette,911,27,938
24,Centre,41,3,15,260,Thoury,383,4,387
24,Centre,41,1,03,262,Tour-en-Sologne,897,10,907
24,Centre,41,2,23,261,Tourailles,137,5,142
24,Centre,41,2,12,263,Tréhet,104,0,104
24,Centre,41,1,16,264,Tripleville,140,3,143
24,Centre,41,2,12,265,Troo,329,4,333
24,Centre,41,1,04,266,Valaire,84,3,87
24,Centre,41,1,13,267,Vallières-les-Grandes,808,13,821
24,Centre,41,3,17,268,Veilleins,138,3,141
24,Centre,41,2,98,269,Vendôme,16669,696,17365
24,Centre,41,1,16,270,Verdes,503,9,512
24,Centre,41,3,17,271,Vernou-en-Sologne,592,8,600
24,Centre,41,1,06,272,Veuves,220,15,235
24,Centre,41,1,16,273,Vievy-le-Rayé,495,12,507
24,Centre,41,2,12,274,Villavard,148,4,152
24,Centre,41,2,14,275,La Ville-aux-Clercs,1313,27,1340
24,Centre,41,1,01,276,Villebarou,2587,49,2636
24,Centre,41,2,05,277,Villebout,136,1,137
24,Centre,41,2,19,278,Villechauve,287,6,293
24,Centre,41,2,12,279,Villedieu-le-Château,409,7,416
24,Centre,41,3,09,280,Villefranche-sur-Cher,2647,90,2737
24,Centre,41,1,06,281,Villefrancoeur,473,13,486
24,Centre,41,3,29,282,Villeherviers,487,9,496
24,Centre,41,2,23,283,Villemardy,275,7,282
24,Centre,41,1,08,284,Villeneuve-Frouville,72,1,73
24,Centre,41,3,15,285,Villeny,380,3,383
24,Centre,41,2,19,286,Villeporcher,148,1,149
24,Centre,41,2,28,287,Villerable,509,12,521
24,Centre,41,1,01,288,Villerbon,765,22,787
24,Centre,41,1,16,289,Villermain,322,10,332
24,Centre,41,2,23,290,Villeromain,215,3,218
24,Centre,41,2,23,291,Villetrun,298,13,311
24,Centre,41,1,10,292,Villexanton,199,7,206
24,Centre,41,2,24,294,Villiers-sur-Loir,1211,51,1262
24,Centre,41,2,28,293,Villiersfaux,255,9,264
24,Centre,41,1,30,295,Vineuil,7026,197,7223
24,Centre,41,3,07,296,Vouzon,1458,50,1508
24,Centre,41,3,07,297,Yvoy-le-Marron,609,7,616
82,Rhône-Alpes,42,1,17,001,Aboën,294,10,304
82,Rhône-Alpes,42,1,02,002,Ailleux,151,6,157
82,Rhône-Alpes,42,2,27,003,Ambierle,1826,53,1879
82,Rhône-Alpes,42,2,26,004,Amions,292,12,304
82,Rhône-Alpes,42,1,23,005,Andrézieux-Bouthéon,9591,220,9811
82,Rhône-Alpes,42,1,17,006,Apinac,384,10,394
82,Rhône-Alpes,42,2,01,007,Arcinges,185,3,188
82,Rhône-Alpes,42,2,27,008,Arcon,102,2,104
82,Rhône-Alpes,42,1,02,009,Arthun,489,14,503
82,Rhône-Alpes,42,1,23,010,Aveizieux,1378,30,1408
82,Rhône-Alpes,42,2,10,011,Balbigny,2721,40,2761
82,Rhône-Alpes,42,1,09,012,Bard,625,24,649
82,Rhône-Alpes,42,1,23,013,Bellegarde-en-Forez,1820,39,1859
82,Rhône-Alpes,42,2,01,014,Belleroche,261,3,264
82,Rhône-Alpes,42,2,01,015,Belmont-de-la-Loire,1517,37,1554
82,Rhône-Alpes,42,2,16,016,La Bénisson-Dieu,444,11,455
82,Rhône-Alpes,42,3,24,017,Le Bessat,437,12,449
82,Rhône-Alpes,42,3,13,018,Bessey,387,9,396
82,Rhône-Alpes,42,1,02,019,Boën,3138,72,3210
82,Rhône-Alpes,42,1,31,020,Boisset-lès-Montrond,1057,13,1070
82,Rhône-Alpes,42,1,29,021,Boisset-Saint-Priest,1074,17,1091
82,Rhône-Alpes,42,1,31,022,Bonson,3680,56,3736
82,Rhône-Alpes,42,3,03,023,Bourg-Argental,2972,70,3042
82,Rhône-Alpes,42,2,05,025,Boyer,206,4,210
82,Rhône-Alpes,42,2,16,026,Briennon,1715,40,1755
82,Rhône-Alpes,42,2,26,027,Bully,387,7,394
82,Rhône-Alpes,42,3,03,028,Burdignes,354,16,370
82,Rhône-Alpes,42,2,10,029,Bussières,1482,16,1498
82,Rhône-Alpes,42,1,02,030,Bussy-Albieux,475,17,492
82,Rhône-Alpes,42,3,08,031,Caloire,327,9,336
82,Rhône-Alpes,42,3,33,032,Cellieu,1526,55,1581
82,Rhône-Alpes,42,2,01,033,Le Cergne,709,15,724
82,Rhône-Alpes,42,1,11,034,Cervières,124,5,129
82,Rhône-Alpes,42,1,02,035,Cezay,194,7,201
82,Rhône-Alpes,42,3,33,036,Chagnon,522,2,524
82,Rhône-Alpes,42,1,09,037,Chalain-d'Uzore,538,11,549
82,Rhône-Alpes,42,1,09,038,Chalain-le-Comtal,608,15,623
82,Rhône-Alpes,42,1,25,039,Chalmazel,437,9,446
82,Rhône-Alpes,42,1,11,040,La Chamba,54,2,56
82,Rhône-Alpes,42,1,07,041,Chambéon,462,12,474
82,Rhône-Alpes,42,1,31,042,Chambles,933,23,956
82,Rhône-Alpes,42,1,23,043,Chamboeuf,1568,45,1613
82,Rhône-Alpes,42,3,04,044,Le Chambon-Feugerolles,12992,163,13155
82,Rhône-Alpes,42,1,11,045,La Chambonie,62,0,62
82,Rhône-Alpes,42,1,09,046,Champdieu,1656,45,1701
82,Rhône-Alpes,42,2,30,047,Champoly,276,6,282
82,Rhône-Alpes,42,2,05,048,Chandon,1460,40,1500
82,Rhône-Alpes,42,2,12,049,Changy,616,11,627
82,Rhône-Alpes,42,1,29,050,La Chapelle-en-Lafaye,120,0,120
82,Rhône-Alpes,42,3,13,051,La Chapelle-Villars,558,7,565
82,Rhône-Alpes,42,2,05,052,Charlieu,3652,139,3791
82,Rhône-Alpes,42,3,15,053,Châteauneuf,1470,22,1492
82,Rhône-Alpes,42,1,25,054,Châtelneuf,316,3,319
82,Rhône-Alpes,42,1,06,055,Châtelus,123,1,124
82,Rhône-Alpes,42,2,30,339,Chausseterre,248,4,252
82,Rhône-Alpes,42,3,13,056,Chavanay,2790,57,2847
82,Rhône-Alpes,42,1,29,058,Chazelles-sur-Lavieu,242,5,247
82,Rhône-Alpes,42,1,06,059,Chazelles-sur-Lyon,5080,93,5173
82,Rhône-Alpes,42,1,29,060,Chenereilles,460,6,466
82,Rhône-Alpes,42,2,30,061,Cherier,470,7,477
82,Rhône-Alpes,42,1,06,062,Chevrières,1034,19,1053
82,Rhône-Alpes,42,2,32,063,Chirassimont,374,12,386
82,Rhône-Alpes,42,3,13,064,Chuyer,737,20,757
82,Rhône-Alpes,42,1,07,065,Civens,1367,42,1409
82,Rhône-Alpes,42,1,07,066,Cleppé,551,24,575
82,Rhône-Alpes,42,3,03,067,Colombier,306,4,310
82,Rhône-Alpes,42,2,14,068,Combre,378,6,384
82,Rhône-Alpes,42,2,14,069,Commelle-Vernay,2809,104,2913
82,Rhône-Alpes,42,2,32,070,Cordelle,901,24,925
82,Rhône-Alpes,42,1,11,072,La Côte-en-Couzan,71,8,79
82,Rhône-Alpes,42,2,14,071,Le Coteau,6977,190,7167
82,Rhône-Alpes,42,1,07,073,Cottance,638,15,653
82,Rhône-Alpes,42,2,14,074,Coutouvre,1106,14,1120
82,Rhône-Alpes,42,1,31,075,Craintilleux,1134,9,1143
82,Rhône-Alpes,42,2,30,076,Cremeaux,945,12,957
82,Rhône-Alpes,42,2,32,077,Croizet-sur-Gand,266,8,274
82,Rhône-Alpes,42,2,12,078,Le Crozet,290,1,291
82,Rhône-Alpes,42,2,01,079,Cuinzier,622,11,633
82,Rhône-Alpes,42,1,23,081,Cuzieu,1494,23,1517
82,Rhône-Alpes,42,2,26,082,Dancé,149,11,160
82,Rhône-Alpes,42,3,15,083,Dargoire,421,10,431
82,Rhône-Alpes,42,1,02,084,Débats-Rivière-d'Orpra,147,2,149
82,Rhône-Alpes,42,3,33,085,Doizieux,805,13,818
82,Rhône-Alpes,42,2,01,086,Écoche,534,3,537
82,Rhône-Alpes,42,1,09,087,Écotay-l'Olme,1103,51,1154
82,Rhône-Alpes,42,1,07,088,Épercieux-Saint-Paul,653,15,668
82,Rhône-Alpes,42,1,09,089,Essertines-en-Châtelneuf,632,17,649
82,Rhône-Alpes,42,1,07,090,Essertines-en-Donzy,479,11,490
82,Rhône-Alpes,42,1,17,091,Estivareilles,653,14,667
82,Rhône-Alpes,42,3,28,092,L' Étrat,2663,95,2758
82,Rhône-Alpes,42,3,33,093,Farnay,1286,20,1306
82,Rhône-Alpes,42,1,07,094,Feurs,7561,214,7775
82,Rhône-Alpes,42,3,08,095,Firminy,17513,241,17754
82,Rhône-Alpes,42,3,28,096,Fontanès,630,11,641
82,Rhône-Alpes,42,3,28,097,La Fouillouse,4390,87,4477
82,Rhône-Alpes,42,2,32,098,Fourneaux,628,21,649
82,Rhône-Alpes,42,3,08,099,Fraisses,4068,60,4128
82,Rhône-Alpes,42,3,15,225,Genilac,3668,143,3811
82,Rhône-Alpes,42,1,06,100,La Gimond,251,1,252
82,Rhône-Alpes,42,3,03,101,Graix,147,1,148
82,Rhône-Alpes,42,1,06,102,Grammond,819,17,836
82,Rhône-Alpes,42,3,33,103,La Grand-Croix,5064,81,5145
82,Rhône-Alpes,42,2,01,104,La Gresle,805,25,830
82,Rhône-Alpes,42,1,09,105,Grézieux-le-Fromental,108,5,113
82,Rhône-Alpes,42,2,26,106,Grézolles,279,4,283
82,Rhône-Alpes,42,1,29,107,Gumières,294,6,300
82,Rhône-Alpes,42,1,09,108,L' Hôpital-le-Grand,918,18,936
82,Rhône-Alpes,42,1,02,109,L' Hôpital-sous-Rochefort,108,3,111
82,Rhône-Alpes,42,3,33,110,L' Horme,4742,69,4811
82,Rhône-Alpes,42,2,05,112,Jarnosse,409,6,415
82,Rhône-Alpes,42,1,07,113,Jas,198,7,205
82,Rhône-Alpes,42,1,25,114,Jeansagnière,86,3,89
82,Rhône-Alpes,42,3,24,115,Jonzieux,1239,16,1255
82,Rhône-Alpes,42,2,30,116,Juré,252,6,258
82,Rhône-Alpes,42,1,29,117,Lavieu,95,2,97
82,Rhône-Alpes,42,2,32,118,Lay,700,26,726
82,Rhône-Alpes,42,1,02,119,Leigneux,360,12,372
82,Rhône-Alpes,42,2,34,120,Lentigny,1470,44,1514
82,Rhône-Alpes,42,1,09,121,Lérigneux,149,1,150
82,Rhône-Alpes,42,1,09,122,Lézigneux,1616,54,1670
82,Rhône-Alpes,42,3,33,123,Lorette,4451,62,4513
82,Rhône-Alpes,42,3,13,124,Lupé,309,16,325
82,Rhône-Alpes,42,2,26,125,Luré,142,1,143
82,Rhône-Alpes,42,1,29,126,Luriecq,1032,18,1050
82,Rhône-Alpes,42,2,16,127,Mably,7445,194,7639
82,Rhône-Alpes,42,2,32,128,Machézal,411,13,424
82,Rhône-Alpes,42,3,13,129,Maclas,1619,30,1649
82,Rhône-Alpes,42,1,09,130,Magneux-Haute-Rive,415,10,425
82,Rhône-Alpes,42,2,05,131,Maizilly,327,7,334
82,Rhône-Alpes,42,3,13,132,Malleval,539,18,557
82,Rhône-Alpes,42,3,28,133,Marcenod,625,7,632
82,Rhône-Alpes,42,1,02,134,Marcilly-le-Châtel,1229,30,1259
82,Rhône-Alpes,42,1,07,135,Marclopt,487,13,500
82,Rhône-Alpes,42,1,02,136,Marcoux,685,17,702
82,Rhône-Alpes,42,1,29,137,Margerie-Chantagret,661,6,667
82,Rhône-Alpes,42,1,06,138,Maringes,620,30,650
82,Rhône-Alpes,42,3,24,139,Marlhes,1382,83,1465
82,Rhône-Alpes,42,1,29,140,Marols,375,7,382
82,Rhône-Alpes,42,2,05,141,Mars,549,18,567
82,Rhône-Alpes,42,1,17,142,Merle-Leignec,300,7,307
82,Rhône-Alpes,42,1,07,143,Mizérieux,322,12,334
82,Rhône-Alpes,42,2,14,145,Montagny,1116,21,1137
82,Rhône-Alpes,42,1,29,146,Montarcher,63,1,64
82,Rhône-Alpes,42,1,09,147,Montbrison,14931,653,15584
82,Rhône-Alpes,42,1,07,148,Montchal,455,12,467
82,Rhône-Alpes,42,1,23,149,Montrond-les-Bains,4652,107,4759
82,Rhône-Alpes,42,1,02,150,Montverdun,1010,17,1027
82,Rhône-Alpes,42,1,09,151,Mornand-en-Forez,420,87,507
82,Rhône-Alpes,42,2,05,152,Nandax,498,265,763
82,Rhône-Alpes,42,2,32,153,Neaux,488,6,494
82,Rhône-Alpes,42,2,10,154,Néronde,463,67,530
82,Rhône-Alpes,42,1,07,155,Nervieux,896,11,907
82,Rhône-Alpes,42,2,32,156,Neulise,1260,25,1285
82,Rhône-Alpes,42,2,27,157,Noailly,756,16,772
82,Rhône-Alpes,42,2,27,158,Les Noës,172,6,178
82,Rhône-Alpes,42,1,11,159,Noirétable,1704,98,1802
82,Rhône-Alpes,42,2,26,160,Nollieux,151,7,158
82,Rhône-Alpes,42,2,14,161,Notre-Dame-de-Boisset,536,21,557
82,Rhône-Alpes,42,2,34,162,Ouches,1130,33,1163
82,Rhône-Alpes,42,2,12,163,La Pacaudière,1091,30,1121
82,Rhône-Alpes,42,1,25,164,Palogneux,59,2,61
82,Rhône-Alpes,42,1,07,165,Panissières,2906,93,2999
82,Rhône-Alpes,42,2,14,166,Parigny,579,15,594
82,Rhône-Alpes,42,3,15,167,Pavezin,291,5,296
82,Rhône-Alpes,42,3,13,168,Pélussin,3464,80,3544
82,Rhône-Alpes,42,1,31,169,Périgneux,1305,27,1332
82,Rhône-Alpes,42,2,14,170,Perreux,2157,196,2353
82,Rhône-Alpes,42,2,10,171,Pinay,275,8,283
82,Rhône-Alpes,42,3,24,172,Planfoy,907,30,937
82,Rhône-Alpes,42,2,26,173,Pommiers,383,5,388
82,Rhône-Alpes,42,1,07,174,Poncins,857,29,886
82,Rhône-Alpes,42,1,07,175,Pouilly-lès-Feurs,1112,32,1144
82,Rhône-Alpes,42,2,34,176,Pouilly-les-Nonains,1761,69,1830
82,Rhône-Alpes,42,2,05,177,Pouilly-sous-Charlieu,2619,61,2680
82,Rhône-Alpes,42,2,32,178,Pradines,644,10,654
82,Rhône-Alpes,42,1,02,179,Pralong,846,19,865
82,Rhône-Alpes,42,1,09,180,Précieux,1010,123,1133
82,Rhône-Alpes,42,2,32,181,Régny,1515,25,1540
82,Rhône-Alpes,42,2,27,182,Renaison,2825,109,2934
82,Rhône-Alpes,42,3,04,183,La Ricamarie,7949,72,8021
82,Rhône-Alpes,42,2,34,184,Riorges,10481,277,10758
82,Rhône-Alpes,42,1,23,185,Rivas,504,4,508
82,Rhône-Alpes,42,3,15,186,Rive-de-Gier,14831,165,14996
82,Rhône-Alpes,42,2,98,187,Roanne,35936,1407,37343
82,Rhône-Alpes,42,1,09,188,Roche,270,2,272
82,Rhône-Alpes,42,3,22,189,Roche-la-Molière,10248,144,10392
82,Rhône-Alpes,42,3,13,191,Roisey,869,8,877
82,Rhône-Alpes,42,1,17,192,Rozier-Côtes-d'Aurec,426,7,433
82,Rhône-Alpes,42,1,07,193,Rozier-en-Donzy,1350,30,1380
82,Rhône-Alpes,42,2,12,194,Sail-les-Bains,217,4,221
82,Rhône-Alpes,42,1,25,195,Sail-sous-Couzan,963,8,971
82,Rhône-Alpes,42,2,27,198,Saint-Alban-les-Eaux,929,47,976
82,Rhône-Alpes,42,2,27,199,Saint-André-d'Apchon,1867,54,1921
82,Rhône-Alpes,42,1,23,200,Saint-André-le-Puy,1235,22,1257
82,Rhône-Alpes,42,3,13,201,Saint-Appolinard,605,14,619
82,Rhône-Alpes,42,1,07,202,Saint-Barthélemy-Lestra,691,18,709
82,Rhône-Alpes,42,2,12,203,Saint-Bonnet-des-Quarts,335,6,341
82,Rhône-Alpes,42,1,17,204,Saint-Bonnet-le-Château,1519,56,1575
82,Rhône-Alpes,42,1,25,205,Saint-Bonnet-le-Courreau,734,20,754
82,Rhône-Alpes,42,1,23,206,Saint-Bonnet-les-Oules,1499,48,1547
82,Rhône-Alpes,42,3,97,207,Saint-Chamond,35516,664,36180
82,Rhône-Alpes,42,3,28,208,Saint-Christo-en-Jarez,1766,33,1799
82,Rhône-Alpes,42,1,31,211,Saint-Cyprien,2360,47,2407
82,Rhône-Alpes,42,2,32,212,Saint-Cyr-de-Favières,806,32,838
82,Rhône-Alpes,42,2,10,213,Saint-Cyr-de-Valorges,347,4,351
82,Rhône-Alpes,42,1,07,214,Saint-Cyr-les-Vignes,927,38,965
82,Rhône-Alpes,42,2,05,215,Saint-Denis-de-Cabanne,1294,26,1320
82,Rhône-Alpes,42,1,06,216,Saint-Denis-sur-Coise,563,31,594
82,Rhône-Alpes,42,1,11,217,Saint-Didier-sur-Rochefort,426,11,437
82,Rhône-Alpes,42,3,99,218,Saint-Étienne,172696,3244,175940
82,Rhône-Alpes,42,1,02,219,Saint-Étienne-le-Molard,907,26,933
82,Rhône-Alpes,42,2,12,220,Saint-Forgeux-Lespinasse,500,12,512
82,Rhône-Alpes,42,1,23,222,Saint-Galmier,5607,200,5807
82,Rhône-Alpes,42,3,22,223,Saint-Genest-Lerpt,5582,149,5731
82,Rhône-Alpes,42,3,24,224,Saint-Genest-Malifaux,2901,109,3010
82,Rhône-Alpes,42,2,26,226,Saint-Georges-de-Baroille,305,7,312
82,Rhône-Alpes,42,1,25,227,Saint-Georges-en-Couzan,419,15,434
82,Rhône-Alpes,42,1,29,228,Saint-Georges-Haute-Ville,1241,25,1266
82,Rhône-Alpes,42,2,01,229,Saint-Germain-la-Montagne,212,6,218
82,Rhône-Alpes,42,2,26,230,Saint-Germain-Laval,1624,24,1648
82,Rhône-Alpes,42,2,27,231,Saint-Germain-Lespinasse,1157,58,1215
82,Rhône-Alpes,42,2,27,232,Saint-Haon-le-Châtel,583,31,614
82,Rhône-Alpes,42,2,27,233,Saint-Haon-le-Vieux,889,34,923
82,Rhône-Alpes,42,3,28,234,Saint-Héand,3671,87,3758
82,Rhône-Alpes,42,1,17,235,Saint-Hilaire-Cusson-la-Valmitte,323,2,325
82,Rhône-Alpes,42,2,05,236,Saint-Hilaire-sous-Charlieu,518,26,544
82,Rhône-Alpes,42,3,20,237,Saint-Jean-Bonnefonds,6151,85,6236
82,Rhône-Alpes,42,1,11,238,Saint-Jean-la-Vêtre,350,10,360
82,Rhône-Alpes,42,2,34,239,Saint-Jean-Saint-Maurice-sur-Loire,1095,26,1121
82,Rhône-Alpes,42,1,29,240,Saint-Jean-Soleymieux,802,15,817
82,Rhône-Alpes,42,2,10,241,Saint-Jodard,582,19,601
82,Rhône-Alpes,42,3,15,242,Saint-Joseph,1827,39,1866
82,Rhône-Alpes,42,2,26,243,Saint-Julien-d'Oddes,258,9,267
82,Rhône-Alpes,42,1,11,245,Saint-Julien-la-Vêtre,393,5,398
82,Rhône-Alpes,42,3,03,246,Saint-Julien-Molin-Molette,1210,19,1229
82,Rhône-Alpes,42,1,25,247,Saint-Just-en-Bas,308,12,320
82,Rhône-Alpes,42,2,30,248,Saint-Just-en-Chevalet,1189,64,1253
82,Rhône-Alpes,42,2,32,249,Saint-Just-la-Pendue,1530,18,1548
82,Rhône-Alpes,42,1,31,279,Saint-Just-Saint-Rambert,14484,255,14739
82,Rhône-Alpes,42,1,07,251,Saint-Laurent-la-Conche,579,7,586
82,Rhône-Alpes,42,1,02,252,Saint-Laurent-Rochefort,257,9,266
82,Rhône-Alpes,42,2,34,253,Saint-Léger-sur-Roanne,1101,71,1172
82,Rhône-Alpes,42,2,30,255,Saint-Marcel-d'Urfé,299,5,304
82,Rhône-Alpes,42,2,10,254,Saint-Marcel-de-Félines,762,14,776
82,Rhône-Alpes,42,1,31,256,Saint-Marcellin-en-Forez,4124,58,4182
82,Rhône-Alpes,42,2,12,257,Saint-Martin-d'Estréaux,903,20,923
82,Rhône-Alpes,42,3,15,259,Saint-Martin-la-Plaine,3638,68,3706
82,Rhône-Alpes,42,2,26,260,Saint-Martin-la-Sauveté,966,55,1021
82,Rhône-Alpes,42,1,07,261,Saint-Martin-Lestra,872,7,879
82,Rhône-Alpes,42,1,17,262,Saint-Maurice-en-Gourgois,1698,24,1722
82,Rhône-Alpes,42,1,06,264,Saint-Médard-en-Forez,895,31,926
82,Rhône-Alpes,42,3,13,265,Saint-Michel-sur-Rhône,751,14,765
82,Rhône-Alpes,42,1,17,266,Saint-Nizier-de-Fornas,632,8,640
82,Rhône-Alpes,42,2,05,267,Saint-Nizier-sous-Charlieu,1658,46,1704
82,Rhône-Alpes,42,1,09,269,Saint-Paul-d'Uzore,121,1,122
82,Rhône-Alpes,42,2,26,268,Saint-Paul-de-Vézelin,296,6,302
82,Rhône-Alpes,42,3,08,270,Saint-Paul-en-Cornillon,1299,72,1371
82,Rhône-Alpes,42,3,33,271,Saint-Paul-en-Jarez,4054,142,4196
82,Rhône-Alpes,42,3,13,272,Saint-Pierre-de-Boeuf,1596,32,1628
82,Rhône-Alpes,42,2,05,273,Saint-Pierre-la-Noaille,365,8,373
82,Rhône-Alpes,42,2,26,274,Saint-Polgues,223,5,228
82,Rhône-Alpes,42,3,20,275,Saint-Priest-en-Jarez,6080,130,6210
82,Rhône-Alpes,42,2,30,276,Saint-Priest-la-Prugne,468,19,487
82,Rhône-Alpes,42,2,32,277,Saint-Priest-la-Roche,286,13,299
82,Rhône-Alpes,42,1,11,278,Saint-Priest-la-Vêtre,129,3,132
82,Rhône-Alpes,42,3,24,280,Saint-Régis-du-Coin,374,9,383
82,Rhône-Alpes,42,2,27,281,Saint-Rirand,150,2,152
82,Rhône-Alpes,42,2,30,282,Saint-Romain-d'Urfé,273,7,280
82,Rhône-Alpes,42,3,15,283,Saint-Romain-en-Jarez,1128,13,1141
82,Rhône-Alpes,42,2,27,284,Saint-Romain-la-Motte,1529,49,1578
82,Rhône-Alpes,42,1,31,285,Saint-Romain-le-Puy,3496,46,3542
82,Rhône-Alpes,42,3,24,286,Saint-Romain-les-Atheux,931,17,948
82,Rhône-Alpes,42,3,03,287,Saint-Sauveur-en-Rue,1108,33,1141
82,Rhône-Alpes,42,1,02,288,Saint-Sixte,690,2,692
82,Rhône-Alpes,42,2,32,289,Saint-Symphorien-de-Lay,1710,39,1749
82,Rhône-Alpes,42,1,09,290,Saint-Thomas-la-Garde,581,15,596
82,Rhône-Alpes,42,1,11,291,Saint-Thurin,196,29,225
82,Rhône-Alpes,42,2,32,293,Saint-Victor-sur-Rhins,1078,22,1100
82,Rhône-Alpes,42,2,14,294,Saint-Vincent-de-Boisset,883,26,909
82,Rhône-Alpes,42,2,10,196,Sainte-Agathe-en-Donzy,118,2,120
82,Rhône-Alpes,42,1,02,197,Sainte-Agathe-la-Bouteresse,993,20,1013
82,Rhône-Alpes,42,2,10,209,Sainte-Colombe-sur-Gand,410,15,425
82,Rhône-Alpes,42,3,15,210,Sainte-Croix-en-Jarez,424,13,437
82,Rhône-Alpes,42,1,02,221,Sainte-Foy-Saint-Sulpice,433,15,448
82,Rhône-Alpes,42,1,11,295,Les Salles,477,12,489
82,Rhône-Alpes,42,1,07,296,Salt-en-Donzy,493,20,513
82,Rhône-Alpes,42,1,07,297,Salvizinet,616,29,645
82,Rhône-Alpes,42,1,25,298,Sauvain,408,17,425
82,Rhône-Alpes,42,1,09,299,Savigneux,3111,95,3206
82,Rhône-Alpes,42,2,01,300,Sevelinges,634,15,649
82,Rhône-Alpes,42,1,29,301,Soleymieux,603,16,619
82,Rhône-Alpes,42,3,28,302,Sorbiers,7606,157,7763
82,Rhône-Alpes,42,2,26,303,Souternon,328,2,330
82,Rhône-Alpes,42,1,31,304,Sury-le-Comtal,5324,200,5524
82,Rhône-Alpes,42,3,28,305,La Talaudière,6459,161,6620
82,Rhône-Alpes,42,3,24,306,Tarentaise,451,13,464
82,Rhône-Alpes,42,3,15,307,Tartaras,738,68,806
82,Rhône-Alpes,42,3,33,308,La Terrasse-sur-Dorlay,732,12,744
82,Rhône-Alpes,42,3,03,310,Thélis-la-Combe,176,3,179
82,Rhône-Alpes,42,3,28,311,La Tour-en-Jarez,1261,30,1291
82,Rhône-Alpes,42,1,17,312,La Tourette,536,12,548
82,Rhône-Alpes,42,1,02,313,Trelins,566,15,581
82,Rhône-Alpes,42,2,30,314,La Tuilière,297,5,302
82,Rhône-Alpes,42,1,31,315,Unias,340,8,348
82,Rhône-Alpes,42,3,08,316,Unieux,8504,109,8613
82,Rhône-Alpes,42,2,12,317,Urbise,133,1,134
82,Rhône-Alpes,42,1,17,318,Usson-en-Forez,1441,27,1468
82,Rhône-Alpes,42,1,07,319,Valeille,626,21,647
82,Rhône-Alpes,42,3,33,320,Valfleury,625,11,636
82,Rhône-Alpes,42,3,18,322,La Valla-en-Gier,912,40,952
82,Rhône-Alpes,42,1,11,321,La Valla-sur-Rochefort,133,2,135
82,Rhône-Alpes,42,1,23,323,Veauche,8420,148,8568
82,Rhône-Alpes,42,1,31,324,Veauchette,861,15,876
82,Rhône-Alpes,42,2,32,325,Vendranges,300,5,305
82,Rhône-Alpes,42,3,13,326,Véranne,731,11,742
82,Rhône-Alpes,42,3,13,327,Vérin,705,12,717
82,Rhône-Alpes,42,1,09,328,Verrières-en-Forez,626,103,729
82,Rhône-Alpes,42,3,03,329,La Versanne,362,10,372
82,Rhône-Alpes,42,3,21,330,Villars,7919,234,8153
82,Rhône-Alpes,42,2,34,331,Villemontais,950,22,972
82,Rhône-Alpes,42,2,34,332,Villerest,4436,184,4620
82,Rhône-Alpes,42,2,05,333,Villers,560,6,566
82,Rhône-Alpes,42,2,10,334,Violay,1351,38,1389
82,Rhône-Alpes,42,1,06,335,Viricelles,402,8,410
82,Rhône-Alpes,42,1,06,336,Virigneux,559,31,590
82,Rhône-Alpes,42,2,12,337,Vivans,247,5,252
82,Rhône-Alpes,42,2,05,338,Vougy,1422,73,1495
83,Auvergne,43,1,02,001,Agnat,189,8,197
83,Auvergne,43,2,19,002,Aiguilhe,1597,66,1663
83,Auvergne,43,2,01,003,Allègre,1008,25,1033
83,Auvergne,43,2,13,004,Alleyrac,123,3,126
83,Auvergne,43,2,98,005,Alleyras,174,7,181
83,Auvergne,43,1,11,006,Ally,173,7,180
83,Auvergne,43,3,29,007,Araules,619,24,643
83,Auvergne,43,2,18,008,Arlempdes,133,4,137
83,Auvergne,43,1,11,009,Arlet,22,1,23
83,Auvergne,43,2,20,010,Arsac-en-Velay,1108,26,1134
83,Auvergne,43,1,11,011,Aubazat,185,9,194
83,Auvergne,43,3,30,012,Aurec-sur-Loire,5449,140,5589
83,Auvergne,43,1,04,014,Autrac,73,1,74
83,Auvergne,43,1,17,015,Auvers,59,1,60
83,Auvergne,43,1,02,016,Auzon,933,19,952
83,Auvergne,43,1,02,017,Azérat,264,6,270
83,Auvergne,43,2,26,018,Bains,1203,87,1290
83,Auvergne,43,2,18,019,Barges,67,2,69
83,Auvergne,43,3,03,020,Bas-en-Basset,3926,78,4004
83,Auvergne,43,2,28,021,Beaulieu,911,16,927
83,Auvergne,43,1,05,022,Beaumont,270,9,279
83,Auvergne,43,2,08,023,Beaune-sur-Arzon,207,9,216
83,Auvergne,43,3,29,024,Beaux,780,21,801
83,Auvergne,43,3,14,025,Beauzac,2654,56,2710
83,Auvergne,43,2,01,026,Bellevue-la-Montagne,483,12,495
83,Auvergne,43,1,07,027,Berbezit,60,3,63
83,Auvergne,43,3,29,028,Bessamorel,408,6,414
83,Auvergne,43,1,17,029,La Besseyre-Saint-Mary,141,4,145
83,Auvergne,43,2,24,030,Blanzac,298,11,309
83,Auvergne,43,1,11,031,Blassac,148,5,153
83,Auvergne,43,2,31,032,Blavozy,1559,41,1600
83,Auvergne,43,1,04,033,Blesle,656,19,675
83,Auvergne,43,3,03,034,Boisset,264,6,270
83,Auvergne,43,1,07,035,Bonneval,96,2,98
83,Auvergne,43,2,24,036,Borne,412,8,420
83,Auvergne,43,2,06,037,Le Bouchet-Saint-Nicolas,233,11,244
83,Auvergne,43,1,05,038,Bournoncle-Saint-Pierre,1010,30,1040
83,Auvergne,43,2,26,039,Le Brignon,580,15,595
83,Auvergne,43,1,97,040,Brioude,6676,398,7074
83,Auvergne,43,2,31,041,Brives-Charensac,4146,193,4339
83,Auvergne,43,2,06,042,Cayres,714,14,728
83,Auvergne,43,2,01,043,Céaux-d'Allègre,445,15,460
83,Auvergne,43,1,11,044,Cerzat,194,5,199
83,Auvergne,43,2,32,045,Ceyssac,393,18,411
83,Auvergne,43,2,19,046,Chadrac,2676,123,2799
83,Auvergne,43,2,13,047,Chadron,241,8,249
83,Auvergne,43,1,07,048,La Chaise-Dieu,768,75,843
83,Auvergne,43,2,28,049,Chamalières-sur-Loire,438,9,447
83,Auvergne,43,1,04,050,Chambezon,92,3,95
83,Auvergne,43,3,27,051,Le Chambon-sur-Lignon,2662,179,2841
83,Auvergne,43,1,02,052,Champagnac-le-Vieux,237,8,245
83,Auvergne,43,2,09,053,Champclause,222,3,225
83,Auvergne,43,1,25,054,Chanaleilles,210,7,217
83,Auvergne,43,1,34,055,Chaniat,162,5,167
83,Auvergne,43,1,10,056,Chanteuges,413,12,425
83,Auvergne,43,2,01,057,La Chapelle-Bertin,63,3,66
83,Auvergne,43,3,14,058,La Chapelle-d'Aurec,836,14,850
83,Auvergne,43,1,07,059,La Chapelle-Geneste,139,1,140
83,Auvergne,43,1,10,060,Charraix,98,4,102
83,Auvergne,43,2,19,061,Chaspinhac,709,21,730
83,Auvergne,43,2,12,062,Chaspuzac,643,17,660
83,Auvergne,43,1,16,063,Chassagnes,178,8,186
83,Auvergne,43,1,02,064,Chassignolles,85,2,87
83,Auvergne,43,1,17,065,Chastel,142,5,147
83,Auvergne,43,2,09,066,Chaudeyrolles,115,0,115
83,Auvergne,43,1,16,067,Chavaniac-Lafayette,293,36,329
83,Auvergne,43,1,17,068,Chazelles,32,5,37
83,Auvergne,43,3,27,069,Chenereilles,280,5,285
83,Auvergne,43,1,11,070,Chilhac,199,12,211
83,Auvergne,43,2,08,071,Chomelix,501,10,511
83,Auvergne,43,1,16,072,La Chomette,138,2,140
83,Auvergne,43,1,07,073,Cistrières,139,5,144
83,Auvergne,43,1,05,074,Cohade,778,34,812
83,Auvergne,43,1,16,075,Collat,85,2,87
83,Auvergne,43,1,07,076,Connangles,136,2,138
83,Auvergne,43,2,06,077,Costaros,599,14,613
83,Auvergne,43,2,20,078,Coubon,3044,117,3161
83,Auvergne,43,1,16,079,Couteuges,307,3,310
83,Auvergne,43,2,08,080,Craponne-sur-Arzon,2149,52,2201
83,Auvergne,43,1,25,081,Croisances,35,0,35
83,Auvergne,43,1,17,082,Cronce,81,4,85
83,Auvergne,43,1,25,083,Cubelles,127,7,134
83,Auvergne,43,2,26,084,Cussac-sur-Loire,1644,46,1690
83,Auvergne,43,1,17,085,Desges,78,5,83
83,Auvergne,43,1,16,086,Domeyrat,173,10,183
83,Auvergne,43,3,15,087,Dunières,2967,72,3039
83,Auvergne,43,1,04,088,Espalem,265,8,273
83,Auvergne,43,2,32,089,Espaly-Saint-Marcel,3615,180,3795
83,Auvergne,43,1,25,090,Esplantas,102,1,103
83,Auvergne,43,2,09,091,Les Estables,365,10,375
83,Auvergne,43,2,09,092,Fay-sur-Lignon,429,11,440
83,Auvergne,43,1,07,093,Félines,284,5,289
83,Auvergne,43,1,17,094,Ferrussac,80,3,83
83,Auvergne,43,2,01,095,Fix-Saint-Geneys,147,8,155
83,Auvergne,43,1,34,096,Fontannes,1090,216,1306
83,Auvergne,43,2,13,097,Freycenet-la-Cuche,148,7,155
83,Auvergne,43,2,13,098,Freycenet-la-Tour,127,5,132
83,Auvergne,43,1,02,099,Frugerès-les-Mines,517,8,525
83,Auvergne,43,1,16,100,Frugières-le-Pin,142,9,151
83,Auvergne,43,2,13,101,Goudet,63,3,66
83,Auvergne,43,3,29,102,Grazac,956,11,967
83,Auvergne,43,1,04,103,Grenier-Montgon,118,2,120
83,Auvergne,43,1,25,104,Grèzes,218,9,227
83,Auvergne,43,1,34,105,Javaugues,194,6,200
83,Auvergne,43,1,16,106,Jax,132,3,135
83,Auvergne,43,1,16,107,Josat,90,3,93
83,Auvergne,43,2,08,108,Jullianges,412,2,414
83,Auvergne,43,2,18,109,Lafarre,68,2,70
83,Auvergne,43,1,05,110,Lamothe,850,29,879
83,Auvergne,43,2,18,111,Landos,893,16,909
83,Auvergne,43,1,10,112,Langeac,3960,113,4073
83,Auvergne,43,2,23,113,Lantriac,1827,62,1889
83,Auvergne,43,3,29,114,Lapte,1484,31,1515
83,Auvergne,43,2,13,115,Laussonne,985,29,1014
83,Auvergne,43,1,07,116,Laval-sur-Doulon,62,1,63
83,Auvergne,43,1,34,117,Lavaudieu,228,10,238
83,Auvergne,43,1,11,118,Lavoûte-Chilhac,311,11,322
83,Auvergne,43,2,24,119,Lavoûte-sur-Loire,736,13,749
83,Auvergne,43,1,02,120,Lempdes-sur-Allagnon,1314,23,1337
83,Auvergne,43,1,04,121,Léotoing,205,5,210
83,Auvergne,43,2,24,122,Lissac,261,7,268
83,Auvergne,43,1,04,123,Lorlanges,288,1,289
83,Auvergne,43,2,12,124,Loudes,869,24,893
83,Auvergne,43,1,04,125,Lubilhac,110,5,115
83,Auvergne,43,2,19,126,Malrevers,714,22,736
83,Auvergne,43,3,03,127,Malvalette,654,5,659
83,Auvergne,43,1,07,128,Malvières,133,3,136
83,Auvergne,43,3,27,129,Le Mas-de-Tence,169,4,173
83,Auvergne,43,1,16,131,Mazerat-Aurouze,194,6,200
83,Auvergne,43,3,27,130,Mazet-Saint-Voy,1098,36,1134
83,Auvergne,43,1,10,132,Mazeyrat-d'Allier,1505,40,1545
83,Auvergne,43,1,11,133,Mercoeur,131,3,134
83,Auvergne,43,2,28,134,Mézères,160,5,165
83,Auvergne,43,2,13,135,Le Monastier-sur-Gazeille,1747,47,1794
83,Auvergne,43,1,25,136,Monistrol-d'Allier,218,12,230
83,Auvergne,43,3,14,137,Monistrol-sur-Loire,8656,427,9083
83,Auvergne,43,2,01,138,Monlet,418,9,427
83,Auvergne,43,1,16,139,Montclard,61,11,72
83,Auvergne,43,2,19,140,Le Monteil,581,22,603
83,Auvergne,43,3,15,141,Montfaucon-en-Velay,1228,65,1293
83,Auvergne,43,3,15,142,Montregard,608,12,620
83,Auvergne,43,2,23,143,Montusclat,128,3,131
83,Auvergne,43,2,13,144,Moudeyres,105,7,112
83,Auvergne,43,2,06,145,Ouides,56,1,57
83,Auvergne,43,1,05,147,Paulhac,660,33,693
83,Auvergne,43,1,16,148,Paulhaguet,979,31,1010
83,Auvergne,43,1,10,149,Pébrac,125,2,127
83,Auvergne,43,2,23,150,Le Pertuis,416,5,421
83,Auvergne,43,1,17,151,Pinols,233,9,242
83,Auvergne,43,2,19,152,Polignac,2783,109,2892
83,Auvergne,43,3,22,153,Pont-Salomon,1834,23,1857
83,Auvergne,43,2,18,154,Pradelles,622,29,651
83,Auvergne,43,1,10,155,Prades,60,2,62
83,Auvergne,43,2,13,156,Présailles,157,4,161
83,Auvergne,43,2,99,157,Le Puy-en-Velay,18879,1167,20046
83,Auvergne,43,2,23,158,Queyrières,313,16,329
83,Auvergne,43,3,15,159,Raucoules,860,30,890
83,Auvergne,43,2,18,160,Rauret,180,1,181
83,Auvergne,43,3,21,162,Retournac,2641,37,2678
83,Auvergne,43,3,15,163,Riotord,1180,24,1204
83,Auvergne,43,2,28,164,Roche-en-Régnier,484,10,494
83,Auvergne,43,2,28,165,Rosières,1438,17,1455
83,Auvergne,43,3,21,166,Saint-André-de-Chalencon,340,10,350
83,Auvergne,43,1,10,167,Saint-Arcons-d'Allier,185,10,195
83,Auvergne,43,2,18,168,Saint-Arcons-de-Barges,117,7,124
83,Auvergne,43,1,11,169,Saint-Austremoine,51,7,58
83,Auvergne,43,1,05,170,Saint-Beauzire,316,9,325
83,Auvergne,43,1,10,171,Saint-Bérain,102,2,104
83,Auvergne,43,3,15,172,Saint-Bonnet-le-Froid,232,9,241
83,Auvergne,43,1,25,173,Saint-Christophe-d'Allier,113,7,120
83,Auvergne,43,2,26,174,Saint-Christophe-sur-Dolaison,941,20,961
83,Auvergne,43,1,11,175,Saint-Cirgues,157,8,165
83,Auvergne,43,2,06,176,Saint-Didier-d'Allier,33,2,35
83,Auvergne,43,3,22,177,Saint-Didier-en-Velay,3316,186,3502
83,Auvergne,43,1,16,178,Saint-Didier-sur-Doulon,218,12,230
83,Auvergne,43,2,18,180,Saint-Étienne-du-Vigan,116,4,120
83,Auvergne,43,2,23,181,Saint-Étienne-Lardeyrol,669,23,692
83,Auvergne,43,1,04,182,Saint-Étienne-sur-Blesle,50,1,51
83,Auvergne,43,3,22,184,Saint-Ferréol-d'Auroure,2318,38,2356
83,Auvergne,43,2,09,186,Saint-Front,483,10,493
83,Auvergne,43,2,24,187,Saint-Geneys-près-Saint-Paulien,308,16,324
83,Auvergne,43,1,16,188,Saint-Georges-d'Aurac,429,13,442
83,Auvergne,43,2,08,189,Saint-Georges-Lagricol,477,15,492
83,Auvergne,43,2,31,190,Saint-Germain-Laprade,3363,126,3489
83,Auvergne,43,1,05,191,Saint-Géron,206,3,209
83,Auvergne,43,2,18,192,Saint-Haon,364,7,371
83,Auvergne,43,1,02,193,Saint-Hilaire,191,10,201
83,Auvergne,43,2,23,194,Saint-Hostien,634,22,656
83,Auvergne,43,1,11,195,Saint-Ilpize,181,12,193
83,Auvergne,43,2,08,196,Saint-Jean-d'Aubrigoux,180,5,185
83,Auvergne,43,2,12,197,Saint-Jean-de-Nay,394,8,402
83,Auvergne,43,2,06,198,Saint-Jean-Lachalm,282,11,293
83,Auvergne,43,3,27,199,Saint-Jeures,886,6,892
83,Auvergne,43,2,23,200,Saint-Julien-Chapteuil,1870,63,1933
83,Auvergne,43,2,08,201,Saint-Julien-d'Ance,233,10,243
83,Auvergne,43,1,10,202,Saint-Julien-des-Chazes,81,1,82
83,Auvergne,43,3,29,203,Saint-Julien-du-Pinet,444,10,454
83,Auvergne,43,3,15,204,Saint-Julien-Molhesabate,207,2,209
83,Auvergne,43,3,22,205,Saint-Just-Malmont,4153,71,4224
83,Auvergne,43,1,34,206,Saint-Just-près-Brioude,407,16,423
83,Auvergne,43,1,05,207,Saint-Laurent-Chabreuges,237,14,251
83,Auvergne,43,2,13,210,Saint-Martin-de-Fugères,228,3,231
83,Auvergne,43,3,14,211,Saint-Maurice-de-Lignon,2323,57,2380
83,Auvergne,43,3,03,212,Saint-Pal-de-Chalencon,1009,30,1039
83,Auvergne,43,3,35,213,Saint-Pal-de-Mons,2022,48,2070
83,Auvergne,43,1,07,214,Saint-Pal-de-Senouire,93,1,94
83,Auvergne,43,2,18,215,Saint-Paul-de-Tartas,188,8,196
83,Auvergne,43,2,24,216,Saint-Paulien,2326,47,2373
83,Auvergne,43,2,28,217,Saint-Pierre-du-Champ,499,18,517
83,Auvergne,43,2,23,218,Saint-Pierre-Eynac,1003,36,1039
83,Auvergne,43,1,16,219,Saint-Préjet-Armandon,108,3,111
83,Auvergne,43,1,25,220,Saint-Préjet-d'Allier,173,10,183
83,Auvergne,43,2,12,221,Saint-Privat-d'Allier,409,5,414
83,Auvergne,43,1,11,222,Saint-Privat-du-Dragon,173,6,179
83,Auvergne,43,3,22,223,Saint-Romain-Lachalm,1015,26,1041
83,Auvergne,43,1,25,225,Saint-Vénérand,55,2,57
83,Auvergne,43,1,02,226,Saint-Vert,105,1,106
83,Auvergne,43,3,22,227,Saint-Victor-Malescours,727,18,745
83,Auvergne,43,2,08,228,Saint-Victor-sur-Arlanc,105,1,106
83,Auvergne,43,2,12,229,Saint-Vidal,482,9,491
83,Auvergne,43,2,24,230,Saint-Vincent,962,14,976
83,Auvergne,43,1,16,183,Sainte-Eugénie-de-Villeneuve,97,3,100
83,Auvergne,43,1,02,185,Sainte-Florine,3121,97,3218
83,Auvergne,43,1,16,208,Sainte-Marguerite,31,1,32
83,Auvergne,43,3,35,224,Sainte-Sigolène,5876,133,6009
83,Auvergne,43,2,13,231,Salettes,154,4,158
83,Auvergne,43,1,16,232,Salzuit,358,6,364
83,Auvergne,43,2,12,233,Sanssac-l'Église,1019,25,1044
83,Auvergne,43,1,25,234,Saugues,1879,133,2012
83,Auvergne,43,3,22,236,La Séauve-sur-Semène,1313,26,1339
83,Auvergne,43,1,07,237,Sembadel,249,5,254
83,Auvergne,43,2,06,238,Séneujols,294,2,296
83,Auvergne,43,1,10,239,Siaugues-Sainte-Marie,799,25,824
83,Auvergne,43,3,21,240,Solignac-sous-Roche,210,11,221
83,Auvergne,43,2,26,241,Solignac-sur-Loire,1188,25,1213
83,Auvergne,43,1,17,242,Tailhac,83,2,85
83,Auvergne,43,3,27,244,Tence,3271,82,3353
83,Auvergne,43,1,25,245,Thoras,224,19,243
83,Auvergne,43,3,03,246,Tiranges,443,19,462
83,Auvergne,43,1,04,247,Torsiac,73,1,74
83,Auvergne,43,3,03,249,Valprivas,492,14,506
83,Auvergne,43,1,16,250,Vals-le-Chastel,47,1,48
83,Auvergne,43,2,33,251,Vals-près-le-Puy,3541,148,3689
83,Auvergne,43,2,01,252,Varennes-Saint-Honorat,40,3,43
83,Auvergne,43,2,09,253,Les Vastres,230,9,239
83,Auvergne,43,2,12,254,Vazeilles-Limandre,229,5,234
83,Auvergne,43,1,25,255,Vazeilles-près-Saugues,43,1,44
83,Auvergne,43,1,25,256,Venteuges,366,13,379
83,Auvergne,43,2,12,257,Vergezac,434,8,442
83,Auvergne,43,1,02,258,Vergongheon,1801,57,1858
83,Auvergne,43,2,01,259,Vernassal,380,8,388
83,Auvergne,43,2,12,260,Le Vernet,36,0,36
83,Auvergne,43,1,02,261,Vézézoux,471,19,490
83,Auvergne,43,1,34,262,Vieille-Brioude,1200,46,1246
83,Auvergne,43,2,18,263,Vielprat,63,1,64
83,Auvergne,43,1,11,264,Villeneuve-d'Allier,328,6,334
83,Auvergne,43,3,35,265,Les Villettes,1151,24,1175
83,Auvergne,43,1,10,013,Vissac-Auteyrac,331,7,338
83,Auvergne,43,2,28,267,Vorey,1434,20,1454
83,Auvergne,43,3,29,268,Yssingeaux,6936,402,7338
52,Pays de la Loire,44,1,28,001,Abbaretz,1828,37,1865
52,Pays de la Loire,44,2,01,002,Aigrefeuille-sur-Maine,2929,84,3013
52,Pays de la Loire,44,4,02,003,Ancenis,7511,303,7814
52,Pays de la Loire,44,4,02,004,Anetz,1776,34,1810
52,Pays de la Loire,44,3,32,005,Arthon-en-Retz,3497,47,3544
52,Pays de la Loire,44,3,14,006,Assérac,1757,37,1794
52,Pays de la Loire,44,1,40,007,Avessac,2389,55,2444
52,Pays de la Loire,44,2,17,008,Barbechat,1268,18,1286
52,Pays de la Loire,44,2,59,009,Basse-Goulaine,7928,264,8192
52,Pays de la Loire,44,3,10,010,Batz-sur-Mer,3132,98,3230
52,Pays de la Loire,44,3,57,055,La Baule-Escoublac,16731,553,17284
52,Pays de la Loire,44,4,45,011,Belligné,1739,46,1785
52,Pays de la Loire,44,3,05,012,La Bernerie-en-Retz,2519,58,2577
52,Pays de la Loire,44,3,31,013,Besné,2441,47,2488
52,Pays de la Loire,44,2,01,014,Le Bignon,3208,56,3264
52,Pays de la Loire,44,1,03,015,Blain,9041,177,9218
52,Pays de la Loire,44,2,17,016,La Boissière-du-Doré,868,12,880
52,Pays de la Loire,44,4,38,017,Bonnoeuvre,554,17,571
52,Pays de la Loire,44,2,04,018,Bouaye,5763,147,5910
52,Pays de la Loire,44,3,43,019,Bouée,821,21,842
52,Pays de la Loire,44,2,51,020,Bouguenais,16790,532,17322
52,Pays de la Loire,44,3,05,021,Bourgneuf-en-Retz,3232,45,3277
52,Pays de la Loire,44,2,09,022,Boussay,2621,68,2689
52,Pays de la Loire,44,1,03,023,Bouvron,2732,52,2784
52,Pays de la Loire,44,2,04,024,Brains,2537,42,2579
52,Pays de la Loire,44,3,43,025,Campbon,3636,151,3787
52,Pays de la Loire,44,2,06,026,Carquefou,17415,419,17834
52,Pays de la Loire,44,1,27,027,Casson,2045,31,2076
52,Pays de la Loire,44,4,16,028,Le Cellier,3604,69,3673
52,Pays de la Loire,44,2,17,029,La Chapelle-Basse-Mer,4981,64,5045
52,Pays de la Loire,44,3,14,030,La Chapelle-des-Marais,3514,64,3578
52,Pays de la Loire,44,1,37,031,La Chapelle-Glain,818,24,842
52,Pays de la Loire,44,2,44,032,La Chapelle-Heulin,2898,35,2933
52,Pays de la Loire,44,3,43,033,La Chapelle-Launay,2711,90,2801
52,Pays de la Loire,44,4,45,034,La Chapelle-Saint-Sauveur,760,19,779
52,Pays de la Loire,44,2,07,035,La Chapelle-sur-Erdre,17034,498,17532
52,Pays de la Loire,44,2,59,037,Château-Thébaud,2794,60,2854
52,Pays de la Loire,44,1,08,036,Châteaubriant,12246,606,12852
52,Pays de la Loire,44,3,41,038,Chauvé,2391,61,2452
52,Pays de la Loire,44,2,30,039,Cheix-en-Retz,779,9,788
52,Pays de la Loire,44,3,05,040,Chéméré,2134,44,2178
52,Pays de la Loire,44,1,28,221,La Chevallerais,1291,17,1308
52,Pays de la Loire,44,2,42,041,La Chevrolière,4945,90,5035
52,Pays de la Loire,44,2,09,043,Clisson,6739,240,6979
52,Pays de la Loire,44,1,12,044,Conquereuil,1026,38,1064
52,Pays de la Loire,44,2,15,156,Corcoué-sur-Logne,2395,51,2446
52,Pays de la Loire,44,2,35,045,Cordemais,2864,64,2928
52,Pays de la Loire,44,3,29,046,Corsept,2638,43,2681
52,Pays de la Loire,44,2,35,047,Couëron,18373,248,18621
52,Pays de la Loire,44,4,16,048,Couffé,2219,53,2272
52,Pays de la Loire,44,3,10,049,Le Croisic,4073,61,4134
52,Pays de la Loire,44,3,31,050,Crossac,2608,128,2736
52,Pays de la Loire,44,1,11,051,Derval,3013,341,3354
52,Pays de la Loire,44,3,47,052,Donges,6520,321,6841
52,Pays de la Loire,44,3,36,053,Drefféac,1687,48,1735
52,Pays de la Loire,44,1,37,054,Erbray,2793,95,2888
52,Pays de la Loire,44,1,03,056,Fay-de-Bretagne,3019,48,3067
52,Pays de la Loire,44,1,40,057,Fégréac,2181,45,2226
52,Pays de la Loire,44,1,34,058,Fercé,478,14,492
52,Pays de la Loire,44,3,05,059,Fresnay-en-Retz,1169,24,1193
52,Pays de la Loire,44,4,45,060,Le Fresne-sur-Loire,973,14,987
52,Pays de la Loire,44,3,41,061,Frossay,2792,40,2832
52,Pays de la Loire,44,1,03,062,Le Gâvre,1388,19,1407
52,Pays de la Loire,44,2,01,223,Geneston,3429,51,3480
52,Pays de la Loire,44,2,09,063,Gétigné,3360,78,3438
52,Pays de la Loire,44,2,09,064,Gorges,3769,204,3973
52,Pays de la Loire,44,1,19,065,Grand-Auverné,758,18,776
52,Pays de la Loire,44,2,07,066,Grandchamps-des-Fontaines,4553,70,4623
52,Pays de la Loire,44,1,28,224,La Grigonnais,1454,20,1474
52,Pays de la Loire,44,1,12,067,Guémené-Penfao,4928,114,5042
52,Pays de la Loire,44,3,36,068,Guenrouet,2860,51,2911
52,Pays de la Loire,44,3,13,069,Guérande,15228,727,15955
52,Pays de la Loire,44,2,59,070,La Haie-Fouassière,4223,94,4317
52,Pays de la Loire,44,2,59,071,Haute-Goulaine,5487,121,5608
52,Pays de la Loire,44,3,14,072,Herbignac,5345,117,5462
52,Pays de la Loire,44,1,27,073,Héric,5056,83,5139
52,Pays de la Loire,44,2,55,074,Indre,3818,50,3868
52,Pays de la Loire,44,1,19,075,Issé,1821,33,1854
52,Pays de la Loire,44,1,11,076,Jans,1018,29,1047
52,Pays de la Loire,44,4,33,077,Joué-sur-Erdre,1982,36,2018
52,Pays de la Loire,44,1,37,078,Juigné-des-Moutiers,335,7,342
52,Pays de la Loire,44,2,17,079,Le Landreau,2861,257,3118
52,Pays de la Loire,44,3,43,080,Lavau-sur-Loire,764,13,777
52,Pays de la Loire,44,2,15,081,Legé,4159,116,4275
52,Pays de la Loire,44,4,16,082,Ligné,4160,92,4252
52,Pays de la Loire,44,2,42,083,La Limouzinière,2074,44,2118
52,Pays de la Loire,44,2,17,084,Le Loroux-Bottereau,6330,93,6423
52,Pays de la Loire,44,1,19,085,Louisfert,881,24,905
52,Pays de la Loire,44,1,11,086,Lusanger,1015,33,1048
52,Pays de la Loire,44,2,18,087,Machecoul,5811,269,6080
52,Pays de la Loire,44,2,01,088,Maisdon-sur-Sèvre,2528,49,2577
52,Pays de la Loire,44,3,43,089,Malville,3110,116,3226
52,Pays de la Loire,44,2,18,090,La Marne,1369,17,1386
52,Pays de la Loire,44,1,12,091,Marsac-sur-Don,1386,35,1421
52,Pays de la Loire,44,1,12,092,Massérac,600,14,614
52,Pays de la Loire,44,4,38,093,Maumusson,990,23,1013
52,Pays de la Loire,44,2,06,094,Mauves-sur-Loire,2964,63,3027
52,Pays de la Loire,44,1,19,095,La Meilleraye-de-Bretagne,1246,27,1273
52,Pays de la Loire,44,4,02,096,Mésanger,4185,86,4271
52,Pays de la Loire,44,3,13,097,Mesquer,1694,52,1746
52,Pays de la Loire,44,3,36,098,Missillac,4717,91,4808
52,Pays de la Loire,44,1,19,099,Moisdon-la-Rivière,1883,61,1944
52,Pays de la Loire,44,2,09,100,Monnières,1815,43,1858
52,Pays de la Loire,44,2,30,101,La Montagne,5998,116,6114
52,Pays de la Loire,44,2,01,102,Montbert,2945,43,2988
52,Pays de la Loire,44,3,47,103,Montoir-de-Bretagne,6523,208,6731
52,Pays de la Loire,44,4,45,104,Montrelais,827,14,841
52,Pays de la Loire,44,1,11,105,Mouais,350,6,356
52,Pays de la Loire,44,3,05,106,Les Moutiers-en-Retz,1240,33,1273
52,Pays de la Loire,44,4,16,107,Mouzeil,1700,28,1728
52,Pays de la Loire,44,2,44,108,Mouzillon,2513,41,2554
52,Pays de la Loire,44,2,99,109,Nantes,283288,8216,291504
52,Pays de la Loire,44,1,27,110,Nort-sur-Erdre,7252,209,7461
52,Pays de la Loire,44,1,03,111,Notre-Dame-des-Landes,1892,29,1921
52,Pays de la Loire,44,1,34,112,Noyal-sur-Brutz,560,14,574
52,Pays de la Loire,44,1,28,113,Nozay,3734,70,3804
52,Pays de la Loire,44,2,54,114,Orvault,24442,700,25142
52,Pays de la Loire,44,4,02,115,Oudon,3162,83,3245
52,Pays de la Loire,44,3,29,116,Paimboeuf,3138,114,3252
52,Pays de la Loire,44,2,44,117,Le Pallet,2706,57,2763
52,Pays de la Loire,44,4,33,118,Pannecé,1248,19,1267
52,Pays de la Loire,44,2,18,119,Paulx,1854,34,1888
52,Pays de la Loire,44,2,30,120,Le Pellerin,4268,153,4421
52,Pays de la Loire,44,1,37,121,Petit-Auverné,419,7,426
52,Pays de la Loire,44,1,27,122,Petit-Mars,3419,58,3477
52,Pays de la Loire,44,1,12,123,Pierric,892,29,921
52,Pays de la Loire,44,4,38,124,Le Pin,701,17,718
52,Pays de la Loire,44,3,13,125,Piriac-sur-Mer,2279,52,2331
52,Pays de la Loire,44,3,32,126,La Plaine-sur-Mer,3747,44,3791
52,Pays de la Loire,44,2,01,127,La Planche,2325,53,2378
52,Pays de la Loire,44,1,40,128,Plessé,4329,166,4495
52,Pays de la Loire,44,2,04,130,Pont-Saint-Martin,5536,84,5620
52,Pays de la Loire,44,3,31,129,Pontchâteau,9324,275,9599
52,Pays de la Loire,44,3,32,131,Pornic,13965,390,14355
52,Pays de la Loire,44,3,57,132,Pornichet,10502,338,10840
52,Pays de la Loire,44,2,30,133,Port-Saint-Père,2590,31,2621
52,Pays de la Loire,44,4,02,134,Pouillé-les-Côteaux,824,18,842
52,Pays de la Loire,44,3,10,135,Le Pouliguen,5088,146,5234
52,Pays de la Loire,44,3,32,136,Préfailles,1231,27,1258
52,Pays de la Loire,44,3,43,137,Prinquiau,2849,80,2929
52,Pays de la Loire,44,1,28,138,Puceul,925,16,941
52,Pays de la Loire,44,3,43,139,Quilly,1216,44,1260
52,Pays de la Loire,44,2,44,140,La Regrippière,1517,21,1538
52,Pays de la Loire,44,2,17,141,La Remaudière,1093,11,1104
52,Pays de la Loire,44,2,01,142,Remouillé,1650,22,1672
52,Pays de la Loire,44,2,97,143,Rezé,37910,1235,39145
52,Pays de la Loire,44,4,33,144,Riaillé,2036,87,2123
52,Pays de la Loire,44,4,02,222,La Roche-Blanche,1017,18,1035
52,Pays de la Loire,44,2,30,145,Rouans,2544,32,2576
52,Pays de la Loire,44,1,34,146,Rougé,2268,54,2322
52,Pays de la Loire,44,4,45,147,La Rouxière,958,17,975
52,Pays de la Loire,44,1,08,148,Ruffigné,702,12,714
52,Pays de la Loire,44,1,28,149,Saffré,3426,71,3497
52,Pays de la Loire,44,2,04,150,Saint-Aignan-Grandlieu,3476,56,3532
52,Pays de la Loire,44,3,13,151,Saint-André-des-Eaux,5228,173,5401
52,Pays de la Loire,44,1,08,153,Saint-Aubin-des-Châteaux,1540,37,1577
52,Pays de la Loire,44,3,29,154,Saint-Brevin-les-Pins,12294,276,12570
52,Pays de la Loire,44,2,42,155,Saint-Colomban,2972,40,3012
52,Pays de la Loire,44,2,18,157,Saint-Étienne-de-Mer-Morte,1344,19,1363
52,Pays de la Loire,44,2,35,158,Saint-Étienne-de-Montluc,6605,203,6808
52,Pays de la Loire,44,2,59,159,Saint-Fiacre-sur-Maine,1172,18,1190
52,Pays de la Loire,44,4,02,160,Saint-Géréon,2645,115,2760
52,Pays de la Loire,44,3,36,161,Saint-Gildas-des-Bois,3384,134,3518
52,Pays de la Loire,44,2,96,162,Saint-Herblain,43177,858,44035
52,Pays de la Loire,44,4,02,163,Saint-Herblon,2262,37,2299
52,Pays de la Loire,44,3,05,164,Saint-Hilaire-de-Chaléons,1891,30,1921
52,Pays de la Loire,44,2,09,165,Saint-Hilaire-de-Clisson,1906,27,1933
52,Pays de la Loire,44,2,30,166,Saint-Jean-de-Boiseau,4734,65,4799
52,Pays de la Loire,44,3,31,168,Saint-Joachim,3956,79,4035
52,Pays de la Loire,44,2,17,169,Saint-Julien-de-Concelles,6852,108,6960
52,Pays de la Loire,44,1,37,170,Saint-Julien-de-Vouvantes,927,15,942
52,Pays de la Loire,44,2,04,171,Saint-Léger-les-Vignes,1447,22,1469
52,Pays de la Loire,44,2,09,173,Saint-Lumine-de-Clisson,1832,29,1861
52,Pays de la Loire,44,2,42,174,Saint-Lumine-de-Coutais,1814,36,1850
52,Pays de la Loire,44,3,14,175,Saint-Lyphard,4203,132,4335
52,Pays de la Loire,44,3,47,176,Saint-Malo-de-Guersac,3127,65,3192
52,Pays de la Loire,44,2,18,178,Saint-Mars-de-Coutais,2461,41,2502
52,Pays de la Loire,44,1,27,179,Saint-Mars-du-Désert,4003,62,4065
52,Pays de la Loire,44,4,38,180,Saint-Mars-la-Jaille,2416,55,2471
52,Pays de la Loire,44,2,18,181,Saint-Même-le-Tenu,1132,27,1159
52,Pays de la Loire,44,3,32,182,Saint-Michel-Chef-Chef,4364,85,4449
52,Pays de la Loire,44,3,13,183,Saint-Molf,2179,47,2226
52,Pays de la Loire,44,3,98,184,Saint-Nazaire,66912,2454,69366
52,Pays de la Loire,44,1,40,185,Saint-Nicolas-de-Redon,3016,92,3108
52,Pays de la Loire,44,3,41,187,Saint-Père-en-Retz,4023,180,4203
52,Pays de la Loire,44,2,42,188,Saint-Philbert-de-Grand-Lieu,7617,151,7768
52,Pays de la Loire,44,2,50,190,Saint-Sébastien-sur-Loire,24748,804,25552
52,Pays de la Loire,44,4,38,191,Saint-Sulpice-des-Landes,636,12,648
52,Pays de la Loire,44,3,41,192,Saint-Viaud,2106,44,2150
52,Pays de la Loire,44,1,11,193,Saint-Vincent-des-Landes,1410,39,1449
52,Pays de la Loire,44,3,31,152,Sainte-Anne-sur-Brivet,2420,40,2460
52,Pays de la Loire,44,2,06,172,Sainte-Luce-sur-Loire,11696,270,11966
52,Pays de la Loire,44,2,30,186,Sainte-Pazanne,5133,79,5212
52,Pays de la Loire,44,3,31,189,Sainte-Reine-de-Bretagne,1945,26,1971
52,Pays de la Loire,44,2,54,194,Sautron,6860,215,7075
52,Pays de la Loire,44,3,43,195,Savenay,7195,347,7542
52,Pays de la Loire,44,3,36,196,Sévérac,1450,23,1473
52,Pays de la Loire,44,1,11,197,Sion-les-Mines,1576,35,1611
52,Pays de la Loire,44,2,46,198,Les Sorinières,7253,98,7351
52,Pays de la Loire,44,1,08,199,Soudan,2058,61,2119
52,Pays de la Loire,44,1,34,200,Soulvache,398,7,405
52,Pays de la Loire,44,2,07,201,Sucé-sur-Erdre,6172,150,6322
52,Pays de la Loire,44,4,33,202,Teillé,1706,37,1743
52,Pays de la Loire,44,2,35,203,Le Temple-de-Bretagne,1828,19,1847
52,Pays de la Loire,44,2,06,204,Thouaré-sur-Loire,7498,148,7646
52,Pays de la Loire,44,1,27,205,Les Touches,2198,42,2240
52,Pays de la Loire,44,2,15,206,Touvois,1482,29,1511
52,Pays de la Loire,44,4,33,207,Trans-sur-Erdre,892,15,907
52,Pays de la Loire,44,1,28,208,Treffieux,734,18,752
52,Pays de la Loire,44,2,07,209,Treillières,7606,171,7777
52,Pays de la Loire,44,3,47,210,Trignac,7209,491,7700
52,Pays de la Loire,44,3,13,211,La Turballe,4448,108,4556
52,Pays de la Loire,44,2,44,212,Vallet,8117,265,8382
52,Pays de la Loire,44,4,45,213,Varades,3517,148,3665
52,Pays de la Loire,44,1,28,214,Vay,1871,23,1894
52,Pays de la Loire,44,2,46,215,Vertou,21422,582,22004
52,Pays de la Loire,44,2,01,216,Vieillevigne,3861,68,3929
52,Pays de la Loire,44,2,35,217,Vigneux-de-Bretagne,5279,119,5398
52,Pays de la Loire,44,1,34,218,Villepot,674,22,696
52,Pays de la Loire,44,4,38,219,Vritz,748,13,761
52,Pays de la Loire,44,2,30,220,Vue,1370,27,1397
24,Centre,45,1,05,001,Adon,171,12,183
24,Centre,45,1,08,002,Aillant-sur-Milleron,376,11,387
24,Centre,45,1,32,004,Amilly,11548,644,12192
24,Centre,45,3,26,005,Andonville,199,6,205
24,Centre,45,2,13,006,Ardon,1139,35,1174
24,Centre,45,2,01,008,Artenay,1772,24,1796
24,Centre,45,3,26,009,Aschères-le-Marché,1166,19,1185
24,Centre,45,3,29,010,Ascoux,869,27,896
24,Centre,45,3,26,011,Attray,208,4,212
24,Centre,45,3,17,012,Audeville,168,4,172
24,Centre,45,3,30,013,Augerville-la-Rivière,230,3,233
24,Centre,45,3,30,014,Aulnay-la-Rivière,518,19,537
24,Centre,45,3,26,015,Autruy-sur-Juine,732,16,748
24,Centre,45,1,09,016,Autry-le-Châtel,1024,51,1075
24,Centre,45,1,04,017,Auvilliers-en-Gâtinais,343,17,360
24,Centre,45,3,03,018,Auxy,995,16,1011
24,Centre,45,2,18,019,Baccon,681,18,699
24,Centre,45,2,18,020,Le Bardon,955,17,972
24,Centre,45,3,03,021,Barville-en-Gâtinais,281,6,287
24,Centre,45,3,03,022,Batilly-en-Gâtinais,399,10,409
24,Centre,45,1,05,023,Batilly-en-Puisaye,110,10,120
24,Centre,45,2,02,024,Baule,2028,76,2104
24,Centre,45,3,26,025,Bazoches-les-Gallerandes,1437,25,1462
24,Centre,45,1,11,026,Bazoches-sur-le-Betz,886,16,902
24,Centre,45,1,04,027,Beauchamps-sur-Huillard,410,24,434
24,Centre,45,2,02,028,Beaugency,7715,234,7949
24,Centre,45,1,09,029,Beaulieu-sur-Loire,1765,54,1819
24,Centre,45,3,03,030,Beaune-la-Rolande,2069,147,2216
24,Centre,45,1,04,031,Bellegarde,1700,134,1834
24,Centre,45,1,12,032,Le Bignon-Mirabeau,261,4,265
24,Centre,45,3,30,033,Boësses,376,7,383
24,Centre,45,2,38,034,Boigny-sur-Bionne,2128,75,2203
24,Centre,45,3,03,035,Boiscommun,1157,26,1183
24,Centre,45,1,14,036,Boismorand,800,34,834
24,Centre,45,3,26,037,Boisseaux,373,2,375
24,Centre,45,3,29,038,Bondaroy,391,17,408
24,Centre,45,2,27,039,Bonnée,676,21,697
24,Centre,45,1,05,040,Bonny-sur-Loire,2054,63,2117
24,Centre,45,3,03,041,Bordeaux-en-Gâtinais,116,3,119
24,Centre,45,2,27,042,Les Bordes,1693,56,1749
24,Centre,45,2,38,043,Bou,900,29,929
24,Centre,45,2,20,044,Bougy-lez-Neuville,177,0,177
24,Centre,45,3,29,045,Bouilly-en-Gâtinais,325,5,330
24,Centre,45,2,28,046,Boulay-les-Barres,1121,18,1139
24,Centre,45,3,29,047,Bouzonville-aux-Bois,420,4,424
24,Centre,45,2,06,049,Bouzy-la-Forêt,1176,15,1191
24,Centre,45,3,29,050,Boynes,1192,53,1245
24,Centre,45,2,27,051,Bray-en-Val,1310,25,1335
24,Centre,45,1,05,052,Breteau,77,7,84
24,Centre,45,1,05,053,Briare,5709,184,5893
24,Centre,45,3,30,054,Briarres-sur-Essonne,576,11,587
24,Centre,45,2,28,055,Bricy,540,10,550
24,Centre,45,3,30,056,Bromeilles,330,6,336
24,Centre,45,2,01,058,Bucy-le-Roi,190,4,194
24,Centre,45,2,28,059,Bucy-Saint-Liphard,208,6,214
24,Centre,45,1,05,060,La Bussière,796,26,822
24,Centre,45,1,33,061,Cepoy,2337,67,2404
24,Centre,45,2,01,062,Cercottes,1156,15,1171
24,Centre,45,2,31,063,Cerdon,1059,21,1080
24,Centre,45,1,09,064,Cernoy-en-Berry,459,16,475
24,Centre,45,3,17,065,Césarville-Dossainville,212,5,217
24,Centre,45,1,16,066,Chailly-en-Gâtinais,657,12,669
24,Centre,45,2,18,067,Chaingy,3432,109,3541
24,Centre,45,1,33,068,Châlette-sur-Loing,13021,365,13386
24,Centre,45,3,03,069,Chambon-la-Forêt,738,18,756
24,Centre,45,1,05,070,Champoulet,51,0,51
24,Centre,45,2,34,072,Chanteau,1237,27,1264
24,Centre,45,1,11,073,Chantecoq,515,11,526
24,Centre,45,2,28,074,La Chapelle-Onzerain,108,3,111
24,Centre,45,2,39,075,La Chapelle-Saint-Mesmin,9367,183,9550
24,Centre,45,1,11,076,La Chapelle-Saint-Sépulcre,272,10,282
24,Centre,45,1,08,077,La Chapelle-sur-Aveyron,503,11,514
24,Centre,45,1,04,078,Chapelon,285,9,294
24,Centre,45,1,08,079,Le Charme,147,6,153
24,Centre,45,3,26,080,Charmont-en-Beauce,378,6,384
24,Centre,45,2,18,081,Charsonville,615,14,629
24,Centre,45,1,07,083,Château-Renard,2321,81,2402
24,Centre,45,2,06,082,Châteauneuf-sur-Loire,7893,171,8064
24,Centre,45,2,06,084,Châtenoy,420,15,435
24,Centre,45,1,08,085,Châtillon-Coligny,1937,66,2003
24,Centre,45,3,26,086,Châtillon-le-Roi,276,6,282
24,Centre,45,1,09,087,Châtillon-sur-Loire,3104,90,3194
24,Centre,45,3,26,088,Chaussy,338,14,352
24,Centre,45,2,38,089,Chécy,8044,175,8219
24,Centre,45,1,12,091,Chevannes,322,8,330
24,Centre,45,1,32,092,Chevillon-sur-Huillard,1268,44,1312
24,Centre,45,2,01,093,Chevilly,2428,42,2470
24,Centre,45,1,12,094,Chevry-sous-le-Bignon,229,4,233
24,Centre,45,3,29,095,Chilleurs-aux-Bois,1879,30,1909
24,Centre,45,1,14,096,Les Choux,510,30,540
24,Centre,45,1,07,097,Chuelles,1113,38,1151
24,Centre,45,2,10,098,Cléry-Saint-André,3147,113,3260
24,Centre,45,2,28,099,Coinces,513,9,522
24,Centre,45,2,38,100,Combleux,460,22,482
24,Centre,45,2,06,101,Combreux,243,4,247
24,Centre,45,1,32,102,Conflans-sur-Loing,352,33,385
24,Centre,45,1,12,103,Corbeilles,1483,55,1538
24,Centre,45,1,33,104,Corquilleroy,2495,101,2596
24,Centre,45,1,08,105,Cortrat,88,6,94
24,Centre,45,3,17,106,Coudray,416,8,424
24,Centre,45,1,16,107,Coudroy,345,6,351
24,Centre,45,1,14,108,Coullons,2417,62,2479
24,Centre,45,2,18,109,Coulmiers,522,6,528
24,Centre,45,1,16,112,La Cour-Marigny,358,6,364
24,Centre,45,3,03,110,Courcelles,276,8,284
24,Centre,45,3,29,111,Courcy-aux-Loges,433,3,436
24,Centre,45,1,11,113,Courtemaux,279,22,301
24,Centre,45,1,12,114,Courtempierre,242,4,246
24,Centre,45,1,11,115,Courtenay,3796,95,3891
24,Centre,45,2,02,116,Cravant,930,8,938
24,Centre,45,3,26,118,Crottes-en-Pithiverais,328,7,335
24,Centre,45,3,29,119,Dadonville,2066,80,2146
24,Centre,45,1,05,120,Dammarie-en-Puisaye,172,6,178
24,Centre,45,1,08,121,Dammarie-sur-Loing,517,19,536
24,Centre,45,2,27,122,Dampierre-en-Burly,1226,40,1266
24,Centre,45,2,15,123,Darvoy,1864,31,1895
24,Centre,45,3,30,124,Desmonts,177,3,180
24,Centre,45,3,30,125,Dimancheville,90,2,92
24,Centre,45,2,38,126,Donnery,2392,63,2455
24,Centre,45,1,12,127,Dordives,2855,50,2905
24,Centre,45,1,07,129,Douchy,991,39,1030
24,Centre,45,2,10,130,Dry,1385,17,1402
24,Centre,45,3,30,131,Échilleuses,351,5,356
24,Centre,45,3,03,132,Égry,322,6,328
24,Centre,45,3,17,133,Engenville,476,9,485
24,Centre,45,2,18,134,Épieds-en-Beauce,1400,17,1417
24,Centre,45,3,26,135,Erceville,308,7,315
24,Centre,45,1,11,136,Ervauville,544,23,567
24,Centre,45,3,29,137,Escrennes,686,11,697
24,Centre,45,1,05,138,Escrignelles,71,1,72
24,Centre,45,3,29,139,Estouy,520,12,532
24,Centre,45,1,05,141,Faverelles,164,0,164
24,Centre,45,2,06,142,Fay-aux-Loges,3261,57,3318
24,Centre,45,1,05,143,Feins-en-Gâtinais,50,1,51
24,Centre,45,2,15,144,Férolles,1135,77,1212
24,Centre,45,1,12,145,Ferrières-en-Gâtinais,3331,63,3394
24,Centre,45,2,13,146,La Ferté-Saint-Aubin,7082,123,7205
24,Centre,45,2,34,147,Fleury-les-Aubrais,21203,303,21506
24,Centre,45,1,12,148,Fontenay-sur-Loing,1703,46,1749
24,Centre,45,1,11,149,Foucherolles,277,5,282
24,Centre,45,1,04,150,Fréville-du-Gâtinais,179,3,182
24,Centre,45,3,03,151,Gaubertin,265,10,275
24,Centre,45,2,28,152,Gémigny,195,4,199
24,Centre,45,2,06,153,Germigny-des-Prés,718,10,728
24,Centre,45,2,01,154,Gidy,1502,27,1529
24,Centre,45,1,14,155,Gien,15337,562,15899
24,Centre,45,1,12,156,Girolles,700,27,727
24,Centre,45,3,29,157,Givraines,339,12,351
24,Centre,45,1,12,158,Gondreville,373,13,386
24,Centre,45,3,30,159,Grangermont,214,4,218
24,Centre,45,3,26,160,Greneville-en-Beauce,651,8,659
24,Centre,45,1,12,161,Griselles,783,22,805
24,Centre,45,3,29,162,Guigneville,511,9,520
24,Centre,45,2,31,164,Guilly,651,7,658
24,Centre,45,1,07,165,Gy-les-Nonains,615,27,642
24,Centre,45,2,01,166,Huêtre,223,3,226
24,Centre,45,2,18,167,Huisseau-sur-Mauves,1679,33,1712
24,Centre,45,2,20,168,Ingrannes,502,10,512
24,Centre,45,2,39,169,Ingré,7927,182,8109
24,Centre,45,3,17,170,Intville-la-Guétard,110,2,112
24,Centre,45,2,31,171,Isdes,612,30,642
24,Centre,45,2,15,173,Jargeau,4454,122,4576
24,Centre,45,3,26,174,Jouy-en-Pithiverais,249,6,255
24,Centre,45,2,10,175,Jouy-le-Potier,1339,38,1377
24,Centre,45,3,03,176,Juranville,478,7,485
24,Centre,45,3,29,177,Laas,196,7,203
24,Centre,45,3,17,057,Labrosse,87,1,88
24,Centre,45,1,04,178,Ladon,1359,38,1397
24,Centre,45,2,02,179,Lailly-en-Val,2500,54,2554
24,Centre,45,1,14,180,Langesse,77,0,77
24,Centre,45,3,26,181,Léouville,66,0,66
24,Centre,45,2,13,182,Ligny-le-Ribault,1335,36,1371
24,Centre,45,2,01,183,Lion-en-Beauce,116,2,118
24,Centre,45,2,31,184,Lion-en-Sullias,407,14,421
24,Centre,45,1,32,185,Lombreuil,288,14,302
24,Centre,45,3,03,186,Lorcy,555,11,566
24,Centre,45,1,16,187,Lorris,2916,76,2992
24,Centre,45,2,20,188,Loury,2486,59,2545
24,Centre,45,1,11,189,Louzouer,269,10,279
24,Centre,45,3,17,190,Mainvilliers,232,3,235
24,Centre,45,3,17,191,Malesherbes,6059,113,6172
24,Centre,45,3,17,192,Manchecourt,636,18,654
24,Centre,45,2,13,193,Marcilly-en-Villette,1961,58,2019
24,Centre,45,2,38,194,Mardié,2593,56,2649
24,Centre,45,3,29,195,Mareau-aux-Bois,585,11,596
24,Centre,45,2,10,196,Mareau-aux-Prés,1256,23,1279
24,Centre,45,2,38,197,Marigny-les-Usages,1129,32,1161
24,Centre,45,3,29,198,Marsainvilliers,280,15,295
24,Centre,45,1,07,199,Melleroy,520,11,531
24,Centre,45,2,13,200,Ménestreau-en-Villette,1471,49,1520
24,Centre,45,1,11,201,Mérinville,160,4,164
24,Centre,45,2,02,202,Messas,888,20,908
24,Centre,45,2,18,203,Meung-sur-Loire,6122,97,6219
24,Centre,45,1,04,205,Mézières-en-Gâtinais,260,3,263
24,Centre,45,2,10,204,Mézières-lez-Cléry,753,15,768
24,Centre,45,1,12,206,Mignères,327,15,342
24,Centre,45,1,12,207,Mignerette,330,18,348
24,Centre,45,1,19,208,Montargis,15526,900,16426
24,Centre,45,3,03,209,Montbarrois,258,12,270
24,Centre,45,1,08,210,Montbouy,744,18,762
24,Centre,45,1,07,211,Montcorbon,461,10,471
24,Centre,45,1,08,212,Montcresson,1314,42,1356
24,Centre,45,1,16,213,Montereau,609,16,625
24,Centre,45,3,26,214,Montigny,260,7,267
24,Centre,45,3,03,215,Montliard,222,5,227
24,Centre,45,1,32,216,Mormant-sur-Vernisson,126,6,132
24,Centre,45,3,17,217,Morville-en-Beauce,192,5,197
24,Centre,45,1,14,218,Le Moulinet-sur-Solin,140,4,144
24,Centre,45,1,04,219,Moulon,179,12,191
24,Centre,45,3,03,220,Nancray-sur-Rimarde,521,6,527
24,Centre,45,3,17,221,Nangeville,117,5,122
24,Centre,45,1,12,222,Nargis,1298,40,1338
24,Centre,45,1,04,223,Nesploy,364,9,373
24,Centre,45,2,20,224,Neuville-aux-Bois,4006,75,4081
24,Centre,45,3,30,225,La Neuville-sur-Essonne,350,2,352
24,Centre,45,2,15,226,Neuvy-en-Sullias,1125,24,1149
24,Centre,45,1,14,227,Nevoy,1108,34,1142
24,Centre,45,3,03,228,Nibelle,965,23,988
24,Centre,45,1,08,229,Nogent-sur-Vernisson,2551,47,2598
24,Centre,45,1,16,230,Noyers,714,25,739
24,Centre,45,3,26,231,Oison,121,0,121
24,Centre,45,2,35,232,Olivet,20103,620,20723
24,Centre,45,3,30,233,Ondreville-sur-Essonne,369,7,376
24,Centre,45,2,99,234,Orléans,113257,3258,116515
24,Centre,45,2,39,235,Ormes,3381,64,3445
24,Centre,45,3,17,236,Orveau-Bellesauve,377,7,384
24,Centre,45,3,30,237,Orville,115,3,118
24,Centre,45,1,05,238,Ousson-sur-Loire,754,32,786
24,Centre,45,1,16,239,Oussoy-en-Gâtinais,403,13,416
24,Centre,45,3,26,240,Outarville,1443,24,1467
24,Centre,45,2,15,241,Ouvrouer-les-Champs,508,12,520
24,Centre,45,1,16,242,Ouzouer-des-Champs,356,11,367
24,Centre,45,1,04,243,Ouzouer-sous-Bellegarde,263,6,269
24,Centre,45,2,27,244,Ouzouer-sur-Loire,2713,76,2789
24,Centre,45,1,05,245,Ouzouer-sur-Trézée,1302,21,1323
24,Centre,45,3,17,246,Pannecières,118,1,119
24,Centre,45,1,33,247,Pannes,3181,104,3285
24,Centre,45,2,28,248,Patay,2090,33,2123
24,Centre,45,1,33,249,Paucourt,889,63,952
24,Centre,45,1,11,250,Pers-en-Gâtinais,201,5,206
24,Centre,45,1,09,251,Pierrefitte-ès-Bois,284,14,298
24,Centre,45,3,29,252,Pithiviers,8719,197,8916
24,Centre,45,3,29,253,Pithiviers-le-Vieil,1881,52,1933
24,Centre,45,1,14,254,Poilly-lez-Gien,2287,70,2357
24,Centre,45,1,12,255,Préfontaines,468,16,484
24,Centre,45,1,16,256,Presnoy,250,4,254
24,Centre,45,1,08,257,Pressigny-les-Pins,421,6,427
24,Centre,45,3,30,258,Puiseaux,3284,81,3365
24,Centre,45,1,04,259,Quiers-sur-Bézonde,1153,32,1185
24,Centre,45,3,17,260,Ramoulu,255,4,259
24,Centre,45,2,20,261,Rebréchien,1367,29,1396
24,Centre,45,2,28,262,Rouvray-Sainte-Croix,150,5,155
24,Centre,45,3,17,263,Rouvres-Saint-Jean,262,12,274
24,Centre,45,2,18,264,Rozières-en-Beauce,184,3,187
24,Centre,45,1,11,265,Rozoy-le-Vieil,378,5,383
24,Centre,45,2,01,266,Ruan,223,7,230
24,Centre,45,2,06,267,Saint-Aignan-des-Gués,338,9,347
24,Centre,45,2,31,268,Saint-Aignan-le-Jaillard,549,11,560
24,Centre,45,2,18,269,Saint-Ay,3060,52,3112
24,Centre,45,2,27,270,Saint-Benoît-sur-Loire,1999,39,2038
24,Centre,45,1,14,271,Saint-Brisson-sur-Loire,1045,46,1091
24,Centre,45,2,40,272,Saint-Cyr-en-Val,3147,145,3292
24,Centre,45,2,06,273,Saint-Denis-de-l'Hôtel,2826,41,2867
24,Centre,45,2,40,274,Saint-Denis-en-Val,7176,224,7400
24,Centre,45,1,07,275,Saint-Firmin-des-Bois,460,12,472
24,Centre,45,1,09,276,Saint-Firmin-sur-Loire,510,12,522
24,Centre,45,2,31,277,Saint-Florent,472,4,476
24,Centre,45,1,07,279,Saint-Germain-des-Prés,1883,43,1926
24,Centre,45,1,14,280,Saint-Gondon,1078,34,1112
24,Centre,45,1,11,281,Saint-Hilaire-les-Andrésis,944,31,975
24,Centre,45,2,35,282,Saint-Hilaire-Saint-Mesmin,2733,81,2814
24,Centre,45,1,16,283,Saint-Hilaire-sur-Puiseaux,172,6,178
24,Centre,45,2,36,284,Saint-Jean-de-Braye,18933,515,19448
24,Centre,45,2,37,285,Saint-Jean-de-la-Ruelle,16669,327,16996
24,Centre,45,2,40,286,Saint-Jean-le-Blanc,8294,256,8550
24,Centre,45,1,11,287,Saint-Loup-de-Gonois,110,2,112
24,Centre,45,3,03,288,Saint-Loup-des-Vignes,437,10,447
24,Centre,45,2,20,289,Saint-Lyé-la-Forêt,1052,17,1069
24,Centre,45,2,06,290,Saint-Martin-d'Abbat,1581,27,1608
24,Centre,45,1,14,291,Saint-Martin-sur-Ocre,1225,44,1269
24,Centre,45,1,08,292,Saint-Maurice-sur-Aveyron,865,43,908
24,Centre,45,1,32,293,Saint-Maurice-sur-Fessard,1123,35,1158
24,Centre,45,3,03,294,Saint-Michel,120,5,125
24,Centre,45,2,28,296,Saint-Péravy-la-Colombe,644,8,652
24,Centre,45,2,31,297,Saint-Père-sur-Loire,1044,32,1076
24,Centre,45,2,35,298,Saint-Pryvé-Saint-Mesmin,5271,145,5416
24,Centre,45,2,28,299,Saint-Sigismond,275,3,278
24,Centre,45,1,08,278,Sainte-Geneviève-des-Bois,1064,73,1137
24,Centre,45,2,15,300,Sandillon,3738,79,3817
24,Centre,45,3,29,301,Santeau,340,8,348
24,Centre,45,2,39,302,Saran,15328,300,15628
24,Centre,45,1,12,303,Sceaux-du-Gâtinais,594,16,610
24,Centre,45,2,06,305,Seichebrières,182,4,186
24,Centre,45,1,07,306,La Selle-en-Hermoy,768,22,790
24,Centre,45,1,11,307,La Selle-sur-le-Bied,964,37,1001
24,Centre,45,2,36,308,Semoy,2910,63,2973
24,Centre,45,2,13,309,Sennely,610,8,618
24,Centre,45,3,17,310,Sermaises,1620,34,1654
24,Centre,45,2,15,311,Sigloy,635,7,642
24,Centre,45,1,32,312,Solterre,494,22,516
24,Centre,45,2,01,313,Sougy,855,17,872
24,Centre,45,2,20,314,Sully-la-Chapelle,397,5,402
24,Centre,45,2,31,315,Sully-sur-Loire,5668,130,5798
24,Centre,45,2,06,316,Sury-aux-Bois,727,14,741
24,Centre,45,2,02,317,Tavers,1306,35,1341
24,Centre,45,3,17,320,Thignonville,321,11,332
24,Centre,45,1,16,321,Thimory,670,19,689
24,Centre,45,1,11,322,Thorailles,141,2,143
24,Centre,45,1,05,323,Thou,235,12,247
24,Centre,45,2,15,324,Tigy,2228,38,2266
24,Centre,45,3,26,325,Tivernon,235,4,239
24,Centre,45,2,28,326,Tournoisis,363,8,371
24,Centre,45,2,20,327,Traînou,3073,49,3122
24,Centre,45,1,12,328,Treilles-en-Gâtinais,294,5,299
24,Centre,45,1,07,329,Triguères,1348,23,1371
24,Centre,45,2,01,330,Trinay,206,4,210
24,Centre,45,2,15,331,Vannes-sur-Cosson,595,17,612
24,Centre,45,1,16,332,Varennes-Changy,1504,30,1534
24,Centre,45,2,20,333,Vennecy,1380,18,1398
24,Centre,45,1,16,334,Vieilles-Maisons-sur-Joudry,584,15,599
24,Centre,45,2,15,335,Vienne-en-Val,1772,39,1811
24,Centre,45,2,31,336,Viglain,899,13,912
24,Centre,45,2,28,337,Villamblain,276,8,284
24,Centre,45,1,32,338,Villemandeur,6299,404,6703
24,Centre,45,1,04,339,Villemoutiers,497,9,506
24,Centre,45,2,31,340,Villemurlin,538,8,546
24,Centre,45,2,28,341,Villeneuve-sur-Conie,207,9,216
24,Centre,45,2,20,342,Villereau,395,12,407
24,Centre,45,1,33,343,Villevoques,203,12,215
24,Centre,45,2,02,344,Villorceau,1088,23,1111
24,Centre,45,1,32,345,Vimory,1106,28,1134
24,Centre,45,2,06,346,Vitry-aux-Loges,1811,42,1853
24,Centre,45,3,29,347,Vrigny,760,33,793
24,Centre,45,3,29,348,Yèvre-la-Ville,682,25,707
73,Midi-Pyrénées,46,1,19,001,Albas,507,9,516
73,Midi-Pyrénées,46,2,13,002,Albiac,82,3,85
73,Midi-Pyrénées,46,3,11,003,Alvignac,663,21,684
73,Midi-Pyrénées,46,2,13,004,Anglars,162,3,165
73,Midi-Pyrénées,46,1,19,005,Anglars-Juillac,344,8,352
73,Midi-Pyrénées,46,3,10,006,Anglars-Nozac,296,4,300
73,Midi-Pyrénées,46,1,03,007,Arcambal,922,33,955
73,Midi-Pyrénées,46,1,07,008,Les Arques,184,3,187
73,Midi-Pyrénées,46,2,18,009,Assier,698,22,720
73,Midi-Pyrénées,46,1,14,010,Aujols,281,9,290
73,Midi-Pyrénées,46,2,24,011,Autoire,353,15,368
73,Midi-Pyrénées,46,2,13,012,Aynac,557,8,565
73,Midi-Pyrénées,46,1,14,013,Bach,177,3,180
73,Midi-Pyrénées,46,1,21,014,Bagat-en-Quercy,192,4,196
73,Midi-Pyrénées,46,2,08,015,Bagnac-sur-Célé,1571,58,1629
73,Midi-Pyrénées,46,3,20,016,Baladou,402,8,410
73,Midi-Pyrénées,46,2,24,017,Bannes,138,5,143
73,Midi-Pyrénées,46,3,11,018,Le Bastit,130,2,132
73,Midi-Pyrénées,46,3,12,019,Beaumat,77,0,77
73,Midi-Pyrénées,46,1,17,020,Beauregard,241,7,248
73,Midi-Pyrénées,46,2,09,021,Béduer,726,30,756
73,Midi-Pyrénées,46,1,19,022,Bélaye,218,10,228
73,Midi-Pyrénées,46,1,14,023,Belfort-du-Quercy,528,10,538
73,Midi-Pyrénées,46,2,01,024,Belmont-Bretenoux,330,8,338
73,Midi-Pyrénées,46,1,14,026,Belmont-Sainte-Foi,114,0,114
73,Midi-Pyrénées,46,1,21,025,Belmontet,152,4,156
73,Midi-Pyrénées,46,1,26,027,Berganty,97,4,101
73,Midi-Pyrénées,46,2,15,338,Bessonies,105,3,108
73,Midi-Pyrénées,46,3,29,028,Bétaille,1015,19,1034
73,Midi-Pyrénées,46,2,01,029,Biars-sur-Cère,1944,87,2031
73,Midi-Pyrénées,46,3,11,030,Bio,297,10,307
73,Midi-Pyrénées,46,1,16,031,Blars,125,1,126
73,Midi-Pyrénées,46,1,06,032,Boissières,361,8,369
73,Midi-Pyrénées,46,1,21,033,Le Boulvé,193,9,202
73,Midi-Pyrénées,46,2,13,034,Le Bourg,296,8,304
73,Midi-Pyrénées,46,2,18,035,Boussac,173,8,181
73,Midi-Pyrénées,46,2,13,036,Le Bouyssou,132,9,141
73,Midi-Pyrénées,46,1,26,037,Bouziès,77,2,79
73,Midi-Pyrénées,46,2,18,039,Brengues,234,6,240
73,Midi-Pyrénées,46,2,01,038,Bretenoux,1331,50,1381
73,Midi-Pyrénées,46,1,16,040,Cabrerets,228,5,233
73,Midi-Pyrénées,46,2,04,041,Cadrieu,152,3,155
73,Midi-Pyrénées,46,1,98,042,Cahors,20031,1126,21157
73,Midi-Pyrénées,46,2,01,043,Cahus,191,3,194
73,Midi-Pyrénées,46,1,19,044,Caillac,573,15,588
73,Midi-Pyrénées,46,2,04,045,Cajarc,1099,58,1157
73,Midi-Pyrénées,46,1,06,046,Calamane,443,12,455
73,Midi-Pyrénées,46,3,22,047,Calès,151,7,158
73,Midi-Pyrénées,46,2,30,048,Calviac,177,5,182
73,Midi-Pyrénées,46,1,17,049,Calvignac,197,7,204
73,Midi-Pyrénées,46,1,19,050,Cambayrac,139,3,142
73,Midi-Pyrénées,46,2,18,051,Cambes,361,14,375
73,Midi-Pyrénées,46,2,09,052,Camboulit,245,6,251
73,Midi-Pyrénées,46,2,09,053,Camburat,440,4,444
73,Midi-Pyrénées,46,3,12,054,Caniac-du-Causse,333,6,339
73,Midi-Pyrénées,46,2,09,055,Capdenac,1100,30,1130
73,Midi-Pyrénées,46,2,04,056,Carayac,76,2,78
73,Midi-Pyrénées,46,2,13,057,Cardaillac,559,30,589
73,Midi-Pyrénées,46,3,29,058,Carennac,383,14,397
73,Midi-Pyrénées,46,3,11,059,Carlucet,225,11,236
73,Midi-Pyrénées,46,1,19,060,Carnac-Rouffiac,247,4,251
73,Midi-Pyrénées,46,1,23,061,Cassagnes,208,12,220
73,Midi-Pyrénées,46,1,19,062,Castelfranc,444,8,452
73,Midi-Pyrénées,46,1,05,063,Castelnau-Montratier,1855,124,1979
73,Midi-Pyrénées,46,1,06,064,Catus,926,16,942
73,Midi-Pyrénées,46,3,29,065,Cavagnac,446,14,460
73,Midi-Pyrénées,46,1,07,066,Cazals,639,20,659
73,Midi-Pyrénées,46,3,20,067,Cazillac,401,3,404
73,Midi-Pyrénées,46,1,17,068,Cénevières,178,2,180
73,Midi-Pyrénées,46,1,05,069,Cézac,163,4,167
73,Midi-Pyrénées,46,1,14,070,Cieurac,411,15,426
73,Midi-Pyrénées,46,2,30,071,Comiac,233,10,243
73,Midi-Pyrénées,46,3,25,072,Concorès,301,6,307
73,Midi-Pyrénées,46,1,17,073,Concots,402,6,408
73,Midi-Pyrénées,46,3,29,074,Condat,420,4,424
73,Midi-Pyrénées,46,2,18,075,Corn,199,4,203
73,Midi-Pyrénées,46,2,01,076,Cornac,357,8,365
73,Midi-Pyrénées,46,1,26,077,Cours,271,9,280
73,Midi-Pyrénées,46,3,11,078,Couzou,102,3,105
73,Midi-Pyrénées,46,1,16,079,Cras,91,5,96
73,Midi-Pyrénées,46,1,06,080,Crayssac,715,8,723
73,Midi-Pyrénées,46,1,26,081,Crégols,83,3,86
73,Midi-Pyrénées,46,1,14,082,Cremps,308,6,314
73,Midi-Pyrénées,46,3,20,083,Cressensac,658,18,676
73,Midi-Pyrénées,46,3,20,084,Creysse,296,5,301
73,Midi-Pyrénées,46,2,08,085,Cuzac,231,5,236
73,Midi-Pyrénées,46,3,20,086,Cuzance,491,8,499
73,Midi-Pyrénées,46,3,27,087,Dégagnac,588,4,592
73,Midi-Pyrénées,46,1,19,088,Douelle,765,20,785
73,Midi-Pyrénées,46,1,23,089,Duravel,962,31,993
73,Midi-Pyrénées,46,2,18,090,Durbans,141,5,146
73,Midi-Pyrénées,46,1,14,091,Escamps,155,4,159
73,Midi-Pyrénées,46,1,26,092,Esclauzels,198,4,202
73,Midi-Pyrénées,46,2,18,093,Espagnac-Sainte-Eulalie,84,2,86
73,Midi-Pyrénées,46,2,18,094,Espédaillac,262,4,266
73,Midi-Pyrénées,46,1,31,095,Espère,978,32,1010
73,Midi-Pyrénées,46,2,13,096,Espeyroux,99,4,103
73,Midi-Pyrénées,46,2,01,097,Estal,123,1,124
73,Midi-Pyrénées,46,3,22,098,Fajoles,272,8,280
73,Midi-Pyrénées,46,1,21,099,Fargues,162,7,169
73,Midi-Pyrénées,46,2,09,100,Faycelles,621,15,636
73,Midi-Pyrénées,46,2,08,101,Felzins,360,15,375
73,Midi-Pyrénées,46,2,99,102,Figeac,9984,743,10727
73,Midi-Pyrénées,46,1,05,103,Flaugnac,426,18,444
73,Midi-Pyrénées,46,2,18,104,Flaujac-Gare,90,4,94
73,Midi-Pyrénées,46,1,14,105,Flaujac-Poujols,677,22,699
73,Midi-Pyrénées,46,3,20,106,Floirac,270,6,276
73,Midi-Pyrénées,46,1,23,107,Floressas,149,4,153
73,Midi-Pyrénées,46,2,09,108,Fons,400,13,413
73,Midi-Pyrénées,46,1,14,109,Fontanes,456,11,467
73,Midi-Pyrénées,46,3,12,110,Fontanes-du-Causse,71,1,72
73,Midi-Pyrénées,46,2,09,111,Fourmagnac,145,2,147
73,Midi-Pyrénées,46,1,06,112,Francoulès,217,4,221
73,Midi-Pyrénées,46,3,25,113,Frayssinet,285,8,293
73,Midi-Pyrénées,46,1,07,114,Frayssinet-le-Gélat,410,5,415
73,Midi-Pyrénées,46,2,24,115,Frayssinhes,197,8,205
73,Midi-Pyrénées,46,2,04,116,Frontenac,76,0,76
73,Midi-Pyrénées,46,2,01,117,Gagnac-sur-Cère,730,41,771
73,Midi-Pyrénées,46,3,28,118,Gignac,624,18,642
73,Midi-Pyrénées,46,1,06,119,Gigouzac,221,9,230
73,Midi-Pyrénées,46,1,07,120,Gindou,310,14,324
73,Midi-Pyrénées,46,3,12,121,Ginouillac,167,1,168
73,Midi-Pyrénées,46,2,01,122,Gintrac,108,2,110
73,Midi-Pyrénées,46,2,01,123,Girac,389,17,406
73,Midi-Pyrénées,46,2,01,124,Glanes,297,11,308
73,Midi-Pyrénées,46,2,15,125,Gorses,348,8,356
73,Midi-Pyrénées,46,1,07,126,Goujounac,209,3,212
73,Midi-Pyrénées,46,3,10,127,Gourdon,4603,187,4790
73,Midi-Pyrénées,46,3,11,128,Gramat,3524,111,3635
73,Midi-Pyrénées,46,2,04,129,Gréalou,243,8,251
73,Midi-Pyrénées,46,1,23,130,Grézels,215,10,225
73,Midi-Pyrénées,46,2,18,131,Grèzes,160,9,169
73,Midi-Pyrénées,46,2,13,132,Issendolus,537,9,546
73,Midi-Pyrénées,46,2,18,133,Issepts,177,4,181
73,Midi-Pyrénées,46,1,06,134,Les Junies,256,5,261
73,Midi-Pyrénées,46,2,15,135,Labastide-du-Haut-Mont,41,6,47
73,Midi-Pyrénées,46,1,06,136,Labastide-du-Vert,230,8,238
73,Midi-Pyrénées,46,1,03,137,Labastide-Marnhac,1058,35,1093
73,Midi-Pyrénées,46,3,12,138,Labastide-Murat,640,20,660
73,Midi-Pyrénées,46,2,13,139,Labathude,183,5,188
73,Midi-Pyrénées,46,1,14,140,Laburgade,290,6,296
73,Midi-Pyrénées,46,2,30,141,Lacam-d'Ourcet,128,1,129
73,Midi-Pyrénées,46,1,23,142,Lacapelle-Cabanac,153,5,158
73,Midi-Pyrénées,46,2,13,143,Lacapelle-Marival,1324,50,1374
73,Midi-Pyrénées,46,3,28,144,Lacave,290,10,300
73,Midi-Pyrénées,46,3,28,145,Lachapelle-Auzac,767,15,782
73,Midi-Pyrénées,46,2,15,146,Ladirat,115,4,119
73,Midi-Pyrénées,46,1,23,147,Lagardelle,130,1,131
73,Midi-Pyrénées,46,1,14,148,Lalbenque,1468,34,1502
73,Midi-Pyrénées,46,1,02,149,Lamagdelaine,764,44,808
73,Midi-Pyrénées,46,2,30,150,Lamativie,67,2,69
73,Midi-Pyrénées,46,3,25,151,Lamothe-Cassel,102,1,103
73,Midi-Pyrénées,46,3,22,152,Lamothe-Fénelon,339,5,344
73,Midi-Pyrénées,46,3,28,153,Lanzac,567,12,579
73,Midi-Pyrénées,46,1,17,154,Laramière,300,8,308
73,Midi-Pyrénées,46,2,04,155,Larnagol,133,7,140
73,Midi-Pyrénées,46,1,02,156,Laroque-des-Arcs,482,19,501
73,Midi-Pyrénées,46,2,04,157,Larroque-Toirac,150,3,153
73,Midi-Pyrénées,46,1,21,158,Lascabanes,184,3,187
73,Midi-Pyrénées,46,2,24,159,Latouille-Lentillac,243,12,255
73,Midi-Pyrénées,46,2,15,160,Latronquière,543,10,553
73,Midi-Pyrénées,46,2,15,161,Lauresses,288,7,295
73,Midi-Pyrénées,46,1,16,162,Lauzès,167,1,168
73,Midi-Pyrénées,46,2,01,163,Laval-de-Cère,346,12,358
73,Midi-Pyrénées,46,3,27,164,Lavercantière,253,3,256
73,Midi-Pyrénées,46,3,11,165,Lavergne,430,16,446
73,Midi-Pyrénées,46,1,21,166,Lebreil,150,0,150
73,Midi-Pyrénées,46,1,16,167,Lentillac-du-Causse,107,2,109
73,Midi-Pyrénées,46,2,08,168,Lentillac-Saint-Blaise,135,3,138
73,Midi-Pyrénées,46,3,27,169,Léobard,203,6,209
73,Midi-Pyrénées,46,2,13,170,Leyme,989,24,1013
73,Midi-Pyrénées,46,1,06,171,Lherm,235,7,242
73,Midi-Pyrénées,46,1,05,172,Lhospitalet,453,14,467
73,Midi-Pyrénées,46,1,17,173,Limogne-en-Quercy,797,9,806
73,Midi-Pyrénées,46,2,08,174,Linac,202,6,208
73,Midi-Pyrénées,46,2,09,175,Lissac-et-Mouret,914,36,950
73,Midi-Pyrénées,46,2,18,176,Livernon,594,10,604
73,Midi-Pyrénées,46,2,24,177,Loubressac,489,24,513
73,Midi-Pyrénées,46,3,22,178,Loupiac,271,9,280
73,Midi-Pyrénées,46,1,17,179,Lugagnac,118,11,129
73,Midi-Pyrénées,46,2,08,180,Lunan,498,13,511
73,Midi-Pyrénées,46,3,12,181,Lunegarde,75,1,76
73,Midi-Pyrénées,46,1,19,182,Luzech,1737,35,1772
73,Midi-Pyrénées,46,2,04,183,Marcilhac-sur-Célé,199,8,207
73,Midi-Pyrénées,46,1,07,184,Marminiac,370,15,385
73,Midi-Pyrénées,46,3,20,185,Martel,1579,44,1623
73,Midi-Pyrénées,46,3,22,186,Masclat,338,5,343
73,Midi-Pyrénées,46,1,23,187,Mauroux,524,11,535
73,Midi-Pyrénées,46,1,06,188,Maxou,248,4,252
73,Midi-Pyrénées,46,3,28,337,Mayrac,263,2,265
73,Midi-Pyrénées,46,2,24,189,Mayrinhac-Lentour,484,15,499
73,Midi-Pyrénées,46,1,06,190,Mechmont,116,6,122
73,Midi-Pyrénées,46,1,31,191,Mercuès,1074,26,1100
73,Midi-Pyrénées,46,3,28,192,Meyronne,302,10,312
73,Midi-Pyrénées,46,3,11,193,Miers,433,19,452
73,Midi-Pyrénées,46,3,10,194,Milhac,208,6,214
73,Midi-Pyrénées,46,2,13,195,Molières,366,4,370
73,Midi-Pyrénées,46,3,25,196,Montamel,94,7,101
73,Midi-Pyrénées,46,1,03,197,Le Montat,966,116,1082
73,Midi-Pyrénées,46,2,04,198,Montbrun,115,1,116
73,Midi-Pyrénées,46,1,23,199,Montcabrier,383,12,395
73,Midi-Pyrénées,46,1,07,200,Montcléra,275,12,287
73,Midi-Pyrénées,46,1,21,201,Montcuq,1315,63,1378
73,Midi-Pyrénées,46,1,14,202,Montdoumerc,419,5,424
73,Midi-Pyrénées,46,2,15,203,Montet-et-Bouxal,222,8,230
73,Midi-Pyrénées,46,3,12,204,Montfaucon,550,11,561
73,Midi-Pyrénées,46,1,06,205,Montgesty,284,4,288
73,Midi-Pyrénées,46,1,21,206,Montlauzun,129,4,133
73,Midi-Pyrénées,46,2,08,207,Montredon,288,9,297
73,Midi-Pyrénées,46,3,20,208,Montvalent,304,6,310
73,Midi-Pyrénées,46,3,22,209,Nadaillac-de-Rouge,181,0,181
73,Midi-Pyrénées,46,1,16,210,Nadillac,65,3,68
73,Midi-Pyrénées,46,1,06,211,Nuzéjouls,323,10,333
73,Midi-Pyrénées,46,1,16,212,Orniac,103,0,103
73,Midi-Pyrénées,46,3,11,213,Padirac,196,4,200
73,Midi-Pyrénées,46,1,19,214,Parnac,375,13,388
73,Midi-Pyrénées,46,3,22,215,Payrac,687,7,694
73,Midi-Pyrénées,46,3,10,216,Payrignac,705,18,723
73,Midi-Pyrénées,46,1,05,217,Pern,430,41,471
73,Midi-Pyrénées,46,1,23,218,Pescadoires,134,1,135
73,Midi-Pyrénées,46,3,25,219,Peyrilles,356,10,366
73,Midi-Pyrénées,46,3,28,220,Pinsac,727,12,739
73,Midi-Pyrénées,46,2,09,221,Planioles,490,29,519
73,Midi-Pyrénées,46,1,07,222,Pomarède,184,8,192
73,Midi-Pyrénées,46,1,06,223,Pontcirq,156,3,159
73,Midi-Pyrénées,46,1,31,224,Pradines,3317,132,3449
73,Midi-Pyrénées,46,1,23,225,Prayssac,2461,99,2560
73,Midi-Pyrénées,46,2,08,226,Prendeignes,209,6,215
73,Midi-Pyrénées,46,1,17,227,Promilhanes,183,1,184
73,Midi-Pyrénées,46,2,01,228,Prudhomat,691,31,722
73,Midi-Pyrénées,46,1,23,231,Puy-l'Évêque,2213,45,2258
73,Midi-Pyrénées,46,2,01,229,Puybrun,882,22,904
73,Midi-Pyrénées,46,2,04,230,Puyjourdes,62,2,64
73,Midi-Pyrénées,46,3,29,232,Les Quatre-Routes-du-Lot,688,14,702
73,Midi-Pyrénées,46,2,18,233,Quissac,117,2,119
73,Midi-Pyrénées,46,3,27,234,Rampoux,100,4,104
73,Midi-Pyrénées,46,2,18,235,Reilhac,168,5,173
73,Midi-Pyrénées,46,3,22,236,Reilhaguet,127,2,129
73,Midi-Pyrénées,46,2,18,237,Reyrevignes,281,2,283
73,Midi-Pyrénées,46,3,11,238,Rignac,259,16,275
73,Midi-Pyrénées,46,3,22,239,Le Roc,231,2,233
73,Midi-Pyrénées,46,3,11,240,Rocamadour,677,21,698
73,Midi-Pyrénées,46,3,10,241,Rouffilhac,160,12,172
73,Midi-Pyrénées,46,2,13,242,Rudelle,186,6,192
73,Midi-Pyrénées,46,2,13,243,Rueyres,236,3,239
73,Midi-Pyrénées,46,2,15,244,Sabadel-Latronquière,95,4,99
73,Midi-Pyrénées,46,1,16,245,Sabadel-Lauzès,95,2,97
73,Midi-Pyrénées,46,2,24,246,Saignes,70,1,71
73,Midi-Pyrénées,46,1,17,247,Saillac,140,8,148
73,Midi-Pyrénées,46,2,13,249,Saint-Bressou,109,7,116
73,Midi-Pyrénées,46,1,07,250,Saint-Caprais,79,1,80
73,Midi-Pyrénées,46,2,24,251,Saint-Céré,3582,149,3731
73,Midi-Pyrénées,46,1,16,252,Saint-Cernin,195,2,197
73,Midi-Pyrénées,46,3,25,253,Saint-Chamarand,202,7,209
73,Midi-Pyrénées,46,2,04,254,Saint-Chels,151,3,154
73,Midi-Pyrénées,46,2,15,255,Saint-Cirgues,382,14,396
73,Midi-Pyrénées,46,1,26,256,Saint-Cirq-Lapopie,216,8,224
73,Midi-Pyrénées,46,3,10,257,Saint-Cirq-Madelon,152,2,154
73,Midi-Pyrénées,46,3,10,258,Saint-Cirq-Souillaguet,145,1,146
73,Midi-Pyrénées,46,3,10,259,Saint-Clair,153,2,155
73,Midi-Pyrénées,46,1,21,262,Saint-Cyprien,309,4,313
73,Midi-Pyrénées,46,1,21,263,Saint-Daunès,227,4,231
73,Midi-Pyrénées,46,1,06,264,Saint-Denis-Catus,208,4,212
73,Midi-Pyrénées,46,3,20,265,Saint-Denis-lès-Martel,407,8,415
73,Midi-Pyrénées,46,2,08,266,Saint-Félix,432,14,446
73,Midi-Pyrénées,46,3,25,267,Saint-Germain-du-Bel-Air,514,14,528
73,Midi-Pyrénées,46,1,26,268,Saint-Géry,454,11,465
73,Midi-Pyrénées,46,2,15,269,Saint-Hilaire,77,3,80
73,Midi-Pyrénées,46,2,04,270,Saint-Jean-de-Laur,206,6,212
73,Midi-Pyrénées,46,2,24,339,Saint-Jean-Lagineste,295,8,303
73,Midi-Pyrénées,46,2,24,271,Saint-Jean-Lespinasse,414,27,441
73,Midi-Pyrénées,46,2,08,272,Saint-Jean-Mirabel,229,2,231
73,Midi-Pyrénées,46,2,24,273,Saint-Laurent-les-Tours,914,36,950
73,Midi-Pyrénées,46,1,21,274,Saint-Laurent-Lolmie,203,2,205
73,Midi-Pyrénées,46,1,16,275,Saint-Martin-de-Vers,116,7,123
73,Midi-Pyrénées,46,1,17,276,Saint-Martin-Labouval,177,2,179
73,Midi-Pyrénées,46,1,23,277,Saint-Martin-le-Redon,210,1,211
73,Midi-Pyrénées,46,1,21,278,Saint-Matré,130,3,133
73,Midi-Pyrénées,46,2,13,279,Saint-Maurice-en-Quercy,220,6,226
73,Midi-Pyrénées,46,1,06,280,Saint-Médard,165,4,169
73,Midi-Pyrénées,46,2,24,281,Saint-Médard-de-Presque,195,13,208
73,Midi-Pyrénées,46,2,15,282,Saint-Médard-Nicourby,90,0,90
73,Midi-Pyrénées,46,3,29,283,Saint-Michel-de-Bannières,302,6,308
73,Midi-Pyrénées,46,2,01,284,Saint-Michel-Loubéjou,365,17,382
73,Midi-Pyrénées,46,1,21,285,Saint-Pantaléon,238,5,243
73,Midi-Pyrénées,46,1,05,287,Saint-Paul-de-Loubressac,536,16,552
73,Midi-Pyrénées,46,2,24,286,Saint-Paul-de-Vern,180,2,182
73,Midi-Pyrénées,46,2,08,288,Saint-Perdoux,204,5,209
73,Midi-Pyrénées,46,1,06,340,Saint-Pierre-Lafeuille,342,4,346
73,Midi-Pyrénées,46,2,04,289,Saint-Pierre-Toirac,143,1,144
73,Midi-Pyrénées,46,3,10,290,Saint-Projet,399,9,408
73,Midi-Pyrénées,46,3,12,291,Saint-Sauveur-la-Vallée,58,0,58
73,Midi-Pyrénées,46,2,18,292,Saint-Simon,139,1,140
73,Midi-Pyrénées,46,3,28,293,Saint-Sozy,502,16,518
73,Midi-Pyrénées,46,2,04,294,Saint-Sulpice,132,6,138
73,Midi-Pyrénées,46,2,24,295,Saint-Vincent-du-Pendit,181,10,191
73,Midi-Pyrénées,46,1,19,296,Saint-Vincent-Rive-d'Olt,487,9,496
73,Midi-Pyrénées,46,1,05,248,Sainte-Alauzie,141,0,141
73,Midi-Pyrénées,46,2,13,260,Sainte-Colombe,160,4,164
73,Midi-Pyrénées,46,1,21,261,Sainte-Croix,81,1,82
73,Midi-Pyrénées,46,3,27,297,Salviac,1217,17,1234
73,Midi-Pyrénées,46,3,20,298,Sarrazac,569,12,581
73,Midi-Pyrénées,46,1,16,299,Sauliac-sur-Célé,110,3,113
73,Midi-Pyrénées,46,1,21,300,Saux,126,2,128
73,Midi-Pyrénées,46,1,19,301,Sauzet,493,19,512
73,Midi-Pyrénées,46,2,15,302,Sénaillac-Latronquière,147,4,151
73,Midi-Pyrénées,46,1,16,303,Sénaillac-Lauzès,161,7,168
73,Midi-Pyrénées,46,3,12,304,Séniergues,135,6,141
73,Midi-Pyrénées,46,1,23,305,Sérignac,295,6,301
73,Midi-Pyrénées,46,2,18,306,Sonac,78,3,81
73,Midi-Pyrénées,46,1,23,307,Soturac,653,18,671
73,Midi-Pyrénées,46,3,25,308,Soucirac,101,6,107
73,Midi-Pyrénées,46,3,28,309,Souillac,3887,377,4264
73,Midi-Pyrénées,46,3,12,310,Soulomès,117,2,119
73,Midi-Pyrénées,46,2,30,311,Sousceyrac,913,24,937
73,Midi-Pyrénées,46,3,29,312,Strenquels,271,12,283
73,Midi-Pyrénées,46,2,01,313,Tauriac,370,5,375
73,Midi-Pyrénées,46,2,15,314,Terrou,186,52,238
73,Midi-Pyrénées,46,2,01,315,Teyssieu,190,7,197
73,Midi-Pyrénées,46,3,27,316,Thédirac,300,3,303
73,Midi-Pyrénées,46,3,11,317,Thégra,495,14,509
73,Midi-Pyrénées,46,2,13,318,Thémines,232,14,246
73,Midi-Pyrénées,46,2,13,319,Théminettes,180,1,181
73,Midi-Pyrénées,46,1,26,320,Tour-de-Faure,379,3,382
73,Midi-Pyrénées,46,1,23,321,Touzac,351,6,357
73,Midi-Pyrénées,46,1,03,322,Trespoux-Rassiels,742,37,779
73,Midi-Pyrénées,46,3,25,323,Ussel,73,0,73
73,Midi-Pyrénées,46,3,25,324,Uzech,218,8,226
73,Midi-Pyrénées,46,3,12,325,Vaillac,95,2,97
73,Midi-Pyrénées,46,1,21,326,Valprionde,128,9,137
73,Midi-Pyrénées,46,1,02,327,Valroufié,417,6,423
73,Midi-Pyrénées,46,1,17,328,Varaire,301,5,306
73,Midi-Pyrénées,46,1,14,329,Vaylats,257,4,261
73,Midi-Pyrénées,46,3,29,330,Vayrac,1320,19,1339
73,Midi-Pyrénées,46,1,26,331,Vers,413,9,422
73,Midi-Pyrénées,46,2,08,332,Viazac,286,37,323
73,Midi-Pyrénées,46,1,17,333,Vidaillac,166,2,168
73,Midi-Pyrénées,46,3,10,334,Le Vigan,1437,36,1473
73,Midi-Pyrénées,46,1,19,335,Villesèque,383,10,393
73,Midi-Pyrénées,46,1,23,336,Vire-sur-Lot,361,43,404
72,Aquitaine,47,1,99,001,Agen,33245,1337,34582
72,Aquitaine,47,2,19,002,Agmé,121,2,123
72,Aquitaine,47,2,17,003,Agnac,419,7,426
72,Aquitaine,47,1,27,004,Aiguillon,4356,173,4529
72,Aquitaine,47,2,17,005,Allemans-du-Dropt,470,15,485
72,Aquitaine,47,3,30,006,Allez-et-Cazeneuve,674,27,701
72,Aquitaine,47,4,14,007,Allons,173,7,180
72,Aquitaine,47,4,10,008,Ambrus,95,3,98
72,Aquitaine,47,4,25,009,Andiran,241,13,254
72,Aquitaine,47,2,05,010,Antagnac,214,3,217
72,Aquitaine,47,3,33,011,Anthé,202,5,207
72,Aquitaine,47,4,07,012,Anzex,268,1,269
72,Aquitaine,47,2,05,013,Argenton,304,8,312
72,Aquitaine,47,2,17,014,Armillac,174,3,177
72,Aquitaine,47,1,03,015,Astaffort,2016,70,2086
72,Aquitaine,47,1,15,016,Aubiac,1002,29,1031
72,Aquitaine,47,3,26,017,Auradou,360,20,380
72,Aquitaine,47,2,11,018,Auriac-sur-Dropt,201,4,205
72,Aquitaine,47,1,02,019,Bajamont,898,46,944
72,Aquitaine,47,2,11,020,Baleyssagues,197,5,202
72,Aquitaine,47,4,18,021,Barbaste,1488,82,1570
72,Aquitaine,47,1,27,022,Bazens,520,13,533
72,Aquitaine,47,3,06,023,Beaugas,347,12,359
72,Aquitaine,47,2,38,024,Beaupuy,1370,33,1403
72,Aquitaine,47,1,04,025,Beauville,589,18,607
72,Aquitaine,47,4,07,026,Beauziac,247,6,253
72,Aquitaine,47,3,39,027,Bias,3166,150,3316
72,Aquitaine,47,2,19,028,Birac-sur-Trec,786,22,808
72,Aquitaine,47,3,13,029,Blanquefort-sur-Briolance,508,15,523
72,Aquitaine,47,1,04,030,Blaymont,223,6,229
72,Aquitaine,47,1,40,031,Boé,5342,136,5478
72,Aquitaine,47,1,40,032,Bon-Encontre,5961,160,6121
72,Aquitaine,47,3,06,033,Boudy-de-Beauregard,395,10,405
72,Aquitaine,47,2,05,034,Bouglon,594,7,601
72,Aquitaine,47,2,17,035,Bourgougnague,286,89,375
72,Aquitaine,47,3,33,036,Bourlens,363,8,371
72,Aquitaine,47,3,35,037,Bournel,250,5,255
72,Aquitaine,47,1,27,038,Bourran,605,15,620
72,Aquitaine,47,4,14,039,Boussès,42,0,42
72,Aquitaine,47,1,15,040,Brax,1777,48,1825
72,Aquitaine,47,4,18,041,Bruch,772,5,777
72,Aquitaine,47,2,08,042,Brugnac,189,7,196
72,Aquitaine,47,4,10,043,Buzet-sur-Baïse,1227,28,1255
72,Aquitaine,47,3,09,044,Cahuzac,293,8,301
72,Aquitaine,47,4,25,045,Calignac,438,20,458
72,Aquitaine,47,2,20,046,Calonges,573,15,588
72,Aquitaine,47,2,31,047,Cambes,166,1,167
72,Aquitaine,47,3,06,048,Cancon,1282,32,1314
72,Aquitaine,47,3,06,049,Casseneuil,2374,77,2451
72,Aquitaine,47,1,16,050,Cassignas,139,4,143
72,Aquitaine,47,1,29,051,Castelculier,2256,48,2304
72,Aquitaine,47,4,07,052,Casteljaloux,4580,66,4646
72,Aquitaine,47,1,16,053,Castella,334,10,344
72,Aquitaine,47,2,08,054,Castelmoron-sur-Lot,1761,46,1807
72,Aquitaine,47,2,31,056,Castelnau-sur-Gupie,816,19,835
72,Aquitaine,47,3,06,055,Castelnaud-de-Gratecambe,549,13,562
72,Aquitaine,47,3,09,057,Castillonnès,1442,33,1475
72,Aquitaine,47,4,10,058,Caubeyres,181,3,184
72,Aquitaine,47,2,31,059,Caubon-Saint-Sauveur,232,2,234
72,Aquitaine,47,1,03,060,Caudecoste,920,25,945
72,Aquitaine,47,2,20,061,Caumont-sur-Garonne,605,19,624
72,Aquitaine,47,1,04,062,Cauzac,376,10,386
72,Aquitaine,47,3,09,063,Cavarc,130,7,137
72,Aquitaine,47,3,33,064,Cazideroque,246,1,247
72,Aquitaine,47,2,32,065,Clairac,2448,202,2650
72,Aquitaine,47,1,27,066,Clermont-Dessous,788,21,809
72,Aquitaine,47,1,29,067,Clermont-Soubiran,371,12,383
72,Aquitaine,47,2,21,068,Cocumont,947,14,961
72,Aquitaine,47,1,36,069,Colayrac-Saint-Cirq,2859,110,2969
72,Aquitaine,47,3,13,070,Condezaygues,876,21,897
72,Aquitaine,47,2,08,071,Coulx,228,4,232
72,Aquitaine,47,3,33,072,Courbiac,111,1,112
72,Aquitaine,47,1,28,073,Cours,213,3,216
72,Aquitaine,47,2,21,074,Couthures-sur-Garonne,405,21,426
72,Aquitaine,47,1,16,075,La Croix-Blanche,816,19,835
72,Aquitaine,47,1,03,076,Cuq,258,5,263
72,Aquitaine,47,3,13,077,Cuzorn,850,18,868
72,Aquitaine,47,4,10,078,Damazan,1256,96,1352
72,Aquitaine,47,3,26,079,Dausse,489,5,494
72,Aquitaine,47,3,35,080,Dévillac,134,3,137
72,Aquitaine,47,3,30,081,Dolmayrac,603,12,615
72,Aquitaine,47,1,04,082,Dondas,205,3,208
72,Aquitaine,47,3,35,083,Doudrac,94,3,97
72,Aquitaine,47,3,09,084,Douzains,283,10,293
72,Aquitaine,47,4,14,085,Durance,270,7,277
72,Aquitaine,47,2,11,086,Duras,1202,21,1223
72,Aquitaine,47,1,04,087,Engayrac,148,3,151
72,Aquitaine,47,2,31,088,Escassefort,563,25,588
72,Aquitaine,47,2,11,089,Esclottes,154,2,156
72,Aquitaine,47,4,25,090,Espiens,388,7,395
72,Aquitaine,47,1,15,091,Estillac,1715,54,1769
72,Aquitaine,47,1,03,092,Fals,318,5,323
72,Aquitaine,47,4,10,093,Fargues-sur-Ourbise,362,11,373
72,Aquitaine,47,2,19,094,Fauguerolles,621,18,639
72,Aquitaine,47,2,32,095,Fauillet,850,18,868
72,Aquitaine,47,3,09,096,Ferrensac,216,11,227
72,Aquitaine,47,4,18,097,Feugarolles,932,19,951
72,Aquitaine,47,4,12,098,Fieux,344,10,354
72,Aquitaine,47,3,23,099,Fongrave,592,16,608
72,Aquitaine,47,1,36,100,Foulayronnes,4909,305,5214
72,Aquitaine,47,2,20,101,Fourques-sur-Garonne,1210,34,1244
72,Aquitaine,47,4,12,102,Francescas,708,23,731
72,Aquitaine,47,4,25,103,Fréchou,207,9,216
72,Aquitaine,47,1,27,104,Frégimont,255,2,257
72,Aquitaine,47,3,26,105,Frespech,289,6,295
72,Aquitaine,47,3,13,106,Fumel,5209,131,5340
72,Aquitaine,47,1,27,107,Galapian,305,5,310
72,Aquitaine,47,2,21,108,Gaujac,289,10,299
72,Aquitaine,47,3,24,109,Gavaudun,290,3,293
72,Aquitaine,47,2,19,110,Gontaud-de-Nogaret,1599,37,1636
72,Aquitaine,47,1,28,111,Granges-sur-Lot,597,10,607
72,Aquitaine,47,2,08,112,Grateloup-Saint-Gayrand,424,17,441
72,Aquitaine,47,1,29,113,Grayssas,123,2,125
72,Aquitaine,47,2,05,114,Grézet-Cavagnan,354,6,360
72,Aquitaine,47,2,05,115,Guérin,237,13,250
72,Aquitaine,47,3,26,117,Hautefage-la-Tour,794,20,814
72,Aquitaine,47,2,19,118,Hautesvignes,169,7,176
72,Aquitaine,47,4,14,119,Houeillès,637,15,652
72,Aquitaine,47,2,21,120,Jusix,113,4,117
72,Aquitaine,47,2,05,121,Labastide-Castel-Amouroux,325,6,331
72,Aquitaine,47,2,08,122,Labretonie,169,9,178
72,Aquitaine,47,3,24,123,Lacapelle-Biron,448,8,456
72,Aquitaine,47,3,24,124,Lacaussade,211,6,217
72,Aquitaine,47,1,28,125,Lacépède,287,6,293
72,Aquitaine,47,2,31,126,Lachapelle,91,3,94
72,Aquitaine,47,2,32,127,Lafitte-sur-Lot,766,27,793
72,Aquitaine,47,1,29,128,Lafox,1169,27,1196
72,Aquitaine,47,1,27,129,Lagarrigue,279,12,291
72,Aquitaine,47,2,20,130,Lagruère,323,11,334
72,Aquitaine,47,2,31,131,Lagupie,587,13,600
72,Aquitaine,47,3,09,132,Lalandusse,188,4,192
72,Aquitaine,47,4,12,133,Lamontjoie,509,22,531
72,Aquitaine,47,4,22,134,Lannes,414,21,435
72,Aquitaine,47,2,08,135,Laparade,446,8,454
72,Aquitaine,47,2,17,136,Laperche,131,6,137
72,Aquitaine,47,1,15,137,Laplume,1362,26,1388
72,Aquitaine,47,1,16,138,Laroque-Timbaut,1489,35,1524
72,Aquitaine,47,4,12,139,Lasserre,76,2,78
72,Aquitaine,47,1,28,140,Laugnac,624,8,632
72,Aquitaine,47,3,24,141,Laussou,261,2,263
72,Aquitaine,47,2,17,142,Lauzun,753,17,770
72,Aquitaine,47,4,18,143,Lavardac,2318,41,2359
72,Aquitaine,47,2,17,144,Lavergne,615,18,633
72,Aquitaine,47,1,03,145,Layrac,3451,129,3580
72,Aquitaine,47,3,34,146,Lédat,1139,37,1176
72,Aquitaine,47,2,31,147,Lévignac-de-Guyenne,635,20,655
72,Aquitaine,47,4,07,148,Leyritz-Moncassin,206,3,209
72,Aquitaine,47,2,19,150,Longueville,322,5,327
72,Aquitaine,47,2,11,151,Loubès-Bernac,402,7,409
72,Aquitaine,47,3,09,152,Lougratte,455,5,460
72,Aquitaine,47,1,28,154,Lusignan-Petit,359,13,372
72,Aquitaine,47,1,28,155,Madaillan,598,16,614
72,Aquitaine,47,2,21,156,Marcellus,785,28,813
72,Aquitaine,47,2,98,157,Marmande,17947,657,18604
72,Aquitaine,47,1,15,158,Marmont-Pachas,139,3,142
72,Aquitaine,47,2,20,159,Le Mas-d'Agenais,1425,19,1444
72,Aquitaine,47,3,33,160,Masquières,172,1,173
72,Aquitaine,47,3,26,161,Massels,108,1,109
72,Aquitaine,47,3,26,162,Massoulès,209,2,211
72,Aquitaine,47,2,38,163,Mauvezin-sur-Gupie,449,12,461
72,Aquitaine,47,3,35,164,Mazières-Naresse,132,4,136
72,Aquitaine,47,2,21,165,Meilhan-sur-Garonne,1320,155,1475
72,Aquitaine,47,4,22,167,Mézin,1518,45,1563
72,Aquitaine,47,2,17,168,Miramont-de-Guyenne,3221,162,3383
72,Aquitaine,47,1,15,169,Moirax,1107,31,1138
72,Aquitaine,47,3,06,170,Monbahus,652,90,742
72,Aquitaine,47,1,16,171,Monbalen,441,12,453
72,Aquitaine,47,4,25,172,Moncaut,510,11,521
72,Aquitaine,47,3,23,173,Monclar,866,17,883
72,Aquitaine,47,4,12,174,Moncrabeau,818,9,827
72,Aquitaine,47,3,24,175,Monflanquin,2344,54,2398
72,Aquitaine,47,4,18,176,Mongaillard,189,2,191
72,Aquitaine,47,4,10,177,Monheurt,208,4,212
72,Aquitaine,47,3,24,178,Monségur,369,4,373
72,Aquitaine,47,3,13,179,Monsempron-Libos,2063,65,2128
72,Aquitaine,47,4,25,180,Montagnac-sur-Auvignon,590,10,600
72,Aquitaine,47,3,24,181,Montagnac-sur-Lède,261,7,268
72,Aquitaine,47,3,23,182,Montastruc,279,8,287
72,Aquitaine,47,3,09,183,Montauriol,227,6,233
72,Aquitaine,47,3,35,184,Montaut,228,1,229
72,Aquitaine,47,3,33,185,Montayral,2994,75,3069
72,Aquitaine,47,4,18,186,Montesquieu,780,26,806
72,Aquitaine,47,2,31,187,Monteton,278,8,286
72,Aquitaine,47,2,17,188,Montignac-de-Lauzun,303,8,311
72,Aquitaine,47,2,31,189,Montignac-Toupinerie,133,2,135
72,Aquitaine,47,1,28,190,Montpezat,578,65,643
72,Aquitaine,47,2,21,191,Montpouillan,637,15,652
72,Aquitaine,47,3,06,192,Monviel,78,0,78
72,Aquitaine,47,3,06,193,Moulinet,194,6,200
72,Aquitaine,47,2,11,194,Moustier,329,13,342
72,Aquitaine,47,4,25,195,Nérac,6886,640,7526
72,Aquitaine,47,1,27,196,Nicole,268,26,294
72,Aquitaine,47,4,12,197,Nomdieu,229,9,238
72,Aquitaine,47,3,06,198,Pailloles,328,7,335
72,Aquitaine,47,2,11,199,Pardaillan,324,10,334
72,Aquitaine,47,3,35,200,Parranquet,121,4,125
72,Aquitaine,47,1,37,201,Le Passage,9350,229,9579
72,Aquitaine,47,3,24,202,Paulhiac,295,9,304
72,Aquitaine,47,3,26,203,Penne-d'Agenais,2459,61,2520
72,Aquitaine,47,2,17,204,Peyrière,272,7,279
72,Aquitaine,47,4,14,205,Pindères,226,4,230
72,Aquitaine,47,3,23,206,Pinel-Hauterive,521,17,538
72,Aquitaine,47,4,18,207,Pompiey,223,4,227
72,Aquitaine,47,4,14,208,Pompogne,179,4,183
72,Aquitaine,47,1,02,209,Pont-du-Casse,4305,157,4462
72,Aquitaine,47,1,27,210,Port-Sainte-Marie,1943,40,1983
72,Aquitaine,47,4,22,211,Poudenas,246,3,249
72,Aquitaine,47,2,05,212,Poussignac,277,4,281
72,Aquitaine,47,1,28,213,Prayssas,936,33,969
72,Aquitaine,47,4,10,214,Puch-d'Agenais,716,11,727
72,Aquitaine,47,3,39,215,Pujols,3657,187,3844
72,Aquitaine,47,2,31,216,Puymiclan,555,27,582
72,Aquitaine,47,1,29,217,Puymirol,939,10,949
72,Aquitaine,47,2,17,218,Puysserampion,234,5,239
72,Aquitaine,47,3,35,219,Rayet,163,1,164
72,Aquitaine,47,4,10,220,Razimet,224,9,233
72,Aquitaine,47,4,22,221,Réaup-Lisse,584,10,594
72,Aquitaine,47,4,07,222,La Réunion,434,11,445
72,Aquitaine,47,3,35,223,Rives,236,1,237
72,Aquitaine,47,2,05,224,Romestaing,162,5,167
72,Aquitaine,47,1,15,225,Roquefort,1691,40,1731
72,Aquitaine,47,2,17,226,Roumagne,542,16,558
72,Aquitaine,47,2,05,227,Ruffiac,172,4,176
72,Aquitaine,47,3,39,228,Saint-Antoine-de-Ficalba,644,14,658
72,Aquitaine,47,2,11,229,Saint-Astier,187,2,189
72,Aquitaine,47,3,24,230,Saint-Aubin,426,7,433
72,Aquitaine,47,2,31,231,Saint-Avit,169,1,170
72,Aquitaine,47,2,31,232,Saint-Barthélemy-d'Agenais,504,15,519
72,Aquitaine,47,1,29,234,Saint-Caprais-de-Lerm,558,20,578
72,Aquitaine,47,2,17,235,Saint-Colomb-de-Lauzun,487,22,509
72,Aquitaine,47,3,23,239,Saint-Étienne-de-Fougères,816,23,839
72,Aquitaine,47,3,35,240,Saint-Étienne-de-Villeréal,292,11,303
72,Aquitaine,47,3,35,241,Saint-Eutrope-de-Born,683,18,701
72,Aquitaine,47,3,13,242,Saint-Front-sur-Lémance,569,15,584
72,Aquitaine,47,3,33,328,Saint-Georges,542,22,564
72,Aquitaine,47,2,31,245,Saint-Géraud,71,4,75
72,Aquitaine,47,1,36,246,Saint-Hilaire-de-Lusignan,1374,32,1406
72,Aquitaine,47,2,11,247,Saint-Jean-de-Duras,229,11,240
72,Aquitaine,47,1,29,248,Saint-Jean-de-Thurac,494,9,503
72,Aquitaine,47,4,18,249,Saint-Laurent,484,11,495
72,Aquitaine,47,4,10,250,Saint-Léger,170,1,171
72,Aquitaine,47,4,10,251,Saint-Léon,293,6,299
72,Aquitaine,47,4,07,254,Saint-Martin-Curton,280,10,290
72,Aquitaine,47,1,04,255,Saint-Martin-de-Beauville,168,4,172
72,Aquitaine,47,3,35,256,Saint-Martin-de-Villeréal,114,4,118
72,Aquitaine,47,2,38,257,Saint-Martin-Petit,418,16,434
72,Aquitaine,47,3,06,259,Saint-Maurice-de-Lestapel,108,4,112
72,Aquitaine,47,1,04,260,Saint-Maurin,445,11,456
72,Aquitaine,47,1,03,262,Saint-Nicolas-de-la-Balerme,410,3,413
72,Aquitaine,47,2,19,263,Saint-Pardoux-du-Breuil,580,38,618
72,Aquitaine,47,2,17,264,Saint-Pardoux-Isaac,1171,26,1197
72,Aquitaine,47,3,23,265,Saint-Pastour,389,12,401
72,Aquitaine,47,4,22,266,Saint-Pé-Saint-Simon,217,1,218
72,Aquitaine,47,4,10,267,Saint-Pierre-de-Buzet,237,4,241
72,Aquitaine,47,1,29,269,Saint-Pierre-de-Clairac,825,21,846
72,Aquitaine,47,2,31,271,Saint-Pierre-sur-Dropt,263,20,283
72,Aquitaine,47,3,09,272,Saint-Quentin-du-Dropt,164,6,170
72,Aquitaine,47,1,16,273,Saint-Robert,181,7,188
72,Aquitaine,47,1,29,274,Saint-Romain-le-Noble,401,11,412
72,Aquitaine,47,1,27,275,Saint-Salvy,189,0,189
72,Aquitaine,47,1,28,276,Saint-Sardos,341,9,350
72,Aquitaine,47,2,21,277,Saint-Sauveur-de-Meilhan,305,8,313
72,Aquitaine,47,2,11,278,Saint-Sernin,433,9,442
72,Aquitaine,47,1,03,279,Saint-Sixte,316,2,318
72,Aquitaine,47,3,26,280,Saint-Sylvestre-sur-Lot,2223,53,2276
72,Aquitaine,47,1,29,281,Saint-Urcisse,228,4,232
72,Aquitaine,47,4,12,282,Saint-Vincent-de-Lamontjoie,246,6,252
72,Aquitaine,47,3,33,283,Saint-Vite,1196,33,1229
72,Aquitaine,47,2,38,233,Sainte-Bazeille,2927,166,3093
72,Aquitaine,47,2,11,236,Sainte-Colombe-de-Duras,93,2,95
72,Aquitaine,47,3,39,237,Sainte-Colombe-de-Villeneuve,415,12,427
72,Aquitaine,47,1,15,238,Sainte-Colombe-en-Bruilhois,1645,46,1691
72,Aquitaine,47,2,05,244,Sainte-Gemme-Martaillac,325,12,337
72,Aquitaine,47,3,30,252,Sainte-Livrade-sur-Lot,6417,226,6643
72,Aquitaine,47,2,20,253,Sainte-Marthe,472,11,483
72,Aquitaine,47,4,22,258,Sainte-Maure-de-Peyriac,338,12,350
72,Aquitaine,47,3,24,284,Salles,312,8,320
72,Aquitaine,47,2,20,285,Samazan,856,16,872
72,Aquitaine,47,4,14,286,Sauméjan,81,0,81
72,Aquitaine,47,4,25,287,Saumont,214,5,219
72,Aquitaine,47,1,16,288,Sauvagnas,447,5,452
72,Aquitaine,47,1,16,289,La Sauvetat-de-Savères,507,15,522
72,Aquitaine,47,2,11,290,La Sauvetat-du-Dropt,582,16,598
72,Aquitaine,47,3,24,291,La Sauvetat-sur-Lède,626,15,641
72,Aquitaine,47,3,13,292,Sauveterre-la-Lémance,592,10,602
72,Aquitaine,47,1,03,293,Sauveterre-Saint-Denis,453,6,459
72,Aquitaine,47,2,11,294,Savignac-de-Duras,237,7,244
72,Aquitaine,47,3,24,295,Savignac-sur-Leyze,264,8,272
72,Aquitaine,47,2,17,296,Ségalas,165,1,166
72,Aquitaine,47,3,39,297,Sembas,143,2,145
72,Aquitaine,47,2,20,298,Sénestis,193,8,201
72,Aquitaine,47,3,09,299,Sérignac-Péboudou,172,6,178
72,Aquitaine,47,1,15,300,Sérignac-sur-Garonne,1082,24,1106
72,Aquitaine,47,2,31,301,Seyches,989,42,1031
72,Aquitaine,47,4,22,302,Sos,702,14,716
72,Aquitaine,47,2,11,303,Soumensac,241,3,244
72,Aquitaine,47,2,19,304,Taillebourg,88,5,93
72,Aquitaine,47,1,04,305,Tayrac,312,4,316
72,Aquitaine,47,3,30,306,Le Temple-sur-Lot,979,35,1014
72,Aquitaine,47,3,33,307,Thézac,179,9,188
72,Aquitaine,47,4,18,308,Thouars-sur-Garonne,197,3,200
72,Aquitaine,47,3,23,309,Tombeboeuf,441,6,447
72,Aquitaine,47,2,32,310,Tonneins,9162,351,9513
72,Aquitaine,47,3,35,311,Tourliac,139,3,142
72,Aquitaine,47,3,33,312,Tournon-d'Agenais,808,14,822
72,Aquitaine,47,3,23,313,Tourtrès,131,2,133
72,Aquitaine,47,3,26,314,Trémons,364,10,374
72,Aquitaine,47,3,26,315,Trentels,819,27,846
72,Aquitaine,47,2,32,316,Varès,656,18,674
72,Aquitaine,47,2,08,317,Verteuil-d'Agenais,509,13,522
72,Aquitaine,47,4,18,318,Vianne,1145,27,1172
72,Aquitaine,47,3,23,319,Villebramar,96,5,101
72,Aquitaine,47,4,07,320,Villefranche-du-Queyran,400,3,403
72,Aquitaine,47,2,11,321,Villeneuve-de-Duras,291,3,294
72,Aquitaine,47,3,97,323,Villeneuve-sur-Lot,23565,1121,24686
72,Aquitaine,47,3,35,324,Villeréal,1259,101,1360
72,Aquitaine,47,2,20,325,Villeton,519,12,531
72,Aquitaine,47,2,19,326,Virazeil,1635,50,1685
72,Aquitaine,47,4,18,327,Xaintrailles,392,1,393
91,Languedoc-Roussillon,48,2,08,001,Albaret-le-Comtal,209,1,210
91,Languedoc-Roussillon,48,2,20,002,Albaret-Sainte-Marie,548,16,564
91,Languedoc-Roussillon,48,2,03,003,Allenc,243,3,246
91,Languedoc-Roussillon,48,2,24,004,Altier,211,13,224
91,Languedoc-Roussillon,48,2,12,005,Antrenas,312,10,322
91,Languedoc-Roussillon,48,2,08,007,Arzenc-d'Apcher,48,2,50
91,Languedoc-Roussillon,48,2,06,008,Arzenc-de-Randon,207,6,213
91,Languedoc-Roussillon,48,2,01,009,Aumont-Aubrac,1112,35,1147
91,Languedoc-Roussillon,48,2,10,010,Auroux,436,7,443
91,Languedoc-Roussillon,48,2,14,013,Badaroux,894,25,919
91,Languedoc-Roussillon,48,2,03,014,Bagnols-les-Bains,231,4,235
91,Languedoc-Roussillon,48,2,25,016,Balsièges,515,25,540
91,Languedoc-Roussillon,48,2,04,017,Banassac,862,31,893
91,Languedoc-Roussillon,48,2,05,018,Barjac,653,14,667
91,Languedoc-Roussillon,48,1,02,019,Barre-des-Cévennes,206,5,211
91,Languedoc-Roussillon,48,1,02,020,Bassurels,62,3,65
91,Languedoc-Roussillon,48,2,24,021,La Bastide-Puylaurent,174,7,181
91,Languedoc-Roussillon,48,1,07,022,Bédouès,299,14,313
91,Languedoc-Roussillon,48,2,03,023,Belvezet,90,1,91
91,Languedoc-Roussillon,48,2,20,025,Les Bessons,448,16,464
91,Languedoc-Roussillon,48,2,20,026,Blavignac,214,17,231
91,Languedoc-Roussillon,48,2,03,027,Le Bleymard,353,33,386
91,Languedoc-Roussillon,48,1,07,028,Les Bondons,140,3,143
91,Languedoc-Roussillon,48,2,14,029,Le Born,155,1,156
91,Languedoc-Roussillon,48,2,25,030,Brenoux,318,9,327
91,Languedoc-Roussillon,48,2,08,031,Brion,97,3,100
91,Languedoc-Roussillon,48,2,12,032,Le Buisson,211,12,223
91,Languedoc-Roussillon,48,2,04,033,Canilhac,137,7,144
91,Languedoc-Roussillon,48,2,04,034,La Canourgue,2104,109,2213
91,Languedoc-Roussillon,48,1,02,036,Cassagnas,121,6,127
91,Languedoc-Roussillon,48,2,03,037,Chadenet,113,4,117
91,Languedoc-Roussillon,48,2,09,038,Chambon-le-Château,307,12,319
91,Languedoc-Roussillon,48,2,05,039,Chanac,1355,37,1392
91,Languedoc-Roussillon,48,2,03,040,Chasseradès,160,1,161
91,Languedoc-Roussillon,48,2,10,041,Chastanier,91,2,93
91,Languedoc-Roussillon,48,2,14,042,Chastel-Nouvel,720,31,751
91,Languedoc-Roussillon,48,2,06,043,Châteauneuf-de-Randon,520,25,545
91,Languedoc-Roussillon,48,2,08,044,Chauchailles,96,2,98
91,Languedoc-Roussillon,48,2,06,045,Chaudeyrac,302,3,305
91,Languedoc-Roussillon,48,2,11,046,Chaulhac,64,4,68
91,Languedoc-Roussillon,48,2,01,047,La Chaze-de-Peyre,247,3,250
91,Languedoc-Roussillon,48,2,10,048,Cheylard-l'Évêque,62,2,64
91,Languedoc-Roussillon,48,2,23,049,Chirac,1133,34,1167
91,Languedoc-Roussillon,48,1,07,050,Cocurès,197,5,202
91,Languedoc-Roussillon,48,1,22,051,Le Collet-de-Dèze,688,28,716
91,Languedoc-Roussillon,48,2,03,053,Cubières,177,10,187
91,Languedoc-Roussillon,48,2,03,054,Cubiérettes,54,0,54
91,Languedoc-Roussillon,48,2,05,055,Cultures,127,4,131
91,Languedoc-Roussillon,48,2,05,056,Esclanèdes,313,16,329
91,Languedoc-Roussillon,48,2,19,057,Estables,159,5,164
91,Languedoc-Roussillon,48,2,08,058,La Fage-Montivernoux,176,4,180
91,Languedoc-Roussillon,48,2,20,059,La Fage-Saint-Julien,276,5,281
91,Languedoc-Roussillon,48,2,01,060,Fau-de-Peyre,173,2,175
91,Languedoc-Roussillon,48,1,07,061,Florac,1900,88,1988
91,Languedoc-Roussillon,48,2,10,062,Fontanes,115,7,122
91,Languedoc-Roussillon,48,2,18,063,Fontans,209,3,212
91,Languedoc-Roussillon,48,2,08,064,Fournels,354,6,360
91,Languedoc-Roussillon,48,1,15,065,Fraissinet-de-Fourques,61,0,61
91,Languedoc-Roussillon,48,1,17,066,Fraissinet-de-Lozère,221,3,224
91,Languedoc-Roussillon,48,1,02,067,Gabriac,107,5,112
91,Languedoc-Roussillon,48,2,12,068,Gabrias,131,4,135
91,Languedoc-Roussillon,48,1,15,069,Gatuzières,43,1,44
91,Languedoc-Roussillon,48,2,09,070,Grandrieu,761,28,789
91,Languedoc-Roussillon,48,2,16,071,Grandvals,80,3,83
91,Languedoc-Roussillon,48,2,12,072,Grèzes,236,10,246
91,Languedoc-Roussillon,48,2,23,073,Les Hermaux,117,3,120
91,Languedoc-Roussillon,48,1,15,074,Hures-la-Parade,224,9,233
91,Languedoc-Roussillon,48,1,07,075,Ispagnac,846,20,866
91,Languedoc-Roussillon,48,2,01,076,Javols,328,23,351
91,Languedoc-Roussillon,48,2,11,077,Julianges,71,0,71
91,Languedoc-Roussillon,48,2,19,078,Lachamp,173,3,176
91,Languedoc-Roussillon,48,2,18,079,Lajo,116,4,120
91,Languedoc-Roussillon,48,2,10,080,Langogne,3129,181,3310
91,Languedoc-Roussillon,48,2,25,081,Lanuéjols,332,8,340
91,Languedoc-Roussillon,48,2,06,082,Laubert,110,8,118
91,Languedoc-Roussillon,48,2,19,083,Les Laubies,168,2,170
91,Languedoc-Roussillon,48,2,09,084,Laval-Atger,166,0,166
91,Languedoc-Roussillon,48,2,04,085,Laval-du-Tarn,108,3,111
91,Languedoc-Roussillon,48,2,10,086,Luc,225,6,231
91,Languedoc-Roussillon,48,2,16,087,Malbouzon,153,5,158
91,Languedoc-Roussillon,48,1,21,088,La Malène,167,4,171
91,Languedoc-Roussillon,48,2,11,089,Le Malzieu-Forain,458,18,476
91,Languedoc-Roussillon,48,2,11,090,Le Malzieu-Ville,867,27,894
91,Languedoc-Roussillon,48,2,16,091,Marchastel,84,1,85
91,Languedoc-Roussillon,48,2,12,092,Marvejols,5011,313,5324
91,Languedoc-Roussillon,48,2,03,093,Mas-d'Orcières,135,3,138
91,Languedoc-Roussillon,48,1,21,141,Mas-Saint-Chély,131,5,136
91,Languedoc-Roussillon,48,1,13,094,Le Massegros,345,8,353
91,Languedoc-Roussillon,48,2,99,095,Mende,12190,1046,13236
91,Languedoc-Roussillon,48,1,15,096,Meyrueis,882,171,1053
91,Languedoc-Roussillon,48,1,22,097,Moissac-Vallée-Française,228,5,233
91,Languedoc-Roussillon,48,1,02,098,Molezon,109,6,115
91,Languedoc-Roussillon,48,2,23,099,Le Monastier-Pin-Moriès,857,24,881
91,Languedoc-Roussillon,48,2,06,100,Montbel,133,3,136
91,Languedoc-Roussillon,48,1,21,101,Montbrun,85,4,89
91,Languedoc-Roussillon,48,2,12,103,Montrodat,1169,37,1206
91,Languedoc-Roussillon,48,2,20,012,Les Monts-Verts,341,10,351
91,Languedoc-Roussillon,48,2,16,104,Nasbinals,504,11,515
91,Languedoc-Roussillon,48,2,10,105,Naussac,204,10,214
91,Languedoc-Roussillon,48,2,08,106,Noalhac,100,1,101
91,Languedoc-Roussillon,48,2,12,107,Palhers,201,7,208
91,Languedoc-Roussillon,48,2,09,108,La Panouse,82,6,88
91,Languedoc-Roussillon,48,2,11,110,Paulhac-en-Margeride,107,5,112
91,Languedoc-Roussillon,48,2,14,111,Pelouse,257,1,258
91,Languedoc-Roussillon,48,2,24,015,Pied-de-Borne,216,8,224
91,Languedoc-Roussillon,48,2,06,112,Pierrefiche,162,4,166
91,Languedoc-Roussillon,48,1,02,115,Le Pompidou,200,7,207
91,Languedoc-Roussillon,48,1,17,116,Le Pont-de-Montvert,289,14,303
91,Languedoc-Roussillon,48,2,24,117,Pourcharesses,133,4,137
91,Languedoc-Roussillon,48,2,24,119,Prévenchères,271,10,281
91,Languedoc-Roussillon,48,2,16,120,Prinsuéjols,158,1,159
91,Languedoc-Roussillon,48,2,11,121,Prunières,251,5,256
91,Languedoc-Roussillon,48,1,21,122,Quézac,323,10,333
91,Languedoc-Roussillon,48,2,16,123,Recoules-d'Aubrac,243,3,246
91,Languedoc-Roussillon,48,2,12,124,Recoules-de-Fumas,95,1,96
91,Languedoc-Roussillon,48,1,13,125,Le Recoux,121,6,127
91,Languedoc-Roussillon,48,2,19,126,Ribennes,164,4,168
91,Languedoc-Roussillon,48,2,19,127,Rieutort-de-Randon,756,19,775
91,Languedoc-Roussillon,48,2,20,128,Rimeize,605,20,625
91,Languedoc-Roussillon,48,2,10,129,Rocles,209,2,211
91,Languedoc-Roussillon,48,1,07,130,Rousses,102,3,105
91,Languedoc-Roussillon,48,1,15,131,Le Rozier,148,2,150
91,Languedoc-Roussillon,48,2,18,132,Saint-Alban-sur-Limagnole,1492,59,1551
91,Languedoc-Roussillon,48,2,19,133,Saint-Amans,141,1,142
91,Languedoc-Roussillon,48,1,17,134,Saint-Andéol-de-Clerguemort,94,1,95
91,Languedoc-Roussillon,48,2,24,135,Saint-André-Capcèze,171,0,171
91,Languedoc-Roussillon,48,1,22,136,Saint-André-de-Lancize,121,3,124
91,Languedoc-Roussillon,48,2,25,137,Saint-Bauzile,549,19,568
91,Languedoc-Roussillon,48,2,12,138,Saint-Bonnet-de-Chirac,54,2,56
91,Languedoc-Roussillon,48,2,09,139,Saint-Bonnet-de-Montauroux,133,3,136
91,Languedoc-Roussillon,48,2,20,140,Saint-Chély-d'Apcher,4462,624,5086
91,Languedoc-Roussillon,48,2,19,145,Saint-Denis-en-Margeride,196,1,197
91,Languedoc-Roussillon,48,2,25,147,Saint-Étienne-du-Valdonnez,617,40,657
91,Languedoc-Roussillon,48,1,22,148,Saint-Étienne-Vallée-Française,529,41,570
91,Languedoc-Roussillon,48,2,10,150,Saint-Flour-de-Mercoire,169,1,170
91,Languedoc-Roussillon,48,2,03,151,Saint-Frézal-d'Albuges,49,2,51
91,Languedoc-Roussillon,48,1,17,152,Saint-Frézal-de-Ventalon,161,7,168
91,Languedoc-Roussillon,48,2,19,153,Saint-Gal,112,0,112
91,Languedoc-Roussillon,48,1,13,154,Saint-Georges-de-Lévéjac,259,2,261
91,Languedoc-Roussillon,48,1,22,155,Saint-Germain-de-Calberte,452,13,465
91,Languedoc-Roussillon,48,2,23,156,Saint-Germain-du-Teil,822,16,838
91,Languedoc-Roussillon,48,1,22,158,Saint-Hilaire-de-Lavit,100,4,104
91,Languedoc-Roussillon,48,2,06,160,Saint-Jean-la-Fouillouse,163,3,166
91,Languedoc-Roussillon,48,2,08,161,Saint-Juéry,70,2,72
91,Languedoc-Roussillon,48,1,02,162,Saint-Julien-d'Arpaon,121,2,123
91,Languedoc-Roussillon,48,1,22,163,Saint-Julien-des-Points,106,5,111
91,Languedoc-Roussillon,48,2,03,164,Saint-Julien-du-Tournel,107,7,114
91,Languedoc-Roussillon,48,2,12,165,Saint-Laurent-de-Muret,170,8,178
91,Languedoc-Roussillon,48,1,07,166,Saint-Laurent-de-Trèves,183,2,185
91,Languedoc-Roussillon,48,2,08,167,Saint-Laurent-de-Veyrès,42,0,42
91,Languedoc-Roussillon,48,2,12,168,Saint-Léger-de-Peyre,176,5,181
91,Languedoc-Roussillon,48,2,11,169,Saint-Léger-du-Malzieu,210,6,216
91,Languedoc-Roussillon,48,1,22,170,Saint-Martin-de-Boubaux,178,9,187
91,Languedoc-Roussillon,48,1,22,171,Saint-Martin-de-Lansuscle,149,2,151
91,Languedoc-Roussillon,48,1,17,172,Saint-Maurice-de-Ventalon,74,4,78
91,Languedoc-Roussillon,48,1,22,173,Saint-Michel-de-Dèze,209,2,211
91,Languedoc-Roussillon,48,2,09,174,Saint-Paul-le-Froid,151,6,157
91,Languedoc-Roussillon,48,2,23,175,Saint-Pierre-de-Nogaret,154,0,154
91,Languedoc-Roussillon,48,1,15,176,Saint-Pierre-des-Tripiers,77,2,79
91,Languedoc-Roussillon,48,2,11,177,Saint-Pierre-le-Vieux,277,13,290
91,Languedoc-Roussillon,48,1,22,178,Saint-Privat-de-Vallongue,269,5,274
91,Languedoc-Roussillon,48,2,11,179,Saint-Privat-du-Fau,130,3,133
91,Languedoc-Roussillon,48,1,13,180,Saint-Rome-de-Dolan,80,4,84
91,Languedoc-Roussillon,48,2,04,181,Saint-Saturnin,64,6,70
91,Languedoc-Roussillon,48,2,06,182,Saint-Sauveur-de-Ginestoux,66,2,68
91,Languedoc-Roussillon,48,2,01,183,Saint-Sauveur-de-Peyre,268,5,273
91,Languedoc-Roussillon,48,2,09,184,Saint-Symphorien,253,5,258
91,Languedoc-Roussillon,48,2,01,142,Sainte-Colombe-de-Peyre,211,6,217
91,Languedoc-Roussillon,48,1,02,144,Sainte-Croix-Vallée-Française,302,22,324
91,Languedoc-Roussillon,48,1,21,146,Sainte-Enimie,523,22,545
91,Languedoc-Roussillon,48,2,18,149,Sainte-Eulalie,55,1,56
91,Languedoc-Roussillon,48,2,03,157,Sainte-Hélène,68,1,69
91,Languedoc-Roussillon,48,2,23,187,Les Salces,93,4,97
91,Languedoc-Roussillon,48,2,05,185,Les Salelles,149,6,155
91,Languedoc-Roussillon,48,1,07,186,La Salle-Prunet,161,2,163
91,Languedoc-Roussillon,48,2,18,188,Serverette,287,5,292
91,Languedoc-Roussillon,48,2,19,189,Servières,178,1,179
91,Languedoc-Roussillon,48,2,08,190,Termes,211,5,216
91,Languedoc-Roussillon,48,2,04,191,La Tieule,102,6,108
91,Languedoc-Roussillon,48,2,23,192,Trélans,102,6,108
91,Languedoc-Roussillon,48,1,07,193,Vebron,212,11,223
91,Languedoc-Roussillon,48,1,17,194,Vialas,427,70,497
91,Languedoc-Roussillon,48,1,13,195,Les Vignes,98,3,101
91,Languedoc-Roussillon,48,2,19,197,La Villedieu,41,0,41
91,Languedoc-Roussillon,48,2,24,198,Villefort,626,33,659
52,Pays de la Loire,49,1,32,001,Les Alleuds,869,20,889
52,Pays de la Loire,49,3,27,002,Allonnes,2944,111,3055
52,Pays de la Loire,49,3,15,003,Ambillou-Château,930,24,954
52,Pays de la Loire,49,1,36,004,Andard,2468,58,2526
52,Pays de la Loire,49,4,16,005,Andigné,334,6,340
52,Pays de la Loire,49,2,06,006,Andrezé,1799,57,1856
52,Pays de la Loire,49,1,98,007,Angers,148405,4564,152969
52,Pays de la Loire,49,4,07,008,Angrie,894,15,909
52,Pays de la Loire,49,3,20,009,Antoigné,474,7,481
52,Pays de la Loire,49,4,24,010,Armaillé,289,12,301
52,Pays de la Loire,49,3,29,011,Artannes-sur-Thouet,449,14,463
52,Pays de la Loire,49,3,34,012,Aubigné-sur-Layon,360,9,369
52,Pays de la Loire,49,3,22,013,Auverse,429,9,438
52,Pays de la Loire,49,4,30,014,Aviré,435,21,456
52,Pays de la Loire,49,1,41,015,Avrillé,12663,347,13010
52,Pays de la Loire,49,1,14,017,Baracé,435,11,446
52,Pays de la Loire,49,3,04,018,Baugé,3592,102,3694
52,Pays de la Loire,49,1,31,019,Bauné,1543,51,1594
52,Pays de la Loire,49,1,38,020,Beaucouzé,4923,125,5048
52,Pays de la Loire,49,1,05,021,Beaufort-en-Vallée,6098,138,6236
52,Pays de la Loire,49,1,32,022,Beaulieu-sur-Layon,1431,30,1461
52,Pays de la Loire,49,2,06,023,Beaupréau,6717,470,7187
52,Pays de la Loire,49,2,25,024,Beausse,387,5,392
52,Pays de la Loire,49,1,31,025,Beauvau,250,2,252
52,Pays de la Loire,49,1,18,026,Bécon-les-Granits,2636,133,2769
52,Pays de la Loire,49,2,06,027,Bégrolles-en-Mauges,1748,47,1795
52,Pays de la Loire,49,1,26,028,Béhuard,127,5,132
52,Pays de la Loire,49,1,23,029,Blaison-Gohier,1062,35,1097
52,Pays de la Loire,49,3,17,030,Blou,998,29,1027
52,Pays de la Loire,49,3,04,031,Bocé,571,9,580
52,Pays de la Loire,49,1,23,032,La Bohalle,1224,35,1259
52,Pays de la Loire,49,2,21,033,La Boissière-sur-Èvre,407,6,413
52,Pays de la Loire,49,2,25,034,Botz-en-Mauges,799,18,817
52,Pays de la Loire,49,1,38,035,Bouchemaine,5853,181,6034
52,Pays de la Loire,49,4,24,036,Bouillé-Ménard,729,11,740
52,Pays de la Loire,49,4,30,037,Le Bourg-d'Iré,807,14,821
52,Pays de la Loire,49,4,24,038,Bourg-l'Évêque,215,9,224
52,Pays de la Loire,49,2,25,039,Bourgneuf-en-Mauges,691,24,715
52,Pays de la Loire,49,2,09,040,Bouzillé,1463,34,1497
52,Pays de la Loire,49,3,27,041,Brain-sur-Allonnes,1969,48,2017
52,Pays de la Loire,49,1,36,042,Brain-sur-l'Authion,3369,292,3661
52,Pays de la Loire,49,4,16,043,Brain-sur-Longuenée,972,20,992
52,Pays de la Loire,49,3,22,044,Breil,271,10,281
52,Pays de la Loire,49,3,27,045,La Breille-les-Pins,586,16,602
52,Pays de la Loire,49,3,20,046,Brézé,1327,24,1351
52,Pays de la Loire,49,3,13,047,Brigné,376,10,386
52,Pays de la Loire,49,1,33,048,Briollay,2599,57,2656
52,Pays de la Loire,49,1,05,049,Brion,1099,37,1136
52,Pays de la Loire,49,1,32,050,Brissac-Quincé,2690,152,2842
52,Pays de la Loire,49,4,10,051,Brissarthe,617,20,637
52,Pays de la Loire,49,3,22,052,Broc,336,3,339
52,Pays de la Loire,49,3,20,053,Brossay,308,3,311
52,Pays de la Loire,49,4,07,054,Candé,2813,57,2870
52,Pays de la Loire,49,1,39,055,Cantenay-Épinard,2085,48,2133
52,Pays de la Loire,49,4,24,056,Carbay,247,3,250
52,Pays de la Loire,49,3,34,057,Cernusson,292,9,301
52,Pays de la Loire,49,2,12,058,Les Cerqueux,796,19,815
52,Pays de la Loire,49,3,34,059,Les Cerqueux-sous-Passavant,482,12,494
52,Pays de la Loire,49,3,29,060,Chacé,1243,25,1268
52,Pays de la Loire,49,4,07,061,Challain-la-Potherie,811,23,834
52,Pays de la Loire,49,3,22,062,Chalonnes-sous-le-Lude,131,4,135
52,Pays de la Loire,49,1,08,063,Chalonnes-sur-Loire,6279,179,6458
52,Pays de la Loire,49,4,16,064,Chambellay,318,1,319
52,Pays de la Loire,49,1,32,066,Champ-sur-Layon,965,23,988
52,Pays de la Loire,49,4,10,065,Champigné,2076,87,2163
52,Pays de la Loire,49,4,10,067,Champteussé-sur-Baconne,228,3,231
52,Pays de la Loire,49,1,26,068,Champtocé-sur-Loire,1734,26,1760
52,Pays de la Loire,49,2,09,069,Champtoceaux,2280,56,2336
52,Pays de la Loire,49,2,12,070,Chanteloup-les-Bois,681,22,703
52,Pays de la Loire,49,1,32,071,Chanzeaux,1092,16,1108
52,Pays de la Loire,49,2,06,072,La Chapelle-du-Genêt,1212,16,1228
52,Pays de la Loire,49,4,24,073,La Chapelle-Hullin,133,4,137
52,Pays de la Loire,49,2,11,074,La Chapelle-Rousselin,713,20,733
52,Pays de la Loire,49,2,25,075,La Chapelle-Saint-Florent,1185,23,1208
52,Pays de la Loire,49,1,31,076,La Chapelle-Saint-Laud,600,8,608
52,Pays de la Loire,49,4,30,077,La Chapelle-sur-Oudon,571,13,584
52,Pays de la Loire,49,1,32,078,Charcé-Saint-Ellier-sur-Aubance,733,19,752
52,Pays de la Loire,49,3,04,079,Chartrené,55,0,55
52,Pays de la Loire,49,4,10,080,Châteauneuf-sur-Sarthe,2868,38,2906
52,Pays de la Loire,49,4,30,081,Châtelais,637,21,658
52,Pays de la Loire,49,1,08,082,Chaudefonds-sur-Layon,959,22,981
52,Pays de la Loire,49,2,21,083,Chaudron-en-Mauges,1416,30,1446
52,Pays de la Loire,49,1,31,084,Chaumont-d'Anjou,300,4,304
52,Pays de la Loire,49,2,21,085,La Chaussaire,749,13,762
52,Pays de la Loire,49,1,32,086,Chavagnes,957,22,979
52,Pays de la Loire,49,3,22,087,Chavaignes,98,6,104
52,Pays de la Loire,49,4,24,088,Chazé-Henry,888,27,915
52,Pays de la Loire,49,4,07,089,Chazé-sur-Argos,992,23,1015
52,Pays de la Loire,49,1,33,090,Cheffes,890,14,904
52,Pays de la Loire,49,3,15,091,Chemellier,694,12,706
52,Pays de la Loire,49,2,11,092,Chemillé,6951,242,7193
52,Pays de la Loire,49,4,10,093,Chemiré-sur-Sarthe,263,4,267
52,Pays de la Loire,49,3,15,094,Chênehutte-Trèves-Cunault,1051,26,1077
52,Pays de la Loire,49,4,10,095,Chenillé-Changé,143,1,144
52,Pays de la Loire,49,4,10,096,Cherré,518,12,530
52,Pays de la Loire,49,3,04,097,Cheviré-le-Rouge,887,11,898
52,Pays de la Loire,49,3,22,098,Chigné,301,5,306
52,Pays de la Loire,49,2,97,099,Cholet,54118,1997,56115
52,Pays de la Loire,49,3,20,100,Cizay-la-Madeleine,453,6,459
52,Pays de la Loire,49,3,04,101,Clefs,943,20,963
52,Pays de la Loire,49,3,34,102,Cléré-sur-Layon,328,12,340
52,Pays de la Loire,49,4,24,103,Combrée,2655,76,2731
52,Pays de la Loire,49,3,13,104,Concourson-sur-Layon,542,16,558
52,Pays de la Loire,49,4,10,105,Contigné,774,44,818
52,Pays de la Loire,49,1,05,106,Corné,2880,70,2950
52,Pays de la Loire,49,1,31,107,Cornillé-les-Caves,425,5,430
52,Pays de la Loire,49,1,18,108,La Cornuaille,917,22,939
52,Pays de la Loire,49,3,34,109,Coron,1498,25,1523
52,Pays de la Loire,49,1,31,110,Corzé,1623,26,1649
52,Pays de la Loire,49,2,11,111,Cossé-d'Anjou,435,13,448
52,Pays de la Loire,49,3,20,112,Le Coudray-Macouard,882,36,918
52,Pays de la Loire,49,3,20,113,Courchamps,447,14,461
52,Pays de la Loire,49,3,17,114,Courléon,156,8,164
52,Pays de la Loire,49,3,15,115,Coutures,529,9,538
52,Pays de la Loire,49,3,04,116,Cuon,587,10,597
52,Pays de la Loire,49,1,23,117,La Daguenière,1291,27,1318
52,Pays de la Loire,49,1,14,119,Daumeray,1527,38,1565
52,Pays de la Loire,49,1,08,120,Denée,1406,32,1438
52,Pays de la Loire,49,3,13,121,Dénezé-sous-Doué,442,13,455
52,Pays de la Loire,49,3,22,122,Dénezé-sous-le-Lude,292,3,295
52,Pays de la Loire,49,3,29,123,Distré,1560,58,1618
52,Pays de la Loire,49,3,13,125,Doué-la-Fontaine,7451,303,7754
52,Pays de la Loire,49,2,09,126,Drain,1817,46,1863
52,Pays de la Loire,49,1,14,127,Durtal,3325,56,3381
52,Pays de la Loire,49,3,04,128,Échemiré,590,11,601
52,Pays de la Loire,49,1,01,129,Écouflant,3755,66,3821
52,Pays de la Loire,49,1,33,130,Écuillé,581,16,597
52,Pays de la Loire,49,3,20,131,Épieds,646,8,654
52,Pays de la Loire,49,1,14,132,Étriché,1446,24,1470
52,Pays de la Loire,49,1,32,133,Faveraye-Mâchelles,635,21,656
52,Pays de la Loire,49,1,32,134,Faye-d'Anjou,1220,39,1259
52,Pays de la Loire,49,1,33,135,Feneu,2109,50,2159
52,Pays de la Loire,49,4,30,136,La Ferrière-de-Flée,331,3,334
52,Pays de la Loire,49,2,21,137,Le Fief-Sauvin,1590,17,1607
52,Pays de la Loire,49,1,05,138,Fontaine-Guérin,914,24,938
52,Pays de la Loire,49,1,31,139,Fontaine-Milon,438,8,446
52,Pays de la Loire,49,3,29,140,Fontevraud-l'Abbaye,1503,26,1529
52,Pays de la Loire,49,3,13,141,Forges,223,7,230
52,Pays de la Loire,49,3,34,142,La Fosse-de-Tigné,186,8,194
52,Pays de la Loire,49,3,04,143,Fougeré,765,16,781
52,Pays de la Loire,49,4,07,144,Freigné,1142,24,1166
52,Pays de la Loire,49,2,21,145,Le Fuilet,1854,57,1911
52,Pays de la Loire,49,1,05,147,Gée,389,32,421
52,Pays de la Loire,49,4,16,148,Gené,452,3,455
52,Pays de la Loire,49,3,15,149,Gennes,1960,61,2021
52,Pays de la Loire,49,3,22,150,Genneteil,348,3,351
52,Pays de la Loire,49,2,06,151,Gesté,2515,45,2560
52,Pays de la Loire,49,4,16,155,Grez-Neuville,1473,30,1503
52,Pays de la Loire,49,3,15,154,Grézillé,500,14,514
52,Pays de la Loire,49,4,24,156,Grugé-l'Hôpital,292,9,301
52,Pays de la Loire,49,3,04,157,Le Guédéniau,330,8,338
52,Pays de la Loire,49,4,30,158,L' Hôtellerie-de-Flée,478,8,486
52,Pays de la Loire,49,1,14,159,Huillé,502,9,511
52,Pays de la Loire,49,1,26,160,Ingrandes,1590,21,1611
52,Pays de la Loire,49,4,16,161,La Jaille-Yvon,290,9,299
52,Pays de la Loire,49,2,06,162,Jallais,3151,107,3258
52,Pays de la Loire,49,1,31,163,Jarzé,1612,34,1646
52,Pays de la Loire,49,2,06,165,La Jubaudière,1210,40,1250
52,Pays de la Loire,49,1,23,167,Juigné-sur-Loire,2483,70,2553
52,Pays de la Loire,49,2,11,169,La Jumellière,1300,23,1323
52,Pays de la Loire,49,4,10,170,Juvardeil,828,24,852
52,Pays de la Loire,49,3,17,171,La Lande-Chasles,100,3,103
52,Pays de la Loire,49,2,09,172,Landemont,1604,36,1640
52,Pays de la Loire,49,3,22,173,Lasse,260,7,267
52,Pays de la Loire,49,1,31,174,Lézigné,719,11,730
52,Pays de la Loire,49,3,22,175,Linières-Bouton,98,4,102
52,Pays de la Loire,49,4,16,176,Le Lion-d'Angers,3657,85,3742
52,Pays de la Loire,49,2,09,177,Liré,2396,122,2518
52,Pays de la Loire,49,4,07,178,Loiré,816,22,838
52,Pays de la Loire,49,2,19,179,Le Longeron,2067,92,2159
52,Pays de la Loire,49,3,17,180,Longué-Jumelles,6827,190,7017
52,Pays de la Loire,49,3,15,181,Louerre,398,10,408
52,Pays de la Loire,49,3,13,182,Louresse-Rochemenier,832,12,844
52,Pays de la Loire,49,1,18,183,Le Louroux-Béconnais,2750,33,2783
52,Pays de la Loire,49,4,30,184,Louvaines,546,9,555
52,Pays de la Loire,49,1,31,185,Lué-en-Baugeois,350,5,355
52,Pays de la Loire,49,1,32,186,Luigné,251,3,254
52,Pays de la Loire,49,4,30,187,Marans,474,14,488
52,Pays de la Loire,49,1,31,188,Marcé,853,9,862
52,Pays de la Loire,49,4,10,189,Marigné,627,18,645
52,Pays de la Loire,49,2,25,190,Le Marillais,996,16,1012
52,Pays de la Loire,49,3,13,191,Martigné-Briand,1855,82,1937
52,Pays de la Loire,49,2,12,192,Maulévrier,3011,72,3083
52,Pays de la Loire,49,2,06,193,Le May-sur-Èvre,3878,95,3973
52,Pays de la Loire,49,1,05,194,Mazé,4686,97,4783
52,Pays de la Loire,49,2,12,195,Mazières-en-Mauges,965,25,990
52,Pays de la Loire,49,1,39,196,La Meignanne,2109,92,2201
52,Pays de la Loire,49,3,13,198,Meigné,339,11,350
52,Pays de la Loire,49,3,22,197,Meigné-le-Vicomte,327,7,334
52,Pays de la Loire,49,2,11,199,Melay,1598,70,1668
52,Pays de la Loire,49,1,39,200,La Membrolle-sur-Longuenée,1773,20,1793
52,Pays de la Loire,49,1,05,201,La Ménitré,2089,36,2125
52,Pays de la Loire,49,3,22,202,Méon,262,6,268
52,Pays de la Loire,49,2,25,204,Le Mesnil-en-Vallée,1457,33,1490
52,Pays de la Loire,49,4,10,205,Miré,979,12,991
52,Pays de la Loire,49,2,19,206,Montfaucon-Montigné,1862,29,1891
52,Pays de la Loire,49,3,13,207,Montfort,110,2,112
52,Pays de la Loire,49,4,30,208,Montguillon,190,8,198
52,Pays de la Loire,49,1,14,209,Montigné-lès-Rairies,363,8,371
52,Pays de la Loire,49,3,34,211,Montilliers,1157,77,1234
52,Pays de la Loire,49,2,25,212,Montjean-sur-Loire,2745,60,2805
52,Pays de la Loire,49,3,04,213,Montpollin,194,1,195
52,Pays de la Loire,49,3,20,215,Montreuil-Bellay,4029,280,4309
52,Pays de la Loire,49,1,39,214,Montreuil-Juigné,6813,140,6953
52,Pays de la Loire,49,1,33,216,Montreuil-sur-Loir,479,6,485
52,Pays de la Loire,49,4,16,217,Montreuil-sur-Maine,708,13,721
52,Pays de la Loire,49,2,21,218,Montrevault,1276,24,1300
52,Pays de la Loire,49,3,29,219,Montsoreau,491,13,504
52,Pays de la Loire,49,1,14,220,Morannes,1704,39,1743
52,Pays de la Loire,49,3,17,221,Mouliherne,903,14,917
52,Pays de la Loire,49,1,23,222,Mozé-sur-Louet,1982,36,2018
52,Pays de la Loire,49,1,23,223,Mûrs-Erigné,5350,149,5499
52,Pays de la Loire,49,3,27,224,Neuillé,888,19,907
52,Pays de la Loire,49,2,11,225,Neuvy-en-Mauges,804,15,819
52,Pays de la Loire,49,4,24,226,Noëllet,403,9,412
52,Pays de la Loire,49,1,32,227,Notre-Dame-d'Allençon,540,9,549
52,Pays de la Loire,49,3,22,228,Noyant,1904,77,1981
52,Pays de la Loire,49,4,30,229,Noyant-la-Gravoyère,1831,34,1865
52,Pays de la Loire,49,3,15,230,Noyant-la-Plaine,305,4,309
52,Pays de la Loire,49,2,12,231,Nuaillé,1327,25,1352
52,Pays de la Loire,49,3,34,232,Nueil-sur-Layon,1308,48,1356
52,Pays de la Loire,49,4,30,233,Nyoiseau,1298,254,1552
52,Pays de la Loire,49,3,29,235,Parnay,472,14,486
52,Pays de la Loire,49,3,22,234,Parçay-les-Pins,912,14,926
52,Pays de la Loire,49,3,34,236,Passavant-sur-Layon,130,4,134
52,Pays de la Loire,49,3,22,237,La Pellerine,156,5,161
52,Pays de la Loire,49,1,01,238,Pellouailles-les-Vignes,2441,53,2494
52,Pays de la Loire,49,2,06,239,Le Pin-en-Mauges,1306,27,1333
52,Pays de la Loire,49,3,34,240,La Plaine,952,28,980
52,Pays de la Loire,49,1,02,241,Le Plessis-Grammoire,2268,47,2315
52,Pays de la Loire,49,1,39,242,Le Plessis-Macé,1256,11,1267
52,Pays de la Loire,49,2,06,243,La Poitevinière,1022,17,1039
52,Pays de la Loire,49,2,25,244,La Pommeraye,4007,125,4132
52,Pays de la Loire,49,3,04,245,Pontigné,258,12,270
52,Pays de la Loire,49,1,23,246,Les Ponts-de-Cé,11434,539,11973
52,Pays de la Loire,49,1,26,247,La Possonnière,2332,46,2378
52,Pays de la Loire,49,4,24,248,Pouancé,3162,141,3303
52,Pays de la Loire,49,4,16,249,La Pouëze,1708,24,1732
52,Pays de la Loire,49,4,24,250,La Prévière,256,5,261
52,Pays de la Loire,49,4,16,251,Pruillé,621,9,630
52,Pays de la Loire,49,2,21,252,Le Puiset-Doré,1097,22,1119
52,Pays de la Loire,49,3,20,253,Le Puy-Notre-Dame,1316,46,1362
52,Pays de la Loire,49,4,10,254,Querré,308,6,314
52,Pays de la Loire,49,1,32,256,Rablay-sur-Layon,721,25,746
52,Pays de la Loire,49,1,14,257,Les Rairies,965,20,985
52,Pays de la Loire,49,2,19,258,La Renaudière,950,12,962
52,Pays de la Loire,49,1,08,259,Rochefort-sur-Loire,2167,49,2216
52,Pays de la Loire,49,2,19,260,La Romagne,1702,67,1769
52,Pays de la Loire,49,3,28,261,Les Rosiers-sur-Loire,2340,39,2379
52,Pays de la Loire,49,3,29,262,Rou-Marson,681,22,703
52,Pays de la Loire,49,2,19,263,Roussay,1117,23,1140
52,Pays de la Loire,49,2,19,264,Saint-André-de-la-Marche,2742,75,2817
52,Pays de la Loire,49,1,08,265,Saint-Aubin-de-Luigné,1141,26,1167
52,Pays de la Loire,49,1,18,266,Saint-Augustin-des-Bois,1005,17,1022
52,Pays de la Loire,49,1,02,267,Saint-Barthélemy-d'Anjou,8912,357,9269
52,Pays de la Loire,49,2,40,269,Saint-Christophe-du-Bois,2663,74,2737
52,Pays de la Loire,49,2,09,270,Saint-Christophe-la-Couperie,730,7,737
52,Pays de la Loire,49,1,18,271,Saint-Clément-de-la-Place,1826,32,1858
52,Pays de la Loire,49,3,28,272,Saint-Clément-des-Levées,1154,35,1189
52,Pays de la Loire,49,2,19,273,Saint-Crespin-sur-Moine,1542,31,1573
52,Pays de la Loire,49,3,20,274,Saint-Cyr-en-Bourg,990,36,1026
52,Pays de la Loire,49,2,25,276,Saint-Florent-le-Vieil,2686,82,2768
52,Pays de la Loire,49,2,11,281,Saint-Georges-des-Gardes,1593,48,1641
52,Pays de la Loire,49,3,15,279,Saint-Georges-des-Sept-Voies,657,17,674
52,Pays de la Loire,49,1,05,280,Saint-Georges-du-Bois,391,11,402
52,Pays de la Loire,49,3,13,282,Saint-Georges-sur-Layon,752,13,765
52,Pays de la Loire,49,1,26,283,Saint-Georges-sur-Loire,3270,75,3345
52,Pays de la Loire,49,1,26,284,Saint-Germain-des-Prés,1347,32,1379
52,Pays de la Loire,49,2,19,285,Saint-Germain-sur-Moine,2754,69,2823
52,Pays de la Loire,49,1,23,288,Saint-Jean-de-la-Croix,236,5,241
52,Pays de la Loire,49,1,26,289,Saint-Jean-de-Linières,1658,43,1701
52,Pays de la Loire,49,1,23,290,Saint-Jean-des-Mauvrets,1729,34,1763
52,Pays de la Loire,49,3,20,291,Saint-Just-sur-Dive,383,2,385
52,Pays de la Loire,49,1,32,292,Saint-Lambert-du-Lattay,1761,43,1804
52,Pays de la Loire,49,1,39,294,Saint-Lambert-la-Potherie,2407,78,2485
52,Pays de la Loire,49,2,25,295,Saint-Laurent-de-la-Plaine,1697,58,1755
52,Pays de la Loire,49,2,09,296,Saint-Laurent-des-Autels,2069,33,2102
52,Pays de la Loire,49,2,25,297,Saint-Laurent-du-Mottay,761,19,780
52,Pays de la Loire,49,1,26,298,Saint-Léger-des-Bois,1508,40,1548
52,Pays de la Loire,49,2,35,299,Saint-Léger-sous-Cholet,2456,104,2560
52,Pays de la Loire,49,2,11,300,Saint-Lézin,752,15,767
52,Pays de la Loire,49,3,20,302,Saint-Macaire-du-Bois,428,4,432
52,Pays de la Loire,49,2,19,301,Saint-Macaire-en-Mauges,6626,140,6766
52,Pays de la Loire,49,3,04,303,Saint-Martin-d'Arcé,763,18,781
52,Pays de la Loire,49,3,28,304,Saint-Martin-de-la-Place,1154,29,1183
52,Pays de la Loire,49,4,30,305,Saint-Martin-du-Bois,827,15,842
52,Pays de la Loire,49,1,26,306,Saint-Martin-du-Fouilloux,1587,30,1617
52,Pays de la Loire,49,1,23,307,Saint-Mathurin-sur-Loire,2359,60,2419
52,Pays de la Loire,49,1,23,308,Saint-Melaine-sur-Aubance,2131,51,2182
52,Pays de la Loire,49,4,24,309,Saint-Michel-et-Chanveaux,339,20,359
52,Pays de la Loire,49,3,34,310,Saint-Paul-du-Bois,578,17,595
52,Pays de la Loire,49,3,17,311,Saint-Philbert-du-Peuple,1301,26,1327
52,Pays de la Loire,49,2,06,312,Saint-Philbert-en-Mauges,363,9,372
52,Pays de la Loire,49,2,21,313,Saint-Pierre-Montlimart,3218,73,3291
52,Pays de la Loire,49,2,21,314,Saint-Quentin-en-Mauges,1004,28,1032
52,Pays de la Loire,49,3,04,315,Saint-Quentin-lès-Beaurepaire,284,4,288
52,Pays de la Loire,49,2,21,316,Saint-Rémy-en-Mauges,1376,45,1421
52,Pays de la Loire,49,1,23,317,Saint-Rémy-la-Varenne,997,26,1023
52,Pays de la Loire,49,1,23,318,Saint-Saturnin-sur-Loire,1303,30,1333
52,Pays de la Loire,49,4,30,319,Saint-Sauveur-de-Flée,282,9,291
52,Pays de la Loire,49,2,09,320,Saint-Sauveur-de-Landemont,851,10,861
52,Pays de la Loire,49,1,18,321,Saint-Sigismond,375,16,391
52,Pays de la Loire,49,1,23,322,Saint-Sulpice,182,15,197
52,Pays de la Loire,49,1,01,323,Saint-Sylvain-d'Anjou,4422,194,4616
52,Pays de la Loire,49,2,11,268,Sainte-Christine,783,8,791
52,Pays de la Loire,49,4,30,277,Sainte-Gemmes-d'Andigné,1521,48,1569
52,Pays de la Loire,49,1,23,278,Sainte-Gemmes-sur-Loire,3939,254,4193
52,Pays de la Loire,49,3,34,325,La Salle-de-Vihiers,1067,34,1101
52,Pays de la Loire,49,2,21,324,La Salle-et-Chapelle-Aubry,1235,31,1266
52,Pays de la Loire,49,1,36,326,Sarrigné,817,16,833
52,Pays de la Loire,49,1,32,327,Saulgé-l'Hôpital,519,3,522
52,Pays de la Loire,49,3,99,328,Saumur,28145,1487,29632
52,Pays de la Loire,49,1,26,329,Savennières,1399,23,1422
52,Pays de la Loire,49,4,10,330,Sceaux-d'Anjou,850,12,862
52,Pays de la Loire,49,4,30,331,Segré,6593,411,7004
52,Pays de la Loire,49,2,35,332,La Séguinière,3678,103,3781
52,Pays de la Loire,49,1,31,333,Seiches-sur-le-Loir,3012,28,3040
52,Pays de la Loire,49,1,31,334,Sermaise,340,2,342
52,Pays de la Loire,49,4,10,335,Soeurdres,335,10,345
52,Pays de la Loire,49,3,34,336,Somloire,905,11,916
52,Pays de la Loire,49,1,33,337,Soucelles,2543,45,2588
52,Pays de la Loire,49,1,23,338,Soulaines-sur-Aubance,1182,41,1223
52,Pays de la Loire,49,1,33,339,Soulaire-et-Bourg,1374,24,1398
52,Pays de la Loire,49,3,29,341,Souzay-Champigny,718,16,734
52,Pays de la Loire,49,3,34,342,Tancoigné,303,5,308
52,Pays de la Loire,49,2,40,343,La Tessoualle,3021,48,3069
52,Pays de la Loire,49,4,10,344,Thorigné-d'Anjou,1042,18,1060
52,Pays de la Loire,49,1,32,345,Thouarcé,1820,60,1880
52,Pays de la Loire,49,3,15,346,Le Thoureil,418,12,430
52,Pays de la Loire,49,1,33,347,Tiercé,4163,68,4231
52,Pays de la Loire,49,3,34,348,Tigné,770,24,794
52,Pays de la Loire,49,2,19,349,Tillières,1739,27,1766
52,Pays de la Loire,49,2,19,350,Torfou,2067,40,2107
52,Pays de la Loire,49,2,11,351,La Tourlandry,1254,39,1293
52,Pays de la Loire,49,2,12,352,Toutlemonde,1110,17,1127
52,Pays de la Loire,49,1,36,353,Trélazé,12066,214,12280
52,Pays de la Loire,49,4,24,354,Le Tremblay,348,11,359
52,Pays de la Loire,49,2,12,355,Trémentines,2848,104,2952
52,Pays de la Loire,49,3,34,356,Trémont,391,13,404
52,Pays de la Loire,49,3,29,358,Turquant,536,22,558
52,Pays de la Loire,49,3,13,359,Les Ulmes,548,14,562
52,Pays de la Loire,49,1,32,153,Valanjou,2177,62,2239
52,Pays de la Loire,49,2,09,360,La Varenne,1676,49,1725
52,Pays de la Loire,49,3,27,361,Varennes-sur-Loire,1877,71,1948
52,Pays de la Loire,49,3,29,362,Varrains,1202,25,1227
52,Pays de la Loire,49,1,32,363,Vauchrétien,1501,57,1558
52,Pays de la Loire,49,3,20,364,Vaudelnay,1230,17,1247
52,Pays de la Loire,49,3,04,380,Vaulandry,292,6,298
52,Pays de la Loire,49,3,13,365,Les Verchers-sur-Layon,864,21,885
52,Pays de la Loire,49,4,24,366,Vergonnes,307,10,317
52,Pays de la Loire,49,4,16,367,Vern-d'Anjou,1924,40,1964
52,Pays de la Loire,49,3,17,368,Vernantes,1921,37,1958
52,Pays de la Loire,49,3,17,369,Vernoil-le-Fourrier,1233,32,1265
52,Pays de la Loire,49,3,29,370,Verrie,423,7,430
52,Pays de la Loire,49,2,12,371,Vezins,1650,41,1691
52,Pays de la Loire,49,3,04,372,Le Vieil-Baugé,1274,82,1356
52,Pays de la Loire,49,3,34,373,Vihiers,4226,144,4370
52,Pays de la Loire,49,3,27,374,Villebernier,1428,26,1454
52,Pays de la Loire,49,2,06,375,Villedieu-la-Blouère,2368,59,2427
52,Pays de la Loire,49,1,18,376,Villemoisan,598,14,612
52,Pays de la Loire,49,1,01,377,Villevêque,2754,43,2797
52,Pays de la Loire,49,3,27,378,Vivy,2279,91,2370
52,Pays de la Loire,49,2,12,381,Yzernay,1710,51,1761
25,Basse-Normandie,50,2,04,001,Acqueville,628,20,648
25,Basse-Normandie,50,4,52,002,Agneaux,4153,486,4639
25,Basse-Normandie,50,3,36,003,Agon-Coutainville,2820,87,2907
25,Basse-Normandie,50,4,31,004,Airel,519,6,525
25,Basse-Normandie,50,2,37,005,Amfreville,299,9,308
25,Basse-Normandie,50,4,34,006,Amigny,142,3,145
25,Basse-Normandie,50,3,36,007,Ancteville,226,1,227
25,Basse-Normandie,50,3,06,008,Anctoville-sur-Boscq,538,22,560
25,Basse-Normandie,50,1,42,009,Angey,221,4,225
25,Basse-Normandie,50,2,37,010,Angoville-au-Plain,46,2,48
25,Basse-Normandie,50,3,20,012,Angoville-sur-Ay,256,8,264
25,Basse-Normandie,50,2,30,013,Anneville-en-Saire,375,6,381
25,Basse-Normandie,50,3,20,014,Anneville-sur-Mer,221,9,230
25,Basse-Normandie,50,3,23,015,Annoville,605,13,618
25,Basse-Normandie,50,3,16,016,Appeville,209,9,218
25,Basse-Normandie,50,1,33,018,Argouges,553,14,567
25,Basse-Normandie,50,1,29,019,Aucey-la-Plaine,458,10,468
25,Basse-Normandie,50,2,04,020,Auderville,286,5,291
25,Basse-Normandie,50,2,37,021,Audouville-la-Hubert,61,5,66
25,Basse-Normandie,50,2,30,022,Aumeville-Lestre,145,1,146
25,Basse-Normandie,50,4,09,023,Auvers,661,6,667
25,Basse-Normandie,50,4,09,024,Auxais,177,1,178
25,Basse-Normandie,50,1,01,025,Avranches,8179,568,8747
25,Basse-Normandie,50,2,22,026,Azeville,78,1,79
25,Basse-Normandie,50,1,42,027,Bacilly,808,34,842
25,Basse-Normandie,50,3,14,028,La Baleine,93,0,93
25,Basse-Normandie,50,1,02,029,Barenton,1275,41,1316
25,Basse-Normandie,50,2,30,030,Barfleur,653,14,667
25,Basse-Normandie,50,2,03,031,Barneville-Carteret,2299,58,2357
25,Basse-Normandie,50,4,35,032,La Barre-de-Semilly,938,34,972
25,Basse-Normandie,50,2,03,033,Baubigny,151,5,156
25,Basse-Normandie,50,4,35,034,Baudre,501,18,519
25,Basse-Normandie,50,3,16,035,Baudreville,84,0,84
25,Basse-Normandie,50,3,27,036,Baupte,444,5,449
25,Basse-Normandie,50,1,19,037,La Bazoge,169,3,172
25,Basse-Normandie,50,1,17,038,Beauchamps,395,13,408
25,Basse-Normandie,50,4,45,039,Beaucoudray,151,3,154
25,Basse-Normandie,50,1,43,040,Beauficel,164,5,169
25,Basse-Normandie,50,2,04,041,Beaumont-Hague,1367,47,1414
25,Basse-Normandie,50,1,29,042,Beauvoir,419,20,439
25,Basse-Normandie,50,1,19,043,Bellefontaine,152,4,156
25,Basse-Normandie,50,3,10,044,Belval,305,7,312
25,Basse-Normandie,50,2,28,045,Benoîtville,561,12,573
25,Basse-Normandie,50,4,31,046,Bérigny,372,13,385
25,Basse-Normandie,50,4,26,048,Beslon,519,10,529
25,Basse-Normandie,50,2,41,049,Besneville,659,11,670
25,Basse-Normandie,50,4,45,050,Beuvrigny,158,4,162
25,Basse-Normandie,50,2,37,051,Beuzeville-au-Plain,50,2,52
25,Basse-Normandie,50,2,37,052,Beuzeville-la-Bastille,146,6,152
25,Basse-Normandie,50,4,46,054,Biéville,164,4,168
25,Basse-Normandie,50,2,41,055,Biniville,96,0,96
25,Basse-Normandie,50,1,24,056,Bion,381,11,392
25,Basse-Normandie,50,2,04,057,Biville,533,14,547
25,Basse-Normandie,50,3,36,058,Blainville-sur-Mer,1590,49,1639
25,Basse-Normandie,50,2,37,059,Blosville,266,6,272
25,Basse-Normandie,50,4,48,060,La Bloutière,402,8,410
25,Basse-Normandie,50,3,36,061,Boisroger,176,3,179
25,Basse-Normandie,50,1,39,062,Boisyvon,115,2,117
25,Basse-Normandie,50,3,16,063,Bolleville,377,14,391
25,Basse-Normandie,50,2,41,064,La Bonneville,162,6,168
25,Basse-Normandie,50,4,48,069,Bourguenolles,300,1,301
25,Basse-Normandie,50,2,37,070,Boutteville,54,1,55
25,Basse-Normandie,50,1,05,071,Braffais,181,3,184
25,Basse-Normandie,50,3,36,072,Brainville,187,1,188
25,Basse-Normandie,50,2,04,073,Branville-Hague,166,1,167
25,Basse-Normandie,50,1,05,074,Brécey,2159,177,2336
25,Basse-Normandie,50,4,46,075,Brectouville,151,8,159
25,Basse-Normandie,50,3,06,076,Bréhal,2987,85,3072
25,Basse-Normandie,50,2,51,077,Bretteville,1043,41,1084
25,Basse-Normandie,50,3,20,078,Bretteville-sur-Ay,353,2,355
25,Basse-Normandie,50,2,07,079,Breuville,384,10,394
25,Basse-Normandie,50,4,09,080,Brévands,361,15,376
25,Basse-Normandie,50,3,06,081,Bréville-sur-Mer,806,40,846
25,Basse-Normandie,50,2,07,082,Bricquebec,4248,128,4376
25,Basse-Normandie,50,2,28,083,Bricquebosq,488,8,496
25,Basse-Normandie,50,3,12,084,Bricqueville-la-Blouette,536,25,561
25,Basse-Normandie,50,3,06,085,Bricqueville-sur-Mer,1107,23,1130
25,Basse-Normandie,50,2,38,086,Brillevast,288,8,296
25,Basse-Normandie,50,2,47,087,Brix,2064,50,2114
25,Basse-Normandie,50,1,43,088,Brouains,191,4,195
25,Basse-Normandie,50,2,37,089,Brucheville,147,9,156
25,Basse-Normandie,50,1,44,090,Buais,584,15,599
25,Basse-Normandie,50,3,12,092,Cambernon,698,19,717
25,Basse-Normandie,50,3,10,093,Cametours,409,12,421
25,Basse-Normandie,50,3,40,094,Camprond,359,8,367
25,Basse-Normandie,50,4,08,095,Canisy,1028,22,1050
25,Basse-Normandie,50,2,38,096,Canteloup,175,8,183
25,Basse-Normandie,50,3,16,097,Canville-la-Rocque,129,1,130
25,Basse-Normandie,50,4,21,098,Carantilly,594,16,610
25,Basse-Normandie,50,4,09,099,Carentan,6058,499,6557
25,Basse-Normandie,50,1,33,100,Carnet,472,20,492
25,Basse-Normandie,50,2,38,101,Carneville,225,5,230
25,Basse-Normandie,50,1,42,102,Carolles,742,32,774
25,Basse-Normandie,50,2,37,103,Carquebut,298,8,306
25,Basse-Normandie,50,2,41,105,Catteville,123,0,123
25,Basse-Normandie,50,4,09,107,Catz,121,1,122
25,Basse-Normandie,50,4,34,106,Cavigny,195,6,201
25,Basse-Normandie,50,1,13,108,Céaux,437,8,445
25,Basse-Normandie,50,3,06,109,Cérences,1798,39,1837
25,Basse-Normandie,50,4,31,110,Cerisy-la-Forêt,934,7,941
25,Basse-Normandie,50,3,10,111,Cerisy-la-Salle,1024,33,1057
25,Basse-Normandie,50,1,05,112,La Chaise-Baudouin,434,14,448
25,Basse-Normandie,50,1,17,114,Les Chambres,116,3,119
25,Basse-Normandie,50,1,17,115,Champcervon,213,4,217
25,Basse-Normandie,50,1,42,116,Champcey,188,5,193
25,Basse-Normandie,50,1,42,117,Champeaux,365,6,371
25,Basse-Normandie,50,4,48,118,Champrepus,289,2,291
25,Basse-Normandie,50,4,34,119,Les Champs-de-Losque,203,4,207
25,Basse-Normandie,50,3,06,120,Chanteloup,313,4,317
25,Basse-Normandie,50,1,39,121,La Chapelle-Cécelin,202,6,208
25,Basse-Normandie,50,4,21,123,La Chapelle-en-Juger,659,14,673
25,Basse-Normandie,50,1,05,124,La Chapelle-Urée,128,6,134
25,Basse-Normandie,50,1,19,125,Chasseguey,75,1,76
25,Basse-Normandie,50,1,43,514,Chaulieu,278,7,285
25,Basse-Normandie,50,1,01,126,Chavoy,137,0,137
25,Basse-Normandie,50,2,37,127,Chef-du-Pont,760,19,779
25,Basse-Normandie,50,4,26,128,Le Chefresne,302,7,309
25,Basse-Normandie,50,2,96,129,Cherbourg-Octeville,39774,1297,41071
25,Basse-Normandie,50,4,48,130,Chérencé-le-Héron,381,6,387
25,Basse-Normandie,50,1,19,131,Chérencé-le-Roussel,330,4,334
25,Basse-Normandie,50,1,13,132,Les Chéris,255,5,260
25,Basse-Normandie,50,1,32,133,Chèvreville,200,4,204
25,Basse-Normandie,50,4,45,134,Chevry,77,0,77
25,Basse-Normandie,50,2,38,135,Clitourps,191,3,194
25,Basse-Normandie,50,3,16,136,Coigny,207,3,210
25,Basse-Normandie,50,4,26,137,La Colombe,637,21,658
25,Basse-Normandie,50,2,41,138,Colomby,477,2,479
25,Basse-Normandie,50,4,46,139,Condé-sur-Vire,3255,130,3385
25,Basse-Normandie,50,3,23,140,Contrières,378,7,385
25,Basse-Normandie,50,2,38,142,Cosqueville,579,7,586
25,Basse-Normandie,50,3,06,143,Coudeville-sur-Mer,814,18,832
25,Basse-Normandie,50,1,39,144,Coulouvray-Boisbenâtre,563,3,566
25,Basse-Normandie,50,3,12,145,Courcy,537,9,546
25,Basse-Normandie,50,1,13,146,Courtils,247,16,263
25,Basse-Normandie,50,3,12,147,Coutances,9436,1324,10760
25,Basse-Normandie,50,4,31,148,Couvains,435,11,446
25,Basse-Normandie,50,2,25,149,Couville,941,27,968
25,Basse-Normandie,50,2,30,150,Crasville,240,5,245
25,Basse-Normandie,50,3,20,151,Créances,2140,44,2184
25,Basse-Normandie,50,1,05,152,Les Cresnays,253,3,256
25,Basse-Normandie,50,3,16,153,Cretteville,223,6,229
25,Basse-Normandie,50,1,33,154,La Croix-Avranchin,511,12,523
25,Basse-Normandie,50,1,13,155,Crollon,241,4,245
25,Basse-Normandie,50,2,41,156,Crosville-sur-Douve,65,1,66
25,Basse-Normandie,50,1,05,158,Cuves,357,12,369
25,Basse-Normandie,50,4,08,159,Dangy,650,13,663
25,Basse-Normandie,50,3,16,160,Denneville,535,13,548
25,Basse-Normandie,50,4,34,161,Le Dézert,559,7,566
25,Basse-Normandie,50,2,51,162,Digosville,1543,44,1587
25,Basse-Normandie,50,2,04,163,Digulleville,300,4,304
25,Basse-Normandie,50,4,45,164,Domjean,997,12,1009
25,Basse-Normandie,50,1,15,165,Donville-les-Bains,3296,156,3452
25,Basse-Normandie,50,3,16,166,Doville,290,5,295
25,Basse-Normandie,50,1,42,167,Dragey-Ronthon,774,12,786
25,Basse-Normandie,50,1,13,168,Ducey,2409,58,2467
25,Basse-Normandie,50,2,22,169,Écausseville,108,0,108
25,Basse-Normandie,50,2,37,170,Écoquenéauville,69,1,70
25,Basse-Normandie,50,2,04,171,Éculleville,46,0,46
25,Basse-Normandie,50,2,22,172,Émondeville,341,5,346
25,Basse-Normandie,50,2,50,173,Équeurdreville-Hainneville,17435,541,17976
25,Basse-Normandie,50,1,17,174,Équilly,154,6,160
25,Basse-Normandie,50,2,22,175,Éroudeville,246,6,252
25,Basse-Normandie,50,2,07,176,L' Étang-Bertrand,334,6,340
25,Basse-Normandie,50,2,41,177,Étienville,328,12,340
25,Basse-Normandie,50,2,38,178,Fermanville,1420,39,1459
25,Basse-Normandie,50,1,44,179,Ferrières,60,0,60
25,Basse-Normandie,50,4,45,180,Fervaches,373,7,380
25,Basse-Normandie,50,3,27,181,Feugères,352,7,359
25,Basse-Normandie,50,3,20,182,La Feuillie,290,7,297
25,Basse-Normandie,50,2,03,183,Fierville-les-Mines,304,6,310
25,Basse-Normandie,50,2,28,184,Flamanville,1725,39,1764
25,Basse-Normandie,50,4,48,185,Fleury,873,23,896
25,Basse-Normandie,50,2,22,186,Flottemanville,197,6,203
25,Basse-Normandie,50,2,04,187,Flottemanville-Hague,866,28,894
25,Basse-Normandie,50,1,17,188,Folligny,961,28,989
25,Basse-Normandie,50,1,24,189,Fontenay,297,11,308
25,Basse-Normandie,50,2,22,190,Fontenay-sur-Mer,180,3,183
25,Basse-Normandie,50,2,37,191,Foucarville,132,3,135
25,Basse-Normandie,50,4,45,192,Fourneaux,83,2,85
25,Basse-Normandie,50,1,43,193,Le Fresne-Poret,235,0,235
25,Basse-Normandie,50,2,22,194,Fresville,371,13,384
25,Basse-Normandie,50,1,43,195,Gathemo,280,7,287
25,Basse-Normandie,50,2,38,196,Gatteville-le-Phare,519,14,533
25,Basse-Normandie,50,3,14,197,Gavray,1362,34,1396
25,Basse-Normandie,50,3,20,198,Geffosses,434,5,439
25,Basse-Normandie,50,1,42,199,Genêts,437,9,446
25,Basse-Normandie,50,1,02,200,Ger,859,22,881
25,Basse-Normandie,50,4,46,202,Giéville,653,11,664
25,Basse-Normandie,50,2,51,203,La Glacerie,5340,132,5472
25,Basse-Normandie,50,3,16,204,Glatigny,155,2,157
25,Basse-Normandie,50,1,01,205,La Godefroy,221,3,224
25,Basse-Normandie,50,1,01,206,La Gohannière,119,2,121
25,Basse-Normandie,50,2,41,207,Golleville,184,2,186
25,Basse-Normandie,50,3,27,208,Gonfreville,163,4,167
25,Basse-Normandie,50,2,38,209,Gonneville,857,33,890
25,Basse-Normandie,50,3,27,210,Gorges,366,7,373
25,Basse-Normandie,50,2,38,211,Gouberville,124,4,128
25,Basse-Normandie,50,2,37,212,Gourbesville,176,1,177
25,Basse-Normandie,50,4,08,213,Gourfaleur,434,13,447
25,Basse-Normandie,50,4,45,214,Gouvets,261,5,266
25,Basse-Normandie,50,3,36,215,Gouville-sur-Mer,2080,52,2132
25,Basse-Normandie,50,4,34,216,Graignes-Mesnil-Angot,786,133,919
25,Basse-Normandie,50,1,05,217,Le Grand-Celland,538,10,548
25,Basse-Normandie,50,1,15,218,Granville,13087,740,13827
25,Basse-Normandie,50,3,36,219,Gratot,660,35,695
25,Basse-Normandie,50,2,04,220,Gréville-Hague,780,36,816
25,Basse-Normandie,50,3,14,221,Grimesnil,70,0,70
25,Basse-Normandie,50,2,28,222,Grosville,678,9,687
25,Basse-Normandie,50,3,10,223,Guéhébert,130,6,136
25,Basse-Normandie,50,4,46,224,Guilberville,937,15,952
25,Basse-Normandie,50,4,26,225,Le Guislain,117,2,119
25,Basse-Normandie,50,2,22,227,Le Ham,336,4,340
25,Basse-Normandie,50,3,14,228,Hambye,1176,28,1204
25,Basse-Normandie,50,1,33,229,Hamelin,115,0,115
25,Basse-Normandie,50,2,25,230,Hardinvast,925,22,947
25,Basse-Normandie,50,3,40,232,Hauteville-la-Guichard,449,6,455
25,Basse-Normandie,50,3,23,231,Hauteville-sur-Mer,633,11,644
25,Basse-Normandie,50,2,41,233,Hautteville-Bocage,115,2,117
25,Basse-Normandie,50,4,26,234,La Haye-Bellefond,74,0,74
25,Basse-Normandie,50,2,03,235,La Haye-d'Ectot,227,9,236
25,Basse-Normandie,50,3,16,236,La Haye-du-Puits,1713,87,1800
25,Basse-Normandie,50,1,17,237,La Haye-Pesnel,1358,36,1394
25,Basse-Normandie,50,2,28,238,Héauville,455,6,461
25,Basse-Normandie,50,4,21,239,Hébécrevon,1124,30,1154
25,Basse-Normandie,50,2,28,240,Helleville,432,10,442
25,Basse-Normandie,50,2,22,241,Hémevez,172,3,175
25,Basse-Normandie,50,3,23,244,Hérenguerville,158,7,165
25,Basse-Normandie,50,2,04,242,Herqueville,156,4,160
25,Basse-Normandie,50,3,36,243,Heugueville-sur-Sienne,551,14,565
25,Basse-Normandie,50,1,44,245,Heussé,247,0,247
25,Basse-Normandie,50,2,37,246,Hiesville,72,4,76
25,Basse-Normandie,50,1,17,247,Hocquigny,186,3,189
25,Basse-Normandie,50,4,34,248,Le Hommet-d'Arthenay,426,127,553
25,Basse-Normandie,50,2,37,249,Houesville,284,1,285
25,Basse-Normandie,50,3,16,250,Houtteville,94,1,95
25,Basse-Normandie,50,2,47,251,Huberville,343,9,352
25,Basse-Normandie,50,3,06,252,Hudimesnil,856,8,864
25,Basse-Normandie,50,1,29,253,Huisnes-sur-Mer,190,5,195
25,Basse-Normandie,50,1,44,254,Husson,234,16,250
25,Basse-Normandie,50,3,23,255,Hyenville,326,9,335
25,Basse-Normandie,50,1,18,256,Isigny-le-Buat,3231,98,3329
25,Basse-Normandie,50,2,04,257,Jobourg,449,14,463
25,Basse-Normandie,50,2,22,258,Joganville,68,6,74
25,Basse-Normandie,50,1,13,259,Juilley,579,13,592
25,Basse-Normandie,50,1,97,066,Jullouville,2180,58,2238
25,Basse-Normandie,50,1,19,260,Juvigny-le-Tertre,613,16,629
25,Basse-Normandie,50,4,46,261,Lamberville,158,2,160
25,Basse-Normandie,50,4,48,262,La Lande-d'Airou,504,12,516
25,Basse-Normandie,50,1,32,263,Lapenty,446,10,456
25,Basse-Normandie,50,3,20,265,Laulne,156,7,163
25,Basse-Normandie,50,3,14,266,Lengronne,450,16,466
25,Basse-Normandie,50,3,20,267,Lessay,2040,35,2075
25,Basse-Normandie,50,2,22,268,Lestre,246,3,249
25,Basse-Normandie,50,2,37,269,Liesville-sur-Douve,224,1,225
25,Basse-Normandie,50,2,47,270,Lieusaint,364,8,372
25,Basse-Normandie,50,1,39,271,Lingeard,84,2,86
25,Basse-Normandie,50,3,23,272,Lingreville,942,22,964
25,Basse-Normandie,50,3,16,273,Lithaire,556,6,562
25,Basse-Normandie,50,1,32,274,Les Loges-Marchis,1022,150,1172
25,Basse-Normandie,50,1,05,275,Les Loges-sur-Brécey,148,9,157
25,Basse-Normandie,50,1,42,276,Lolif,554,16,570
25,Basse-Normandie,50,3,06,277,Longueville,609,19,628
25,Basse-Normandie,50,3,06,278,Le Loreur,205,2,207
25,Basse-Normandie,50,3,40,279,Le Lorey,601,11,612
25,Basse-Normandie,50,4,21,280,Lozon,307,6,313
25,Basse-Normandie,50,1,17,281,La Lucerne-d'Outremer,815,22,837
25,Basse-Normandie,50,1,17,282,Le Luot,214,5,219
25,Basse-Normandie,50,4,35,283,La Luzerne,39,5,44
25,Basse-Normandie,50,1,29,284,Macey,107,2,109
25,Basse-Normandie,50,2,07,285,Magneville,278,6,284
25,Basse-Normandie,50,4,08,287,La Mancellière-sur-Vire,478,11,489
25,Basse-Normandie,50,1,01,288,Marcey-les-Grèves,1231,38,1269
25,Basse-Normandie,50,3,27,289,Marchésieux,712,18,730
25,Basse-Normandie,50,1,13,290,Marcilly,379,0,379
25,Basse-Normandie,50,4,26,291,Margueray,145,0,145
25,Basse-Normandie,50,4,21,292,Marigny,2106,76,2182
25,Basse-Normandie,50,1,32,293,Martigny,328,6,334
25,Basse-Normandie,50,2,25,294,Martinvast,1160,34,1194
25,Basse-Normandie,50,4,26,295,Maupertuis,135,4,139
25,Basse-Normandie,50,2,38,296,Maupertus-sur-Mer,257,4,261
25,Basse-Normandie,50,4,31,297,La Meauffe,1073,28,1101
25,Basse-Normandie,50,4,09,298,Méautis,655,26,681
25,Basse-Normandie,50,2,03,299,Le Mesnil,194,8,202
25,Basse-Normandie,50,1,19,300,Le Mesnil-Adelée,191,5,196
25,Basse-Normandie,50,3,14,301,Le Mesnil-Amand,156,1,157
25,Basse-Normandie,50,4,21,302,Le Mesnil-Amey,258,14,272
25,Basse-Normandie,50,2,51,305,Le Mesnil-au-Val,653,22,675
25,Basse-Normandie,50,3,06,304,Le Mesnil-Aubert,158,3,161
25,Basse-Normandie,50,4,21,310,Le Mesnil-Eury,181,2,183
25,Basse-Normandie,50,3,14,311,Le Mesnil-Garnier,220,8,228
25,Basse-Normandie,50,1,39,312,Le Mesnil-Gilbert,153,4,157
25,Basse-Normandie,50,4,08,313,Le Mesnil-Herman,140,6,146
25,Basse-Normandie,50,4,45,316,Le Mesnil-Opac,257,6,263
25,Basse-Normandie,50,1,13,317,Le Mesnil-Ozenne,233,0,233
25,Basse-Normandie,50,1,19,318,Le Mesnil-Rainfray,245,3,248
25,Basse-Normandie,50,4,45,319,Le Mesnil-Raoult,368,4,372
25,Basse-Normandie,50,3,14,320,Le Mesnil-Rogues,162,5,167
25,Basse-Normandie,50,4,52,321,Le Mesnil-Rouxelin,482,35,517
25,Basse-Normandie,50,1,19,323,Le Mesnil-Tôve,227,7,234
25,Basse-Normandie,50,4,34,324,Le Mesnil-Véneron,97,1,98
25,Basse-Normandie,50,4,21,325,Le Mesnil-Vigot,258,4,262
25,Basse-Normandie,50,3,14,326,Le Mesnil-Villeman,223,5,228
25,Basse-Normandie,50,3,40,308,Le Mesnilbus,268,6,274
25,Basse-Normandie,50,1,32,315,Le Mesnillard,281,8,289
25,Basse-Normandie,50,3,06,327,La Meurdraquière,161,0,161
25,Basse-Normandie,50,3,20,328,Millières,629,7,636
25,Basse-Normandie,50,1,32,329,Milly,332,12,344
25,Basse-Normandie,50,3,16,330,Mobecq,251,3,254
25,Basse-Normandie,50,2,03,332,Les Moitiers-d'Allonne,674,17,691
25,Basse-Normandie,50,2,41,333,Les Moitiers-en-Bauptois,327,7,334
25,Basse-Normandie,50,1,29,353,Le Mont-Saint-Michel,42,2,44
25,Basse-Normandie,50,4,26,334,Montabot,291,5,296
25,Basse-Normandie,50,2,47,335,Montaigu-la-Brisette,482,12,494
25,Basse-Normandie,50,3,14,336,Montaigu-les-Bois,232,6,238
25,Basse-Normandie,50,1,33,337,Montanel,367,10,377
25,Basse-Normandie,50,4,26,338,Montbray,369,1,370
25,Basse-Normandie,50,3,23,339,Montchaton,345,15,360
25,Basse-Normandie,50,3,40,340,Montcuit,194,5,199
25,Basse-Normandie,50,2,22,341,Montebourg,2127,141,2268
25,Basse-Normandie,50,2,30,342,Montfarville,805,22,827
25,Basse-Normandie,50,3,16,343,Montgardon,405,13,418
25,Basse-Normandie,50,3,40,345,Monthuchon,594,21,615
25,Basse-Normandie,50,1,33,347,Montjoie-Saint-Martin,274,7,281
25,Basse-Normandie,50,4,34,348,Montmartin-en-Graignes,551,9,560
25,Basse-Normandie,50,3,23,349,Montmartin-sur-Mer,1292,37,1329
25,Basse-Normandie,50,3,10,350,Montpinchon,557,11,568
25,Basse-Normandie,50,4,46,351,Montrabot,84,3,87
25,Basse-Normandie,50,4,21,352,Montreuil-sur-Lozon,280,6,286
25,Basse-Normandie,50,3,36,354,Montsurvent,338,6,344
25,Basse-Normandie,50,1,42,355,Montviron,326,4,330
25,Basse-Normandie,50,4,31,356,Moon-sur-Elle,839,17,856
25,Basse-Normandie,50,4,26,357,Morigny,89,3,92
25,Basse-Normandie,50,2,30,358,Morsalines,216,7,223
25,Basse-Normandie,50,1,24,359,Mortain,1812,256,2068
25,Basse-Normandie,50,2,07,360,Morville,262,9,271
25,Basse-Normandie,50,1,17,361,La Mouche,184,0,184
25,Basse-Normandie,50,1,32,362,Moulines,302,7,309
25,Basse-Normandie,50,4,45,363,Moyon,1102,23,1125
25,Basse-Normandie,50,3,40,364,Muneville-le-Bingard,653,10,663
25,Basse-Normandie,50,3,06,365,Muneville-sur-Mer,363,2,365
25,Basse-Normandie,50,3,27,368,Nay,79,2,81
25,Basse-Normandie,50,2,07,369,Négreville,819,24,843
25,Basse-Normandie,50,2,41,370,Néhou,532,8,540
25,Basse-Normandie,50,1,24,371,Le Neufbourg,470,15,485
25,Basse-Normandie,50,3,16,372,Neufmesnil,183,4,187
25,Basse-Normandie,50,2,37,373,Neuville-au-Plain,109,1,110
25,Basse-Normandie,50,2,41,374,Neuville-en-Beaumont,37,0,37
25,Basse-Normandie,50,2,38,375,Néville-sur-Mer,180,1,181
25,Basse-Normandie,50,3,12,376,Nicorps,423,21,444
25,Basse-Normandie,50,4,31,380,Notre-Dame-d'Elle,130,2,132
25,Basse-Normandie,50,3,10,378,Notre-Dame-de-Cenilly,690,5,695
25,Basse-Normandie,50,1,05,379,Notre-Dame-de-Livoye,121,4,125
25,Basse-Normandie,50,1,24,381,Notre-Dame-du-Touchet,654,16,670
25,Basse-Normandie,50,2,50,382,Nouainville,457,25,482
25,Basse-Normandie,50,2,30,384,Octeville-l'Avenel,189,2,191
25,Basse-Normandie,50,2,04,385,Omonville-la-Petite,123,2,125
25,Basse-Normandie,50,2,04,386,Omonville-la-Rogue,526,15,541
25,Basse-Normandie,50,2,41,387,Orglandes,327,8,335
25,Basse-Normandie,50,3,23,388,Orval,887,37,924
25,Basse-Normandie,50,3,10,389,Ouville,440,14,454
25,Basse-Normandie,50,2,22,390,Ozeville,145,1,146
25,Basse-Normandie,50,1,32,391,Parigny,1779,73,1852
25,Basse-Normandie,50,4,26,393,Percy,2242,80,2322
25,Basse-Normandie,50,3,27,394,Périers,2420,62,2482
25,Basse-Normandie,50,2,30,395,La Pernelle,252,5,257
25,Basse-Normandie,50,2,07,396,Les Perques,152,4,156
25,Basse-Normandie,50,1,43,397,Perriers-en-Beauficel,230,9,239
25,Basse-Normandie,50,4,46,398,Le Perron,175,1,176
25,Basse-Normandie,50,1,05,399,Le Petit-Celland,180,6,186
25,Basse-Normandie,50,2,37,400,Picauville,1982,38,2020
25,Basse-Normandie,50,2,28,401,Pierreville,659,25,684
25,Basse-Normandie,50,2,28,402,Les Pieux,3521,104,3625
25,Basse-Normandie,50,3,20,403,Pirou,1607,42,1649
25,Basse-Normandie,50,4,46,404,Placy-Montaigu,208,6,214
25,Basse-Normandie,50,3,27,405,Le Plessis-Lastelle,252,2,254
25,Basse-Normandie,50,1,01,406,Plomb,386,14,400
25,Basse-Normandie,50,1,13,407,Poilley,803,26,829
25,Basse-Normandie,50,4,34,409,Pont-Hébert,1787,50,1837
25,Basse-Normandie,50,1,01,408,Pontaubault,468,12,480
25,Basse-Normandie,50,1,29,410,Pontorson,4094,75,4169
25,Basse-Normandie,50,1,01,411,Ponts,547,17,564
25,Basse-Normandie,50,2,03,412,Portbail,1667,69,1736
25,Basse-Normandie,50,1,13,413,Précey,466,12,478
25,Basse-Normandie,50,4,46,414,Précorbin,513,8,521
25,Basse-Normandie,50,3,16,415,Prétot-Sainte-Suzanne,326,12,338
25,Basse-Normandie,50,2,50,416,Querqueville,5464,169,5633
25,Basse-Normandie,50,2,30,417,Quettehou,1564,34,1598
25,Basse-Normandie,50,2,07,418,Quettetot,736,11,747
25,Basse-Normandie,50,3,23,419,Quettreville-sur-Sienne,1420,38,1458
25,Basse-Normandie,50,4,08,420,Quibou,881,14,895
25,Basse-Normandie,50,2,22,421,Quinéville,304,2,306
25,Basse-Normandie,50,4,09,422,Raids,197,3,200
25,Basse-Normandie,50,4,52,423,Rampan,221,13,234
25,Basse-Normandie,50,2,07,425,Rauville-la-Bigot,1104,15,1119
25,Basse-Normandie,50,2,41,426,Rauville-la-Place,386,12,398
25,Basse-Normandie,50,2,37,427,Ravenoville,259,1,260
25,Basse-Normandie,50,1,19,428,Reffuveille,464,15,479
25,Basse-Normandie,50,3,23,429,Regnéville-sur-Mer,833,28,861
25,Basse-Normandie,50,2,41,430,Reigneville-Bocage,29,0,29
25,Basse-Normandie,50,4,21,431,Remilly-sur-Lozon,663,4,667
25,Basse-Normandie,50,2,38,432,Réthoville,134,5,139
25,Basse-Normandie,50,2,30,433,Réville,1193,25,1218
25,Basse-Normandie,50,1,17,434,La Rochelle-Normande,289,10,299
25,Basse-Normandie,50,2,07,435,Rocheville,642,22,664
25,Basse-Normandie,50,1,24,436,Romagny,1053,37,1090
25,Basse-Normandie,50,3,10,437,Roncey,799,28,827
25,Basse-Normandie,50,3,40,438,La Ronde-Haye,345,7,352
25,Basse-Normandie,50,4,48,440,Rouffigny,312,11,323
25,Basse-Normandie,50,4,46,441,Rouxeville,320,1,321
25,Basse-Normandie,50,2,28,442,Le Rozel,277,12,289
25,Basse-Normandie,50,1,29,443,Sacey,517,9,526
25,Basse-Normandie,50,4,46,444,Saint-Amand,2211,63,2274
25,Basse-Normandie,50,4,09,445,Saint-André-de-Bohon,315,7,322
25,Basse-Normandie,50,4,31,446,Saint-André-de-l'Épine,531,18,549
25,Basse-Normandie,50,1,33,448,Saint-Aubin-de-Terregatte,711,9,720
25,Basse-Normandie,50,1,15,447,Saint-Aubin-des-Préaux,411,19,430
25,Basse-Normandie,50,3,40,449,Saint-Aubin-du-Perron,229,3,232
25,Basse-Normandie,50,1,24,450,Saint-Barthélemy,353,14,367
25,Basse-Normandie,50,1,01,451,Saint-Brice,130,3,133
25,Basse-Normandie,50,1,32,452,Saint-Brice-de-Landelles,642,11,653
25,Basse-Normandie,50,2,28,454,Saint-Christophe-du-Foc,335,9,344
25,Basse-Normandie,50,4,31,455,Saint-Clair-sur-l'Elle,871,19,890
25,Basse-Normandie,50,1,24,456,Saint-Clément-Rancoudray,536,4,540
25,Basse-Normandie,50,4,09,458,Saint-Côme-du-Mont,511,18,529
25,Basse-Normandie,50,2,22,461,Saint-Cyr,199,1,200
25,Basse-Normandie,50,1,02,462,Saint-Cyr-du-Bailleul,422,8,430
25,Basse-Normandie,50,3,14,463,Saint-Denis-le-Gast,541,10,551
25,Basse-Normandie,50,3,10,464,Saint-Denis-le-Vêtu,604,18,622
25,Basse-Normandie,50,4,08,465,Saint-Ébremond-de-Bonfossé,737,23,760
25,Basse-Normandie,50,2,22,467,Saint-Floxel,439,14,453
25,Basse-Normandie,50,4,34,468,Saint-Fromond,730,11,741
25,Basse-Normandie,50,4,31,473,Saint-Georges-d'Elle,378,10,388
25,Basse-Normandie,50,4,09,470,Saint-Georges-de-Bohon,407,10,417
25,Basse-Normandie,50,2,03,471,Saint-Georges-de-la-Rivière,253,9,262
25,Basse-Normandie,50,1,05,472,Saint-Georges-de-Livoye,219,2,221
25,Basse-Normandie,50,1,02,474,Saint-Georges-de-Rouelley,528,7,535
25,Basse-Normandie,50,4,52,475,Saint-Georges-Montcocq,839,40,879
25,Basse-Normandie,50,4,31,476,Saint-Germain-d'Elle,185,2,187
25,Basse-Normandie,50,2,22,478,Saint-Germain-de-Tournebut,386,7,393
25,Basse-Normandie,50,2,37,479,Saint-Germain-de-Varreville,118,3,121
25,Basse-Normandie,50,2,04,477,Saint-Germain-des-Vaux,415,6,421
25,Basse-Normandie,50,2,28,480,Saint-Germain-le-Gaillard,680,18,698
25,Basse-Normandie,50,3,20,481,Saint-Germain-sur-Ay,881,22,903
25,Basse-Normandie,50,3,27,482,Saint-Germain-sur-Sèves,194,6,200
25,Basse-Normandie,50,4,21,483,Saint-Gilles,908,30,938
25,Basse-Normandie,50,1,32,484,Saint-Hilaire-du-Harcouët,4112,303,4415
25,Basse-Normandie,50,4,09,485,Saint-Hilaire-Petitville,1399,49,1448
25,Basse-Normandie,50,2,41,486,Saint-Jacques-de-Néhou,502,10,512
25,Basse-Normandie,50,1,33,487,Saint-James,2678,105,2783
25,Basse-Normandie,50,4,34,488,Saint-Jean-de-Daye,607,12,619
25,Basse-Normandie,50,1,01,489,Saint-Jean-de-la-Haize,490,16,506
25,Basse-Normandie,50,2,03,490,Saint-Jean-de-la-Rivière,354,8,362
25,Basse-Normandie,50,4,31,491,Saint-Jean-de-Savigny,357,11,368
25,Basse-Normandie,50,4,46,492,Saint-Jean-des-Baisants,1163,29,1192
25,Basse-Normandie,50,1,17,493,Saint-Jean-des-Champs,1303,45,1348
25,Basse-Normandie,50,1,24,494,Saint-Jean-du-Corail,274,10,284
25,Basse-Normandie,50,1,05,495,Saint-Jean-du-Corail-des-Bois,74,0,74
25,Basse-Normandie,50,1,42,496,Saint-Jean-le-Thomas,429,9,438
25,Basse-Normandie,50,3,27,497,Saint-Jores,364,12,376
25,Basse-Normandie,50,2,47,498,Saint-Joseph,815,23,838
25,Basse-Normandie,50,1,39,499,Saint-Laurent-de-Cuves,495,16,511
25,Basse-Normandie,50,1,33,500,Saint-Laurent-de-Terregatte,562,12,574
25,Basse-Normandie,50,4,95,502,Saint-Lô,19092,1193,20285
25,Basse-Normandie,50,2,03,503,Saint-Lô-d'Ourville,559,21,580
25,Basse-Normandie,50,4,45,504,Saint-Louet-sur-Vire,188,3,191
25,Basse-Normandie,50,1,01,505,Saint-Loup,636,20,656
25,Basse-Normandie,50,3,36,506,Saint-Malo-de-la-Lande,426,8,434
25,Basse-Normandie,50,2,22,507,Saint-Marcouf,330,6,336
25,Basse-Normandie,50,3,27,510,Saint-Martin-d'Aubigny,537,13,550
25,Basse-Normandie,50,2,22,511,Saint-Martin-d'Audouville,116,3,119
25,Basse-Normandie,50,4,08,512,Saint-Martin-de-Bonfossé,539,17,556
25,Basse-Normandie,50,3,10,513,Saint-Martin-de-Cenilly,217,8,225
25,Basse-Normandie,50,1,32,515,Saint-Martin-de-Landelles,1174,31,1205
25,Basse-Normandie,50,2,37,517,Saint-Martin-de-Varreville,208,0,208
25,Basse-Normandie,50,1,01,516,Saint-Martin-des-Champs,2203,129,2332
25,Basse-Normandie,50,1,39,518,Saint-Martin-le-Bouillant,286,8,294
25,Basse-Normandie,50,2,25,519,Saint-Martin-le-Gréard,395,9,404
25,Basse-Normandie,50,2,07,520,Saint-Martin-le-Hébert,131,2,133
25,Basse-Normandie,50,1,39,521,Saint-Maur-des-Bois,129,4,133
25,Basse-Normandie,50,2,03,522,Saint-Maurice-en-Cotentin,285,10,295
25,Basse-Normandie,50,3,40,524,Saint-Michel-de-la-Pierre,182,5,187
25,Basse-Normandie,50,1,39,525,Saint-Michel-de-Montjoie,328,3,331
25,Basse-Normandie,50,3,16,528,Saint-Nicolas-de-Pierrepont,248,10,258
25,Basse-Normandie,50,1,05,529,Saint-Nicolas-des-Bois,116,1,117
25,Basse-Normandie,50,1,99,531,Saint-Ovin,747,14,761
25,Basse-Normandie,50,1,15,532,Saint-Pair-sur-Mer,3795,140,3935
25,Basse-Normandie,50,3,20,533,Saint-Patrice-de-Claids,157,2,159
25,Basse-Normandie,50,4,09,534,Saint-Pellerin,357,6,363
25,Basse-Normandie,50,2,03,536,Saint-Pierre-d'Arthéglise,151,2,153
25,Basse-Normandie,50,3,12,537,Saint-Pierre-de-Coutances,395,14,409
25,Basse-Normandie,50,4,31,538,Saint-Pierre-de-Semilly,415,24,439
25,Basse-Normandie,50,2,38,539,Saint-Pierre-Église,1782,35,1817
25,Basse-Normandie,50,1,42,540,Saint-Pierre-Langers,526,23,549
25,Basse-Normandie,50,1,15,541,Saint-Planchers,1283,46,1329
25,Basse-Normandie,50,1,39,542,Saint-Pois,523,29,552
25,Basse-Normandie,50,1,13,543,Saint-Quentin-sur-le-Homme,1228,38,1266
25,Basse-Normandie,50,3,16,544,Saint-Rémy-des-Landes,211,6,217
25,Basse-Normandie,50,4,08,545,Saint-Romphaire,733,10,743
25,Basse-Normandie,50,4,08,546,Saint-Samson-de-Bonfossé,905,31,936
25,Basse-Normandie,50,3,16,548,Saint-Sauveur-de-Pierrepont,132,2,134
25,Basse-Normandie,50,3,06,549,Saint-Sauveur-la-Pommeraye,309,11,320
25,Basse-Normandie,50,2,41,551,Saint-Sauveur-le-Vicomte,2044,36,2080
25,Basse-Normandie,50,3,40,550,Saint-Sauveur-Lendelin,1648,81,1729
25,Basse-Normandie,50,3,27,552,Saint-Sébastien-de-Raids,353,4,357
25,Basse-Normandie,50,1,33,553,Saint-Senier-de-Beuvron,299,6,305
25,Basse-Normandie,50,1,01,554,Saint-Senier-sous-Avranches,1230,68,1298
25,Basse-Normandie,50,1,44,557,Saint-Symphorien-des-Monts,151,1,152
25,Basse-Normandie,50,3,16,558,Saint-Symphorien-le-Valois,795,23,818
25,Basse-Normandie,50,2,30,562,Saint-Vaast-la-Hougue,2095,34,2129
25,Basse-Normandie,50,4,45,563,Saint-Vigor-des-Monts,289,5,294
25,Basse-Normandie,50,4,48,453,Sainte-Cécile,788,28,816
25,Basse-Normandie,50,2,41,457,Sainte-Colombe,194,1,195
25,Basse-Normandie,50,2,04,460,Sainte-Croix-Hague,724,19,743
25,Basse-Normandie,50,2,30,469,Sainte-Geneviève,316,14,330
25,Basse-Normandie,50,1,44,508,Sainte-Marie-du-Bois,59,0,59
25,Basse-Normandie,50,2,37,509,Sainte-Marie-du-Mont,770,24,794
25,Basse-Normandie,50,2,37,523,Sainte-Mère-Église,1629,47,1676
25,Basse-Normandie,50,1,17,535,Sainte-Pience,267,9,276
25,Basse-Normandie,50,4,35,556,Sainte-Suzanne-sur-Vire,503,38,541
25,Basse-Normandie,50,4,09,564,Sainteny,795,31,826
25,Basse-Normandie,50,1,42,565,Sartilly,1461,24,1485
25,Basse-Normandie,50,2,47,567,Saussemesnil,918,23,941
25,Basse-Normandie,50,3,12,568,Saussey,501,25,526
25,Basse-Normandie,50,3,10,569,Savigny,372,9,381
25,Basse-Normandie,50,1,44,570,Savigny-le-Vieux,430,10,440
25,Basse-Normandie,50,2,37,571,Sébeville,34,0,34
25,Basse-Normandie,50,2,03,572,Sénoville,209,13,222
25,Basse-Normandie,50,3,36,573,Servigny,217,2,219
25,Basse-Normandie,50,1,29,574,Servon,271,2,273
25,Basse-Normandie,50,2,50,575,Sideville,534,20,554
25,Basse-Normandie,50,2,28,576,Siouville-Hague,1104,40,1144
25,Basse-Normandie,50,2,22,578,Sortosville,87,4,91
25,Basse-Normandie,50,2,03,577,Sortosville-en-Beaumont,315,3,318
25,Basse-Normandie,50,2,07,579,Sottevast,1345,34,1379
25,Basse-Normandie,50,2,28,580,Sotteville,414,17,431
25,Basse-Normandie,50,4,08,581,Soulles,429,7,436
25,Basse-Normandie,50,1,43,582,Sourdeval,2879,54,2933
25,Basse-Normandie,50,3,14,583,Sourdeval-les-Bois,167,2,169
25,Basse-Normandie,50,1,17,584,Subligny,330,12,342
25,Basse-Normandie,50,2,28,585,Surtainville,1274,36,1310
25,Basse-Normandie,50,3,16,586,Surville,199,3,202
25,Basse-Normandie,50,2,41,587,Taillepied,29,0,29
25,Basse-Normandie,50,2,47,588,Tamerville,600,19,619
25,Basse-Normandie,50,1,29,589,Tanis,305,13,318
25,Basse-Normandie,50,1,17,590,Le Tanu,336,7,343
25,Basse-Normandie,50,1,44,591,Le Teilleul,1293,42,1335
25,Basse-Normandie,50,4,45,592,Tessy-sur-Vire,1482,30,1512
25,Basse-Normandie,50,2,30,593,Teurthéville-Bocage,589,9,598
25,Basse-Normandie,50,2,50,594,Teurthéville-Hague,872,24,896
25,Basse-Normandie,50,2,38,595,Le Theil,682,13,695
25,Basse-Normandie,50,2,38,596,Théville,320,3,323
25,Basse-Normandie,50,1,05,597,Tirepied,770,24,794
25,Basse-Normandie,50,2,38,598,Tocqueville,269,10,279
25,Basse-Normandie,50,2,25,599,Tollevast,1179,33,1212
25,Basse-Normandie,50,2,04,600,Tonneville,648,29,677
25,Basse-Normandie,50,4,46,601,Torigni-sur-Vire,2416,50,2466
25,Basse-Normandie,50,2,51,602,Tourlaville,16317,479,16796
25,Basse-Normandie,50,3,36,603,Tourville-sur-Sienne,736,21,757
25,Basse-Normandie,50,2,28,604,Tréauville,734,24,758
25,Basse-Normandie,50,3,23,605,Trelly,623,12,635
25,Basse-Normandie,50,4,34,606,Tribehou,503,15,518
25,Basse-Normandie,50,4,48,607,La Trinité,387,6,393
25,Basse-Normandie,50,4,45,608,Troisgots,273,29,302
25,Basse-Normandie,50,2,37,609,Turqueville,136,2,138
25,Basse-Normandie,50,2,22,610,Urville,189,4,193
25,Basse-Normandie,50,2,04,611,Urville-Nacqueville,2194,131,2325
25,Basse-Normandie,50,1,01,612,Vains,743,45,788
25,Basse-Normandie,50,1,01,616,Le Val-Saint-Père,1864,104,1968
25,Basse-Normandie,50,2,30,613,Valcanville,368,8,376
25,Basse-Normandie,50,2,07,614,Le Valdécie,117,6,123
25,Basse-Normandie,50,2,47,615,Valognes,7196,366,7562
25,Basse-Normandie,50,3,16,617,Varenguebec,341,2,343
25,Basse-Normandie,50,2,38,618,Varouville,285,7,292
25,Basse-Normandie,50,2,38,619,Le Vast,289,4,293
25,Basse-Normandie,50,2,04,620,Vasteville,1042,25,1067
25,Basse-Normandie,50,2,22,621,Vaudreville,80,1,81
25,Basse-Normandie,50,3,40,622,Vaudrimesnil,425,8,433
25,Basse-Normandie,50,2,04,623,Vauville,390,11,401
25,Basse-Normandie,50,3,36,624,La Vendelée,412,7,419
25,Basse-Normandie,50,1,43,625,Vengeons,487,12,499
25,Basse-Normandie,50,3,14,626,Ver,368,9,377
25,Basse-Normandie,50,1,33,627,Vergoncey,216,4,220
25,Basse-Normandie,50,1,05,628,Vernix,170,9,179
25,Basse-Normandie,50,3,98,629,Vesly,632,6,638
25,Basse-Normandie,50,1,29,630,Vessey,396,10,406
25,Basse-Normandie,50,4,09,631,Les Veys,426,6,432
25,Basse-Normandie,50,2,30,633,Le Vicel,143,1,144
25,Basse-Normandie,50,2,30,634,Videcosville,84,3,87
25,Basse-Normandie,50,4,46,635,Vidouville,123,4,127
25,Basse-Normandie,50,2,37,636,Vierville,44,4,48
25,Basse-Normandie,50,4,26,637,Villebaudon,284,2,286
25,Basse-Normandie,50,1,24,638,Villechien,201,4,205
25,Basse-Normandie,50,4,48,639,Villedieu-les-Poêles,3895,144,4039
25,Basse-Normandie,50,4,31,641,Villiers-Fossard,516,18,534
25,Basse-Normandie,50,1,33,640,Villiers-le-Pré,192,9,201
25,Basse-Normandie,50,3,16,642,Vindefontaine,294,12,306
25,Basse-Normandie,50,2,50,643,Virandeville,793,29,822
25,Basse-Normandie,50,1,32,644,Virey,1011,21,1032
25,Basse-Normandie,50,2,07,646,Le Vrétot,556,4,560
25,Basse-Normandie,50,1,15,647,Yquelon,981,42,1023
25,Basse-Normandie,50,2,47,648,Yvetot-Bocage,1076,39,1115
21,Champagne-Ardenne,51,4,33,001,Ablancourt,152,4,156
21,Champagne-Ardenne,51,1,35,003,Aigny,229,4,233
21,Champagne-Ardenne,51,2,01,004,Allemanche-Launay-et-Soyer,104,2,106
21,Champagne-Ardenne,51,2,25,005,Allemant,167,2,169
21,Champagne-Ardenne,51,4,15,006,Alliancelles,145,4,149
21,Champagne-Ardenne,51,2,03,007,Ambonnay,932,16,948
21,Champagne-Ardenne,51,4,24,008,Ambrières,229,4,233
21,Champagne-Ardenne,51,2,01,009,Anglure,874,19,893
21,Champagne-Ardenne,51,2,13,010,Angluzelles-et-Courcelles,136,2,138
21,Champagne-Ardenne,51,3,07,012,Anthenay,62,1,63
21,Champagne-Ardenne,51,3,31,013,Aougny,98,1,99
21,Champagne-Ardenne,51,3,14,014,Arcis-le-Ponsart,269,4,273
21,Champagne-Ardenne,51,5,23,015,Argers,106,3,109
21,Champagne-Ardenne,51,4,24,016,Arrigny,269,6,275
21,Champagne-Ardenne,51,4,24,017,Arzillières-Neuville,342,8,350
21,Champagne-Ardenne,51,1,10,018,Athis,822,12,834
21,Champagne-Ardenne,51,3,04,019,Aubérive,198,4,202
21,Champagne-Ardenne,51,3,31,020,Aubilly,51,1,52
21,Champagne-Ardenne,51,4,33,022,Aulnay-l'Aître,137,4,141
21,Champagne-Ardenne,51,1,10,023,Aulnay-sur-Marne,225,5,230
21,Champagne-Ardenne,51,3,05,025,Auménancourt,888,8,896
21,Champagne-Ardenne,51,5,08,027,Auve,235,22,257
21,Champagne-Ardenne,51,2,03,028,Avenay-Val-d'Or,930,15,945
21,Champagne-Ardenne,51,2,02,029,Avize,1640,142,1782
21,Champagne-Ardenne,51,2,03,030,Ay,4134,59,4193
21,Champagne-Ardenne,51,3,30,031,Baconnes,283,7,290
21,Champagne-Ardenne,51,2,01,032,Bagneux,497,3,500
21,Champagne-Ardenne,51,2,18,033,Le Baizil,267,2,269
21,Champagne-Ardenne,51,2,18,034,Bannay,22,1,23
21,Champagne-Ardenne,51,2,13,035,Bannes,264,4,268
21,Champagne-Ardenne,51,2,25,036,Barbonne-Fayel,491,15,506
21,Champagne-Ardenne,51,3,14,037,Baslieux-lès-Fismes,293,5,298
21,Champagne-Ardenne,51,3,07,038,Baslieux-sous-Châtillon,205,2,207
21,Champagne-Ardenne,51,4,15,039,Bassu,128,8,136
21,Champagne-Ardenne,51,4,15,040,Bassuet,270,9,279
21,Champagne-Ardenne,51,2,01,041,Baudement,115,1,116
21,Champagne-Ardenne,51,2,18,042,Baye,380,9,389
21,Champagne-Ardenne,51,3,05,043,Bazancourt,1965,22,1987
21,Champagne-Ardenne,51,3,30,044,Beaumont-sur-Vesle,713,20,733
21,Champagne-Ardenne,51,2,18,045,Beaunay,99,2,101
21,Champagne-Ardenne,51,3,04,046,Beine-Nauroy,1046,26,1072
21,Champagne-Ardenne,51,5,08,047,Belval-en-Argonne,56,0,56
21,Champagne-Ardenne,51,3,07,048,Belval-sous-Châtillon,170,5,175
21,Champagne-Ardenne,51,1,29,049,Bergères-lès-Vertus,559,19,578
21,Champagne-Ardenne,51,2,17,050,Bergères-sous-Montmirail,139,1,140
21,Champagne-Ardenne,51,3,05,051,Berméricourt,137,3,140
21,Champagne-Ardenne,51,3,04,052,Berru,503,3,506
21,Champagne-Ardenne,51,5,32,053,Berzieux,74,0,74
21,Champagne-Ardenne,51,3,04,054,Bétheniville,1061,13,1074
21,Champagne-Ardenne,51,3,22,055,Bétheny,6412,88,6500
21,Champagne-Ardenne,51,2,12,056,Bethon,270,6,276
21,Champagne-Ardenne,51,4,15,057,Bettancourt-la-Longue,88,4,92
21,Champagne-Ardenne,51,3,38,058,Bezannes,1334,80,1414
21,Champagne-Ardenne,51,4,33,059,Bignicourt-sur-Marne,397,9,406
21,Champagne-Ardenne,51,4,28,060,Bignicourt-sur-Saulx,163,1,164
21,Champagne-Ardenne,51,1,27,061,Billy-le-Grand,103,8,111
21,Champagne-Ardenne,51,5,32,062,Binarville,108,2,110
21,Champagne-Ardenne,51,3,07,063,Binson-et-Orquigny,170,0,170
21,Champagne-Ardenne,51,2,03,064,Bisseuil,648,12,660
21,Champagne-Ardenne,51,4,34,065,Blacy,658,19,677
21,Champagne-Ardenne,51,4,24,066,Blaise-sous-Arzillières,348,31,379
21,Champagne-Ardenne,51,4,28,068,Blesme,190,2,192
21,Champagne-Ardenne,51,3,31,069,Bligny,108,3,111
21,Champagne-Ardenne,51,2,17,070,Boissy-le-Repos,207,4,211
21,Champagne-Ardenne,51,2,12,071,Bouchy-Saint-Genest,159,1,160
21,Champagne-Ardenne,51,3,31,072,Bouilly,164,3,167
21,Champagne-Ardenne,51,3,31,073,Bouleuse,168,1,169
21,Champagne-Ardenne,51,3,05,074,Boult-sur-Suippe,1580,23,1603
21,Champagne-Ardenne,51,3,05,075,Bourgogne,1019,15,1034
21,Champagne-Ardenne,51,2,09,076,Boursault,465,4,469
21,Champagne-Ardenne,51,3,14,077,Bouvancourt,174,4,178
21,Champagne-Ardenne,51,1,27,078,Bouy,462,11,473
21,Champagne-Ardenne,51,2,03,079,Bouzy,951,17,968
21,Champagne-Ardenne,51,4,24,080,Brandonvillers,150,3,153
21,Champagne-Ardenne,51,3,31,081,Branscourt,243,3,246
21,Champagne-Ardenne,51,5,23,083,Braux-Saint-Remy,82,1,83
21,Champagne-Ardenne,51,5,23,082,Braux-Sainte-Cohière,81,1,82
21,Champagne-Ardenne,51,4,26,084,Bréban,86,5,91
21,Champagne-Ardenne,51,3,14,086,Breuil,299,3,302
21,Champagne-Ardenne,51,2,09,085,Le Breuil,380,7,387
21,Champagne-Ardenne,51,1,10,087,Breuvery-sur-Coole,205,10,215
21,Champagne-Ardenne,51,3,05,088,Brimont,447,13,460
21,Champagne-Ardenne,51,3,31,089,Brouillet,91,0,91
21,Champagne-Ardenne,51,2,13,090,Broussy-le-Grand,300,9,309
21,Champagne-Ardenne,51,2,25,091,Broussy-le-Petit,140,1,141
21,Champagne-Ardenne,51,2,25,092,Broyes,395,10,405
21,Champagne-Ardenne,51,2,02,093,Brugny-Vaudancourt,433,5,438
21,Champagne-Ardenne,51,4,28,094,Brusson,216,2,218
21,Champagne-Ardenne,51,4,28,095,Le Buisson,93,0,93
21,Champagne-Ardenne,51,1,27,097,Bussy-le-Château,163,6,169
21,Champagne-Ardenne,51,4,15,098,Bussy-le-Repos,111,3,114
21,Champagne-Ardenne,51,1,10,099,Bussy-Lettrée,309,8,317
21,Champagne-Ardenne,51,2,18,100,La Caure,84,1,85
21,Champagne-Ardenne,51,3,05,101,Caurel,650,13,663
21,Champagne-Ardenne,51,3,05,102,Cauroy-lès-Hermonville,473,6,479
21,Champagne-Ardenne,51,2,01,103,La Celle-sous-Chantemerle,165,1,166
21,Champagne-Ardenne,51,5,32,104,Cernay-en-Dormois,150,0,150
21,Champagne-Ardenne,51,3,04,105,Cernay-lès-Reims,1326,26,1352
21,Champagne-Ardenne,51,1,10,106,Cernon,130,3,133
21,Champagne-Ardenne,51,1,29,107,Chaintrix-Bierges,265,6,271
21,Champagne-Ardenne,51,1,96,108,Châlons-en-Champagne,46138,1429,47567
21,Champagne-Ardenne,51,3,14,109,Châlons-sur-Vesle,160,7,167
21,Champagne-Ardenne,51,2,18,110,Chaltrait,79,1,80
21,Champagne-Ardenne,51,3,31,111,Chambrecy,143,1,144
21,Champagne-Ardenne,51,3,30,112,Chamery,390,15,405
21,Champagne-Ardenne,51,2,18,113,Champaubert,133,3,136
21,Champagne-Ardenne,51,3,30,115,Champfleury,532,10,542
21,Champagne-Ardenne,51,2,12,116,Champguyon,250,7,257
21,Champagne-Ardenne,51,1,10,117,Champigneul-Champagne,278,6,284
21,Champagne-Ardenne,51,3,41,118,Champigny,1266,23,1289
21,Champagne-Ardenne,51,2,03,119,Champillon,516,15,531
21,Champagne-Ardenne,51,3,07,120,Champlat-et-Boujacourt,143,2,145
21,Champagne-Ardenne,51,2,09,121,Champvoisy,221,5,226
21,Champagne-Ardenne,51,4,15,122,Changy,116,7,123
21,Champagne-Ardenne,51,2,12,124,Chantemerle,56,2,58
21,Champagne-Ardenne,51,4,26,125,Chapelaine,54,2,56
21,Champagne-Ardenne,51,5,23,126,La Chapelle-Felcourt,68,1,69
21,Champagne-Ardenne,51,2,01,127,La Chapelle-Lasson,86,3,89
21,Champagne-Ardenne,51,2,18,128,La Chapelle-sous-Orbais,47,2,49
21,Champagne-Ardenne,51,2,17,129,Charleville,241,7,248
21,Champagne-Ardenne,51,4,15,130,Charmont,225,7,232
21,Champagne-Ardenne,51,5,08,132,Les Charmontois,138,5,143
21,Champagne-Ardenne,51,5,08,133,Le Châtelier,58,7,65
21,Champagne-Ardenne,51,4,24,134,Châtelraould-Saint-Louvent,232,10,242
21,Champagne-Ardenne,51,4,24,135,Châtillon-sur-Broué,66,0,66
21,Champagne-Ardenne,51,3,07,136,Châtillon-sur-Marne,702,139,841
21,Champagne-Ardenne,51,2,12,137,Châtillon-sur-Morin,191,3,194
21,Champagne-Ardenne,51,5,23,138,Châtrices,34,1,35
21,Champagne-Ardenne,51,5,23,139,Chaudefontaine,322,12,334
21,Champagne-Ardenne,51,3,31,140,Chaumuzy,320,3,323
21,Champagne-Ardenne,51,4,33,141,La Chaussée-sur-Marne,672,22,694
21,Champagne-Ardenne,51,2,02,142,Chavot-Courcourt,381,11,392
21,Champagne-Ardenne,51,5,08,143,Le Chemin,42,1,43
21,Champagne-Ardenne,51,4,28,144,Cheminon,630,15,645
21,Champagne-Ardenne,51,3,14,145,Chenay,281,13,294
21,Champagne-Ardenne,51,1,10,146,Cheniers,113,2,115
21,Champagne-Ardenne,51,1,27,147,La Cheppe,340,16,356
21,Champagne-Ardenne,51,1,10,148,Cheppes-la-Prairie,185,2,187
21,Champagne-Ardenne,51,1,16,149,Chepy,384,14,398
21,Champagne-Ardenne,51,1,10,150,Cherville,92,3,95
21,Champagne-Ardenne,51,2,25,151,Chichey,159,4,163
21,Champagne-Ardenne,51,3,30,152,Chigny-les-Roses,512,2,514
21,Champagne-Ardenne,51,2,37,153,Chouilly,1005,13,1018
21,Champagne-Ardenne,51,1,29,154,Clamanges,210,6,216
21,Champagne-Ardenne,51,2,01,155,Clesles,579,4,583
21,Champagne-Ardenne,51,4,28,156,Cloyes-sur-Marne,113,4,117
21,Champagne-Ardenne,51,2,18,157,Coizard-Joches,88,3,91
21,Champagne-Ardenne,51,1,36,160,Compertrix,1216,39,1255
21,Champagne-Ardenne,51,1,35,161,Condé-sur-Marne,692,8,700
21,Champagne-Ardenne,51,2,01,162,Conflans-sur-Seine,674,14,688
21,Champagne-Ardenne,51,2,18,163,Congy,271,8,279
21,Champagne-Ardenne,51,2,13,164,Connantray-Vaurefroy,189,5,194
21,Champagne-Ardenne,51,2,13,165,Connantre,1078,40,1118
21,Champagne-Ardenne,51,5,08,166,Contault,70,3,73
21,Champagne-Ardenne,51,4,26,167,Coole,140,4,144
21,Champagne-Ardenne,51,1,36,168,Coolus,225,7,232
21,Champagne-Ardenne,51,4,26,169,Corbeil,102,2,104
21,Champagne-Ardenne,51,2,17,170,Corfélix,105,2,107
21,Champagne-Ardenne,51,3,05,171,Cormicy,1400,29,1429
21,Champagne-Ardenne,51,3,40,172,Cormontreuil,6248,89,6337
21,Champagne-Ardenne,51,2,03,173,Cormoyeux,120,4,124
21,Champagne-Ardenne,51,2,18,174,Corribert,54,1,55
21,Champagne-Ardenne,51,2,17,175,Corrobert,175,6,181
21,Champagne-Ardenne,51,2,13,176,Corroy,142,2,144
21,Champagne-Ardenne,51,3,31,177,Coulommes-la-Montagne,214,5,219
21,Champagne-Ardenne,51,1,10,178,Coupetz,81,3,84
21,Champagne-Ardenne,51,1,16,179,Coupéville,161,3,164
21,Champagne-Ardenne,51,3,31,181,Courcelles-Sapicourt,285,3,288
21,Champagne-Ardenne,51,2,13,182,Courcemain,130,1,131
21,Champagne-Ardenne,51,3,05,183,Courcy,1321,21,1342
21,Champagne-Ardenne,51,4,34,184,Courdemanges,418,14,432
21,Champagne-Ardenne,51,2,12,185,Courgivaux,264,7,271
21,Champagne-Ardenne,51,2,18,186,Courjeonnet,52,1,53
21,Champagne-Ardenne,51,3,14,187,Courlandon,287,1,288
21,Champagne-Ardenne,51,3,31,188,Courmas,177,4,181
21,Champagne-Ardenne,51,3,07,190,Courtagnon,67,3,70
21,Champagne-Ardenne,51,5,23,191,Courtémont,65,0,65
21,Champagne-Ardenne,51,2,09,192,Courthiézy,335,12,347
21,Champagne-Ardenne,51,1,16,193,Courtisols,2571,109,2680
21,Champagne-Ardenne,51,3,14,194,Courville,450,4,454
21,Champagne-Ardenne,51,4,33,195,Couvrot,856,21,877
21,Champagne-Ardenne,51,2,02,196,Cramant,889,8,897
21,Champagne-Ardenne,51,5,23,197,La Croix-en-Champagne,61,3,64
21,Champagne-Ardenne,51,3,14,198,Crugny,606,10,616
21,Champagne-Ardenne,51,3,07,199,Cuchery,394,3,397
21,Champagne-Ardenne,51,2,02,200,Cuis,399,10,409
21,Champagne-Ardenne,51,3,07,201,Cuisles,139,1,140
21,Champagne-Ardenne,51,2,03,202,Cumières,840,13,853
21,Champagne-Ardenne,51,1,27,203,Cuperly,222,5,227
21,Champagne-Ardenne,51,2,37,204,Damery,1492,21,1513
21,Champagne-Ardenne,51,1,27,205,Dampierre-au-Temple,263,12,275
21,Champagne-Ardenne,51,5,08,206,Dampierre-le-Château,102,3,105
21,Champagne-Ardenne,51,1,16,208,Dampierre-sur-Moivre,118,3,121
21,Champagne-Ardenne,51,2,03,210,Dizy,1676,43,1719
21,Champagne-Ardenne,51,5,23,211,Dommartin-Dampierre,72,0,72
21,Champagne-Ardenne,51,4,26,212,Dommartin-Lettrée,158,3,161
21,Champagne-Ardenne,51,5,23,213,Dommartin-sous-Hans,52,2,54
21,Champagne-Ardenne,51,5,08,214,Dommartin-Varimont,137,3,140
21,Champagne-Ardenne,51,4,28,215,Dompremy,114,2,116
21,Champagne-Ardenne,51,3,04,216,Dontrien,205,5,210
21,Champagne-Ardenne,51,2,09,217,Dormans,2953,78,3031
21,Champagne-Ardenne,51,4,24,219,Drosnay,169,2,171
21,Champagne-Ardenne,51,4,34,220,Drouilly,125,7,132
21,Champagne-Ardenne,51,5,08,222,Éclaires,93,0,93
21,Champagne-Ardenne,51,4,24,223,Écollemont,52,0,52
21,Champagne-Ardenne,51,4,28,224,Écriennes,142,6,148
21,Champagne-Ardenne,51,3,31,225,Écueil,313,10,323
21,Champagne-Ardenne,51,1,29,226,Écury-le-Repos,63,3,66
21,Champagne-Ardenne,51,1,10,227,Écury-sur-Coole,466,11,477
21,Champagne-Ardenne,51,5,23,228,Élise-Daucourt,106,2,108
21,Champagne-Ardenne,51,5,08,229,Épense,102,4,106
21,Champagne-Ardenne,51,2,97,230,Épernay,24609,629,25238
21,Champagne-Ardenne,51,1,16,231,L' Épine,642,27,669
21,Champagne-Ardenne,51,3,04,232,Époye,438,4,442
21,Champagne-Ardenne,51,2,12,233,Escardes,83,5,88
21,Champagne-Ardenne,51,2,01,234,Esclavolles-Lurey,531,12,543
21,Champagne-Ardenne,51,2,12,236,Les Essarts-le-Vicomte,131,6,137
21,Champagne-Ardenne,51,2,12,235,Les Essarts-lès-Sézanne,268,6,274
21,Champagne-Ardenne,51,2,12,237,Esternay,1755,35,1790
21,Champagne-Ardenne,51,2,18,238,Étoges,312,5,317
21,Champagne-Ardenne,51,1,29,239,Étréchy,120,2,122
21,Champagne-Ardenne,51,4,28,240,Étrepy,144,9,153
21,Champagne-Ardenne,51,2,13,241,Euvy,82,2,84
21,Champagne-Ardenne,51,1,36,242,Fagnières,4522,139,4661
21,Champagne-Ardenne,51,2,13,243,Faux-Fresnay,344,11,355
21,Champagne-Ardenne,51,1,10,244,Faux-Vésigneul,236,7,243
21,Champagne-Ardenne,51,3,31,245,Faverolles-et-Coëmy,508,5,513
21,Champagne-Ardenne,51,4,28,246,Favresse,180,3,183
21,Champagne-Ardenne,51,2,13,248,Fère-Champenoise,2303,54,2357
21,Champagne-Ardenne,51,2,18,247,Fèrebrianges,176,4,180
21,Champagne-Ardenne,51,2,09,249,Festigny,389,13,402
21,Champagne-Ardenne,51,3,14,250,Fismes,5330,113,5443
21,Champagne-Ardenne,51,2,02,251,Flavigny,194,8,202
21,Champagne-Ardenne,51,2,37,252,Fleury-la-Rivière,497,6,503
21,Champagne-Ardenne,51,5,23,253,Florent-en-Argonne,243,10,253
21,Champagne-Ardenne,51,2,25,254,Fontaine-Denis-Nuisy,248,4,252
21,Champagne-Ardenne,51,5,32,255,Fontaine-en-Dormois,21,0,21
21,Champagne-Ardenne,51,2,03,256,Fontaine-sur-Ay,323,8,331
21,Champagne-Ardenne,51,2,12,258,La Forestière,235,7,242
21,Champagne-Ardenne,51,1,16,259,Francheville,210,4,214
21,Champagne-Ardenne,51,1,16,260,Le Fresne,56,2,58
21,Champagne-Ardenne,51,3,05,261,Fresne-lès-Reims,428,12,440
21,Champagne-Ardenne,51,4,33,262,Frignicourt,1786,77,1863
21,Champagne-Ardenne,51,2,17,263,Fromentières,369,8,377
21,Champagne-Ardenne,51,2,17,264,Le Gault-Soigny,498,10,508
21,Champagne-Ardenne,51,2,25,265,Gaye,555,18,573
21,Champagne-Ardenne,51,2,03,266,Germaine,538,12,550
21,Champagne-Ardenne,51,3,31,267,Germigny,192,4,196
21,Champagne-Ardenne,51,1,29,268,Germinon,127,4,131
21,Champagne-Ardenne,51,4,24,269,Giffaumont-Champaubert,259,4,263
21,Champagne-Ardenne,51,4,24,270,Gigny-Bussy,251,10,261
21,Champagne-Ardenne,51,2,02,271,Gionges,145,89,234
21,Champagne-Ardenne,51,5,08,272,Givry-en-Argonne,464,16,480
21,Champagne-Ardenne,51,1,29,273,Givry-lès-Loisy,79,2,81
21,Champagne-Ardenne,51,5,23,274,Gizaucourt,105,3,108
21,Champagne-Ardenne,51,4,34,275,Glannes,163,4,167
21,Champagne-Ardenne,51,2,13,276,Gourgançon,164,2,166
21,Champagne-Ardenne,51,1,35,278,Les Grandes-Loges,259,8,267
21,Champagne-Ardenne,51,2,01,279,Granges-sur-Aube,170,0,170
21,Champagne-Ardenne,51,5,32,280,Gratreuil,27,0,27
21,Champagne-Ardenne,51,2,02,281,Grauves,668,19,687
21,Champagne-Ardenne,51,3,31,282,Gueux,1774,56,1830
21,Champagne-Ardenne,51,5,23,283,Hans,153,2,155
21,Champagne-Ardenne,51,4,28,284,Haussignémont,282,5,287
21,Champagne-Ardenne,51,2,13,285,Haussimont,160,7,167
21,Champagne-Ardenne,51,4,24,286,Hauteville,223,6,229
21,Champagne-Ardenne,51,2,03,287,Hautvillers,792,9,801
21,Champagne-Ardenne,51,4,15,290,Heiltz-l'Évêque,284,6,290
21,Champagne-Ardenne,51,4,28,288,Heiltz-le-Hutier,200,3,203
21,Champagne-Ardenne,51,4,15,289,Heiltz-le-Maurupt,392,17,409
21,Champagne-Ardenne,51,3,14,291,Hermonville,1310,25,1335
21,Champagne-Ardenne,51,5,08,292,Herpont,116,0,116
21,Champagne-Ardenne,51,3,05,293,Heutrégiville,402,9,411
21,Champagne-Ardenne,51,3,14,294,Hourges,95,1,96
21,Champagne-Ardenne,51,4,34,295,Huiron,331,12,343
21,Champagne-Ardenne,51,4,26,296,Humbauville,70,1,71
21,Champagne-Ardenne,51,2,09,298,Igny-Comblizy,440,12,452
21,Champagne-Ardenne,51,4,28,300,Isle-sur-Marne,107,2,109
21,Champagne-Ardenne,51,3,05,299,Isles-sur-Suippe,797,13,810
21,Champagne-Ardenne,51,1,35,301,Isse,123,0,123
21,Champagne-Ardenne,51,2,02,302,Les Istres-et-Bury,90,7,97
21,Champagne-Ardenne,51,1,10,303,Jâlons,586,10,596
21,Champagne-Ardenne,51,2,17,304,Janvilliers,120,0,120
21,Champagne-Ardenne,51,3,31,305,Janvry,120,6,126
21,Champagne-Ardenne,51,2,12,306,Joiselle,86,5,91
21,Champagne-Ardenne,51,1,27,307,Jonchery-sur-Suippe,170,4,174
21,Champagne-Ardenne,51,3,14,308,Jonchery-sur-Vesle,1968,28,1996
21,Champagne-Ardenne,51,3,07,309,Jonquery,89,4,93
21,Champagne-Ardenne,51,3,31,310,Jouy-lès-Reims,191,3,194
21,Champagne-Ardenne,51,4,15,311,Jussecourt-Minecourt,201,2,203
21,Champagne-Ardenne,51,1,35,312,Juvigny,968,30,998
21,Champagne-Ardenne,51,2,25,313,Lachy,328,11,339
21,Champagne-Ardenne,51,3,31,314,Lagery,193,5,198
21,Champagne-Ardenne,51,4,24,315,Landricourt,145,6,151
21,Champagne-Ardenne,51,4,28,316,Larzicourt,305,7,312
21,Champagne-Ardenne,51,5,23,317,Laval-sur-Tourbe,53,2,55
21,Champagne-Ardenne,51,3,05,318,Lavannes,578,10,588
21,Champagne-Ardenne,51,2,13,319,Lenharrée,96,4,100
21,Champagne-Ardenne,51,2,09,320,Leuvrigny,322,9,331
21,Champagne-Ardenne,51,3,31,321,Lhéry,81,1,82
21,Champagne-Ardenne,51,4,24,322,Lignon,94,6,100
21,Champagne-Ardenne,51,2,25,323,Linthelles,115,5,120
21,Champagne-Ardenne,51,2,25,324,Linthes,115,6,121
21,Champagne-Ardenne,51,4,33,325,Lisse-en-Champagne,123,1,124
21,Champagne-Ardenne,51,1,27,326,Livry-Louvercy,845,35,880
21,Champagne-Ardenne,51,1,29,327,Loisy-en-Brie,189,3,192
21,Champagne-Ardenne,51,4,34,328,Loisy-sur-Marne,941,14,955
21,Champagne-Ardenne,51,3,05,329,Loivre,1122,16,1138
21,Champagne-Ardenne,51,2,03,331,Louvois,344,7,351
21,Champagne-Ardenne,51,3,30,333,Ludes,634,9,643
21,Champagne-Ardenne,51,4,33,334,Luxémont-et-Villotte,488,12,500
21,Champagne-Ardenne,51,5,23,336,Maffrécourt,60,3,63
21,Champagne-Ardenne,51,2,03,663,Magenta,1750,27,1777
21,Champagne-Ardenne,51,3,14,337,Magneux,237,2,239
21,Champagne-Ardenne,51,3,30,338,Mailly-Champagne,743,19,762
21,Champagne-Ardenne,51,1,10,339,Mairy-sur-Marne,548,25,573
21,Champagne-Ardenne,51,4,34,340,Maisons-en-Champagne,475,13,488
21,Champagne-Ardenne,51,5,32,341,Malmy,23,2,25
21,Champagne-Ardenne,51,2,02,342,Mancy,259,3,262
21,Champagne-Ardenne,51,2,01,343,Marcilly-sur-Seine,653,24,677
21,Champagne-Ardenne,51,2,37,344,Mardeuil,1548,34,1582
21,Champagne-Ardenne,51,2,18,345,Mareuil-en-Brie,251,6,257
21,Champagne-Ardenne,51,2,09,346,Mareuil-le-Port,1289,19,1308
21,Champagne-Ardenne,51,2,03,347,Mareuil-sur-Ay,1184,25,1209
21,Champagne-Ardenne,51,3,31,348,Marfaux,154,3,157
21,Champagne-Ardenne,51,4,24,349,Margerie-Hancourt,203,0,203
21,Champagne-Ardenne,51,2,18,350,Margny,108,4,112
21,Champagne-Ardenne,51,2,13,351,Marigny,100,1,101
21,Champagne-Ardenne,51,4,33,352,Marolles,838,3,841
21,Champagne-Ardenne,51,2,01,353,Marsangis,49,0,49
21,Champagne-Ardenne,51,1,16,354,Marson,278,7,285
21,Champagne-Ardenne,51,5,32,355,Massiges,49,0,49
21,Champagne-Ardenne,51,4,28,356,Matignicourt-Goncourt,113,1,114
21,Champagne-Ardenne,51,1,10,357,Matougues,654,17,671
21,Champagne-Ardenne,51,4,28,358,Maurupt-le-Montois,564,4,568
21,Champagne-Ardenne,51,2,17,359,Mécringes,139,5,144
21,Champagne-Ardenne,51,2,12,360,Le Meix-Saint-Epoing,245,10,255
21,Champagne-Ardenne,51,4,26,361,Le Meix-Tiercelin,193,4,197
21,Champagne-Ardenne,51,3,05,362,Merfy,654,11,665
21,Champagne-Ardenne,51,4,33,363,Merlaut,260,8,268
21,Champagne-Ardenne,51,3,31,364,Méry-Prémecy,63,1,64
21,Champagne-Ardenne,51,3,31,365,Les Mesneux,853,29,882
21,Champagne-Ardenne,51,2,02,367,Le Mesnil-sur-Oger,1237,13,1250
21,Champagne-Ardenne,51,5,32,368,Minaucourt-le-Mesnil-lès-Hurlus,78,2,80
21,Champagne-Ardenne,51,2,25,369,Moeurs-Verdey,283,10,293
21,Champagne-Ardenne,51,5,23,370,Moiremont,208,1,209
21,Champagne-Ardenne,51,1,16,371,Moivre,49,1,50
21,Champagne-Ardenne,51,4,28,373,Moncetz-l'Abbaye,107,3,110
21,Champagne-Ardenne,51,1,16,372,Moncetz-Longevas,565,14,579
21,Champagne-Ardenne,51,2,25,374,Mondement-Montgivroux,46,2,48
21,Champagne-Ardenne,51,3,14,382,Mont-sur-Courville,130,2,132
21,Champagne-Ardenne,51,3,30,375,Montbré,263,3,266
21,Champagne-Ardenne,51,2,13,377,Montépreux,39,1,40
21,Champagne-Ardenne,51,2,12,376,Montgenost,149,7,156
21,Champagne-Ardenne,51,2,02,378,Monthelon,359,3,362
21,Champagne-Ardenne,51,3,14,379,Montigny-sur-Vesle,461,10,471
21,Champagne-Ardenne,51,2,17,380,Montmirail,3787,76,3863
21,Champagne-Ardenne,51,2,18,381,Montmort-Lucy,590,25,615
21,Champagne-Ardenne,51,2,02,384,Morangis,282,7,289
21,Champagne-Ardenne,51,2,17,386,Morsains,100,6,106
21,Champagne-Ardenne,51,2,02,387,Moslins,279,15,294
21,Champagne-Ardenne,51,1,27,388,Mourmelon-le-Grand,4979,69,5048
21,Champagne-Ardenne,51,1,27,389,Mourmelon-le-Petit,775,18,793
21,Champagne-Ardenne,51,2,37,390,Moussy,773,23,796
21,Champagne-Ardenne,51,3,31,391,Muizon,2250,59,2309
21,Champagne-Ardenne,51,2,03,392,Mutigny,227,4,231
21,Champagne-Ardenne,51,3,07,393,Nanteuil-la-Forêt,223,4,227
21,Champagne-Ardenne,51,2,12,395,Nesle-la-Reposte,93,6,99
21,Champagne-Ardenne,51,2,09,396,Nesle-le-Repons,154,2,156
21,Champagne-Ardenne,51,5,23,399,La Neuville-au-Pont,586,20,606
21,Champagne-Ardenne,51,5,08,397,La Neuville-aux-Bois,156,10,166
21,Champagne-Ardenne,51,3,07,398,La Neuville-aux-Larris,166,4,170
21,Champagne-Ardenne,51,2,12,402,Neuvy,217,4,221
21,Champagne-Ardenne,51,3,04,403,Nogent-l'Abbesse,558,7,565
21,Champagne-Ardenne,51,5,08,404,Noirlieu,124,8,132
21,Champagne-Ardenne,51,4,28,406,Norrois,177,1,178
21,Champagne-Ardenne,51,2,12,407,La Noue,277,6,283
21,Champagne-Ardenne,51,1,10,409,Nuisement-sur-Coole,318,14,332
21,Champagne-Ardenne,51,2,09,410,OEuilly,632,6,638
21,Champagne-Ardenne,51,2,02,411,Oger,576,15,591
21,Champagne-Ardenne,51,2,13,412,Ognes,69,1,70
21,Champagne-Ardenne,51,2,02,413,Oiry,896,20,916
21,Champagne-Ardenne,51,3,07,414,Olizy,137,2,139
21,Champagne-Ardenne,51,1,16,415,Omey,247,1,248
21,Champagne-Ardenne,51,2,18,416,Orbais-l'Abbaye,580,19,599
21,Champagne-Ardenne,51,4,28,417,Orconte,413,19,432
21,Champagne-Ardenne,51,3,19,418,Ormes,454,6,460
21,Champagne-Ardenne,51,4,24,419,Outines,148,1,149
21,Champagne-Ardenne,51,4,15,420,Outrepont,104,5,109
21,Champagne-Ardenne,51,2,25,421,Oyes,83,3,86
21,Champagne-Ardenne,51,3,31,422,Pargny-lès-Reims,346,10,356
21,Champagne-Ardenne,51,4,28,423,Pargny-sur-Saulx,1963,15,1978
21,Champagne-Ardenne,51,5,23,424,Passavant-en-Argonne,215,1,216
21,Champagne-Ardenne,51,3,07,425,Passy-Grigny,382,6,388
21,Champagne-Ardenne,51,2,25,426,Péas,67,1,68
21,Champagne-Ardenne,51,3,30,428,Les Petites-Loges,436,7,443
21,Champagne-Ardenne,51,3,14,429,Pévy,198,3,201
21,Champagne-Ardenne,51,1,29,430,Pierre-Morains,95,0,95
21,Champagne-Ardenne,51,2,37,431,Pierry,1216,37,1253
21,Champagne-Ardenne,51,2,25,432,Pleurs,778,18,796
21,Champagne-Ardenne,51,4,28,433,Plichancourt,201,6,207
21,Champagne-Ardenne,51,2,02,434,Plivot,742,17,759
21,Champagne-Ardenne,51,1,29,435,Pocancy,159,4,163
21,Champagne-Ardenne,51,1,16,436,Pogny,857,21,878
21,Champagne-Ardenne,51,3,31,437,Poilly,88,2,90
21,Champagne-Ardenne,51,1,16,438,Poix,84,0,84
21,Champagne-Ardenne,51,3,05,439,Pomacle,345,6,351
21,Champagne-Ardenne,51,3,04,440,Pontfaverger-Moronvilliers,1542,35,1577
21,Champagne-Ardenne,51,4,28,441,Ponthion,110,2,112
21,Champagne-Ardenne,51,4,15,442,Possesse,176,1,177
21,Champagne-Ardenne,51,2,12,443,Potangis,87,2,89
21,Champagne-Ardenne,51,3,05,444,Pouillon,453,7,460
21,Champagne-Ardenne,51,3,07,445,Pourcy,187,0,187
21,Champagne-Ardenne,51,4,34,446,Pringy,446,10,456
21,Champagne-Ardenne,51,3,04,447,Prosnes,535,5,540
21,Champagne-Ardenne,51,3,14,448,Prouilly,562,4,566
21,Champagne-Ardenne,51,3,04,449,Prunay,961,14,975
21,Champagne-Ardenne,51,3,30,450,Puisieulx,350,11,361
21,Champagne-Ardenne,51,2,25,451,Queudes,81,1,82
21,Champagne-Ardenne,51,5,08,452,Rapsécourt,34,0,34
21,Champagne-Ardenne,51,1,35,453,Recy,1032,38,1070
21,Champagne-Ardenne,51,3,99,454,Reims,181468,4073,185541
21,Champagne-Ardenne,51,4,28,455,Reims-la-Brûlée,210,6,216
21,Champagne-Ardenne,51,5,08,456,Remicourt,65,3,68
21,Champagne-Ardenne,51,3,07,457,Reuil,304,4,308
21,Champagne-Ardenne,51,2,25,458,Reuves,62,1,63
21,Champagne-Ardenne,51,2,12,459,Réveillon,113,5,118
21,Champagne-Ardenne,51,2,17,460,Rieux,168,2,170
21,Champagne-Ardenne,51,3,30,461,Rilly-la-Montagne,1052,21,1073
21,Champagne-Ardenne,51,4,24,463,Les Rivières-Henruel,156,3,159
21,Champagne-Ardenne,51,3,14,464,Romain,316,7,323
21,Champagne-Ardenne,51,2,03,465,Romery,160,1,161
21,Champagne-Ardenne,51,3,31,466,Romigny,201,1,202
21,Champagne-Ardenne,51,3,31,468,Rosnay,291,10,301
21,Champagne-Ardenne,51,1,29,469,Rouffy,93,2,95
21,Champagne-Ardenne,51,5,32,470,Rouvroy-Ripont,7,0,7
21,Champagne-Ardenne,51,3,31,471,Sacy,375,5,380
21,Champagne-Ardenne,51,4,33,472,Saint-Amand-sur-Fion,1043,31,1074
21,Champagne-Ardenne,51,2,12,473,Saint-Bon,103,3,106
21,Champagne-Ardenne,51,3,41,474,Saint-Brice-Courcelles,3371,44,3415
21,Champagne-Ardenne,51,4,24,475,Saint-Chéron,80,1,81
21,Champagne-Ardenne,51,1,35,476,Saint-Étienne-au-Temple,597,20,617
21,Champagne-Ardenne,51,3,05,477,Saint-Étienne-sur-Suippe,270,5,275
21,Champagne-Ardenne,51,4,28,478,Saint-Eulien,419,9,428
21,Champagne-Ardenne,51,3,31,479,Saint-Euphraise-et-Clairizet,205,4,209
21,Champagne-Ardenne,51,1,16,482,Saint-Germain-la-Ville,573,18,591
21,Champagne-Ardenne,51,1,36,483,Saint-Gibrien,454,7,461
21,Champagne-Ardenne,51,3,14,484,Saint-Gilles,253,2,255
21,Champagne-Ardenne,51,1,27,485,Saint-Hilaire-au-Temple,283,11,294
21,Champagne-Ardenne,51,1,27,486,Saint-Hilaire-le-Grand,334,13,347
21,Champagne-Ardenne,51,3,04,487,Saint-Hilaire-le-Petit,282,9,291
21,Champagne-Ardenne,51,2,03,488,Saint-Imoges,280,27,307
21,Champagne-Ardenne,51,4,15,489,Saint-Jean-devant-Possesse,48,0,48
21,Champagne-Ardenne,51,1,16,490,Saint-Jean-sur-Moivre,200,6,206
21,Champagne-Ardenne,51,5,23,491,Saint-Jean-sur-Tourbe,109,1,110
21,Champagne-Ardenne,51,2,01,492,Saint-Just-Sauvage,1501,25,1526
21,Champagne-Ardenne,51,3,40,493,Saint-Léonard,88,2,90
21,Champagne-Ardenne,51,2,25,495,Saint-Loup,72,1,73
21,Champagne-Ardenne,51,4,33,496,Saint-Lumier-en-Champagne,214,8,222
21,Champagne-Ardenne,51,4,28,497,Saint-Lumier-la-Populeuse,33,0,33
21,Champagne-Ardenne,51,1,29,499,Saint-Mard-lès-Rouffy,157,2,159
21,Champagne-Ardenne,51,5,08,498,Saint-Mard-sur-Auve,56,1,57
21,Champagne-Ardenne,51,5,08,500,Saint-Mard-sur-le-Mont,126,1,127
21,Champagne-Ardenne,51,1,10,502,Saint-Martin-aux-Champs,99,1,100
21,Champagne-Ardenne,51,2,37,002,Saint-Martin-d'Ablois,1473,37,1510
21,Champagne-Ardenne,51,3,04,503,Saint-Martin-l'Heureux,73,6,79
21,Champagne-Ardenne,51,1,35,504,Saint-Martin-sur-le-Pré,828,42,870
21,Champagne-Ardenne,51,3,04,505,Saint-Masmes,453,4,457
21,Champagne-Ardenne,51,1,43,506,Saint-Memmie,5317,125,5442
21,Champagne-Ardenne,51,4,26,508,Saint-Ouen-Domprot,212,9,221
21,Champagne-Ardenne,51,1,10,509,Saint-Pierre,288,7,295
21,Champagne-Ardenne,51,2,01,511,Saint-Quentin-le-Verger,130,4,134
21,Champagne-Ardenne,51,4,33,510,Saint-Quentin-les-Marais,130,7,137
21,Champagne-Ardenne,51,1,10,512,Saint-Quentin-sur-Coole,60,3,63
21,Champagne-Ardenne,51,4,24,513,Saint-Remy-en-Bouzemont-Saint-Genest-et-Isson,607,12,619
21,Champagne-Ardenne,51,2,25,514,Saint-Remy-sous-Broyes,95,2,97
21,Champagne-Ardenne,51,5,08,515,Saint-Remy-sur-Bussy,343,7,350
21,Champagne-Ardenne,51,2,01,516,Saint-Saturnin,54,1,55
21,Champagne-Ardenne,51,3,04,517,Saint-Souplet-sur-Py,150,3,153
21,Champagne-Ardenne,51,3,05,518,Saint-Thierry,621,21,642
21,Champagne-Ardenne,51,5,32,519,Saint-Thomas-en-Argonne,43,3,46
21,Champagne-Ardenne,51,4,26,520,Saint-Utin,74,3,77
21,Champagne-Ardenne,51,4,28,521,Saint-Vrain,207,5,212
21,Champagne-Ardenne,51,3,07,480,Sainte-Gemme,136,4,140
21,Champagne-Ardenne,51,1,27,501,Sainte-Marie-à-Py,198,8,206
21,Champagne-Ardenne,51,4,24,277,Sainte-Marie-du-Lac-Nuisement,247,4,251
21,Champagne-Ardenne,51,5,23,507,Sainte-Menehould,4630,183,4813
21,Champagne-Ardenne,51,4,28,522,Sapignicourt,343,13,356
21,Champagne-Ardenne,51,3,31,523,Sarcy,251,10,261
21,Champagne-Ardenne,51,2,01,524,Saron-sur-Aube,295,4,299
21,Champagne-Ardenne,51,1,16,525,Sarry,2067,100,2167
21,Champagne-Ardenne,51,2,25,526,Saudoy,356,12,368
21,Champagne-Ardenne,51,3,31,527,Savigny-sur-Ardres,264,4,268
21,Champagne-Ardenne,51,4,28,528,Scrupt,121,3,124
21,Champagne-Ardenne,51,3,04,529,Selles,359,3,362
21,Champagne-Ardenne,51,3,30,530,Sept-Saulx,574,10,584
21,Champagne-Ardenne,51,4,28,531,Sermaize-les-Bains,2160,33,2193
21,Champagne-Ardenne,51,3,30,532,Sermiers,575,17,592
21,Champagne-Ardenne,51,5,32,533,Servon-Melzicourt,122,4,126
21,Champagne-Ardenne,51,3,31,534,Serzy-et-Prin,187,5,192
21,Champagne-Ardenne,51,2,25,535,Sézanne,5187,205,5392
21,Champagne-Ardenne,51,3,30,536,Sillery,1593,33,1626
21,Champagne-Ardenne,51,5,08,537,Sivry-Ante,182,6,188
21,Champagne-Ardenne,51,1,10,538,Sogny-aux-Moulins,122,3,125
21,Champagne-Ardenne,51,4,15,539,Sogny-en-l'Angle,43,1,44
21,Champagne-Ardenne,51,2,17,542,Soizy-aux-Bois,147,1,148
21,Champagne-Ardenne,51,5,23,543,Somme-Bionne,72,1,73
21,Champagne-Ardenne,51,1,27,546,Somme-Suippe,444,190,634
21,Champagne-Ardenne,51,5,23,547,Somme-Tourbe,140,2,142
21,Champagne-Ardenne,51,1,16,548,Somme-Vesle,366,139,505
21,Champagne-Ardenne,51,5,08,549,Somme-Yèvre,110,0,110
21,Champagne-Ardenne,51,5,32,544,Sommepy-Tahure,613,19,632
21,Champagne-Ardenne,51,4,26,545,Sommesous,442,7,449
21,Champagne-Ardenne,51,4,26,550,Sompuis,270,8,278
21,Champagne-Ardenne,51,4,26,551,Somsois,184,10,194
21,Champagne-Ardenne,51,4,34,552,Songy,273,9,282
21,Champagne-Ardenne,51,1,27,553,Souain-Perthes-lès-Hurlus,205,5,210
21,Champagne-Ardenne,51,4,26,555,Soudé,157,4,161
21,Champagne-Ardenne,51,1,10,556,Soudron,289,8,297
21,Champagne-Ardenne,51,4,33,557,Soulanges,468,7,475
21,Champagne-Ardenne,51,1,29,558,Soulières,109,3,112
21,Champagne-Ardenne,51,1,27,559,Suippes,3874,54,3928
21,Champagne-Ardenne,51,2,18,560,Suizy-le-Franc,116,6,122
21,Champagne-Ardenne,51,3,40,562,Taissy,2256,61,2317
21,Champagne-Ardenne,51,2,18,563,Talus-Saint-Prix,109,0,109
21,Champagne-Ardenne,51,2,03,564,Tauxières-Mutry,266,5,271
21,Champagne-Ardenne,51,2,13,565,Thaas,99,2,101
21,Champagne-Ardenne,51,1,10,566,Thibie,263,6,269
21,Champagne-Ardenne,51,4,28,567,Thiéblemont-Farémont,514,12,526
21,Champagne-Ardenne,51,3,05,568,Thil,284,6,290
21,Champagne-Ardenne,51,3,19,569,Thillois,323,74,397
21,Champagne-Ardenne,51,2,17,570,Le Thoult-Trosnay,93,4,97
21,Champagne-Ardenne,51,5,08,572,Tilloy-et-Bellay,219,9,228
21,Champagne-Ardenne,51,3,19,573,Tinqueux,10408,172,10580
21,Champagne-Ardenne,51,1,10,574,Togny-aux-Boeufs,142,3,145
21,Champagne-Ardenne,51,2,03,576,Tours-sur-Marne,1312,24,1336
21,Champagne-Ardenne,51,3,31,577,Tramery,145,2,147
21,Champagne-Ardenne,51,1,29,578,Trécon,82,0,82
21,Champagne-Ardenne,51,2,17,579,Tréfols,137,7,144
21,Champagne-Ardenne,51,3,30,580,Trépail,440,4,444
21,Champagne-Ardenne,51,3,31,581,Treslon,181,0,181
21,Champagne-Ardenne,51,3,14,582,Trigny,552,6,558
21,Champagne-Ardenne,51,4,28,583,Trois-Fontaines-l'Abbaye,229,12,241
21,Champagne-Ardenne,51,3,40,584,Trois-Puits,148,3,151
21,Champagne-Ardenne,51,2,09,585,Troissy,831,9,840
21,Champagne-Ardenne,51,3,14,586,Unchair,157,2,159
21,Champagne-Ardenne,51,1,27,587,Vadenay,254,3,257
21,Champagne-Ardenne,51,3,30,571,Val-de-Vesle,769,16,785
21,Champagne-Ardenne,51,4,15,218,Val-de-Vière,120,2,122
21,Champagne-Ardenne,51,1,29,158,Val-des-Marais,559,8,567
21,Champagne-Ardenne,51,5,23,588,Valmy,280,4,284
21,Champagne-Ardenne,51,4,15,589,Vanault-le-Châtel,183,4,187
21,Champagne-Ardenne,51,4,15,590,Vanault-les-Dames,368,8,376
21,Champagne-Ardenne,51,3,14,591,Vandeuil,196,3,199
21,Champagne-Ardenne,51,3,07,592,Vandières,333,11,344
21,Champagne-Ardenne,51,2,13,594,Vassimont-et-Chapelaine,74,3,77
21,Champagne-Ardenne,51,1,10,595,Vatry,109,3,112
21,Champagne-Ardenne,51,2,17,596,Vauchamps,306,10,316
21,Champagne-Ardenne,51,2,37,597,Vauciennes,301,6,307
21,Champagne-Ardenne,51,4,28,598,Vauclerc,455,10,465
21,Champagne-Ardenne,51,1,27,599,Vaudemange,291,3,294
21,Champagne-Ardenne,51,3,04,600,Vaudesincourt,116,3,119
21,Champagne-Ardenne,51,4,15,601,Vavray-le-Grand,182,9,191
21,Champagne-Ardenne,51,4,15,602,Vavray-le-Petit,66,3,69
21,Champagne-Ardenne,51,1,29,603,Vélye,133,2,135
21,Champagne-Ardenne,51,3,14,604,Ventelay,265,14,279
21,Champagne-Ardenne,51,2,37,605,Venteuil,599,9,608
21,Champagne-Ardenne,51,2,17,607,Verdon,176,4,180
21,Champagne-Ardenne,51,4,15,608,Vernancourt,77,3,80
21,Champagne-Ardenne,51,2,09,609,Verneuil,826,17,843
21,Champagne-Ardenne,51,5,23,610,Verrières,409,15,424
21,Champagne-Ardenne,51,1,29,611,Vert-Toulon,302,9,311
21,Champagne-Ardenne,51,1,29,612,Vertus,2665,89,2754
21,Champagne-Ardenne,51,3,30,613,Verzenay,1077,11,1088
21,Champagne-Ardenne,51,3,30,614,Verzy,1057,17,1074
21,Champagne-Ardenne,51,1,16,616,Vésigneul-sur-Marne,275,5,280
21,Champagne-Ardenne,51,1,35,617,La Veuve,618,8,626
21,Champagne-Ardenne,51,2,17,618,Le Vézier,178,3,181
21,Champagne-Ardenne,51,5,08,619,Le Vieil-Dampierre,101,0,101
21,Champagne-Ardenne,51,5,32,620,Vienne-la-Ville,188,8,196
21,Champagne-Ardenne,51,5,32,621,Vienne-le-Château,577,13,590
21,Champagne-Ardenne,51,3,31,622,Ville-Dommange,414,14,428
21,Champagne-Ardenne,51,3,30,623,Ville-en-Selve,284,45,329
21,Champagne-Ardenne,51,3,31,624,Ville-en-Tardenois,557,16,573
21,Champagne-Ardenne,51,2,18,639,La Ville-sous-Orbais,48,1,49
21,Champagne-Ardenne,51,5,32,640,Ville-sur-Tourbe,209,2,211
21,Champagne-Ardenne,51,2,12,625,Villeneuve-la-Lionne,302,4,306
21,Champagne-Ardenne,51,2,17,626,La Villeneuve-lès-Charleville,118,4,122
21,Champagne-Ardenne,51,1,29,627,Villeneuve-Renneville-Chevigny,303,10,313
21,Champagne-Ardenne,51,2,25,628,Villeneuve-Saint-Vistre-et-Villevotte,133,4,137
21,Champagne-Ardenne,51,3,30,629,Villers-Allerand,834,21,855
21,Champagne-Ardenne,51,2,02,630,Villers-aux-Bois,261,2,263
21,Champagne-Ardenne,51,3,30,631,Villers-aux-Noeuds,179,3,182
21,Champagne-Ardenne,51,5,23,632,Villers-en-Argonne,228,3,231
21,Champagne-Ardenne,51,3,05,633,Villers-Franqueux,301,18,319
21,Champagne-Ardenne,51,1,10,634,Villers-le-Château,261,5,266
21,Champagne-Ardenne,51,4,15,635,Villers-le-Sec,102,5,107
21,Champagne-Ardenne,51,3,30,636,Villers-Marmery,557,8,565
21,Champagne-Ardenne,51,3,07,637,Villers-sous-Châtillon,196,3,199
21,Champagne-Ardenne,51,1,29,638,Villeseneux,207,9,216
21,Champagne-Ardenne,51,2,18,641,Villevenard,193,3,196
21,Champagne-Ardenne,51,2,01,642,Villiers-aux-Corneilles,88,1,89
21,Champagne-Ardenne,51,2,37,643,Vinay,512,9,521
21,Champagne-Ardenne,51,2,09,644,Vincelles,306,6,312
21,Champagne-Ardenne,51,2,25,645,Vindey,129,11,140
21,Champagne-Ardenne,51,5,32,646,Virginy,85,0,85
21,Champagne-Ardenne,51,4,33,647,Vitry-en-Perthois,811,33,844
21,Champagne-Ardenne,51,1,10,648,Vitry-la-Ville,367,16,383
21,Champagne-Ardenne,51,4,98,649,Vitry-le-François,14207,568,14775
21,Champagne-Ardenne,51,5,23,650,Voilemont,46,1,47
21,Champagne-Ardenne,51,1,29,651,Voipreux,210,6,216
21,Champagne-Ardenne,51,2,01,652,Vouarces,58,2,60
21,Champagne-Ardenne,51,4,28,654,Vouillers,203,2,205
21,Champagne-Ardenne,51,1,29,655,Vouzy,324,13,337
21,Champagne-Ardenne,51,1,35,656,Vraux,478,10,488
21,Champagne-Ardenne,51,3,31,657,Vrigny,221,4,225
21,Champagne-Ardenne,51,4,15,658,Vroil,114,3,117
21,Champagne-Ardenne,51,5,32,659,Wargemoulin-Hurlus,49,4,53
21,Champagne-Ardenne,51,3,05,660,Warmeriville,2145,26,2171
21,Champagne-Ardenne,51,3,05,662,Witry-lès-Reims,4685,74,4759
21,Champagne-Ardenne,52,1,21,001,Ageville,306,2,308
21,Champagne-Ardenne,52,2,04,002,Aigremont,22,0,22
21,Champagne-Ardenne,52,1,24,003,Aillianville,163,3,166
21,Champagne-Ardenne,52,3,22,004,Aingoulaincourt,13,0,13
21,Champagne-Ardenne,52,1,06,005,Aizanville,27,0,27
21,Champagne-Ardenne,52,3,28,006,Allichamps,393,2,395
21,Champagne-Ardenne,52,3,11,007,Ambonville,70,1,71
21,Champagne-Ardenne,52,1,01,008,Andelot-Blancheville,926,16,942
21,Champagne-Ardenne,52,2,20,009,Andilly-en-Bassigny,109,1,110
21,Champagne-Ardenne,52,1,27,011,Annéville-la-Prairie,70,1,71
21,Champagne-Ardenne,52,3,22,012,Annonville,31,0,31
21,Champagne-Ardenne,52,2,15,013,Anrosey,163,7,170
21,Champagne-Ardenne,52,2,17,014,Aprey,190,3,193
21,Champagne-Ardenne,52,2,26,015,Arbigny-sous-Varennes,84,0,84
21,Champagne-Ardenne,52,2,03,016,Arbot,71,1,72
21,Champagne-Ardenne,52,1,02,017,Arc-en-Barrois,768,20,788
21,Champagne-Ardenne,52,3,11,019,Arnancourt,111,2,113
21,Champagne-Ardenne,52,3,28,021,Attancourt,242,8,250
21,Champagne-Ardenne,52,1,02,022,Aubepierre-sur-Aube,196,5,201
21,Champagne-Ardenne,52,2,03,023,Auberive,192,5,197
21,Champagne-Ardenne,52,1,09,025,Audeloncourt,98,1,99
21,Champagne-Ardenne,52,2,17,027,Aujeurres,88,0,88
21,Champagne-Ardenne,52,2,03,028,Aulnoy-sur-Aube,59,1,60
21,Champagne-Ardenne,52,3,13,029,Autigny-le-Grand,167,3,170
21,Champagne-Ardenne,52,3,13,030,Autigny-le-Petit,53,2,55
21,Champagne-Ardenne,52,1,14,031,Autreville-sur-la-Renne,490,13,503
21,Champagne-Ardenne,52,3,28,034,Bailly-aux-Forges,130,3,133
21,Champagne-Ardenne,52,2,17,035,Baissey,206,6,212
21,Champagne-Ardenne,52,2,16,036,Balesmes-sur-Marne,262,12,274
21,Champagne-Ardenne,52,2,20,037,Bannes,404,14,418
21,Champagne-Ardenne,52,1,09,038,Bassoncourt,69,2,71
21,Champagne-Ardenne,52,3,11,039,Baudrecourt,124,1,125
21,Champagne-Ardenne,52,2,03,040,Bay-sur-Aube,56,0,56
21,Champagne-Ardenne,52,3,08,265,Bayard-sur-Marne,1491,17,1508
21,Champagne-Ardenne,52,2,20,042,Beauchemin,110,0,110
21,Champagne-Ardenne,52,2,12,043,Belmont,58,0,58
21,Champagne-Ardenne,52,3,30,045,Bettancourt-la-Ferrée,1853,69,1922
21,Champagne-Ardenne,52,3,11,047,Beurville,103,3,106
21,Champagne-Ardenne,52,1,21,050,Biesles,1421,30,1451
21,Champagne-Ardenne,52,2,15,051,Bize,81,0,81
21,Champagne-Ardenne,52,1,14,053,Blaisy,79,3,82
21,Champagne-Ardenne,52,3,13,055,Blécourt,109,2,111
21,Champagne-Ardenne,52,1,06,056,Blessonville,221,3,224
21,Champagne-Ardenne,52,3,11,057,Blumeray,100,9,109
21,Champagne-Ardenne,52,1,27,058,Bologne,1866,42,1908
21,Champagne-Ardenne,52,2,20,059,Bonnecourt,129,1,130
21,Champagne-Ardenne,52,2,04,060,Bourbonne-les-Bains,2267,94,2361
21,Champagne-Ardenne,52,1,01,061,Bourdons-sur-Rognon,288,6,294
21,Champagne-Ardenne,52,2,17,062,Bourg,148,7,155
21,Champagne-Ardenne,52,1,05,063,Bourg-Sainte-Marie,91,4,95
21,Champagne-Ardenne,52,1,05,064,Bourmont,540,56,596
21,Champagne-Ardenne,52,3,11,065,Bouzancourt,59,1,60
21,Champagne-Ardenne,52,3,11,066,Brachay,59,2,61
21,Champagne-Ardenne,52,1,05,067,Brainville-sur-Meuse,81,6,87
21,Champagne-Ardenne,52,1,06,069,Braux-le-Châtel,143,4,147
21,Champagne-Ardenne,52,2,17,070,Brennes,122,10,132
21,Champagne-Ardenne,52,1,07,072,Brethenay,390,17,407
21,Champagne-Ardenne,52,1,09,074,Breuvannes-en-Bassigny,718,32,750
21,Champagne-Ardenne,52,1,01,075,Briaucourt,195,9,204
21,Champagne-Ardenne,52,1,06,076,Bricon,440,9,449
21,Champagne-Ardenne,52,3,28,079,Brousseval,700,8,708
21,Champagne-Ardenne,52,1,02,082,Bugnières,149,3,152
21,Champagne-Ardenne,52,1,24,084,Busson,40,0,40
21,Champagne-Ardenne,52,1,09,085,Buxières-lès-Clefmont,23,1,24
21,Champagne-Ardenne,52,1,29,087,Buxières-lès-Villiers,231,66,297
21,Champagne-Ardenne,52,3,18,088,Ceffonds,608,10,618
21,Champagne-Ardenne,52,2,26,089,Celles-en-Bassigny,75,0,75
21,Champagne-Ardenne,52,2,20,090,Celsoy,106,5,111
21,Champagne-Ardenne,52,3,10,091,Cerisières,97,3,100
21,Champagne-Ardenne,52,2,23,092,Chalancey,129,1,130
21,Champagne-Ardenne,52,2,17,093,Chalindrey,2696,61,2757
21,Champagne-Ardenne,52,1,24,095,Chalvraines,190,5,195
21,Champagne-Ardenne,52,1,07,125,Chamarandes-Choignes,1067,158,1225
21,Champagne-Ardenne,52,1,24,097,Chambroncourt,39,0,39
21,Champagne-Ardenne,52,3,32,099,Chamouilley,837,22,859
21,Champagne-Ardenne,52,1,05,101,Champigneulles-en-Bassigny,54,3,57
21,Champagne-Ardenne,52,2,16,102,Champigny-lès-Langres,429,15,444
21,Champagne-Ardenne,52,2,26,103,Champigny-sous-Varennes,119,5,124
21,Champagne-Ardenne,52,2,12,083,Champsevraine,847,34,881
21,Champagne-Ardenne,52,3,30,104,Chancenay,1026,39,1065
21,Champagne-Ardenne,52,2,20,105,Changey,264,7,271
21,Champagne-Ardenne,52,2,16,106,Chanoy,140,2,142
21,Champagne-Ardenne,52,1,01,107,Chantraines,232,3,235
21,Champagne-Ardenne,52,2,20,108,Charmes,141,2,143
21,Champagne-Ardenne,52,3,11,109,Charmes-en-l'Angle,9,0,9
21,Champagne-Ardenne,52,3,11,110,Charmes-la-Grande,167,3,170
21,Champagne-Ardenne,52,2,23,113,Chassigny,260,10,270
21,Champagne-Ardenne,52,1,06,114,Châteauvillain,1650,28,1678
21,Champagne-Ardenne,52,2,04,400,Le Châtelet-sur-Meuse,153,4,157
21,Champagne-Ardenne,52,2,16,115,Chatenay-Mâcheron,110,6,116
21,Champagne-Ardenne,52,2,20,116,Chatenay-Vaudin,59,1,60
21,Champagne-Ardenne,52,3,13,118,Chatonrupt-Sommermont,317,3,320
21,Champagne-Ardenne,52,2,12,119,Chaudenay,304,8,312
21,Champagne-Ardenne,52,2,19,120,Chauffourt,210,5,215
21,Champagne-Ardenne,52,1,85,121,Chaumont,24039,1532,25571
21,Champagne-Ardenne,52,1,05,122,Chaumont-la-Ville,125,2,127
21,Champagne-Ardenne,52,3,08,123,Chevillon,1388,32,1420
21,Champagne-Ardenne,52,2,23,126,Choilley-Dardenay,163,4,167
21,Champagne-Ardenne,52,1,09,127,Choiseul,90,1,91
21,Champagne-Ardenne,52,1,01,128,Cirey-lès-Mareilles,124,0,124
21,Champagne-Ardenne,52,3,11,129,Cirey-sur-Blaise,120,1,121
21,Champagne-Ardenne,52,1,06,130,Cirfontaines-en-Azois,207,1,208
21,Champagne-Ardenne,52,3,22,131,Cirfontaines-en-Ornois,85,5,90
21,Champagne-Ardenne,52,1,09,132,Clefmont,209,2,211
21,Champagne-Ardenne,52,1,05,133,Clinchamp,102,4,106
21,Champagne-Ardenne,52,2,17,134,Cohons,261,9,270
21,Champagne-Ardenne,52,2,26,135,Coiffy-le-Bas,103,2,105
21,Champagne-Ardenne,52,2,04,136,Coiffy-le-Haut,118,2,120
21,Champagne-Ardenne,52,2,03,137,Colmier-le-Bas,20,1,21
21,Champagne-Ardenne,52,2,03,138,Colmier-le-Haut,69,4,73
21,Champagne-Ardenne,52,1,14,140,Colombey-les-Deux-Églises,680,8,688
21,Champagne-Ardenne,52,1,07,141,Condes,283,14,297
21,Champagne-Ardenne,52,1,01,142,Consigny,70,0,70
21,Champagne-Ardenne,52,2,23,145,Coublanc,135,4,139
21,Champagne-Ardenne,52,1,02,146,Coupray,176,6,182
21,Champagne-Ardenne,52,1,02,151,Cour-l'Évêque,187,1,188
21,Champagne-Ardenne,52,2,16,147,Courcelles-en-Montagne,85,2,87
21,Champagne-Ardenne,52,3,11,149,Courcelles-sur-Blaise,120,1,121
21,Champagne-Ardenne,52,2,16,155,Culmont,578,10,588
21,Champagne-Ardenne,52,3,13,156,Curel,407,7,414
21,Champagne-Ardenne,52,1,14,157,Curmont,16,0,16
21,Champagne-Ardenne,52,2,23,158,Cusey,247,4,251
21,Champagne-Ardenne,52,1,09,159,Cuves,24,0,24
21,Champagne-Ardenne,52,1,27,160,Daillancourt,71,6,77
21,Champagne-Ardenne,52,1,09,161,Daillecourt,79,0,79
21,Champagne-Ardenne,52,2,19,162,Dammartin-sur-Meuse,224,1,225
21,Champagne-Ardenne,52,2,20,163,Dampierre,360,14,374
21,Champagne-Ardenne,52,2,04,164,Damrémont,213,11,224
21,Champagne-Ardenne,52,1,02,165,Dancevoir,240,3,243
21,Champagne-Ardenne,52,1,01,167,Darmannes,263,5,268
21,Champagne-Ardenne,52,1,06,168,Dinteville,59,1,60
21,Champagne-Ardenne,52,3,28,169,Domblain,94,5,99
21,Champagne-Ardenne,52,2,23,170,Dommarien,157,3,160
21,Champagne-Ardenne,52,3,28,171,Dommartin-le-Franc,217,1,218
21,Champagne-Ardenne,52,3,11,172,Dommartin-le-Saint-Père,281,8,289
21,Champagne-Ardenne,52,3,10,173,Domremy-Landéville,86,1,87
21,Champagne-Ardenne,52,1,05,174,Doncourt-sur-Meuse,54,1,55
21,Champagne-Ardenne,52,3,10,175,Donjeux,397,16,413
21,Champagne-Ardenne,52,3,10,177,Doulaincourt-Saucourt,955,99,1054
21,Champagne-Ardenne,52,3,11,178,Doulevant-le-Château,436,12,448
21,Champagne-Ardenne,52,3,28,179,Doulevant-le-Petit,46,0,46
21,Champagne-Ardenne,52,3,18,180,Droyes,412,86,498
21,Champagne-Ardenne,52,3,22,181,Échenay,89,5,94
21,Champagne-Ardenne,52,3,31,182,Éclaron-Braucourt-Sainte-Livière,1984,49,2033
21,Champagne-Ardenne,52,1,01,183,Ecot-la-Combe,44,1,45
21,Champagne-Ardenne,52,3,22,184,Effincourt,75,0,75
21,Champagne-Ardenne,52,2,04,185,Enfonvelle,84,4,88
21,Champagne-Ardenne,52,3,22,187,Épizon,141,4,145
21,Champagne-Ardenne,52,1,21,190,Esnouveaux,338,8,346
21,Champagne-Ardenne,52,1,07,193,Euffigneix,281,8,289
21,Champagne-Ardenne,52,3,08,194,Eurville-Bienville,2048,32,2080
21,Champagne-Ardenne,52,2,12,195,Farincourt,52,2,54
21,Champagne-Ardenne,52,2,16,196,Faverolles,119,5,124
21,Champagne-Ardenne,52,2,12,197,Fayl-Billot,1443,128,1571
21,Champagne-Ardenne,52,3,28,198,Fays,75,3,78
21,Champagne-Ardenne,52,3,13,199,Ferrière-et-Lafolie,43,3,46
21,Champagne-Ardenne,52,2,17,200,Flagey,85,2,87
21,Champagne-Ardenne,52,3,11,201,Flammerécourt,66,0,66
21,Champagne-Ardenne,52,3,08,203,Fontaines-sur-Marne,161,0,161
21,Champagne-Ardenne,52,1,01,204,Forcey,89,4,93
21,Champagne-Ardenne,52,1,29,205,Foulain,747,18,765
21,Champagne-Ardenne,52,3,18,206,Frampas,153,4,157
21,Champagne-Ardenne,52,2,20,207,Frécourt,95,1,96
21,Champagne-Ardenne,52,2,04,208,Fresnes-sur-Apance,154,5,159
21,Champagne-Ardenne,52,1,27,211,Froncles,1618,22,1640
21,Champagne-Ardenne,52,3,13,212,Fronville,333,7,340
21,Champagne-Ardenne,52,2,12,213,Genevrières,155,4,159
21,Champagne-Ardenne,52,1,27,214,La Genevroye,27,0,27
21,Champagne-Ardenne,52,2,03,216,Germaines,29,1,30
21,Champagne-Ardenne,52,1,05,217,Germainvilliers,99,3,102
21,Champagne-Ardenne,52,3,22,218,Germay,46,1,47
21,Champagne-Ardenne,52,3,22,219,Germisay,22,0,22
21,Champagne-Ardenne,52,1,02,220,Giey-sur-Aujon,157,3,160
21,Champagne-Ardenne,52,1,14,221,Gillancourt,128,1,129
21,Champagne-Ardenne,52,3,22,222,Gillaumé,27,1,28
21,Champagne-Ardenne,52,2,12,223,Gilley,76,3,79
21,Champagne-Ardenne,52,1,05,225,Goncourt,308,9,317
21,Champagne-Ardenne,52,1,05,227,Graffigny-Chemin,230,9,239
21,Champagne-Ardenne,52,2,23,228,Grandchamp,82,1,83
21,Champagne-Ardenne,52,2,12,229,Grenant,152,4,156
21,Champagne-Ardenne,52,3,10,230,Gudmont-Villiers,352,3,355
21,Champagne-Ardenne,52,3,13,231,Guindrecourt-aux-Ormes,82,0,82
21,Champagne-Ardenne,52,1,27,232,Guindrecourt-sur-Blaise,45,0,45
21,Champagne-Ardenne,52,2,15,233,Guyonvelle,120,5,125
21,Champagne-Ardenne,52,1,05,234,Hâcourt,35,0,35
21,Champagne-Ardenne,52,3,31,235,Hallignicourt,287,6,293
21,Champagne-Ardenne,52,1,05,237,Harréville-les-Chanteurs,273,7,280
21,Champagne-Ardenne,52,2,26,242,Haute-Amance,997,20,1017
21,Champagne-Ardenne,52,2,17,239,Heuilley-Cotton,272,3,275
21,Champagne-Ardenne,52,2,17,240,Heuilley-le-Grand,196,9,205
21,Champagne-Ardenne,52,1,05,243,Huilliécourt,132,11,143
21,Champagne-Ardenne,52,3,31,244,Humbécourt,740,17,757
21,Champagne-Ardenne,52,1,24,245,Humberville,60,1,61
21,Champagne-Ardenne,52,2,16,246,Humes-Jorquenay,580,7,587
21,Champagne-Ardenne,52,1,05,247,Illoud,275,7,282
21,Champagne-Ardenne,52,1,21,248,Is-en-Bassigny,572,13,585
21,Champagne-Ardenne,52,2,23,249,Isômes,144,3,147
21,Champagne-Ardenne,52,3,13,250,Joinville,3762,134,3896
21,Champagne-Ardenne,52,1,07,251,Jonchery,969,23,992
21,Champagne-Ardenne,52,1,14,253,Juzennecourt,203,1,204
21,Champagne-Ardenne,52,1,14,254,Lachapelle-en-Blaisy,78,5,83
21,Champagne-Ardenne,52,1,24,256,Lafauche,87,2,89
21,Champagne-Ardenne,52,2,15,257,Laferté-sur-Amance,114,3,117
21,Champagne-Ardenne,52,1,06,258,Laferté-sur-Aube,363,3,366
21,Champagne-Ardenne,52,1,27,260,Lamancine,115,0,115
21,Champagne-Ardenne,52,1,14,262,Lamothe-en-Blaisy,82,1,83
21,Champagne-Ardenne,52,2,26,264,Laneuvelle,67,4,71
21,Champagne-Ardenne,52,3,31,267,Laneuville-au-Pont,182,3,185
21,Champagne-Ardenne,52,2,16,269,Langres,8240,561,8801
21,Champagne-Ardenne,52,1,21,271,Lanques-sur-Rognon,213,4,217
21,Champagne-Ardenne,52,1,06,272,Lanty-sur-Aube,139,3,142
21,Champagne-Ardenne,52,2,04,273,Larivière-Arnoncourt,145,1,146
21,Champagne-Ardenne,52,1,06,274,Latrecey-Ormoy-sur-Aube,339,13,352
21,Champagne-Ardenne,52,2,26,275,Lavernoy,78,2,80
21,Champagne-Ardenne,52,1,07,276,Laville-aux-Bois,225,4,229
21,Champagne-Ardenne,52,2,19,277,Lavilleneuve,72,3,75
21,Champagne-Ardenne,52,2,20,280,Lecey,218,4,222
21,Champagne-Ardenne,52,1,02,282,Leffonds,321,9,330
21,Champagne-Ardenne,52,3,11,284,Leschères-sur-le-Blaiseron,99,0,99
21,Champagne-Ardenne,52,2,17,285,Leuchey,63,1,64
21,Champagne-Ardenne,52,1,24,286,Leurville,89,2,91
21,Champagne-Ardenne,52,1,05,287,Levécourt,94,4,98
21,Champagne-Ardenne,52,3,22,288,Lezéville,117,3,120
21,Champagne-Ardenne,52,1,24,289,Liffol-le-Petit,350,7,357
21,Champagne-Ardenne,52,2,12,290,Les Loges,136,3,139
21,Champagne-Ardenne,52,1,09,291,Longchamp,78,2,80
21,Champagne-Ardenne,52,2,17,292,Longeau-Percey,707,24,731
21,Champagne-Ardenne,52,3,18,293,Longeville-sur-la-Laines,447,7,454
21,Champagne-Ardenne,52,3,28,294,Louvemont,771,21,792
21,Champagne-Ardenne,52,1,21,295,Louvières,106,3,109
21,Champagne-Ardenne,52,3,18,296,Louze,315,6,321
21,Champagne-Ardenne,52,1,29,297,Luzy-sur-Marne,269,14,283
21,Champagne-Ardenne,52,2,23,298,Maâtz,81,6,87
21,Champagne-Ardenne,52,3,28,300,Magneux,152,5,157
21,Champagne-Ardenne,52,1,09,301,Maisoncelles,59,1,60
21,Champagne-Ardenne,52,3,08,302,Maizières,169,5,174
21,Champagne-Ardenne,52,2,15,303,Maizières-sur-Amance,110,0,110
21,Champagne-Ardenne,52,1,05,304,Malaincourt-sur-Meuse,59,0,59
21,Champagne-Ardenne,52,1,21,305,Mandres-la-Côte,525,19,544
21,Champagne-Ardenne,52,1,24,306,Manois,461,5,466
21,Champagne-Ardenne,52,2,16,307,Marac,229,2,231
21,Champagne-Ardenne,52,1,14,308,Maranville,459,8,467
21,Champagne-Ardenne,52,1,27,310,Marbéville,110,1,111
21,Champagne-Ardenne,52,2,26,311,Marcilly-en-Bassigny,228,5,233
21,Champagne-Ardenne,52,2,16,312,Mardor,63,0,63
21,Champagne-Ardenne,52,1,01,313,Mareilles,140,6,146
21,Champagne-Ardenne,52,1,21,315,Marnay-sur-Marne,289,6,295
21,Champagne-Ardenne,52,3,13,316,Mathons,57,1,58
21,Champagne-Ardenne,52,2,04,318,Melay,295,1,296
21,Champagne-Ardenne,52,1,09,319,Mennouveaux,68,3,71
21,Champagne-Ardenne,52,1,09,320,Merrey,133,5,138
21,Champagne-Ardenne,52,3,11,321,Mertrud,203,5,208
21,Champagne-Ardenne,52,1,14,322,Meures,109,0,109
21,Champagne-Ardenne,52,1,09,325,Millières,127,2,129
21,Champagne-Ardenne,52,1,27,326,Mirbel,57,1,58
21,Champagne-Ardenne,52,3,31,327,Moëslains,466,12,478
21,Champagne-Ardenne,52,2,04,328,Montcharvot,38,1,39
21,Champagne-Ardenne,52,1,14,330,Montheries,72,1,73
21,Champagne-Ardenne,52,3,18,331,Montier-en-Der,2083,83,2166
21,Champagne-Ardenne,52,1,01,335,Montot-sur-Rognon,115,2,117
21,Champagne-Ardenne,52,3,28,336,Montreuil-sur-Blaise,158,5,163
21,Champagne-Ardenne,52,3,22,337,Montreuil-sur-Thonnance,68,1,69
21,Champagne-Ardenne,52,2,23,340,Montsaugeon,67,4,71
21,Champagne-Ardenne,52,3,28,341,Morancourt,135,5,140
21,Champagne-Ardenne,52,1,24,342,Morionvilliers,28,1,29
21,Champagne-Ardenne,52,2,03,344,Mouilleron,34,1,35
21,Champagne-Ardenne,52,3,10,346,Mussey-sur-Marne,334,3,337
21,Champagne-Ardenne,52,3,08,347,Narcy,240,5,245
21,Champagne-Ardenne,52,2,20,348,Neuilly-l'Évêque,644,22,666
21,Champagne-Ardenne,52,1,29,349,Neuilly-sur-Suize,348,10,358
21,Champagne-Ardenne,52,2,15,350,Neuvelle-lès-Voisey,93,2,95
21,Champagne-Ardenne,52,1,05,351,Nijon,73,3,76
21,Champagne-Ardenne,52,1,21,352,Ninville,81,2,83
21,Champagne-Ardenne,52,1,21,353,Nogent,4018,68,4086
21,Champagne-Ardenne,52,2,17,354,Noidant-Chatenoy,90,2,92
21,Champagne-Ardenne,52,2,16,355,Noidant-le-Rocheux,218,4,222
21,Champagne-Ardenne,52,3,13,356,Nomécourt,100,5,105
21,Champagne-Ardenne,52,3,22,357,Noncourt-sur-le-Rongeant,173,1,174
21,Champagne-Ardenne,52,1,09,358,Noyers,80,2,82
21,Champagne-Ardenne,52,3,11,359,Nully,175,7,182
21,Champagne-Ardenne,52,2,23,360,Occey,143,7,150
21,Champagne-Ardenne,52,2,20,362,Orbigny-au-Mont,159,8,167
21,Champagne-Ardenne,52,2,20,363,Orbigny-au-Val,96,3,99
21,Champagne-Ardenne,52,2,17,364,Orcevaux,111,5,116
21,Champagne-Ardenne,52,1,06,365,Orges,398,10,408
21,Champagne-Ardenne,52,2,16,366,Ormancey,82,0,82
21,Champagne-Ardenne,52,1,27,367,Ormoy-lès-Sexfontaines,41,2,43
21,Champagne-Ardenne,52,1,24,369,Orquevaux,84,2,86
21,Champagne-Ardenne,52,3,08,370,Osne-le-Val,280,7,287
21,Champagne-Ardenne,52,1,27,371,Oudincourt,163,4,167
21,Champagne-Ardenne,52,1,05,372,Outremécourt,89,3,92
21,Champagne-Ardenne,52,1,05,373,Ozières,58,0,58
21,Champagne-Ardenne,52,2,17,374,Le Pailly,287,7,294
21,Champagne-Ardenne,52,2,17,375,Palaiseul,56,0,56
21,Champagne-Ardenne,52,3,22,376,Pancey,78,0,78
21,Champagne-Ardenne,52,2,04,377,Parnoy-en-Bassigny,301,9,310
21,Champagne-Ardenne,52,3,22,378,Paroy-sur-Saulx,44,0,44
21,Champagne-Ardenne,52,3,10,379,Pautaines-Augeville,23,1,24
21,Champagne-Ardenne,52,2,16,380,Peigney,347,15,362
21,Champagne-Ardenne,52,2,16,383,Perrancey-les-Vieux-Moulins,276,15,291
21,Champagne-Ardenne,52,2,17,384,Perrogney-les-Fontaines,112,4,116
21,Champagne-Ardenne,52,1,09,385,Perrusse,49,2,51
21,Champagne-Ardenne,52,3,31,386,Perthes,557,19,576
21,Champagne-Ardenne,52,2,15,388,Pierremont-sur-Amance,170,5,175
21,Champagne-Ardenne,52,2,15,390,Pisseloup,49,0,49
21,Champagne-Ardenne,52,3,18,391,Planrupt,298,4,302
21,Champagne-Ardenne,52,2,26,392,Plesnoy,104,1,105
21,Champagne-Ardenne,52,2,03,393,Poinsenot,51,3,54
21,Champagne-Ardenne,52,2,12,394,Poinson-lès-Fayl,213,0,213
21,Champagne-Ardenne,52,2,03,395,Poinson-lès-Grancey,61,4,65
21,Champagne-Ardenne,52,1,21,396,Poinson-lès-Nogent,150,8,158
21,Champagne-Ardenne,52,2,20,397,Poiseul,74,1,75
21,Champagne-Ardenne,52,3,22,398,Poissons,734,18,752
21,Champagne-Ardenne,52,1,06,399,Pont-la-Ville,149,7,156
21,Champagne-Ardenne,52,1,21,401,Poulangy,397,9,406
21,Champagne-Ardenne,52,2,03,403,Praslay,67,4,71
21,Champagne-Ardenne,52,2,23,405,Prauthoy,508,12,520
21,Champagne-Ardenne,52,2,12,406,Pressigny,222,9,231
21,Champagne-Ardenne,52,1,24,407,Prez-sous-Lafauche,346,4,350
21,Champagne-Ardenne,52,3,18,411,Puellemontier,197,17,214
21,Champagne-Ardenne,52,3,08,414,Rachecourt-sur-Marne,831,14,845
21,Champagne-Ardenne,52,3,28,413,Rachecourt-Suzémont,108,1,109
21,Champagne-Ardenne,52,1,09,416,Rangecourt,77,0,77
21,Champagne-Ardenne,52,2,26,415,Rançonnières,114,2,116
21,Champagne-Ardenne,52,1,14,419,Rennepont,180,4,184
21,Champagne-Ardenne,52,1,01,420,Reynel,130,5,135
21,Champagne-Ardenne,52,1,07,421,Riaucourt,478,8,486
21,Champagne-Ardenne,52,1,02,422,Richebourg,275,9,284
21,Champagne-Ardenne,52,1,01,423,Rimaucourt,767,13,780
21,Champagne-Ardenne,52,2,23,425,Rivière-les-Fosses,227,5,232
21,Champagne-Ardenne,52,2,17,424,Rivières-le-Bois,66,1,67
21,Champagne-Ardenne,52,1,14,426,Rizaucourt-Buchey,118,2,120
21,Champagne-Ardenne,52,3,18,427,Robert-Magny-Laneuville-à-Rémy,290,2,292
21,Champagne-Ardenne,52,1,01,428,Rochefort-sur-la-Côte,67,2,69
21,Champagne-Ardenne,52,3,10,044,Roches-Bettaincourt,624,8,632
21,Champagne-Ardenne,52,3,32,429,Roches-sur-Marne,597,10,607
21,Champagne-Ardenne,52,2,03,431,Rochetaillée,147,2,149
21,Champagne-Ardenne,52,2,20,432,Rolampont,1613,27,1640
21,Champagne-Ardenne,52,1,05,433,Romain-sur-Meuse,126,7,133
21,Champagne-Ardenne,52,3,10,436,Rouécourt,56,1,57
21,Champagne-Ardenne,52,2,03,437,Rouelles,36,1,37
21,Champagne-Ardenne,52,2,12,438,Rougeux,138,4,142
21,Champagne-Ardenne,52,2,03,439,Rouvres-sur-Aube,103,2,105
21,Champagne-Ardenne,52,3,10,440,Rouvroy-sur-Marne,361,13,374
21,Champagne-Ardenne,52,3,13,442,Rupt,309,9,318
21,Champagne-Ardenne,52,3,22,443,Sailly,47,2,49
21,Champagne-Ardenne,52,1,24,444,Saint-Blin,362,15,377
21,Champagne-Ardenne,52,2,17,445,Saint-Broingt-le-Bois,84,41,125
21,Champagne-Ardenne,52,2,23,446,Saint-Broingt-les-Fosses,217,9,226
21,Champagne-Ardenne,52,2,16,447,Saint-Ciergues,177,6,183
21,Champagne-Ardenne,52,3,86,448,Saint-Dizier,26404,987,27391
21,Champagne-Ardenne,52,2,03,450,Saint-Loup-sur-Aujon,166,3,169
21,Champagne-Ardenne,52,2,16,452,Saint-Martin-lès-Langres,79,3,82
21,Champagne-Ardenne,52,2,16,453,Saint-Maurice,129,3,132
21,Champagne-Ardenne,52,1,05,455,Saint-Thiébault,293,13,306
21,Champagne-Ardenne,52,3,10,456,Saint-Urbain-Maconcourt,651,11,662
21,Champagne-Ardenne,52,2,16,457,Saint-Vallier-sur-Marne,187,3,190
21,Champagne-Ardenne,52,2,16,449,Saints-Geosmes,966,46,1012
21,Champagne-Ardenne,52,1,21,459,Sarcey,113,4,117
21,Champagne-Ardenne,52,2,19,461,Sarrey,385,9,394
21,Champagne-Ardenne,52,3,22,463,Saudron,37,1,38
21,Champagne-Ardenne,52,2,12,464,Saulles,52,0,52
21,Champagne-Ardenne,52,2,12,467,Savigny,54,0,54
21,Champagne-Ardenne,52,1,24,468,Semilly,94,3,97
21,Champagne-Ardenne,52,1,29,469,Semoutiers-Montsaon,886,10,896
21,Champagne-Ardenne,52,2,04,470,Serqueux,466,10,476
21,Champagne-Ardenne,52,1,14,472,Sexfontaines,116,2,118
21,Champagne-Ardenne,52,1,01,473,Signéville,102,0,102
21,Champagne-Ardenne,52,1,06,474,Silvarouvres,47,1,48
21,Champagne-Ardenne,52,3,28,475,Sommancourt,56,1,57
21,Champagne-Ardenne,52,1,05,476,Sommerécourt,84,2,86
21,Champagne-Ardenne,52,3,18,479,Sommevoire,742,18,760
21,Champagne-Ardenne,52,1,27,480,Soncourt-sur-Marne,416,7,423
21,Champagne-Ardenne,52,1,05,482,Soulaucourt-sur-Mouzon,102,4,106
21,Champagne-Ardenne,52,2,15,483,Soyers,79,0,79
21,Champagne-Ardenne,52,3,13,484,Suzannecourt,349,10,359
21,Champagne-Ardenne,52,2,03,486,Ternat,54,5,59
21,Champagne-Ardenne,52,2,26,504,Terre-Natale,382,10,392
21,Champagne-Ardenne,52,3,18,487,Thilleux,87,4,91
21,Champagne-Ardenne,52,1,21,488,Thivet,292,5,297
21,Champagne-Ardenne,52,1,09,489,Thol-lès-Millières,42,0,42
21,Champagne-Ardenne,52,3,13,490,Thonnance-lès-Joinville,810,17,827
21,Champagne-Ardenne,52,3,22,491,Thonnance-les-Moulins,119,0,119
21,Champagne-Ardenne,52,2,12,492,Torcenay,512,21,533
21,Champagne-Ardenne,52,2,12,493,Tornay,44,1,45
21,Champagne-Ardenne,52,1,07,494,Treix,243,13,256
21,Champagne-Ardenne,52,3,11,495,Trémilly,88,3,91
21,Champagne-Ardenne,52,3,28,497,Troisfontaines-la-Ville,391,12,403
21,Champagne-Ardenne,52,2,23,499,Vaillant,62,1,63
21,Champagne-Ardenne,52,2,23,189,Le Val-d'Esnoms,373,13,386
21,Champagne-Ardenne,52,2,19,332,Val-de-Meuse,2181,71,2252
21,Champagne-Ardenne,52,3,31,500,Valcourt,623,29,652
21,Champagne-Ardenne,52,3,28,502,Valleret,50,4,54
21,Champagne-Ardenne,52,2,12,503,Valleroy,31,0,31
21,Champagne-Ardenne,52,2,03,094,Vals-des-Tilles,162,4,166
21,Champagne-Ardenne,52,1,05,505,Vaudrecourt,36,0,36
21,Champagne-Ardenne,52,1,14,506,Vaudrémont,112,3,115
21,Champagne-Ardenne,52,2,23,509,Vaux-sous-Aubigny,675,18,693
21,Champagne-Ardenne,52,3,28,510,Vaux-sur-Blaise,410,10,420
21,Champagne-Ardenne,52,3,10,511,Vaux-sur-Saint-Urbain,54,2,56
21,Champagne-Ardenne,52,2,16,507,Vauxbons,60,2,62
21,Champagne-Ardenne,52,3,13,512,Vecqueville,599,28,627
21,Champagne-Ardenne,52,2,15,513,Velles,84,2,86
21,Champagne-Ardenne,52,1,29,514,Verbiesles,284,9,293
21,Champagne-Ardenne,52,2,17,515,Verseilles-le-Bas,105,4,109
21,Champagne-Ardenne,52,2,17,516,Verseilles-le-Haut,48,2,50
21,Champagne-Ardenne,52,1,24,517,Vesaignes-sous-Lafauche,128,7,135
21,Champagne-Ardenne,52,1,21,518,Vesaignes-sur-Marne,125,2,127
21,Champagne-Ardenne,52,2,23,519,Vesvres-sous-Chalancey,55,1,56
21,Champagne-Ardenne,52,2,26,520,Vicq,171,6,177
21,Champagne-Ardenne,52,1,27,522,Viéville,323,10,333
21,Champagne-Ardenne,52,1,01,523,Vignes-la-Côte,52,1,53
21,Champagne-Ardenne,52,1,27,524,Vignory,297,3,300
21,Champagne-Ardenne,52,1,06,525,Villars-en-Azois,75,2,77
21,Champagne-Ardenne,52,2,03,526,Villars-Santenoge,99,6,105
21,Champagne-Ardenne,52,3,28,528,Ville-en-Blaisois,176,3,179
21,Champagne-Ardenne,52,2,17,529,Villegusien-le-Lac,720,20,740
21,Champagne-Ardenne,52,3,31,534,Villiers-en-Lieu,1584,36,1620
21,Champagne-Ardenne,52,1,29,535,Villiers-le-Sec,642,20,662
21,Champagne-Ardenne,52,2,17,536,Villiers-lès-Aprey,35,0,35
21,Champagne-Ardenne,52,1,02,538,Villiers-sur-Suize,239,9,248
21,Champagne-Ardenne,52,2,17,539,Violot,82,4,86
21,Champagne-Ardenne,52,2,03,540,Vitry-en-Montagne,39,1,40
21,Champagne-Ardenne,52,1,21,541,Vitry-lès-Nogent,174,2,176
21,Champagne-Ardenne,52,2,03,542,Vivey,59,4,63
21,Champagne-Ardenne,52,3,28,543,Voillecomte,468,4,472
21,Champagne-Ardenne,52,2,15,544,Voisey,355,9,364
21,Champagne-Ardenne,52,2,16,545,Voisines,92,5,97
21,Champagne-Ardenne,52,2,12,546,Voncourt,19,1,20
21,Champagne-Ardenne,52,1,27,547,Vouécourt,228,9,237
21,Champagne-Ardenne,52,1,27,548,Vraincourt,96,2,98
21,Champagne-Ardenne,52,1,05,549,Vroncourt-la-Côte,22,3,25
21,Champagne-Ardenne,52,3,28,550,Wassy,3046,140,3186
52,Pays de la Loire,53,2,32,001,Ahuillé,1770,39,1809
52,Pays de la Loire,53,3,21,002,Alexain,505,7,512
52,Pays de la Loire,53,3,01,003,Ambrières-les-Vallées,2775,64,2839
52,Pays de la Loire,53,1,06,004,Ampoigné,551,14,565
52,Pays de la Loire,53,2,05,005,Andouillé,2348,75,2423
52,Pays de la Loire,53,1,04,006,Argenton-Notre-Dame,212,5,217
52,Pays de la Loire,53,2,02,007,Argentré,2568,58,2626
52,Pays de la Loire,53,3,20,008,Aron,1740,48,1788
52,Pays de la Loire,53,2,22,009,Arquenay,637,19,656
52,Pays de la Loire,53,2,11,010,Assé-le-Bérenger,410,16,426
52,Pays de la Loire,53,2,32,011,Astillé,728,17,745
52,Pays de la Loire,53,1,09,012,Athée,497,15,512
52,Pays de la Loire,53,3,27,013,Averton,626,16,642
52,Pays de la Loire,53,1,31,014,Azé,3229,182,3411
52,Pays de la Loire,53,2,05,015,La Baconnière,1514,35,1549
52,Pays de la Loire,53,3,03,016,Bais,1318,29,1347
52,Pays de la Loire,53,1,13,017,Ballée,731,22,753
52,Pays de la Loire,53,1,25,018,Ballots,1211,19,1230
52,Pays de la Loire,53,2,22,019,Bannes,138,2,140
52,Pays de la Loire,53,3,20,021,La Bazoge-Montpinçon,855,23,878
52,Pays de la Loire,53,2,22,022,La Bazouge-de-Chemeré,523,7,530
52,Pays de la Loire,53,3,20,023,La Bazouge-des-Alleux,399,10,409
52,Pays de la Loire,53,2,22,025,Bazougers,996,20,1016
52,Pays de la Loire,53,2,19,026,Beaulieu-sur-Oudon,511,15,526
52,Pays de la Loire,53,1,13,027,Beaumont-Pied-de-Boeuf,201,6,207
52,Pays de la Loire,53,3,20,028,Belgeard,503,2,505
52,Pays de la Loire,53,1,04,029,Bierné,673,25,698
52,Pays de la Loire,53,2,22,030,Le Bignon-du-Maine,350,8,358
52,Pays de la Loire,53,2,05,031,La Bigottière,404,2,406
52,Pays de la Loire,53,2,26,032,Blandouet,198,1,199
52,Pays de la Loire,53,1,09,033,La Boissière,122,6,128
52,Pays de la Loire,53,2,02,034,Bonchamp-lès-Laval,5649,200,5849
52,Pays de la Loire,53,1,09,035,Bouchamps-lès-Craon,561,7,568
52,Pays de la Loire,53,1,13,036,Bouère,995,18,1013
52,Pays de la Loire,53,1,13,037,Bouessay,768,13,781
52,Pays de la Loire,53,3,24,038,Boulay-les-Ifs,163,1,164
52,Pays de la Loire,53,2,19,039,Le Bourgneuf-la-Forêt,1738,22,1760
52,Pays de la Loire,53,2,19,040,Bourgon,614,10,624
52,Pays de la Loire,53,1,25,041,Brains-sur-les-Marches,231,13,244
52,Pays de la Loire,53,3,12,042,Brecé,831,10,841
52,Pays de la Loire,53,2,23,043,Brée,484,4,488
52,Pays de la Loire,53,2,19,045,La Brûlatte,697,10,707
52,Pays de la Loire,53,1,13,046,Le Buret,311,4,315
52,Pays de la Loire,53,3,12,047,Carelles,293,7,300
52,Pays de la Loire,53,2,05,048,Chailland,1160,29,1189
52,Pays de la Loire,53,2,02,049,Châlons-du-Maine,603,9,612
52,Pays de la Loire,53,2,26,050,Chammes,335,6,341
52,Pays de la Loire,53,3,14,051,Champéon,585,11,596
52,Pays de la Loire,53,3,24,052,Champfrémont,300,28,328
52,Pays de la Loire,53,3,03,053,Champgenéteux,583,12,595
52,Pays de la Loire,53,2,17,054,Changé,5263,225,5488
52,Pays de la Loire,53,3,01,055,Chantrigné,610,13,623
52,Pays de la Loire,53,2,02,056,La Chapelle-Anthenaise,887,22,909
52,Pays de la Loire,53,3,14,057,La Chapelle-au-Riboul,513,8,521
52,Pays de la Loire,53,1,07,058,La Chapelle-Craonnaise,312,4,316
52,Pays de la Loire,53,2,23,059,La Chapelle-Rainsouin,369,2,371
52,Pays de la Loire,53,3,14,061,Charchigné,494,8,502
52,Pays de la Loire,53,1,97,062,Château-Gontier,11353,399,11752
52,Pays de la Loire,53,1,04,063,Châtelain,481,18,499
52,Pays de la Loire,53,3,12,064,Châtillon-sur-Colmont,1009,39,1048
52,Pays de la Loire,53,2,11,065,Châtres-la-Forêt,785,20,805
52,Pays de la Loire,53,1,06,066,Chemazé,1328,28,1356
52,Pays de la Loire,53,2,22,067,Chémeré-le-Roi,466,10,476
52,Pays de la Loire,53,1,09,068,Chérancé,170,6,176
52,Pays de la Loire,53,3,08,069,Chevaigné-du-Maine,201,6,207
52,Pays de la Loire,53,3,12,071,Colombiers-du-Plessis,481,15,496
52,Pays de la Loire,53,3,20,072,Commer,1180,31,1211
52,Pays de la Loire,53,1,25,073,Congrier,930,25,955
52,Pays de la Loire,53,3,21,074,Contest,903,31,934
52,Pays de la Loire,53,1,07,075,Cosmes,341,6,347
52,Pays de la Loire,53,2,22,076,Cossé-en-Champagne,336,14,350
52,Pays de la Loire,53,1,07,077,Cossé-le-Vivien,2913,65,2978
52,Pays de la Loire,53,1,04,078,Coudray,833,21,854
52,Pays de la Loire,53,3,01,079,Couesmes-Vaucé,389,11,400
52,Pays de la Loire,53,3,08,080,Couptrain,169,4,173
52,Pays de la Loire,53,2,32,082,Courbeveille,636,5,641
52,Pays de la Loire,53,3,27,083,Courcité,964,30,994
52,Pays de la Loire,53,1,09,084,Craon,4629,206,4835
52,Pays de la Loire,53,3,27,085,Crennes-sur-Fraubée,199,15,214
52,Pays de la Loire,53,2,05,086,La Croixille,629,7,636
52,Pays de la Loire,53,2,22,087,La Cropte,216,7,223
52,Pays de la Loire,53,1,07,088,Cuillé,952,20,972
52,Pays de la Loire,53,1,04,089,Daon,487,14,501
52,Pays de la Loire,53,1,09,090,Denazé,160,4,164
52,Pays de la Loire,53,3,15,091,Désertines,524,6,530
52,Pays de la Loire,53,2,23,092,Deux-Évailles,205,1,206
52,Pays de la Loire,53,3,15,093,La Dorée,326,13,339
52,Pays de la Loire,53,2,28,094,Entrammes,2155,58,2213
52,Pays de la Loire,53,2,22,095,Épineux-le-Seguin,189,5,194
52,Pays de la Loire,53,3,10,096,Ernée,5801,197,5998
52,Pays de la Loire,53,2,11,097,Évron,7092,205,7297
52,Pays de la Loire,53,1,25,098,Fontaine-Couverte,374,14,388
52,Pays de la Loire,53,2,02,099,Forcé,1012,21,1033
52,Pays de la Loire,53,3,15,100,Fougerolles-du-Plessis,1387,23,1410
52,Pays de la Loire,53,1,31,101,Fromentières,807,15,822
52,Pays de la Loire,53,1,07,102,Gastines,199,4,203
52,Pays de la Loire,53,2,19,103,Le Genest-Saint-Isle,2028,44,2072
52,Pays de la Loire,53,1,04,104,Gennes-sur-Glaize,980,25,1005
52,Pays de la Loire,53,2,23,105,Gesnes,218,7,225
52,Pays de la Loire,53,3,27,106,Gesvres,527,10,537
52,Pays de la Loire,53,3,12,107,Gorron,2759,58,2817
52,Pays de la Loire,53,2,19,108,La Gravelle,532,7,539
52,Pays de la Loire,53,3,20,109,Grazay,594,17,611
52,Pays de la Loire,53,1,13,110,Grez-en-Bouère,995,18,1013
52,Pays de la Loire,53,3,01,111,La Haie-Traversaine,502,17,519
52,Pays de la Loire,53,3,14,112,Le Ham,438,14,452
52,Pays de la Loire,53,3,03,113,Hambers,566,17,583
52,Pays de la Loire,53,3,14,114,Hardanges,207,2,209
52,Pays de la Loire,53,3,12,115,Hercé,325,6,331
52,Pays de la Loire,53,3,14,116,Le Horps,760,18,778
52,Pays de la Loire,53,1,06,117,Houssay,407,4,411
52,Pays de la Loire,53,3,16,118,Le Housseau-Brétignolles,229,5,234
52,Pays de la Loire,53,2,32,119,L' Huisserie,3940,120,4060
52,Pays de la Loire,53,3,03,120,Izé,493,5,498
52,Pays de la Loire,53,3,08,121,Javron-les-Chapelles,1461,44,1505
52,Pays de la Loire,53,3,03,122,Jublains,685,20,705
52,Pays de la Loire,53,2,05,123,Juvigné,1389,31,1420
52,Pays de la Loire,53,1,06,124,Laigné,807,19,826
52,Pays de la Loire,53,3,15,125,Landivy,1210,37,1247
52,Pays de la Loire,53,3,10,126,Larchamp,1045,31,1076
52,Pays de la Loire,53,3,16,127,Lassay-les-Châteaux,2438,58,2496
52,Pays de la Loire,53,1,07,128,Laubrières,307,2,309
52,Pays de la Loire,53,2,19,129,Launay-Villiers,398,6,404
52,Pays de la Loire,53,2,98,130,Laval,50931,2669,53600
52,Pays de la Loire,53,3,12,131,Lesbois,195,2,197
52,Pays de la Loire,53,3,12,132,Levaré,309,10,319
52,Pays de la Loire,53,3,08,133,Lignières-Orgères,730,13,743
52,Pays de la Loire,53,2,11,134,Livet,132,2,134
52,Pays de la Loire,53,1,09,135,Livré-la-Touche,778,28,806
52,Pays de la Loire,53,1,06,136,Loigné-sur-Mayenne,877,32,909
52,Pays de la Loire,53,2,19,137,Loiron,1471,25,1496
52,Pays de la Loire,53,1,04,138,Longuefuye,325,10,335
52,Pays de la Loire,53,3,27,139,Loupfougères,447,8,455
52,Pays de la Loire,53,2,02,140,Louverné,3897,108,4005
52,Pays de la Loire,53,2,02,141,Louvigné,906,9,915
52,Pays de la Loire,53,3,08,142,Madré,361,10,371
52,Pays de la Loire,53,2,22,143,Maisoncelles-du-Maine,485,7,492
52,Pays de la Loire,53,3,20,144,Marcillé-la-Ville,816,23,839
52,Pays de la Loire,53,1,06,145,Marigné-Peuton,566,5,571
52,Pays de la Loire,53,3,20,146,Martigné-sur-Mayenne,1606,23,1629
52,Pays de la Loire,53,3,99,147,Mayenne,13295,984,14279
52,Pays de la Loire,53,1,09,148,Mée,200,0,200
52,Pays de la Loire,53,1,31,150,Ménil,960,29,989
52,Pays de la Loire,53,1,07,151,Méral,1076,18,1094
52,Pays de la Loire,53,2,22,152,Meslay-du-Maine,2699,43,2742
52,Pays de la Loire,53,2,11,153,Mézangers,693,19,712
52,Pays de la Loire,53,3,15,154,Montaudin,920,13,933
52,Pays de la Loire,53,3,10,155,Montenay,1415,30,1445
52,Pays de la Loire,53,2,02,156,Montflours,232,9,241
52,Pays de la Loire,53,2,32,157,Montigné-le-Brillant,1264,53,1317
52,Pays de la Loire,53,2,19,158,Montjean,948,12,960
52,Pays de la Loire,53,2,23,159,Montourtier,337,13,350
52,Pays de la Loire,53,3,14,160,Montreuil-Poulay,402,8,410
52,Pays de la Loire,53,2,23,161,Montsûrs,2113,41,2154
52,Pays de la Loire,53,3,20,162,Moulay,998,40,1038
52,Pays de la Loire,53,2,11,163,Neau,705,14,719
52,Pays de la Loire,53,3,08,164,Neuilly-le-Vendin,380,14,394
52,Pays de la Loire,53,1,09,165,Niafles,298,13,311
52,Pays de la Loire,53,2,32,168,Nuillé-sur-Vicoin,1173,26,1199
52,Pays de la Loire,53,3,21,170,Oisseau,1134,22,1156
52,Pays de la Loire,53,2,19,169,Olivet,423,4,427
52,Pays de la Loire,53,1,06,172,Origné,363,9,372
52,Pays de la Loire,53,3,08,173,La Pallu,183,6,189
52,Pays de la Loire,53,3,21,174,Parigné-sur-Braye,724,25,749
52,Pays de la Loire,53,2,02,175,Parné-sur-Roc,1220,29,1249
52,Pays de la Loire,53,3,01,176,Le Pas,539,16,555
52,Pays de la Loire,53,3,10,177,La Pellerine,305,12,317
52,Pays de la Loire,53,1,07,178,Peuton,228,13,241
52,Pays de la Loire,53,3,21,179,Placé,321,4,325
52,Pays de la Loire,53,1,09,180,Pommerieux,677,20,697
52,Pays de la Loire,53,3,15,181,Pontmain,865,17,882
52,Pays de la Loire,53,2,19,182,Port-Brillet,1919,28,1947
52,Pays de la Loire,53,3,24,185,Pré-en-Pail,2075,100,2175
52,Pays de la Loire,53,1,13,184,Préaux,180,3,183
52,Pays de la Loire,53,1,07,186,Quelaines-Saint-Gault,1901,38,1939
52,Pays de la Loire,53,3,24,187,Ravigny,212,5,217
52,Pays de la Loire,53,1,25,188,Renazé,2705,60,2765
52,Pays de la Loire,53,3,16,189,Rennes-en-Grenouilles,109,1,110
52,Pays de la Loire,53,3,14,190,Le Ribay,508,7,515
52,Pays de la Loire,53,1,25,191,La Roë,243,5,248
52,Pays de la Loire,53,1,25,192,La Rouaudière,340,17,357
52,Pays de la Loire,53,1,13,193,Ruillé-Froid-Fonds,501,13,514
52,Pays de la Loire,53,2,19,194,Ruillé-le-Gravelais,824,15,839
52,Pays de la Loire,53,3,20,195,Sacé,436,2,438
52,Pays de la Loire,53,3,08,196,Saint-Aignan-de-Couptrain,389,5,394
52,Pays de la Loire,53,1,25,197,Saint-Aignan-sur-Roë,857,30,887
52,Pays de la Loire,53,3,27,198,Saint-Aubin-du-Désert,273,4,277
52,Pays de la Loire,53,3,12,199,Saint-Aubin-Fosse-Louvain,263,5,268
52,Pays de la Loire,53,3,21,200,Saint-Baudelle,1165,17,1182
52,Pays de la Loire,53,2,32,201,Saint-Berthevin,7031,241,7272
52,Pays de la Loire,53,3,15,202,Saint-Berthevin-la-Tannière,378,14,392
52,Pays de la Loire,53,1,13,203,Saint-Brice,526,15,541
52,Pays de la Loire,53,3,08,204,Saint-Calais-du-Désert,374,6,380
52,Pays de la Loire,53,2,23,205,Saint-Céneré,436,10,446
52,Pays de la Loire,53,1,13,206,Saint-Charles-la-Forêt,216,3,219
52,Pays de la Loire,53,2,11,207,Saint-Christophe-du-Luat,751,6,757
52,Pays de la Loire,53,3,24,208,Saint-Cyr-en-Pail,443,10,453
52,Pays de la Loire,53,2,19,209,Saint-Cyr-le-Gravelais,540,8,548
52,Pays de la Loire,53,1,04,210,Saint-Denis-d'Anjou,1501,36,1537
52,Pays de la Loire,53,3,10,211,Saint-Denis-de-Gastines,1686,37,1723
52,Pays de la Loire,53,2,22,212,Saint-Denis-du-Maine,419,12,431
52,Pays de la Loire,53,3,15,213,Saint-Ellier-du-Maine,529,13,542
52,Pays de la Loire,53,1,25,214,Saint-Erblon,152,11,163
52,Pays de la Loire,53,1,31,215,Saint-Fort,1580,77,1657
52,Pays de la Loire,53,3,20,216,Saint-Fraimbault-de-Prières,992,20,1012
52,Pays de la Loire,53,3,21,219,Saint-Georges-Buttavent,1395,44,1439
52,Pays de la Loire,53,2,22,220,Saint-Georges-le-Fléchard,346,1,347
52,Pays de la Loire,53,2,11,221,Saint-Georges-sur-Erve,410,6,416
52,Pays de la Loire,53,3,21,222,Saint-Germain-d'Anxure,299,7,306
52,Pays de la Loire,53,3,27,223,Saint-Germain-de-Coulamer,402,11,413
52,Pays de la Loire,53,2,17,224,Saint-Germain-le-Fouilloux,1019,17,1036
52,Pays de la Loire,53,2,05,225,Saint-Germain-le-Guillaume,467,8,475
52,Pays de la Loire,53,2,05,226,Saint-Hilaire-du-Maine,819,12,831
52,Pays de la Loire,53,2,26,228,Saint-Jean-sur-Erve,492,2,494
52,Pays de la Loire,53,2,17,229,Saint-Jean-sur-Mayenne,1413,45,1458
52,Pays de la Loire,53,3,16,230,Saint-Julien-du-Terroux,264,5,269
52,Pays de la Loire,53,1,04,231,Saint-Laurent-des-Mortiers,196,5,201
52,Pays de la Loire,53,2,26,232,Saint-Léger,270,2,272
52,Pays de la Loire,53,1,13,233,Saint-Loup-du-Dorat,336,11,347
52,Pays de la Loire,53,3,01,234,Saint-Loup-du-Gast,364,12,376
52,Pays de la Loire,53,3,27,236,Saint-Mars-du-Désert,198,2,200
52,Pays de la Loire,53,3,12,237,Saint-Mars-sur-Colmont,445,11,456
52,Pays de la Loire,53,3,15,238,Saint-Mars-sur-la-Futaie,628,18,646
52,Pays de la Loire,53,3,03,239,Saint-Martin-de-Connée,407,9,416
52,Pays de la Loire,53,1,09,240,Saint-Martin-du-Limet,482,11,493
52,Pays de la Loire,53,1,04,241,Saint-Michel-de-Feins,168,7,175
52,Pays de la Loire,53,1,25,242,Saint-Michel-de-la-Roë,250,7,257
52,Pays de la Loire,53,2,19,243,Saint-Ouën-des-Toits,1700,45,1745
52,Pays de la Loire,53,2,23,244,Saint-Ouën-des-Vallons,180,2,182
52,Pays de la Loire,53,2,05,245,Saint-Pierre-des-Landes,969,27,996
52,Pays de la Loire,53,3,24,246,Saint-Pierre-des-Nids,1932,40,1972
52,Pays de la Loire,53,2,19,247,Saint-Pierre-la-Cour,1893,31,1924
52,Pays de la Loire,53,2,26,248,Saint-Pierre-sur-Erve,136,4,140
52,Pays de la Loire,53,3,03,249,Saint-Pierre-sur-Orthe,485,13,498
52,Pays de la Loire,53,1,07,250,Saint-Poix,400,7,407
52,Pays de la Loire,53,1,09,251,Saint-Quentin-les-Anges,400,7,407
52,Pays de la Loire,53,3,24,252,Saint-Samson,424,8,432
52,Pays de la Loire,53,1,25,253,Saint-Saturnin-du-Limet,517,15,532
52,Pays de la Loire,53,1,06,254,Saint-Sulpice,222,10,232
52,Pays de la Loire,53,3,03,256,Saint-Thomas-de-Courceriers,228,14,242
52,Pays de la Loire,53,2,11,218,Sainte-Gemmes-le-Robert,841,23,864
52,Pays de la Loire,53,3,16,235,Sainte-Marie-du-Bois,226,6,232
52,Pays de la Loire,53,2,26,255,Sainte-Suzanne,973,22,995
52,Pays de la Loire,53,2,22,257,Saulges,320,10,330
52,Pays de la Loire,53,1,09,258,La Selle-Craonnaise,919,21,940
52,Pays de la Loire,53,1,25,259,Senonnes,363,8,371
52,Pays de la Loire,53,1,07,260,Simplé,353,9,362
52,Pays de la Loire,53,3,01,261,Soucé,191,7,198
52,Pays de la Loire,53,2,23,262,Soulgé-sur-Ouette,1098,27,1125
52,Pays de la Loire,53,2,26,264,Thorigné-en-Charnie,176,5,181
52,Pays de la Loire,53,3,16,263,Thuboeuf,289,2,291
52,Pays de la Loire,53,2,26,265,Torcé-Viviers-en-Charnie,728,15,743
52,Pays de la Loire,53,3,03,266,Trans,237,7,244
52,Pays de la Loire,53,2,26,267,Vaiges,1185,12,1197
52,Pays de la Loire,53,3,10,269,Vautorte,583,17,600
52,Pays de la Loire,53,3,12,270,Vieuvy,122,4,126
52,Pays de la Loire,53,3,27,271,Villaines-la-Juhel,3084,88,3172
52,Pays de la Loire,53,3,27,272,Villepail,193,1,194
52,Pays de la Loire,53,1,13,273,Villiers-Charlemagne,1034,27,1061
52,Pays de la Loire,53,2,11,274,Vimarcé,232,5,237
52,Pays de la Loire,53,2,11,276,Voutré,861,22,883
41,Lorraine,54,3,23,001,Abaucourt,289,4,293
41,Lorraine,54,1,11,002,Abbéville-lès-Conflans,230,9,239
41,Lorraine,54,4,10,003,Aboncourt,123,2,125
41,Lorraine,54,1,11,004,Affléville,202,8,210
41,Lorraine,54,3,14,005,Affracourt,104,6,110
41,Lorraine,54,3,42,006,Agincourt,412,6,418
41,Lorraine,54,4,27,007,Aingeray,573,10,583
41,Lorraine,54,4,10,008,Allain,474,8,482
41,Lorraine,54,1,11,009,Allamont,128,3,131
41,Lorraine,54,4,10,010,Allamps,519,13,532
41,Lorraine,54,1,15,011,Allondrelle-la-Malmaison,618,2,620
41,Lorraine,54,3,42,012,Amance,330,14,344
41,Lorraine,54,2,06,013,Amenoncourt,98,2,100
41,Lorraine,54,2,06,014,Ancerviller,250,8,258
41,Lorraine,54,1,02,015,Anderny,316,4,320
41,Lorraine,54,4,12,016,Andilly,284,3,287
41,Lorraine,54,2,04,017,Angomont,101,2,103
41,Lorraine,54,1,07,018,Anoux,277,10,287
41,Lorraine,54,4,12,019,Ansauville,88,1,89
41,Lorraine,54,2,17,020,Anthelupt,444,11,455
41,Lorraine,54,3,23,021,Armaucourt,213,5,218
41,Lorraine,54,4,26,022,Arnaville,590,10,600
41,Lorraine,54,2,01,023,Arracourt,247,3,250
41,Lorraine,54,3,23,024,Arraye-et-Han,330,8,338
41,Lorraine,54,3,40,025,Art-sur-Meurthe,1294,318,1612
41,Lorraine,54,2,01,026,Athienville,161,2,163
41,Lorraine,54,3,24,027,Atton,778,14,792
41,Lorraine,54,1,31,028,Auboué,2655,27,2682
41,Lorraine,54,1,02,029,Audun-le-Roman,2457,47,2504
41,Lorraine,54,2,06,030,Autrepierre,120,3,123
41,Lorraine,54,3,24,031,Autreville-sur-Moselle,290,7,297
41,Lorraine,54,3,29,032,Autrey,173,4,177
41,Lorraine,54,1,02,033,Avillers,84,6,90
41,Lorraine,54,4,12,034,Avrainville,243,4,247
41,Lorraine,54,2,06,035,Avricourt,416,10,426
41,Lorraine,54,1,07,036,Avril,872,18,890
41,Lorraine,54,3,25,037,Azelot,418,9,427
41,Lorraine,54,2,03,038,Azerailles,838,20,858
41,Lorraine,54,2,03,039,Baccarat,4654,70,4724
41,Lorraine,54,2,04,040,Badonviller,1598,26,1624
41,Lorraine,54,4,10,041,Bagneux,145,5,150
41,Lorraine,54,3,14,042,Bainville-aux-Miroirs,342,5,347
41,Lorraine,54,3,33,043,Bainville-sur-Madon,1398,15,1413
41,Lorraine,54,2,06,044,Barbas,144,8,152
41,Lorraine,54,2,05,045,Barbonville,390,5,395
41,Lorraine,54,4,10,046,Barisey-au-Plain,332,8,340
41,Lorraine,54,4,10,047,Barisey-la-Côte,188,3,191
41,Lorraine,54,1,07,048,Les Baroches,370,12,382
41,Lorraine,54,1,37,049,Baslieux,570,9,579
41,Lorraine,54,2,01,050,Bathelémont-lès-Bauzemont,60,6,66
41,Lorraine,54,1,31,051,Batilly,1324,16,1340
41,Lorraine,54,4,10,052,Battigny,107,3,110
41,Lorraine,54,2,17,053,Bauzemont,157,3,160
41,Lorraine,54,2,05,054,Bayon,1484,17,1501
41,Lorraine,54,4,26,055,Bayonville-sur-Mad,318,4,322
41,Lorraine,54,1,37,056,Bazailles,175,0,175
41,Lorraine,54,4,12,057,Beaumont,71,1,72
41,Lorraine,54,1,11,058,Béchamps,79,0,79
41,Lorraine,54,3,23,059,Belleau,771,6,777
41,Lorraine,54,3,24,060,Belleville,1487,18,1505
41,Lorraine,54,2,18,061,Bénaménil,538,15,553
41,Lorraine,54,3,14,062,Benney,596,6,602
41,Lorraine,54,4,12,063,Bernécourt,170,5,175
41,Lorraine,54,2,09,064,Bertrambois,363,10,373
41,Lorraine,54,2,03,065,Bertrichamps,1070,22,1092
41,Lorraine,54,1,02,066,Bettainvillers,202,7,209
41,Lorraine,54,1,15,067,Beuveille,672,9,681
41,Lorraine,54,4,10,068,Beuvezin,117,3,120
41,Lorraine,54,1,02,069,Beuvillers,320,3,323
41,Lorraine,54,3,23,070,Bey-sur-Seille,155,0,155
41,Lorraine,54,2,01,071,Bezange-la-Grande,172,10,182
41,Lorraine,54,3,24,072,Bezaumont,253,0,253
41,Lorraine,54,4,28,073,Bicqueley,912,9,921
41,Lorraine,54,2,17,074,Bienville-la-Petite,29,0,29
41,Lorraine,54,2,04,075,Bionville,134,4,138
41,Lorraine,54,2,05,076,Blainville-sur-l'Eau,4050,46,4096
41,Lorraine,54,2,06,077,Blâmont,1164,24,1188
41,Lorraine,54,2,06,078,Blémerey,56,1,57
41,Lorraine,54,3,41,079,Blénod-lès-Pont-à-Mousson,4414,57,4471
41,Lorraine,54,4,28,080,Blénod-lès-Toul,1042,16,1058
41,Lorraine,54,1,37,081,Boismont,465,11,476
41,Lorraine,54,1,11,082,Boncourt,189,1,190
41,Lorraine,54,2,17,083,Bonviller,185,4,189
41,Lorraine,54,2,05,085,Borville,97,0,97
41,Lorraine,54,4,27,086,Boucq,386,8,394
41,Lorraine,54,4,26,087,Bouillonville,115,4,119
41,Lorraine,54,4,27,088,Bouvron,237,7,244
41,Lorraine,54,3,42,089,Bouxières-aux-Chênes,1400,16,1416
41,Lorraine,54,3,42,090,Bouxières-aux-Dames,3960,42,4002
41,Lorraine,54,3,24,091,Bouxières-sous-Froidmont,264,4,268
41,Lorraine,54,3,14,092,Bouzanville,66,0,66
41,Lorraine,54,1,11,093,Brainville,150,4,154
41,Lorraine,54,3,14,094,Bralleville,175,3,178
41,Lorraine,54,3,23,095,Bratte,35,0,35
41,Lorraine,54,1,37,096,Bréhain-la-Ville,272,5,277
41,Lorraine,54,2,04,097,Bréménil,132,2,134
41,Lorraine,54,2,05,098,Brémoncourt,156,4,160
41,Lorraine,54,1,07,099,Briey,5342,194,5536
41,Lorraine,54,3,42,100,Brin-sur-Seille,640,13,653
41,Lorraine,54,2,03,101,Brouville,127,2,129
41,Lorraine,54,4,27,102,Bruley,583,12,595
41,Lorraine,54,1,11,103,Bruville,195,2,197
41,Lorraine,54,3,40,104,Buissoncourt,260,7,267
41,Lorraine,54,4,28,105,Bulligny,510,13,523
41,Lorraine,54,2,01,106,Bures,74,2,76
41,Lorraine,54,2,06,107,Buriville,67,1,68
41,Lorraine,54,3,25,108,Burthecourt-aux-Chênes,94,2,96
41,Lorraine,54,3,14,109,Ceintrey,785,5,790
41,Lorraine,54,3,40,110,Cerville,584,4,588
41,Lorraine,54,3,33,111,Chaligny,3084,32,3116
41,Lorraine,54,1,08,112,Chambley-Bussières,548,9,557
41,Lorraine,54,3,43,113,Champenoux,1215,26,1241
41,Lorraine,54,3,24,114,Champey-sur-Moselle,328,2,330
41,Lorraine,54,3,34,115,Champigneulles,6767,69,6836
41,Lorraine,54,2,18,116,Chanteheux,1917,45,1962
41,Lorraine,54,3,29,117,Chaouilley,125,1,126
41,Lorraine,54,1,15,118,Charency-Vezin,640,8,648
41,Lorraine,54,4,26,119,Charey,75,0,75
41,Lorraine,54,4,28,120,Charmes-la-Côte,308,4,312
41,Lorraine,54,2,05,121,Charmois,150,2,152
41,Lorraine,54,4,28,122,Chaudeney-sur-Moselle,684,22,706
41,Lorraine,54,3,33,123,Chavigny,1702,29,1731
41,Lorraine,54,2,06,124,Chazelles-sur-Albe,41,1,42
41,Lorraine,54,2,18,125,Chenevières,445,7,452
41,Lorraine,54,3,23,126,Chenicourt,220,4,224
41,Lorraine,54,1,32,127,Chenières,594,18,612
41,Lorraine,54,4,28,128,Choloy-Ménillot,715,20,735
41,Lorraine,54,2,09,129,Cirey-sur-Vezouze,1760,26,1786
41,Lorraine,54,2,05,130,Clayeures,184,4,188
41,Lorraine,54,3,23,131,Clémery,510,10,520
41,Lorraine,54,3,29,132,Clérey-sur-Brenon,64,1,65
41,Lorraine,54,2,01,133,Coincourt,146,3,149
41,Lorraine,54,1,15,134,Colmey,283,2,285
41,Lorraine,54,4,10,135,Colombey-les-Belles,1356,24,1380
41,Lorraine,54,1,11,136,Conflans-en-Jarnisy,2439,33,2472
41,Lorraine,54,1,15,137,Cons-la-Grandville,567,8,575
41,Lorraine,54,1,32,138,Cosnes-et-Romain,2336,45,2381
41,Lorraine,54,2,17,139,Courbesseaux,253,7,260
41,Lorraine,54,4,10,140,Courcelles,92,3,95
41,Lorraine,54,3,25,141,Coyviller,129,0,129
41,Lorraine,54,3,14,142,Crantenoy,126,3,129
41,Lorraine,54,4,10,143,Crépey,341,12,353
41,Lorraine,54,3,14,144,Crévéchamps,323,4,327
41,Lorraine,54,2,17,145,Crévic,918,17,935
41,Lorraine,54,4,28,146,Crézilles,263,5,268
41,Lorraine,54,2,18,147,Crion,90,6,96
41,Lorraine,54,2,18,148,Croismare,617,9,626
41,Lorraine,54,1,02,149,Crusnes,1613,24,1637
41,Lorraine,54,3,42,150,Custines,2978,28,3006
41,Lorraine,54,1,32,151,Cutry,922,30,952
41,Lorraine,54,2,05,152,Damelevières,3016,28,3044
41,Lorraine,54,1,08,153,Dampvitoux,69,0,69
41,Lorraine,54,2,03,154,Deneuvre,565,24,589
41,Lorraine,54,2,17,155,Deuxville,402,12,414
41,Lorraine,54,3,14,156,Diarville,497,9,506
41,Lorraine,54,3,41,157,Dieulouard,4571,50,4621
41,Lorraine,54,4,10,158,Dolcourt,94,2,96
41,Lorraine,54,3,25,159,Dombasle-sur-Meurthe,9964,182,10146
41,Lorraine,54,4,12,160,Domèvre-en-Haye,450,6,456
41,Lorraine,54,2,06,161,Domèvre-sur-Vezouze,288,10,298
41,Lorraine,54,4,28,162,Domgermain,1276,32,1308
41,Lorraine,54,2,06,163,Domjevin,233,9,242
41,Lorraine,54,3,29,164,Dommarie-Eulmont,79,1,80
41,Lorraine,54,3,35,165,Dommartemont,644,20,664
41,Lorraine,54,4,26,166,Dommartin-la-Chaussée,45,0,45
41,Lorraine,54,4,27,167,Dommartin-lès-Toul,1994,26,2020
41,Lorraine,54,3,42,168,Dommartin-sous-Amance,257,7,264
41,Lorraine,54,1,02,169,Domprix,73,3,76
41,Lorraine,54,2,05,170,Domptail-en-l'Air,60,0,60
41,Lorraine,54,1,11,171,Doncourt-lès-Conflans,1241,18,1259
41,Lorraine,54,1,15,172,Doncourt-lès-Longuyon,274,7,281
41,Lorraine,54,2,17,173,Drouville,165,1,166
41,Lorraine,54,4,27,174,Écrouves,4172,67,4239
41,Lorraine,54,2,05,175,Einvaux,327,4,331
41,Lorraine,54,2,17,176,Einville-au-Jard,1233,21,1254
41,Lorraine,54,2,06,177,Emberménil,261,3,264
41,Lorraine,54,1,15,178,Épiez-sur-Chiers,186,5,191
41,Lorraine,54,3,23,179,Éply,300,7,307
41,Lorraine,54,3,40,180,Erbéviller-sur-Amezule,89,1,90
41,Lorraine,54,1,02,181,Errouville,787,7,794
41,Lorraine,54,4,26,182,Essey-et-Maizerais,381,13,394
41,Lorraine,54,2,13,183,Essey-la-Côte,97,0,97
41,Lorraine,54,3,35,184,Essey-lès-Nancy,7811,164,7975
41,Lorraine,54,3,29,185,Étreval,54,1,55
41,Lorraine,54,3,42,186,Eulmont,990,20,1010
41,Lorraine,54,4,26,187,Euvezin,113,1,114
41,Lorraine,54,3,23,188,Faulx,1303,5,1308
41,Lorraine,54,4,10,189,Favières,580,13,593
41,Lorraine,54,4,10,190,Fécocourt,113,1,114
41,Lorraine,54,2,04,191,Fenneviller,104,5,109
41,Lorraine,54,3,25,192,Ferrières,282,3,285
41,Lorraine,54,3,41,193,Fey-en-Haye,75,2,77
41,Lorraine,54,1,37,194,Fillières,468,16,484
41,Lorraine,54,2,17,195,Flainval,202,1,203
41,Lorraine,54,3,25,196,Flavigny-sur-Moselle,1774,159,1933
41,Lorraine,54,3,40,197,Fléville-devant-Nancy,2390,43,2433
41,Lorraine,54,1,11,198,Fléville-Lixières,253,2,255
41,Lorraine,54,2,03,199,Flin,374,8,382
41,Lorraine,54,4,26,200,Flirey,191,4,195
41,Lorraine,54,2,03,201,Fontenoy-la-Joûte,299,11,310
41,Lorraine,54,4,27,202,Fontenoy-sur-Moselle,372,4,376
41,Lorraine,54,3,29,203,Forcelles-Saint-Gorgon,144,7,151
41,Lorraine,54,3,29,204,Forcelles-sous-Gugney,95,0,95
41,Lorraine,54,4,27,205,Foug,2769,42,2811
41,Lorraine,54,2,13,206,Fraimbois,342,8,350
41,Lorraine,54,3,29,207,Fraisnes-en-Saintois,97,0,97
41,Lorraine,54,4,12,208,Francheville,284,8,292
41,Lorraine,54,2,13,209,Franconville,50,2,52
41,Lorraine,54,2,06,210,Fréménil,177,5,182
41,Lorraine,54,2,06,211,Frémonville,219,5,224
41,Lorraine,54,1,15,212,Fresnois-la-Montagne,394,10,404
41,Lorraine,54,1,11,213,Friauville,352,8,360
41,Lorraine,54,3,29,214,Frolois,655,6,661
41,Lorraine,54,3,34,215,Frouard,6652,55,6707
41,Lorraine,54,2,05,216,Froville,123,3,126
41,Lorraine,54,2,03,217,Gélacourt,156,7,163
41,Lorraine,54,4,10,218,Gélaucourt,60,1,61
41,Lorraine,54,3,40,219,Gellenoncourt,50,0,50
41,Lorraine,54,4,10,220,Gémonville,76,2,78
41,Lorraine,54,3,14,221,Gerbécourt-et-Haplemont,222,3,225
41,Lorraine,54,2,13,222,Gerbéviller,1364,25,1389
41,Lorraine,54,4,10,223,Germiny,213,2,215
41,Lorraine,54,3,14,224,Germonville,94,1,95
41,Lorraine,54,4,12,225,Gézoncourt,169,1,170
41,Lorraine,54,4,10,226,Gibeaumeix,148,0,148
41,Lorraine,54,1,11,227,Giraumont,1184,16,1200
41,Lorraine,54,2,13,228,Giriviller,77,0,77
41,Lorraine,54,2,03,229,Glonville,338,9,347
41,Lorraine,54,2,06,230,Gogney,52,1,53
41,Lorraine,54,1,11,231,Gondrecourt-Aix,179,2,181
41,Lorraine,54,4,27,232,Gondreville,2837,30,2867
41,Lorraine,54,2,06,233,Gondrexon,32,3,35
41,Lorraine,54,1,32,234,Gorcy,2390,41,2431
41,Lorraine,54,3,29,235,Goviller,391,12,403
41,Lorraine,54,1,15,236,Grand-Failly,311,0,311
41,Lorraine,54,4,10,237,Grimonviller,86,4,90
41,Lorraine,54,3,14,238,Gripport,235,1,236
41,Lorraine,54,4,12,239,Griscourt,122,2,124
41,Lorraine,54,4,12,240,Grosrouvres,51,0,51
41,Lorraine,54,3,29,241,Gugney,80,4,84
41,Lorraine,54,4,28,242,Gye,190,2,192
41,Lorraine,54,2,03,243,Hablainville,209,8,217
41,Lorraine,54,1,08,244,Hagéville,120,2,122
41,Lorraine,54,2,05,245,Haigneville,52,1,53
41,Lorraine,54,2,06,246,Halloville,65,4,69
41,Lorraine,54,3,29,247,Hammeville,173,5,178
41,Lorraine,54,4,12,248,Hamonville,100,2,102
41,Lorraine,54,1,15,602,Han-devant-Pierrepont,130,1,131
41,Lorraine,54,1,11,249,Hannonville-Suzémont,284,4,288
41,Lorraine,54,3,40,250,Haraucourt,678,8,686
41,Lorraine,54,2,06,251,Harbouey,117,7,124
41,Lorraine,54,3,14,252,Haroué,436,11,447
41,Lorraine,54,1,31,253,Hatrize,739,13,752
41,Lorraine,54,1,30,254,Haucourt-Moulaine,3020,47,3067
41,Lorraine,54,2,13,255,Haudonville,90,2,92
41,Lorraine,54,2,05,256,Haussonville,322,3,325
41,Lorraine,54,3,38,257,Heillecourt,5908,109,6017
41,Lorraine,54,2,18,258,Hénaménil,184,5,189
41,Lorraine,54,2,06,259,Herbéviller,221,6,227
41,Lorraine,54,2,18,260,Hériménil,932,16,948
41,Lorraine,54,1,30,261,Herserange,4501,61,4562
41,Lorraine,54,2,17,262,Hoéville,170,3,173
41,Lorraine,54,1,31,263,Homécourt,6448,70,6518
41,Lorraine,54,3,29,264,Houdelmont,213,1,214
41,Lorraine,54,3,38,265,Houdemont,2435,55,2490
41,Lorraine,54,3,29,266,Houdreville,436,3,439
41,Lorraine,54,3,14,268,Housséville,173,4,177
41,Lorraine,54,2,17,269,Hudiviller,313,4,317
41,Lorraine,54,1,30,270,Hussigny-Godbrange,3305,55,3360
41,Lorraine,54,2,06,271,Igney,109,4,113
41,Lorraine,54,4,12,272,Jaillon,358,5,363
41,Lorraine,54,1,11,273,Jarny,8496,160,8656
41,Lorraine,54,3,38,274,Jarville-la-Malgrange,9438,243,9681
41,Lorraine,54,4,26,275,Jaulny,257,5,262
41,Lorraine,54,3,23,276,Jeandelaincourt,753,6,759
41,Lorraine,54,1,11,277,Jeandelize,397,11,408
41,Lorraine,54,3,14,278,Jevoncourt,75,1,76
41,Lorraine,54,3,41,279,Jezainville,934,15,949
41,Lorraine,54,1,07,280,Joeuf,6926,80,7006
41,Lorraine,54,2,18,281,Jolivet,814,21,835
41,Lorraine,54,1,02,282,Joppécourt,138,2,140
41,Lorraine,54,1,31,283,Jouaville,315,5,320
41,Lorraine,54,1,02,284,Joudreville,1202,26,1228
41,Lorraine,54,2,01,285,Juvrecourt,67,5,72
41,Lorraine,54,1,11,286,Labry,1682,19,1701
41,Lorraine,54,2,03,287,Lachapelle,245,6,251
41,Lorraine,54,4,27,288,Lagney,476,17,493
41,Lorraine,54,3,42,289,Laître-sous-Amance,372,7,379
41,Lorraine,54,1,37,290,Laix,223,0,223
41,Lorraine,54,3,29,291,Laloeuf,298,5,303
41,Lorraine,54,2,13,292,Lamath,189,2,191
41,Lorraine,54,2,05,293,Landécourt,88,4,92
41,Lorraine,54,3,24,294,Landremont,139,5,144
41,Lorraine,54,1,02,295,Landres,866,63,929
41,Lorraine,54,3,43,296,Laneuvelotte,403,14,417
41,Lorraine,54,2,18,297,Laneuveville-aux-Bois,316,7,323
41,Lorraine,54,4,27,298,Laneuveville-derrière-Foug,138,7,145
41,Lorraine,54,3,14,299,Laneuveville-devant-Bayon,236,3,239
41,Lorraine,54,3,40,300,Laneuveville-devant-Nancy,6005,50,6055
41,Lorraine,54,3,23,301,Lanfroicourt,122,3,125
41,Lorraine,54,1,07,302,Lantéfontaine,748,15,763
41,Lorraine,54,2,18,303,Laronxe,381,4,385
41,Lorraine,54,3,39,304,Laxou,14925,357,15282
41,Lorraine,54,3,42,305,Lay-Saint-Christophe,2592,54,2646
41,Lorraine,54,4,27,306,Lay-Saint-Remy,345,3,348
41,Lorraine,54,3,14,307,Lebeuville,169,1,170
41,Lorraine,54,2,06,308,Leintrey,154,1,155
41,Lorraine,54,3,14,309,Lemainville,334,6,340
41,Lorraine,54,3,14,310,Leménil-Mitry,3,0,3
41,Lorraine,54,3,40,311,Lenoncourt,576,8,584
41,Lorraine,54,3,24,312,Lesménils,474,9,483
41,Lorraine,54,3,23,313,Létricourt,226,8,234
41,Lorraine,54,1,32,314,Lexy,2855,66,2921
41,Lorraine,54,3,23,315,Leyr,955,23,978
41,Lorraine,54,4,26,316,Limey-Remenauville,197,4,201
41,Lorraine,54,4,26,317,Lironville,111,3,114
41,Lorraine,54,4,12,318,Liverdun,5908,73,5981
41,Lorraine,54,3,24,320,Loisy,323,11,334
41,Lorraine,54,1,30,321,Longlaville,2487,36,2523
41,Lorraine,54,1,15,322,Longuyon,5665,105,5770
41,Lorraine,54,1,16,323,Longwy,14209,230,14439
41,Lorraine,54,2,05,324,Lorey,92,0,92
41,Lorraine,54,2,05,325,Loromontzey,88,2,90
41,Lorraine,54,1,07,326,Lubey,212,6,218
41,Lorraine,54,4,27,327,Lucey,569,11,580
41,Lorraine,54,3,38,328,Ludres,6662,117,6779
41,Lorraine,54,2,97,329,Lunéville,20096,399,20495
41,Lorraine,54,3,25,330,Lupcourt,388,5,393
41,Lorraine,54,2,13,331,Magnières,343,6,349
41,Lorraine,54,3,41,332,Maidières,1531,21,1552
41,Lorraine,54,3,23,333,Mailly-sur-Seille,256,0,256
41,Lorraine,54,1,02,334,Mairy-Mainville,552,12,564
41,Lorraine,54,2,17,335,Maixe,416,4,420
41,Lorraine,54,3,33,336,Maizières,875,9,884
41,Lorraine,54,1,02,337,Malavillers,149,1,150
41,Lorraine,54,3,23,338,Malleloy,929,14,943
41,Lorraine,54,3,42,339,Malzéville,8160,215,8375
41,Lorraine,54,4,12,340,Mamey,313,4,317
41,Lorraine,54,1,07,341,Mance,625,13,638
41,Lorraine,54,1,07,342,Mancieulles,1608,22,1630
41,Lorraine,54,4,12,343,Mandres-aux-Quatre-Tours,182,2,184
41,Lorraine,54,3,14,344,Mangonville,233,3,236
41,Lorraine,54,3,25,345,Manoncourt-en-Vermois,332,1,333
41,Lorraine,54,4,12,346,Manoncourt-en-Woëvre,207,9,216
41,Lorraine,54,4,12,348,Manonville,242,4,246
41,Lorraine,54,2,18,349,Manonviller,146,7,153
41,Lorraine,54,2,18,350,Marainviller,699,8,707
41,Lorraine,54,3,34,351,Marbache,1768,16,1784
41,Lorraine,54,3,33,352,Maron,829,7,836
41,Lorraine,54,1,08,353,Mars-la-Tour,956,16,972
41,Lorraine,54,3,29,354,Marthemont,39,1,40
41,Lorraine,54,4,12,355,Martincourt,86,1,87
41,Lorraine,54,2,13,356,Mattexey,70,4,74
41,Lorraine,54,3,34,357,Maxéville,8893,141,9034
41,Lorraine,54,3,43,358,Mazerulles,245,7,252
41,Lorraine,54,2,05,359,Méhoncourt,253,9,262
41,Lorraine,54,4,27,360,Ménil-la-Tour,300,5,305
41,Lorraine,54,1,02,362,Mercy-le-Bas,1343,23,1366
41,Lorraine,54,1,02,363,Mercy-le-Haut,244,0,244
41,Lorraine,54,3,33,364,Méréville,1424,19,1443
41,Lorraine,54,2,03,365,Merviller,389,9,398
41,Lorraine,54,3,33,366,Messein,1708,22,1730
41,Lorraine,54,1,30,367,Mexy,2207,60,2267
41,Lorraine,54,2,03,368,Mignéville,173,5,178
41,Lorraine,54,3,24,369,Millery,611,4,615
41,Lorraine,54,4,12,370,Minorville,221,9,230
41,Lorraine,54,1,31,371,Moineville,1094,14,1108
41,Lorraine,54,3,23,372,Moivrons,423,5,428
41,Lorraine,54,2,18,373,Moncel-lès-Lunéville,466,6,472
41,Lorraine,54,3,43,374,Moncel-sur-Seille,490,7,497
41,Lorraine,54,1,02,084,Mont-Bonvillers,994,11,1005
41,Lorraine,54,4,10,379,Mont-l'Étroit,103,2,105
41,Lorraine,54,4,28,380,Mont-le-Vignoble,399,5,404
41,Lorraine,54,1,32,382,Mont-Saint-Martin,8103,116,8219
41,Lorraine,54,2,13,383,Mont-sur-Meurthe,1037,14,1051
41,Lorraine,54,3,41,375,Montauville,1166,19,1185
41,Lorraine,54,3,23,376,Montenoy,398,16,414
41,Lorraine,54,2,03,377,Montigny,132,2,134
41,Lorraine,54,1,15,378,Montigny-sur-Chiers,471,9,480
41,Lorraine,54,2,06,381,Montreux,58,0,58
41,Lorraine,54,1,37,385,Morfontaine,1127,19,1146
41,Lorraine,54,2,13,386,Moriviller,90,2,92
41,Lorraine,54,3,24,387,Morville-sur-Seille,129,5,134
41,Lorraine,54,2,01,388,Mouacourt,81,0,81
41,Lorraine,54,1,11,389,Mouaville,109,0,109
41,Lorraine,54,3,24,390,Mousson,121,1,122
41,Lorraine,54,1,31,391,Moutiers,1750,24,1774
41,Lorraine,54,4,28,392,Moutrot,303,5,308
41,Lorraine,54,2,13,393,Moyen,540,9,549
41,Lorraine,54,1,02,394,Murville,263,8,271
41,Lorraine,54,3,98,395,Nancy,106361,1811,108172
41,Lorraine,54,2,04,396,Neufmaisons,224,21,245
41,Lorraine,54,3,33,397,Neuves-Maisons,7147,75,7222
41,Lorraine,54,2,04,398,Neuviller-lès-Badonviller,90,2,92
41,Lorraine,54,3,14,399,Neuviller-sur-Moselle,247,1,248
41,Lorraine,54,3,23,400,Nomeny,1142,24,1166
41,Lorraine,54,2,06,401,Nonhigny,106,2,108
41,Lorraine,54,1,11,402,Norroy-le-Sec,390,4,394
41,Lorraine,54,3,41,403,Norroy-lès-Pont-à-Mousson,1213,24,1237
41,Lorraine,54,4,12,404,Noviant-aux-Prés,254,2,256
41,Lorraine,54,4,28,405,Ochey,452,7,459
41,Lorraine,54,2,06,406,Ogéviller,299,7,306
41,Lorraine,54,3,29,407,Ognéville,129,1,130
41,Lorraine,54,1,11,408,Olley,244,3,247
41,Lorraine,54,3,29,409,Omelmont,149,4,153
41,Lorraine,54,1,08,410,Onville,529,6,535
41,Lorraine,54,3,14,411,Ormes-et-Ville,246,2,248
41,Lorraine,54,1,15,412,Othe,33,2,35
41,Lorraine,54,1,11,413,Ozerailles,157,2,159
41,Lorraine,54,4,27,414,Pagney-derrière-Barine,567,12,579
41,Lorraine,54,3,41,415,Pagny-sur-Moselle,4123,52,4175
41,Lorraine,54,4,26,416,Pannes,178,5,183
41,Lorraine,54,3,29,417,Parey-Saint-Césaire,224,1,225
41,Lorraine,54,2,01,418,Parroy,166,9,175
41,Lorraine,54,2,09,419,Parux,78,1,79
41,Lorraine,54,1,15,420,Petit-Failly,78,2,80
41,Lorraine,54,2,09,421,Petitmont,367,9,376
41,Lorraine,54,2,03,422,Pettonville,57,0,57
41,Lorraine,54,2,04,423,Pexonne,394,5,399
41,Lorraine,54,3,23,424,Phlin,45,0,45
41,Lorraine,54,1,02,425,Piennes,2458,36,2494
41,Lorraine,54,4,28,426,Pierre-la-Treiche,557,15,572
41,Lorraine,54,2,04,427,Pierre-Percée,97,4,101
41,Lorraine,54,1,15,428,Pierrepont,939,10,949
41,Lorraine,54,3,29,429,Pierreville,334,3,337
41,Lorraine,54,3,34,430,Pompey,5089,52,5141
41,Lorraine,54,3,24,431,Pont-à-Mousson,14333,321,14654
41,Lorraine,54,3,33,432,Pont-Saint-Vincent,2034,46,2080
41,Lorraine,54,3,24,433,Port-sur-Seille,229,3,232
41,Lorraine,54,3,29,434,Praye,258,3,261
41,Lorraine,54,3,41,435,Prény,376,5,381
41,Lorraine,54,1,02,436,Preutin-Higny,137,4,141
41,Lorraine,54,3,29,437,Pulligny,1243,25,1268
41,Lorraine,54,4,10,438,Pulney,64,2,66
41,Lorraine,54,3,43,439,Pulnoy,4546,81,4627
41,Lorraine,54,1,11,440,Puxe,116,4,120
41,Lorraine,54,1,08,441,Puxieux,245,6,251
41,Lorraine,54,3,29,442,Quevilloncourt,109,1,110
41,Lorraine,54,2,04,443,Raon-lès-Leau,40,1,41
41,Lorraine,54,3,23,444,Raucourt,188,4,192
41,Lorraine,54,2,17,445,Raville-sur-Sânon,103,1,104
41,Lorraine,54,2,01,446,Réchicourt-la-Petite,74,1,75
41,Lorraine,54,2,06,447,Réclonville,78,2,80
41,Lorraine,54,2,13,449,Rehainviller,866,14,880
41,Lorraine,54,2,03,450,Reherrey,131,4,135
41,Lorraine,54,1,32,451,Réhon,3718,67,3785
41,Lorraine,54,2,06,452,Reillon,67,7,74
41,Lorraine,54,4,26,453,Rembercourt-sur-Mad,190,5,195
41,Lorraine,54,2,13,455,Remenoville,146,4,150
41,Lorraine,54,3,40,456,Réméréville,528,4,532
41,Lorraine,54,2,06,457,Remoncourt,37,0,37
41,Lorraine,54,2,06,458,Repaix,82,3,85
41,Lorraine,54,3,25,459,Richardménil,2546,34,2580
41,Lorraine,54,4,12,460,Rogéville,155,5,160
41,Lorraine,54,2,05,461,Romain,49,2,51
41,Lorraine,54,3,25,462,Rosières-aux-Salines,2827,30,2857
41,Lorraine,54,4,12,463,Rosières-en-Haye,226,3,229
41,Lorraine,54,3,23,464,Rouves,97,1,98
41,Lorraine,54,3,14,465,Roville-devant-Bayon,746,8,754
41,Lorraine,54,4,12,466,Royaumeix,338,6,344
41,Lorraine,54,2,05,467,Rozelieures,166,1,167
41,Lorraine,54,3,25,468,Saffais,117,2,119
41,Lorraine,54,1,31,469,Saint-Ail,328,4,332
41,Lorraine,54,4,26,470,Saint-Baussant,67,3,70
41,Lorraine,54,2,05,471,Saint-Boingt,78,2,80
41,Lorraine,54,2,18,472,Saint-Clément,881,20,901
41,Lorraine,54,3,14,473,Saint-Firmin,279,2,281
41,Lorraine,54,2,05,475,Saint-Germain,149,5,154
41,Lorraine,54,1,15,476,Saint-Jean-lès-Longuyon,395,5,400
41,Lorraine,54,1,08,477,Saint-Julien-lès-Gorze,153,2,155
41,Lorraine,54,1,11,478,Saint-Marcel,172,9,181
41,Lorraine,54,2,05,479,Saint-Mard,91,2,93
41,Lorraine,54,2,06,480,Saint-Martin,83,1,84
41,Lorraine,54,2,04,481,Saint-Maurice-aux-Forges,87,6,93
41,Lorraine,54,3,35,482,Saint-Max,9893,145,10038
41,Lorraine,54,3,25,483,Saint-Nicolas-de-Port,7608,91,7699
41,Lorraine,54,1,15,485,Saint-Pancré,305,10,315
41,Lorraine,54,3,14,486,Saint-Remimont,330,4,334
41,Lorraine,54,2,05,487,Saint-Rémy-aux-Bois,69,3,72
41,Lorraine,54,2,09,488,Saint-Sauveur,47,0,47
41,Lorraine,54,1,02,489,Saint-Supplet,172,4,176
41,Lorraine,54,3,24,474,Sainte-Geneviève,191,4,195
41,Lorraine,54,2,04,484,Sainte-Pôle,196,5,201
41,Lorraine,54,3,34,490,Saizerais,1477,13,1490
41,Lorraine,54,1,02,491,Sancy,340,5,345
41,Lorraine,54,4,27,492,Sanzey,138,6,144
41,Lorraine,54,1,30,493,Saulnes,2351,46,2397
41,Lorraine,54,4,10,494,Saulxerotte,76,0,76
41,Lorraine,54,3,43,495,Saulxures-lès-Nancy,3909,65,3974
41,Lorraine,54,4,10,496,Saulxures-lès-Vannes,368,5,373
41,Lorraine,54,3,29,497,Saxon-Sion,69,2,71
41,Lorraine,54,3,43,498,Seichamps,5106,71,5177
41,Lorraine,54,4,26,499,Seicheprey,110,0,110
41,Lorraine,54,4,10,500,Selaincourt,189,6,195
41,Lorraine,54,2,13,501,Seranville,100,2,102
41,Lorraine,54,2,17,502,Serres,268,4,272
41,Lorraine,54,1,02,504,Serrouville,604,4,608
41,Lorraine,54,4,28,505,Sexey-aux-Forges,666,9,675
41,Lorraine,54,4,27,506,Sexey-les-Bois,358,5,363
41,Lorraine,54,2,18,507,Sionviller,104,3,107
41,Lorraine,54,3,23,508,Sivry,261,4,265
41,Lorraine,54,2,17,509,Sommerviller,914,9,923
41,Lorraine,54,3,43,510,Sornéville,334,5,339
41,Lorraine,54,1,08,511,Sponville,116,5,121
41,Lorraine,54,2,09,512,Tanconville,92,1,93
41,Lorraine,54,3,14,513,Tantonville,643,14,657
41,Lorraine,54,1,15,514,Tellancourt,578,6,584
41,Lorraine,54,3,29,515,Thélod,263,5,268
41,Lorraine,54,3,29,516,They-sous-Vaudemont,13,0,13
41,Lorraine,54,3,23,517,Thézey-Saint-Martin,196,3,199
41,Lorraine,54,4,26,518,Thiaucourt-Regniéville,1188,28,1216
41,Lorraine,54,2,03,519,Thiaville-sur-Meurthe,481,15,496
41,Lorraine,54,2,18,520,Thiébauménil,394,3,397
41,Lorraine,54,1,37,521,Thil,1615,28,1643
41,Lorraine,54,3,29,522,Thorey-Lyautey,132,3,135
41,Lorraine,54,4,10,523,Thuilley-aux-Groseilles,480,3,483
41,Lorraine,54,1,11,524,Thumeréville,104,3,107
41,Lorraine,54,1,37,525,Tiercelet,684,8,692
41,Lorraine,54,3,40,526,Tomblaine,7661,251,7912
41,Lorraine,54,3,25,527,Tonnoy,729,16,745
41,Lorraine,54,4,99,528,Toul,16082,313,16395
41,Lorraine,54,4,10,529,Tramont-Émy,34,0,34
41,Lorraine,54,4,10,530,Tramont-Lassus,80,3,83
41,Lorraine,54,4,10,531,Tramont-Saint-André,50,0,50
41,Lorraine,54,4,12,532,Tremblecourt,196,3,199
41,Lorraine,54,1,02,533,Trieux,1989,23,2012
41,Lorraine,54,4,27,534,Trondes,524,8,532
41,Lorraine,54,1,08,535,Tronville,214,7,221
41,Lorraine,54,1,02,536,Tucquegnieux,2614,58,2672
41,Lorraine,54,1,15,537,Ugny,679,12,691
41,Lorraine,54,4,10,538,Uruffe,361,9,370
41,Lorraine,54,2,03,539,Vacqueville,247,7,254
41,Lorraine,54,2,09,540,Val-et-Châtillon,683,8,691
41,Lorraine,54,2,17,541,Valhey,166,5,171
41,Lorraine,54,1,31,542,Valleroy,2486,41,2527
41,Lorraine,54,2,13,543,Vallois,151,4,155
41,Lorraine,54,4,26,544,Vandelainville,146,2,148
41,Lorraine,54,4,10,545,Vandeléville,197,4,201
41,Lorraine,54,3,41,546,Vandières,927,11,938
41,Lorraine,54,3,96,547,Vandoeuvre-lès-Nancy,31083,345,31428
41,Lorraine,54,4,10,548,Vannes-le-Châtel,567,11,578
41,Lorraine,54,3,40,549,Varangéville,4071,33,4104
41,Lorraine,54,2,13,550,Vathiménil,319,4,323
41,Lorraine,54,2,06,551,Vaucourt,71,2,73
41,Lorraine,54,3,29,552,Vaudémont,83,1,84
41,Lorraine,54,3,14,553,Vaudeville,192,5,197
41,Lorraine,54,3,14,554,Vaudigny,48,4,52
41,Lorraine,54,2,03,555,Vaxainville,85,0,85
41,Lorraine,54,2,06,556,Vého,109,3,112
41,Lorraine,54,4,12,557,Velaine-en-Haye,1455,107,1562
41,Lorraine,54,3,43,558,Velaine-sous-Amance,279,4,283
41,Lorraine,54,2,05,559,Velle-sur-Moselle,284,5,289
41,Lorraine,54,2,03,560,Veney,53,0,53
41,Lorraine,54,2,13,561,Vennezey,36,0,36
41,Lorraine,54,2,06,562,Verdenal,153,4,157
41,Lorraine,54,3,29,563,Vézelise,1426,25,1451
41,Lorraine,54,4,26,564,Viéville-en-Haye,165,7,172
41,Lorraine,54,2,05,565,Vigneulles,263,5,268
41,Lorraine,54,4,26,566,Vilcey-sur-Trey,161,5,166
41,Lorraine,54,2,05,567,Villacourt,467,9,476
41,Lorraine,54,1,37,568,Ville-au-Montois,265,4,269
41,Lorraine,54,3,24,569,Ville-au-Val,173,3,176
41,Lorraine,54,3,25,571,Ville-en-Vermois,593,9,602
41,Lorraine,54,1,32,572,Ville-Houdlémont,603,12,615
41,Lorraine,54,1,11,581,Ville-sur-Yron,292,11,303
41,Lorraine,54,1,08,570,Villecey-sur-Mad,314,9,323
41,Lorraine,54,4,12,573,Villers-en-Haye,169,2,171
41,Lorraine,54,1,15,574,Villers-la-Chèvre,537,17,554
41,Lorraine,54,1,37,575,Villers-la-Montagne,1480,49,1529
41,Lorraine,54,1,15,576,Villers-le-Rond,96,2,98
41,Lorraine,54,3,23,577,Villers-lès-Moivrons,132,1,133
41,Lorraine,54,3,39,578,Villers-lès-Nancy,14835,346,15181
41,Lorraine,54,3,41,579,Villers-sous-Prény,347,9,356
41,Lorraine,54,1,37,580,Villerupt,9520,172,9692
41,Lorraine,54,1,15,582,Villette,207,6,213
41,Lorraine,54,4,28,583,Villey-le-Sec,415,9,424
41,Lorraine,54,4,12,584,Villey-Saint-Étienne,1077,16,1093
41,Lorraine,54,2,05,585,Virecourt,451,13,464
41,Lorraine,54,3,29,586,Viterne,722,9,731
41,Lorraine,54,3,29,587,Vitrey,233,3,236
41,Lorraine,54,2,17,588,Vitrimont,373,5,378
41,Lorraine,54,3,24,589,Vittonville,135,3,138
41,Lorraine,54,1,15,590,Viviers-sur-Chiers,676,8,684
41,Lorraine,54,3,14,591,Voinémont,346,7,353
41,Lorraine,54,3,29,592,Vroncourt,220,5,225
41,Lorraine,54,1,08,593,Waville,455,6,461
41,Lorraine,54,4,26,594,Xammes,124,2,126
41,Lorraine,54,2,13,595,Xermaménil,527,16,543
41,Lorraine,54,3,29,596,Xeuilley,780,11,791
41,Lorraine,54,3,14,597,Xirocourt,450,7,457
41,Lorraine,54,1,02,598,Xivry-Circourt,265,4,269
41,Lorraine,54,1,08,599,Xonville,121,3,124
41,Lorraine,54,2,06,600,Xousse,115,1,116
41,Lorraine,54,2,01,601,Xures,129,1,130
41,Lorraine,55,2,10,001,Abainville,321,8,329
41,Lorraine,55,3,08,002,Abaucourt-Hautecourt,100,1,101
41,Lorraine,55,3,07,004,Aincreville,89,3,92
41,Lorraine,55,2,10,005,Amanty,50,0,50
41,Lorraine,55,3,26,007,Ambly-sur-Meuse,257,5,262
41,Lorraine,55,3,19,008,Amel-sur-l'Étang,171,1,172
41,Lorraine,55,3,18,009,Ancemont,566,15,581
41,Lorraine,55,1,01,010,Ancerville,2803,68,2871
41,Lorraine,55,1,16,011,Andernay,243,3,246
41,Lorraine,55,2,17,012,Apremont-la-Forêt,401,15,416
41,Lorraine,55,3,19,013,Arrancy-sur-Crusne,446,2,448
41,Lorraine,55,3,04,014,Aubréville,398,7,405
41,Lorraine,55,1,01,015,Aulnois-en-Perthois,460,12,472
41,Lorraine,55,1,21,017,Autrécourt-sur-Aire,134,0,134
41,Lorraine,55,3,20,018,Autréville-Saint-Lambert,48,1,49
41,Lorraine,55,3,09,021,Avillers-Sainte-Croix,60,2,62
41,Lorraine,55,3,14,022,Avioth,124,6,130
41,Lorraine,55,3,22,023,Avocourt,125,2,127
41,Lorraine,55,3,06,024,Azannes-et-Soumazannes,164,3,167
41,Lorraine,55,3,20,025,Baâlon,268,3,271
41,Lorraine,55,2,10,026,Badonvilliers-Gérauvilliers,154,7,161
41,Lorraine,55,2,15,027,Bannoncourt,179,5,184
41,Lorraine,55,3,12,028,Bantheville,132,5,137
41,Lorraine,55,1,92,029,Bar-le-Duc,15757,765,16522
41,Lorraine,55,2,10,030,Baudignécourt,78,3,81
41,Lorraine,55,1,01,031,Baudonvilliers,439,16,455
41,Lorraine,55,2,15,032,Baudrémont,52,7,59
41,Lorraine,55,3,22,033,Baulny,15,0,15
41,Lorraine,55,3,14,034,Bazeilles-sur-Othain,97,2,99
41,Lorraine,55,1,01,035,Bazincourt-sur-Saulx,151,9,160
41,Lorraine,55,3,20,036,Beauclair,85,3,88
41,Lorraine,55,3,20,037,Beaufort-en-Argonne,160,4,164
41,Lorraine,55,1,21,038,Beaulieu-en-Argonne,35,1,36
41,Lorraine,55,3,03,039,Beaumont-en-Verdunois,0,0,0
41,Lorraine,55,1,21,040,Beausite,287,13,300
41,Lorraine,55,1,25,041,Behonne,686,29,715
41,Lorraine,55,3,31,042,Belleray,417,13,430
41,Lorraine,55,3,03,043,Belleville-sur-Meuse,3180,94,3274
41,Lorraine,55,2,15,044,Belrain,47,2,49
41,Lorraine,55,3,26,045,Belrupt-en-Verdunois,441,13,454
41,Lorraine,55,2,27,046,Beney-en-Woëvre,156,4,160
41,Lorraine,55,3,03,047,Béthelainville,191,5,196
41,Lorraine,55,3,03,048,Béthincourt,24,0,24
41,Lorraine,55,1,16,049,Beurey-sur-Saulx,442,5,447
41,Lorraine,55,3,03,050,Bezonvaux,0,0,0
41,Lorraine,55,1,13,051,Biencourt-sur-Orge,155,2,157
41,Lorraine,55,3,19,053,Billy-sous-Mangiennes,384,4,388
41,Lorraine,55,2,17,054,Bislée,62,1,63
41,Lorraine,55,3,08,055,Blanzée,19,1,20
41,Lorraine,55,3,08,057,Boinville-en-Woëvre,71,0,71
41,Lorraine,55,2,05,058,Boncourt-sur-Meuse,330,11,341
41,Lorraine,55,2,10,059,Bonnet,217,8,225
41,Lorraine,55,3,09,060,Bonzée,366,7,373
41,Lorraine,55,1,13,061,Le Bouchon-sur-Saulx,222,6,228
41,Lorraine,55,2,17,062,Bouconville-sur-Madt,104,1,105
41,Lorraine,55,3,19,063,Bouligny,2724,31,2755
41,Lorraine,55,2,15,064,Bouquemont,96,0,96
41,Lorraine,55,3,22,065,Boureuilles,126,5,131
41,Lorraine,55,2,28,066,Bovée-sur-Barboure,133,9,142
41,Lorraine,55,2,28,067,Boviolles,102,4,106
41,Lorraine,55,3,04,068,Brabant-en-Argonne,106,3,109
41,Lorraine,55,1,16,069,Brabant-le-Roi,248,8,256
41,Lorraine,55,3,12,070,Brabant-sur-Meuse,125,2,127
41,Lorraine,55,3,06,071,Brandeville,168,0,168
41,Lorraine,55,3,08,072,Braquis,89,1,90
41,Lorraine,55,3,03,073,Bras-sur-Meuse,691,31,722
41,Lorraine,55,1,13,075,Brauvilliers,174,1,175
41,Lorraine,55,3,06,076,Bréhéville,168,3,171
41,Lorraine,55,3,14,077,Breux,256,6,262
41,Lorraine,55,3,07,078,Brieulles-sur-Meuse,330,9,339
41,Lorraine,55,1,01,079,Brillon-en-Barrois,591,19,610
41,Lorraine,55,2,24,080,Brixey-aux-Chanoines,81,5,86
41,Lorraine,55,1,21,081,Brizeaux,46,2,48
41,Lorraine,55,3,04,082,Brocourt-en-Argonne,47,6,53
41,Lorraine,55,3,20,083,Brouennes,163,3,166
41,Lorraine,55,2,28,084,Broussey-en-Blois,62,4,66
41,Lorraine,55,2,17,085,Broussey-Raulecourt,256,2,258
41,Lorraine,55,1,13,087,Bure,94,0,94
41,Lorraine,55,2,24,088,Burey-en-Vaux,135,0,135
41,Lorraine,55,2,24,089,Burey-la-Côte,71,0,71
41,Lorraine,55,2,27,093,Buxières-sous-les-Côtes,273,11,284
41,Lorraine,55,3,08,094,Buzy-Darmont,570,12,582
41,Lorraine,55,3,20,095,Cesse,130,4,134
41,Lorraine,55,2,27,096,Chaillon,95,5,100
41,Lorraine,55,2,24,097,Chalaines,324,8,332
41,Lorraine,55,3,03,099,Champneuville,116,6,122
41,Lorraine,55,2,24,100,Champougny,105,2,107
41,Lorraine,55,1,11,358,Chanteraine,206,10,216
41,Lorraine,55,1,25,101,Chardogne,291,7,298
41,Lorraine,55,3,03,102,Charny-sur-Meuse,556,14,570
41,Lorraine,55,3,22,103,Charpentry,27,4,31
41,Lorraine,55,2,10,104,Chassey-Beaupré,121,3,124
41,Lorraine,55,3,08,105,Châtillon-sous-les-Côtes,159,3,162
41,Lorraine,55,3,03,106,Chattancourt,173,6,179
41,Lorraine,55,3,06,107,Chaumont-devant-Damvillers,42,0,42
41,Lorraine,55,1,23,108,Chaumont-sur-Aire,166,3,169
41,Lorraine,55,3,14,109,Chauvency-le-Château,255,0,255
41,Lorraine,55,3,14,110,Chauvency-Saint-Hubert,246,6,252
41,Lorraine,55,2,17,111,Chauvoncourt,489,21,510
41,Lorraine,55,3,22,113,Cheppy,131,4,135
41,Lorraine,55,2,05,114,Chonville-Malaumont,167,10,177
41,Lorraine,55,3,12,115,Cierges-sous-Montfaucon,50,1,51
41,Lorraine,55,3,04,116,Le Claon,55,1,56
41,Lorraine,55,3,04,117,Clermont-en-Argonne,1593,33,1626
41,Lorraine,55,3,07,118,Cléry-le-Grand,73,1,74
41,Lorraine,55,3,07,119,Cléry-le-Petit,200,0,200
41,Lorraine,55,1,29,120,Combles-en-Barrois,872,28,900
41,Lorraine,55,3,09,121,Combres-sous-les-Côtes,108,9,117
41,Lorraine,55,2,05,122,Commercy,6446,269,6715
41,Lorraine,55,3,12,124,Consenvoye,285,7,292
41,Lorraine,55,1,16,125,Contrisson,732,12,744
41,Lorraine,55,2,15,127,Courcelles-en-Barrois,31,0,31
41,Lorraine,55,1,23,128,Courcelles-sur-Aire,39,5,44
41,Lorraine,55,2,15,129,Courouvre,42,0,42
41,Lorraine,55,1,01,132,Cousances-les-Forges,1708,32,1740
41,Lorraine,55,2,05,518,Cousances-lès-Triconville,148,3,151
41,Lorraine,55,1,13,133,Couvertpuis,89,2,91
41,Lorraine,55,1,16,134,Couvonges,147,4,151
41,Lorraine,55,3,12,137,Cuisy,45,0,45
41,Lorraine,55,3,03,139,Cumières-le-Mort-Homme,0,0,0
41,Lorraine,55,3,12,140,Cunel,15,0,15
41,Lorraine,55,2,05,141,Dagonville,81,2,83
41,Lorraine,55,2,10,142,Dainville-Bertheléville,155,4,159
41,Lorraine,55,3,08,143,Damloup,147,4,151
41,Lorraine,55,1,13,144,Dammarie-sur-Saulx,433,5,438
41,Lorraine,55,3,06,145,Damvillers,637,107,744
41,Lorraine,55,3,12,146,Dannevoux,207,8,215
41,Lorraine,55,2,10,148,Delouze-Rosières,130,2,132
41,Lorraine,55,3,06,149,Delut,104,0,104
41,Lorraine,55,2,10,150,Demange-aux-Eaux,550,20,570
41,Lorraine,55,3,08,153,Dieppe-sous-Douaumont,173,1,174
41,Lorraine,55,3,26,154,Dieue-sur-Meuse,1391,27,1418
41,Lorraine,55,3,04,155,Dombasle-en-Argonne,412,4,416
41,Lorraine,55,3,06,156,Dombras,139,3,142
41,Lorraine,55,3,09,157,Dommartin-la-Montagne,69,1,70
41,Lorraine,55,3,19,158,Dommary-Baroncourt,829,15,844
41,Lorraine,55,2,15,159,Dompcevrin,360,9,369
41,Lorraine,55,2,27,160,Dompierre-aux-Bois,50,2,52
41,Lorraine,55,3,19,162,Domremy-la-Canne,31,3,34
41,Lorraine,55,3,09,163,Doncourt-aux-Templiers,70,1,71
41,Lorraine,55,3,03,164,Douaumont,7,0,7
41,Lorraine,55,3,07,165,Doulcon,431,15,446
41,Lorraine,55,3,31,166,Dugny-sur-Meuse,1336,38,1374
41,Lorraine,55,3,07,167,Dun-sur-Meuse,752,14,766
41,Lorraine,55,3,19,168,Duzey,50,0,50
41,Lorraine,55,3,14,169,Écouviez,534,9,543
41,Lorraine,55,3,06,170,Écurey-en-Verdunois,136,4,140
41,Lorraine,55,3,08,171,Eix,254,12,266
41,Lorraine,55,3,09,172,Les Éparges,76,2,78
41,Lorraine,55,2,24,173,Épiez-sur-Meuse,35,1,36
41,Lorraine,55,3,12,174,Épinonville,80,2,82
41,Lorraine,55,1,25,175,Érize-la-Brûlée,189,4,193
41,Lorraine,55,1,23,177,Érize-la-Petite,62,1,63
41,Lorraine,55,1,25,178,Érize-Saint-Dizier,196,1,197
41,Lorraine,55,2,05,179,Erneville-aux-Bois,172,6,178
41,Lorraine,55,3,22,180,Esnes-en-Argonne,128,2,130
41,Lorraine,55,3,08,181,Étain,3763,56,3819
41,Lorraine,55,3,19,182,Éton,215,3,218
41,Lorraine,55,3,06,183,Étraye,49,1,50
41,Lorraine,55,2,05,184,Euville,1705,34,1739
41,Lorraine,55,1,21,185,Èvres,88,1,89
41,Lorraine,55,1,02,186,Fains-Véel,2273,115,2388
41,Lorraine,55,3,14,188,Flassigny,48,2,50
41,Lorraine,55,3,03,189,Fleury-devant-Douaumont,0,0,0
41,Lorraine,55,3,08,191,Foameix-Ornel,186,10,196
41,Lorraine,55,3,07,192,Fontaines-Saint-Clair,51,0,51
41,Lorraine,55,3,12,193,Forges-sur-Meuse,100,4,104
41,Lorraine,55,1,21,194,Foucaucourt-sur-Thabas,59,2,61
41,Lorraine,55,1,13,195,Fouchères-aux-Bois,139,0,139
41,Lorraine,55,2,05,196,Frémeréville-sous-les-Côtes,101,2,103
41,Lorraine,55,2,15,197,Fresnes-au-Mont,142,6,148
41,Lorraine,55,3,09,198,Fresnes-en-Woëvre,770,22,792
41,Lorraine,55,3,04,199,Froidos,93,4,97
41,Lorraine,55,3,03,200,Fromeréville-les-Vallons,240,2,242
41,Lorraine,55,3,08,201,Fromezey,57,0,57
41,Lorraine,55,3,04,202,Futeau,159,2,161
41,Lorraine,55,3,26,204,Génicourt-sur-Meuse,278,5,283
41,Lorraine,55,3,12,206,Gercourt-et-Drillancourt,140,9,149
41,Lorraine,55,1,25,207,Géry,49,0,49
41,Lorraine,55,3,12,208,Gesnes-en-Argonne,49,1,50
41,Lorraine,55,2,05,258,Geville,584,6,590
41,Lorraine,55,2,15,210,Gimécourt,38,3,41
41,Lorraine,55,3,08,211,Gincrey,64,2,66
41,Lorraine,55,2,05,212,Girauvoisin,77,6,83
41,Lorraine,55,1,11,214,Givrauval,322,5,327
41,Lorraine,55,2,10,215,Gondrecourt-le-Château,1244,24,1268
41,Lorraine,55,3,19,216,Gouraincourt,44,3,47
41,Lorraine,55,2,24,217,Goussaincourt,117,3,120
41,Lorraine,55,3,06,218,Gremilly,26,0,26
41,Lorraine,55,3,08,219,Grimaucourt-en-Woëvre,93,2,95
41,Lorraine,55,2,05,220,Grimaucourt-près-Sampigny,102,3,105
41,Lorraine,55,1,11,221,Guerpont,258,15,273
41,Lorraine,55,3,08,222,Gussainville,38,1,39
41,Lorraine,55,1,01,224,Haironville,592,8,600
41,Lorraine,55,3,20,225,Halles-sous-les-Côtes,158,1,159
41,Lorraine,55,3,14,226,Han-lès-Juvigny,96,2,98
41,Lorraine,55,2,17,229,Han-sur-Meuse,264,5,269
41,Lorraine,55,3,09,228,Hannonville-sous-les-Côtes,617,13,630
41,Lorraine,55,3,09,232,Harville,107,5,112
41,Lorraine,55,3,26,236,Haudainville,1002,32,1034
41,Lorraine,55,3,09,237,Haudiomont,229,4,233
41,Lorraine,55,3,03,239,Haumont-près-Samogneux,0,0,0
41,Lorraine,55,1,23,123,Les Hauts-de-Chée,725,24,749
41,Lorraine,55,3,18,241,Heippes,73,0,73
41,Lorraine,55,3,09,242,Hennemont,125,3,128
41,Lorraine,55,3,09,243,Herbeuville,169,3,172
41,Lorraine,55,3,08,244,Herméville-en-Woëvre,238,2,240
41,Lorraine,55,2,27,245,Heudicourt-sous-les-Côtes,186,32,218
41,Lorraine,55,1,13,246,Hévilliers,134,5,139
41,Lorraine,55,2,10,247,Horville-en-Ornois,60,3,63
41,Lorraine,55,2,10,248,Houdelaincourt,362,12,374
41,Lorraine,55,3,20,250,Inor,213,6,219
41,Lorraine,55,1,21,251,Ippécourt,98,1,99
41,Lorraine,55,3,14,252,Iré-le-Sec,157,4,161
41,Lorraine,55,3,04,253,Les Islettes,844,19,863
41,Lorraine,55,3,14,255,Jametz,255,1,256
41,Lorraine,55,2,27,256,Jonville-en-Woëvre,138,5,143
41,Lorraine,55,3,04,257,Jouy-en-Argonne,55,0,55
41,Lorraine,55,3,18,260,Julvécourt,71,5,76
41,Lorraine,55,1,01,261,Juvigny-en-Perthois,135,2,137
41,Lorraine,55,3,14,262,Juvigny-sur-Loison,264,5,269
41,Lorraine,55,2,15,263,Koeur-la-Grande,169,5,174
41,Lorraine,55,2,15,264,Koeur-la-Petite,278,4,282
41,Lorraine,55,3,09,265,Labeuville,131,2,133
41,Lorraine,55,3,22,266,Lachalade,56,1,57
41,Lorraine,55,2,27,267,Lachaussée,253,8,261
41,Lorraine,55,2,17,268,Lacroix-sur-Meuse,718,26,744
41,Lorraine,55,2,15,269,Lahaymeix,95,2,97
41,Lorraine,55,2,17,270,Lahayville,29,0,29
41,Lorraine,55,1,23,271,Laheycourt,389,17,406
41,Lorraine,55,1,16,272,Laimont,440,19,459
41,Lorraine,55,2,27,274,Lamorville,282,13,295
41,Lorraine,55,3,20,275,Lamouilly,89,0,89
41,Lorraine,55,3,18,276,Landrecourt-Lempire,209,3,212
41,Lorraine,55,2,28,278,Laneuville-au-Rupt,184,3,187
41,Lorraine,55,3,20,279,Laneuville-sur-Meuse,420,9,429
41,Lorraine,55,3,08,280,Lanhères,58,2,60
41,Lorraine,55,3,09,281,Latour-en-Woëvre,61,2,63
41,Lorraine,55,2,15,282,Lavallée,96,1,97
41,Lorraine,55,1,01,284,Lavincourt,73,0,73
41,Lorraine,55,1,21,285,Lavoye,164,6,170
41,Lorraine,55,3,18,286,Lemmes,234,2,236
41,Lorraine,55,2,05,288,Lérouville,1485,35,1520
41,Lorraine,55,2,15,289,Levoncourt,49,0,49
41,Lorraine,55,2,15,290,Lignières-sur-Aire,49,3,52
41,Lorraine,55,1,11,291,Ligny-en-Barrois,4512,120,4632
41,Lorraine,55,3,07,292,Liny-devant-Dun,180,3,183
41,Lorraine,55,3,07,293,Lion-devant-Dun,184,6,190
41,Lorraine,55,1,23,295,Lisle-en-Barrois,35,0,35
41,Lorraine,55,1,01,296,Lisle-en-Rigault,535,18,553
41,Lorraine,55,3,06,297,Lissey,136,4,140
41,Lorraine,55,1,11,298,Loisey-Culey,451,19,470
41,Lorraine,55,3,19,299,Loison,101,0,101
41,Lorraine,55,2,15,301,Longchamps-sur-Aire,148,5,153
41,Lorraine,55,1,11,300,Longeaux,235,8,243
41,Lorraine,55,1,02,302,Longeville-en-Barrois,1213,31,1244
41,Lorraine,55,2,17,303,Loupmont,89,4,93
41,Lorraine,55,1,23,304,Louppy-le-Château,168,6,174
41,Lorraine,55,3,14,306,Louppy-sur-Loison,120,7,127
41,Lorraine,55,3,03,307,Louvemont-Côte-du-Poivre,0,0,0
41,Lorraine,55,3,20,310,Luzy-Saint-Martin,106,2,108
41,Lorraine,55,3,09,311,Maizeray,38,1,39
41,Lorraine,55,2,17,312,Maizey,185,2,187
41,Lorraine,55,3,22,313,Malancourt,80,3,83
41,Lorraine,55,1,13,315,Mandres-en-Barrois,130,5,135
41,Lorraine,55,3,19,316,Mangiennes,392,10,402
41,Lorraine,55,3,09,317,Manheulles,159,3,162
41,Lorraine,55,3,09,320,Marchéville-en-Woëvre,76,1,77
41,Lorraine,55,3,03,321,Marre,176,8,184
41,Lorraine,55,2,28,322,Marson-sur-Barboure,44,2,46
41,Lorraine,55,3,20,323,Martincourt-sur-Meuse,66,0,66
41,Lorraine,55,3,14,324,Marville,572,12,584
41,Lorraine,55,3,08,325,Maucourt-sur-Orne,53,0,53
41,Lorraine,55,1,11,326,Maulan,107,2,109
41,Lorraine,55,2,10,327,Mauvages,260,9,269
41,Lorraine,55,2,24,328,Maxey-sur-Vaise,304,11,315
41,Lorraine,55,2,05,329,Mécrin,245,6,251
41,Lorraine,55,2,28,330,Méligny-le-Grand,97,7,104
41,Lorraine,55,2,28,331,Méligny-le-Petit,64,5,69
41,Lorraine,55,1,11,332,Menaucourt,225,3,228
41,Lorraine,55,2,15,333,Ménil-aux-Bois,37,1,38
41,Lorraine,55,2,28,334,Ménil-la-Horgne,148,3,151
41,Lorraine,55,1,13,335,Ménil-sur-Saulx,271,7,278
41,Lorraine,55,3,06,336,Merles-sur-Loison,157,4,161
41,Lorraine,55,3,07,338,Milly-sur-Bradon,173,4,177
41,Lorraine,55,3,08,339,Mogeville,74,1,75
41,Lorraine,55,1,16,340,Mognéville,402,10,412
41,Lorraine,55,3,06,341,Moirey-Flabas-Crépion,132,3,135
41,Lorraine,55,3,07,345,Mont-devant-Sassey,112,1,113
41,Lorraine,55,3,22,343,Montblainville,66,4,70
41,Lorraine,55,2,24,344,Montbras,26,2,28
41,Lorraine,55,3,12,346,Montfaucon-d'Argonne,358,6,364
41,Lorraine,55,3,18,347,Les Monthairons,371,4,375
41,Lorraine,55,1,13,348,Montiers-sur-Saulx,450,9,459
41,Lorraine,55,3,07,349,Montigny-devant-Sassey,136,3,139
41,Lorraine,55,2,24,350,Montigny-lès-Vaucouleurs,76,2,78
41,Lorraine,55,3,14,351,Montmédy,2292,87,2379
41,Lorraine,55,1,01,352,Montplonne,163,29,192
41,Lorraine,55,2,17,353,Montsec,77,1,78
41,Lorraine,55,3,03,355,Montzéville,172,7,179
41,Lorraine,55,3,08,356,Moranville,114,3,117
41,Lorraine,55,3,08,357,Morgemoulin,102,6,108
41,Lorraine,55,1,13,359,Morley,209,5,214
41,Lorraine,55,3,09,360,Mouilly,110,5,115
41,Lorraine,55,3,08,361,Moulainville,127,7,134
41,Lorraine,55,3,20,362,Moulins-Saint-Hubert,171,8,179
41,Lorraine,55,3,09,363,Moulotte,98,3,101
41,Lorraine,55,3,20,364,Mouzay,735,16,751
41,Lorraine,55,3,07,365,Murvaux,149,0,149
41,Lorraine,55,3,19,367,Muzeray,123,0,123
41,Lorraine,55,2,28,368,Naives-en-Blois,162,2,164
41,Lorraine,55,1,25,369,Naives-Rosières,843,26,869
41,Lorraine,55,1,11,370,Naix-aux-Forges,211,5,216
41,Lorraine,55,1,11,373,Nant-le-Grand,67,4,71
41,Lorraine,55,1,11,374,Nant-le-Petit,84,2,86
41,Lorraine,55,3,12,375,Nantillois,66,4,70
41,Lorraine,55,1,11,376,Nantois,98,3,101
41,Lorraine,55,2,05,371,Nançois-le-Grand,58,1,59
41,Lorraine,55,1,11,372,Nançois-sur-Ornain,380,8,388
41,Lorraine,55,3,20,377,Nepvant,59,2,61
41,Lorraine,55,1,16,378,Nettancourt,282,11,293
41,Lorraine,55,3,04,379,Le Neufour,77,0,77
41,Lorraine,55,2,15,380,Neuville-en-Verdunois,74,3,77
41,Lorraine,55,2,24,381,Neuville-lès-Vaucouleurs,181,6,187
41,Lorraine,55,1,16,382,Neuville-sur-Ornain,352,6,358
41,Lorraine,55,3,04,383,Neuvilly-en-Argonne,206,4,210
41,Lorraine,55,2,15,384,Nicey-sur-Aire,110,4,114
41,Lorraine,55,3,18,385,Nixéville-Blercourt,431,16,447
41,Lorraine,55,2,27,386,Nonsard-Lamarche,114,5,119
41,Lorraine,55,3,19,387,Nouillonpont,236,8,244
41,Lorraine,55,1,23,388,Noyers-Auzécourt,242,9,251
41,Lorraine,55,1,21,389,Nubécourt,277,9,286
41,Lorraine,55,3,20,391,Olizy-sur-Chiers,179,0,179
41,Lorraine,55,3,03,394,Ornes,3,0,3
41,Lorraine,55,3,18,395,Osches,53,2,55
41,Lorraine,55,2,28,396,Ourches-sur-Meuse,190,4,194
41,Lorraine,55,2,24,397,Pagny-la-Blanche-Côte,249,0,249
41,Lorraine,55,2,28,398,Pagny-sur-Meuse,977,19,996
41,Lorraine,55,3,09,399,Pareid,120,1,121
41,Lorraine,55,3,08,400,Parfondrupt,51,1,52
41,Lorraine,55,2,17,401,Les Paroches,382,14,396
41,Lorraine,55,3,06,403,Peuvillers,67,2,69
41,Lorraine,55,2,15,404,Pierrefitte-sur-Aire,246,10,256
41,Lorraine,55,3,19,405,Pillon,220,4,224
41,Lorraine,55,3,09,406,Pintheville,77,2,79
41,Lorraine,55,2,05,407,Pont-sur-Meuse,143,7,150
41,Lorraine,55,3,20,408,Pouilly-sur-Meuse,199,8,207
41,Lorraine,55,1,21,409,Pretz-en-Argonne,61,4,65
41,Lorraine,55,3,14,410,Quincy-Landzécourt,147,11,158
41,Lorraine,55,1,25,442,Raival,253,5,258
41,Lorraine,55,3,18,411,Rambluzin-et-Benoite-Vaux,95,1,96
41,Lorraine,55,2,17,412,Rambucourt,180,1,181
41,Lorraine,55,1,16,414,Rancourt-sur-Ornain,208,5,213
41,Lorraine,55,2,17,415,Ranzières,69,1,70
41,Lorraine,55,3,04,416,Rarécourt,232,5,237
41,Lorraine,55,3,04,419,Récicourt,157,4,161
41,Lorraine,55,3,18,420,Récourt-le-Creux,76,4,80
41,Lorraine,55,2,28,421,Reffroy,70,0,70
41,Lorraine,55,3,12,422,Regnéville-sur-Meuse,39,0,39
41,Lorraine,55,1,23,423,Rembercourt-Sommaisne,321,14,335
41,Lorraine,55,1,16,424,Remennecourt,58,3,61
41,Lorraine,55,3,14,425,Remoiville,154,6,160
41,Lorraine,55,1,25,426,Resson,411,13,424
41,Lorraine,55,1,16,427,Revigny-sur-Ornain,3187,65,3252
41,Lorraine,55,3,06,428,Réville-aux-Bois,123,9,132
41,Lorraine,55,3,09,429,Riaville,41,3,44
41,Lorraine,55,1,13,430,Ribeaucourt,104,1,105
41,Lorraine,55,2,17,431,Richecourt,63,1,64
41,Lorraine,55,2,24,433,Rigny-la-Salle,366,13,379
41,Lorraine,55,2,24,434,Rigny-Saint-Martin,54,2,56
41,Lorraine,55,1,29,435,Robert-Espagne,825,17,842
41,Lorraine,55,2,10,436,Les Roises,38,0,38
41,Lorraine,55,3,06,437,Romagne-sous-les-Côtes,113,1,114
41,Lorraine,55,3,12,438,Romagne-sous-Montfaucon,187,6,193
41,Lorraine,55,3,09,439,Ronvaux,85,3,88
41,Lorraine,55,3,08,443,Rouvres-en-Woëvre,704,12,716
41,Lorraine,55,2,17,444,Rouvrois-sur-Meuse,190,7,197
41,Lorraine,55,3,19,445,Rouvrois-sur-Othain,195,6,201
41,Lorraine,55,1,25,446,Rumont,100,0,100
41,Lorraine,55,1,01,447,Rupt-aux-Nonains,360,6,366
41,Lorraine,55,2,15,448,Rupt-devant-Saint-Mihiel,51,2,53
41,Lorraine,55,3,26,449,Rupt-en-Woëvre,307,5,312
41,Lorraine,55,3,06,450,Rupt-sur-Othain,56,0,56
41,Lorraine,55,1,11,452,Saint-Amand-sur-Ornain,61,10,71
41,Lorraine,55,3,18,453,Saint-André-en-Barrois,63,3,66
41,Lorraine,55,2,05,454,Saint-Aubin-sur-Aire,175,7,182
41,Lorraine,55,2,24,456,Saint-Germain-sur-Meuse,258,4,262
41,Lorraine,55,3,09,457,Saint-Hilaire-en-Woëvre,191,8,199
41,Lorraine,55,3,08,458,Saint-Jean-lès-Buzy,293,6,299
41,Lorraine,55,2,10,459,Saint-Joire,254,10,264
41,Lorraine,55,2,05,460,Saint-Julien-sous-les-Côtes,126,7,133
41,Lorraine,55,3,19,461,Saint-Laurent-sur-Othain,481,11,492
41,Lorraine,55,2,27,462,Saint-Maurice-sous-les-Côtes,408,7,415
41,Lorraine,55,2,17,463,Saint-Mihiel,4767,90,4857
41,Lorraine,55,3,19,464,Saint-Pierrevillers,156,3,159
41,Lorraine,55,3,09,465,Saint-Remy-la-Calonne,70,1,71
41,Lorraine,55,1,11,466,Salmagne,306,8,314
41,Lorraine,55,3,03,468,Samogneux,74,2,76
41,Lorraine,55,2,15,467,Sampigny,742,14,756
41,Lorraine,55,3,07,469,Sassey-sur-Meuse,111,4,115
41,Lorraine,55,1,01,470,Saudrupt,206,6,212
41,Lorraine,55,3,07,471,Saulmory-et-Villefranche,109,3,112
41,Lorraine,55,2,28,472,Saulvaux,128,2,130
41,Lorraine,55,3,09,473,Saulx-lès-Champlon,130,4,134
41,Lorraine,55,2,24,474,Sauvigny,256,5,261
41,Lorraine,55,2,28,475,Sauvoy,60,3,63
41,Lorraine,55,1,29,476,Savonnières-devant-Bar,493,12,505
41,Lorraine,55,1,01,477,Savonnières-en-Perthois,478,13,491
41,Lorraine,55,1,25,479,Seigneulles,191,6,197
41,Lorraine,55,3,19,481,Senon,312,7,319
41,Lorraine,55,3,18,482,Senoncourt-les-Maujouy,93,1,94
41,Lorraine,55,3,12,484,Septsarges,53,1,54
41,Lorraine,55,2,24,485,Sepvigny,81,2,83
41,Lorraine,55,1,21,517,Seuil-d'Argonne,500,22,522
41,Lorraine,55,2,27,487,Seuzey,93,2,95
41,Lorraine,55,1,11,488,Silmont,177,2,179
41,Lorraine,55,3,30,489,Sivry-la-Perche,255,8,263
41,Lorraine,55,3,12,490,Sivry-sur-Meuse,357,9,366
41,Lorraine,55,3,26,492,Sommedieue,936,13,949
41,Lorraine,55,1,23,493,Sommeilles,191,4,195
41,Lorraine,55,1,01,494,Sommelonne,500,12,512
41,Lorraine,55,3,19,495,Sorbey,210,11,221
41,Lorraine,55,2,28,496,Sorcy-Saint-Martin,997,18,1015
41,Lorraine,55,3,18,497,Les Souhesmes-Rampont,321,6,327
41,Lorraine,55,3,18,498,Souilly,345,7,352
41,Lorraine,55,3,19,500,Spincourt,800,20,820
41,Lorraine,55,1,01,501,Stainville,408,9,417
41,Lorraine,55,3,20,502,Stenay,2775,116,2891
41,Lorraine,55,2,24,503,Taillancourt,141,2,143
41,Lorraine,55,1,11,504,Tannois,406,13,419
41,Lorraine,55,3,03,505,Thierville-sur-Meuse,3106,93,3199
41,Lorraine,55,2,15,506,Thillombois,34,0,34
41,Lorraine,55,3,09,507,Thillot,237,4,241
41,Lorraine,55,3,14,508,Thonne-la-Long,260,4,264
41,Lorraine,55,3,14,509,Thonne-le-Thil,272,5,277
41,Lorraine,55,3,14,510,Thonne-les-Près,139,2,141
41,Lorraine,55,3,14,511,Thonnelle,142,3,145
41,Lorraine,55,3,18,512,Tilly-sur-Meuse,262,4,266
41,Lorraine,55,1,29,514,Trémont-sur-Saulx,655,18,673
41,Lorraine,55,3,09,515,Trésauvaux,90,2,92
41,Lorraine,55,2,10,516,Tréveray,680,17,697
41,Lorraine,55,1,21,254,Les Trois-Domaines,117,1,118
41,Lorraine,55,1,11,519,Tronville-en-Barrois,1623,49,1672
41,Lorraine,55,2,28,520,Troussey,407,8,415
41,Lorraine,55,2,17,521,Troyon,220,5,225
41,Lorraine,55,2,24,522,Ugny-sur-Meuse,104,2,106
41,Lorraine,55,3,03,523,Vacherauville,108,6,114
41,Lorraine,55,3,18,525,Vadelaincourt,62,4,66
41,Lorraine,55,2,05,526,Vadonville,252,5,257
41,Lorraine,55,1,16,366,Val-d'Ornain,973,28,1001
41,Lorraine,55,2,27,530,Valbois,111,2,113
41,Lorraine,55,3,22,527,Varennes-en-Argonne,685,14,699
41,Lorraine,55,2,17,528,Varnéville,56,1,57
41,Lorraine,55,1,16,531,Vassincourt,298,41,339
41,Lorraine,55,1,23,532,Vaubecourt,313,9,322
41,Lorraine,55,2,24,533,Vaucouleurs,2070,42,2112
41,Lorraine,55,2,10,534,Vaudeville-le-Haut,68,2,70
41,Lorraine,55,3,19,535,Vaudoncourt,59,0,59
41,Lorraine,55,3,22,536,Vauquois,20,2,22
41,Lorraine,55,3,03,537,Vaux-devant-Damloup,70,4,74
41,Lorraine,55,2,27,540,Vaux-lès-Palameix,48,0,48
41,Lorraine,55,1,25,541,Vavincourt,466,10,476
41,Lorraine,55,1,11,543,Velaines,952,26,978
41,Lorraine,55,3,14,544,Velosnes,145,3,148
41,Lorraine,55,3,93,545,Verdun,19252,1003,20255
41,Lorraine,55,3,14,546,Verneuil-Grand,221,8,229
41,Lorraine,55,3,14,547,Verneuil-Petit,137,1,138
41,Lorraine,55,3,22,549,Véry,86,5,91
41,Lorraine,55,3,14,552,Vigneul-sous-Montmédy,100,0,100
41,Lorraine,55,2,27,551,Vigneulles-lès-Hattonchâtel,1534,137,1671
41,Lorraine,55,2,05,553,Vignot,1330,34,1364
41,Lorraine,55,2,15,555,Ville-devant-Belrain,29,0,29
41,Lorraine,55,3,06,556,Ville-devant-Chaumont,60,0,60
41,Lorraine,55,3,09,557,Ville-en-Woëvre,134,2,136
41,Lorraine,55,3,18,567,Ville-sur-Cousances,107,4,111
41,Lorraine,55,1,01,568,Ville-sur-Saulx,307,8,315
41,Lorraine,55,3,14,554,Villécloye,236,10,246
41,Lorraine,55,2,28,559,Villeroy-sur-Méholle,34,0,34
41,Lorraine,55,1,16,560,Villers-aux-Vents,133,6,139
41,Lorraine,55,3,07,561,Villers-devant-Dun,70,3,73
41,Lorraine,55,1,13,562,Villers-le-Sec,138,0,138
41,Lorraine,55,3,19,563,Villers-lès-Mangiennes,75,0,75
41,Lorraine,55,3,09,565,Villers-sous-Pareid,64,0,64
41,Lorraine,55,3,18,566,Villers-sur-Meuse,223,5,228
41,Lorraine,55,1,23,569,Villotte-devant-Louppy,150,3,153
41,Lorraine,55,2,15,570,Villotte-sur-Aire,184,9,193
41,Lorraine,55,3,07,571,Vilosnes-Haraumont,195,2,197
41,Lorraine,55,3,06,572,Vittarville,79,3,82
41,Lorraine,55,2,28,573,Void-Vacon,1670,35,1705
41,Lorraine,55,2,10,574,Vouthon-Bas,59,1,60
41,Lorraine,55,2,10,575,Vouthon-Haut,72,5,77
41,Lorraine,55,1,21,577,Waly,56,2,58
41,Lorraine,55,3,08,578,Warcq,207,1,208
41,Lorraine,55,3,09,579,Watronville,107,4,111
41,Lorraine,55,3,06,580,Wavrille,45,2,47
41,Lorraine,55,1,11,581,Willeroncourt,127,4,131
41,Lorraine,55,3,20,582,Wiseppe,114,2,116
41,Lorraine,55,3,09,583,Woël,177,4,181
41,Lorraine,55,2,15,584,Woimbey,108,2,110
41,Lorraine,55,2,17,586,Xivray-et-Marvoisin,83,1,84
53,Bretagne,56,3,01,001,Allaire,3569,100,3669
53,Bretagne,56,3,21,002,Ambon,1620,49,1669
53,Bretagne,56,3,38,003,Arradon,5222,259,5481
53,Bretagne,56,3,21,004,Arzal,1381,19,1400
53,Bretagne,56,3,35,005,Arzon,2153,58,2211
53,Bretagne,56,3,13,006,Augan,1405,40,1445
53,Bretagne,56,1,02,007,Auray,12536,412,12948
53,Bretagne,56,3,38,008,Baden,4038,125,4163
53,Bretagne,56,1,22,009,Bangor,910,39,949
53,Bretagne,56,2,03,010,Baud,5706,139,5845
53,Bretagne,56,3,01,011,Béganne,1404,31,1435
53,Bretagne,56,3,13,012,Beignon,1577,35,1612
53,Bretagne,56,1,04,013,Belz,3456,85,3541
53,Bretagne,56,2,07,014,Berné,1443,181,1624
53,Bretagne,56,3,29,015,Berric,1494,20,1514
53,Bretagne,56,2,03,016,Bieuzy,743,25,768
53,Bretagne,56,2,34,017,Bignan,2665,73,2738
53,Bretagne,56,3,21,018,Billiers,922,20,942
53,Bretagne,56,2,34,019,Billio,373,4,377
53,Bretagne,56,3,19,020,Bohal,750,21,771
53,Bretagne,56,1,02,262,Bono,2199,68,2267
53,Bretagne,56,1,14,021,Brandérion,1079,21,1100
53,Bretagne,56,3,10,022,Brandivy,1116,36,1152
53,Bretagne,56,1,25,023,Brech,6363,254,6617
53,Bretagne,56,2,33,024,Bréhan,2307,64,2371
53,Bretagne,56,3,20,025,Brignac,194,8,202
53,Bretagne,56,1,24,026,Bubry,2349,50,2399
53,Bretagne,56,2,34,027,Buléon,459,6,465
53,Bretagne,56,3,32,028,Caden,1576,15,1591
53,Bretagne,56,1,24,029,Calan,848,20,868
53,Bretagne,56,3,31,030,Camoël,831,16,847
53,Bretagne,56,1,25,031,Camors,2753,66,2819
53,Bretagne,56,3,23,032,Campénéac,1714,54,1768
53,Bretagne,56,3,08,033,Carentoir,2733,54,2787
53,Bretagne,56,1,30,034,Carnac,4428,138,4566
53,Bretagne,56,3,19,035,Caro,1146,47,1193
53,Bretagne,56,1,27,036,Caudan,6839,197,7036
53,Bretagne,56,3,19,037,La Chapelle-Caro,1305,22,1327
53,Bretagne,56,3,08,038,La Chapelle-Gaceline,662,21,683
53,Bretagne,56,2,16,039,La Chapelle-Neuve,747,20,767
53,Bretagne,56,1,27,040,Cléguer,3306,78,3384
53,Bretagne,56,2,05,041,Cléguérec,2871,85,2956
53,Bretagne,56,3,10,042,Colpo,2193,32,2225
53,Bretagne,56,3,20,043,Concoret,777,8,785
53,Bretagne,56,3,08,044,Cournon,729,17,746
53,Bretagne,56,3,29,045,Le Cours,544,3,547
53,Bretagne,56,1,02,046,Crach,3269,88,3357
53,Bretagne,56,2,33,047,Crédin,1452,23,1475
53,Bretagne,56,2,12,048,Le Croisty,694,32,726
53,Bretagne,56,2,15,050,La Croix-Helléan,784,25,809
53,Bretagne,56,2,26,049,Croixanvec,156,3,159
53,Bretagne,56,2,15,051,Cruguel,633,2,635
53,Bretagne,56,3,21,052,Damgan,1523,38,1561
53,Bretagne,56,3,06,053,Elven,4801,132,4933
53,Bretagne,56,1,04,054,Erdeven,3315,87,3402
53,Bretagne,56,1,04,055,Étel,2052,156,2208
53,Bretagne,56,3,36,056,Évriguet,180,9,189
53,Bretagne,56,2,07,057,Le Faouët,2917,118,3035
53,Bretagne,56,3,31,058,Férel,2769,63,2832
53,Bretagne,56,2,15,059,Les Forges,419,10,429
53,Bretagne,56,3,08,060,Les Fougerêts,928,20,948
53,Bretagne,56,3,08,061,La Gacilly,2263,56,2319
53,Bretagne,56,1,28,062,Gâvres,772,16,788
53,Bretagne,56,1,27,063,Gestel,2571,67,2638
53,Bretagne,56,3,08,064,Glénac,842,21,863
53,Bretagne,56,3,23,065,Gourhel,548,25,573
53,Bretagne,56,2,09,066,Gourin,4125,174,4299
53,Bretagne,56,3,10,067,Grand-Champ,4817,116,4933
53,Bretagne,56,2,15,068,La Grée-Saint-Laurent,335,6,341
53,Bretagne,56,1,11,069,Groix,2318,87,2405
53,Bretagne,56,2,15,070,Guégon,2395,37,2432
53,Bretagne,56,2,34,071,Guéhenno,801,14,815
53,Bretagne,56,2,26,072,Gueltas,519,25,544
53,Bretagne,56,2,12,073,Guémené-sur-Scorff,1238,25,1263
53,Bretagne,56,2,03,074,Guénin,1444,18,1462
53,Bretagne,56,3,13,075,Guer,6240,259,6499
53,Bretagne,56,2,26,076,Guern,1458,35,1493
53,Bretagne,56,3,21,077,Le Guerno,779,15,794
53,Bretagne,56,1,27,078,Guidel,10073,350,10423
53,Bretagne,56,2,15,079,Guillac,1252,44,1296
53,Bretagne,56,3,36,080,Guilliers,1308,107,1415
53,Bretagne,56,2,07,081,Guiscriff,2333,61,2394
53,Bretagne,56,2,15,082,Helléan,319,6,325
53,Bretagne,56,1,14,083,Hennebont,14624,381,15005
53,Bretagne,56,3,37,084,Le Hézo,692,17,709
53,Bretagne,56,1,30,085,Hoedic,118,5,123
53,Bretagne,56,3,38,087,Île-aux-Moines,573,11,584
53,Bretagne,56,3,38,088,Île-d'Arz,254,4,258
53,Bretagne,56,1,30,086,Île-d'Houat,274,15,289
53,Bretagne,56,1,24,089,Inguiniel,2057,40,2097
53,Bretagne,56,1,14,090,Inzinzac-Lochrist,5837,158,5995
53,Bretagne,56,2,15,091,Josselin,2604,91,2695
53,Bretagne,56,2,26,092,Kerfourn,813,15,828
53,Bretagne,56,2,05,093,Kergrist,650,19,669
53,Bretagne,56,2,12,264,Kernascléden,395,11,406
53,Bretagne,56,1,28,094,Kervignac,5438,197,5635
53,Bretagne,56,1,25,096,Landaul,1848,30,1878
53,Bretagne,56,1,25,097,Landévant,2882,71,2953
53,Bretagne,56,1,40,098,Lanester,22490,609,23099
53,Bretagne,56,2,12,099,Langoëlan,410,10,420
53,Bretagne,56,2,09,100,Langonnet,1922,63,1985
53,Bretagne,56,1,14,101,Languidic,7328,227,7555
53,Bretagne,56,2,15,102,Lanouée,1676,28,1704
53,Bretagne,56,2,33,103,Lantillac,303,3,306
53,Bretagne,56,1,24,104,Lanvaudan,707,16,723
53,Bretagne,56,2,07,105,Lanvénégen,1206,23,1229
53,Bretagne,56,3,38,106,Larmor-Baden,816,17,833
53,Bretagne,56,1,42,107,Larmor-Plage,8397,345,8742
53,Bretagne,56,3,29,108,Larré,773,31,804
53,Bretagne,56,3,29,109,Lauzach,898,20,918
53,Bretagne,56,2,12,110,Lignol,904,26,930
53,Bretagne,56,3,32,111,Limerzel,1267,27,1294
53,Bretagne,56,3,19,112,Lizio,665,22,687
53,Bretagne,56,2,12,113,Locmalo,834,22,856
53,Bretagne,56,1,22,114,Locmaria,795,26,821
53,Bretagne,56,3,10,115,Locmaria-Grand-Champ,1143,16,1159
53,Bretagne,56,1,02,116,Locmariaquer,1674,38,1712
53,Bretagne,56,2,16,117,Locminé,4034,241,4275
53,Bretagne,56,1,28,118,Locmiquélic,4178,82,4260
53,Bretagne,56,1,04,119,Locoal-Mendon,3113,75,3188
53,Bretagne,56,3,10,120,Locqueltas,1551,30,1581
53,Bretagne,56,1,98,121,Lorient,58148,1682,59830
53,Bretagne,56,3,23,122,Loyat,1475,46,1521
53,Bretagne,56,3,32,123,Malansac,2032,51,2083
53,Bretagne,56,3,19,124,Malestroit,2480,128,2608
53,Bretagne,56,2,05,125,Malguénac,1736,63,1799
53,Bretagne,56,3,31,126,Marzan,1891,41,1932
53,Bretagne,56,3,20,127,Mauron,3185,80,3265
53,Bretagne,56,2,03,128,Melrand,1507,47,1554
53,Bretagne,56,3,36,129,Ménéac,1668,38,1706
53,Bretagne,56,1,28,130,Merlevenez,2966,68,3034
53,Bretagne,56,2,07,131,Meslan,1291,29,1320
53,Bretagne,56,3,10,132,Meucon,2104,55,2159
53,Bretagne,56,3,19,133,Missiriac,1083,37,1120
53,Bretagne,56,3,36,134,Mohon,969,23,992
53,Bretagne,56,3,29,135,Molac,1251,25,1276
53,Bretagne,56,3,13,136,Monteneuf,711,11,722
53,Bretagne,56,3,06,137,Monterblanc,2754,52,2806
53,Bretagne,56,3,19,138,Monterrein,365,5,370
53,Bretagne,56,3,23,139,Montertelot,336,8,344
53,Bretagne,56,2,16,140,Moréac,3564,67,3631
53,Bretagne,56,2,16,141,Moustoir-Ac,1678,32,1710
53,Bretagne,56,2,16,142,Moustoir-Remungol,615,23,638
53,Bretagne,56,3,21,143,Muzillac,4530,112,4642
53,Bretagne,56,2,16,144,Naizin,1676,36,1712
53,Bretagne,56,3,20,145,Néant-sur-Yvel,971,27,998
53,Bretagne,56,2,05,146,Neulliac,1525,41,1566
53,Bretagne,56,3,31,147,Nivillac,3906,115,4021
53,Bretagne,56,1,28,148,Nostang,1288,31,1319
53,Bretagne,56,3,21,149,Noyal-Muzillac,2340,43,2383
53,Bretagne,56,2,26,151,Noyal-Pontivy,3637,117,3754
53,Bretagne,56,3,37,150,Noyalo,738,28,766
53,Bretagne,56,1,22,152,Le Palais,2538,73,2611
53,Bretagne,56,3,29,153,Péaule,2482,45,2527
53,Bretagne,56,3,01,154,Peillac,1815,50,1865
53,Bretagne,56,3,31,155,Pénestin,1849,42,1891
53,Bretagne,56,2,12,156,Persquen,329,10,339
53,Bretagne,56,3,10,157,Plaudren,1633,51,1684
53,Bretagne,56,3,10,158,Plescop,4664,129,4793
53,Bretagne,56,3,29,159,Pleucadeuc,1799,50,1849
53,Bretagne,56,2,33,160,Pleugriffet,1216,36,1252
53,Bretagne,56,1,04,161,Ploemel,2468,53,2521
53,Bretagne,56,1,42,162,Ploemeur,18194,846,19040
53,Bretagne,56,2,12,163,Ploërdut,1271,57,1328
53,Bretagne,56,3,38,164,Ploeren,5703,180,5883
53,Bretagne,56,3,23,165,Ploërmel,8790,535,9325
53,Bretagne,56,1,24,166,Plouay,5260,161,5421
53,Bretagne,56,1,02,167,Plougoumelen,2351,65,2416
53,Bretagne,56,1,30,168,Plouharnel,1962,42,2004
53,Bretagne,56,1,28,169,Plouhinec,4832,124,4956
53,Bretagne,56,2,09,170,Plouray,1107,27,1134
53,Bretagne,56,3,32,171,Pluherlin,1309,30,1339
53,Bretagne,56,2,34,172,Plumelec,2602,52,2654
53,Bretagne,56,2,03,173,Pluméliau,3505,107,3612
53,Bretagne,56,2,16,174,Plumelin,2372,52,2424
53,Bretagne,56,1,02,175,Plumergat,3322,94,3416
53,Bretagne,56,1,02,176,Pluneret,4958,141,5099
53,Bretagne,56,1,25,177,Pluvigner,6829,170,6999
53,Bretagne,56,1,27,179,Pont-Scorff,3123,87,3210
53,Bretagne,56,2,26,178,Pontivy,13693,1002,14695
53,Bretagne,56,3,13,180,Porcaro,645,16,661
53,Bretagne,56,1,28,181,Port-Louis,2898,92,2990
53,Bretagne,56,2,07,182,Priziac,1042,213,1255
53,Bretagne,56,3,08,183,Quelneuc,545,3,548
53,Bretagne,56,3,29,184,Questembert,6870,290,7160
53,Bretagne,56,1,27,185,Quéven,8762,281,9043
53,Bretagne,56,1,30,186,Quiberon,5049,149,5198
53,Bretagne,56,2,15,187,Quily,324,5,329
53,Bretagne,56,1,24,188,Quistinic,1375,27,1402
53,Bretagne,56,2,33,189,Radenac,964,6,970
53,Bretagne,56,2,33,190,Réguiny,1761,23,1784
53,Bretagne,56,3,13,191,Réminiac,349,7,356
53,Bretagne,56,2,16,192,Remungol,950,28,978
53,Bretagne,56,1,28,193,Riantec,5018,155,5173
53,Bretagne,56,3,01,194,Rieux,2840,108,2948
53,Bretagne,56,3,19,197,Le Roc-Saint-André,922,18,940
53,Bretagne,56,3,31,195,La Roche-Bernard,749,23,772
53,Bretagne,56,3,32,196,Rochefort-en-Terre,686,15,701
53,Bretagne,56,2,33,198,Rohan,1612,60,1672
53,Bretagne,56,2,09,199,Roudouallec,711,16,727
53,Bretagne,56,3,19,200,Ruffiac,1401,48,1449
53,Bretagne,56,2,09,201,Le Saint,664,19,683
53,Bretagne,56,3,19,202,Saint-Abraham,542,19,561
53,Bretagne,56,2,05,203,Saint-Aignan,667,22,689
53,Bretagne,56,2,34,204,Saint-Allouestre,633,11,644
53,Bretagne,56,3,35,205,Saint-Armel,821,28,849
53,Bretagne,56,3,37,206,Saint-Avé,10106,292,10398
53,Bretagne,56,2,03,207,Saint-Barthélemy,1118,8,1126
53,Bretagne,56,3,20,208,Saint-Brieuc-de-Mauron,340,3,343
53,Bretagne,56,2,12,210,Saint-Caradec-Trégomel,483,7,490
53,Bretagne,56,3,32,211,Saint-Congard,729,19,748
53,Bretagne,56,3,31,212,Saint-Dolay,2201,49,2250
53,Bretagne,56,2,26,213,Saint-Gérand,998,28,1026
53,Bretagne,56,3,35,214,Saint-Gildas-de-Rhuys,1649,38,1687
53,Bretagne,56,2,26,215,Saint-Gonnery,1046,33,1079
53,Bretagne,56,3,01,216,Saint-Gorgon,322,9,331
53,Bretagne,56,3,32,218,Saint-Gravé,714,23,737
53,Bretagne,56,3,19,219,Saint-Guyomard,1023,19,1042
53,Bretagne,56,3,01,221,Saint-Jacut-les-Pins,1721,84,1805
53,Bretagne,56,2,34,222,Saint-Jean-Brévelay,2659,141,2800
53,Bretagne,56,3,01,223,Saint-Jean-la-Poterie,1492,60,1552
53,Bretagne,56,3,32,224,Saint-Laurent-sur-Oust,345,9,354
53,Bretagne,56,3,20,225,Saint-Léry,178,7,185
53,Bretagne,56,3,13,226,Saint-Malo-de-Beignon,591,137,728
53,Bretagne,56,3,36,227,Saint-Malo-des-Trois-Fontaines,559,12,571
53,Bretagne,56,3,19,228,Saint-Marcel,1009,29,1038
53,Bretagne,56,3,08,229,Saint-Martin-sur-Oust,1264,38,1302
53,Bretagne,56,3,19,230,Saint-Nicolas-du-Tertre,444,12,456
53,Bretagne,56,3,06,231,Saint-Nolff,3641,130,3771
53,Bretagne,56,3,01,232,Saint-Perreux,1148,50,1198
53,Bretagne,56,1,02,233,Saint-Philibert,1477,29,1506
53,Bretagne,56,1,30,234,Saint-Pierre-Quiberon,2229,71,2300
53,Bretagne,56,2,15,236,Saint-Servant,784,30,814
53,Bretagne,56,2,26,237,Saint-Thuriau,1897,72,1969
53,Bretagne,56,2,12,238,Saint-Tugdual,397,6,403
53,Bretagne,56,3,01,239,Saint-Vincent-sur-Oust,1332,31,1363
53,Bretagne,56,1,02,263,Sainte-Anne-d'Auray,2260,45,2305
53,Bretagne,56,2,05,209,Sainte-Brigitte,162,5,167
53,Bretagne,56,1,28,220,Sainte-Hélène,1098,22,1120
53,Bretagne,56,3,35,240,Sarzeau,7494,177,7671
53,Bretagne,56,1,22,241,Sauzon,877,19,896
53,Bretagne,56,2,05,242,Séglien,716,23,739
53,Bretagne,56,3,37,243,Séné,8126,309,8435
53,Bretagne,56,3,19,244,Sérent,2962,39,3001
53,Bretagne,56,2,05,245,Silfiac,458,9,467
53,Bretagne,56,2,26,246,Le Sourn,2023,74,2097
53,Bretagne,56,3,06,247,Sulniac,3059,100,3159
53,Bretagne,56,3,37,248,Surzur,3448,75,3523
53,Bretagne,56,3,23,249,Taupont,2119,94,2213
53,Bretagne,56,3,31,250,Théhillac,519,14,533
53,Bretagne,56,3,37,251,Theix,6794,185,6979
53,Bretagne,56,3,35,252,Le Tour-du-Parc,1064,31,1095
53,Bretagne,56,3,08,253,Tréal,653,20,673
53,Bretagne,56,3,06,254,Trédion,1047,28,1075
53,Bretagne,56,3,06,255,Treffléan,1961,39,2000
53,Bretagne,56,3,20,256,Tréhorenteuc,110,1,111
53,Bretagne,56,3,36,257,La Trinité-Porhoët,767,12,779
53,Bretagne,56,1,30,258,La Trinité-sur-Mer,1613,42,1655
53,Bretagne,56,3,37,259,La Trinité-Surzur,1091,16,1107
53,Bretagne,56,3,99,260,Vannes,52983,2511,55494
53,Bretagne,56,3,06,261,La Vraie-Croix,1318,25,1343
41,Lorraine,57,7,21,001,Aboncourt,367,6,373
41,Lorraine,57,2,06,002,Aboncourt-sur-Seille,70,1,71
41,Lorraine,57,5,16,003,Abreschviller,1510,32,1542
41,Lorraine,57,2,06,004,Achain,89,2,91
41,Lorraine,57,6,26,006,Achen,998,16,1014
41,Lorraine,57,1,09,007,Adaincourt,117,6,123
41,Lorraine,57,1,09,008,Adelange,231,5,236
41,Lorraine,57,2,07,009,Ajoncourt,100,1,101
41,Lorraine,57,2,07,010,Alaincourt-la-Côte,133,4,137
41,Lorraine,57,2,01,011,Albestroff,653,30,683
41,Lorraine,57,8,44,012,Algrange,6360,79,6439
41,Lorraine,57,3,51,013,Alsting,2705,50,2755
41,Lorraine,57,3,14,014,Altrippe,430,8,438
41,Lorraine,57,3,27,015,Altviller,564,29,593
41,Lorraine,57,1,04,016,Alzing,460,9,469
41,Lorraine,57,4,48,017,Amanvillers,2139,25,2164
41,Lorraine,57,2,06,018,Amelécourt,144,0,144
41,Lorraine,57,4,42,019,Amnéville,10129,79,10208
41,Lorraine,57,4,23,020,Ancerville,279,3,282
41,Lorraine,57,4,13,021,Ancy-sur-Moselle,1421,36,1457
41,Lorraine,57,8,11,022,Angevillers,1271,29,1300
41,Lorraine,57,4,35,024,Antilly,116,2,118
41,Lorraine,57,1,04,025,Anzeling,478,11,489
41,Lorraine,57,7,31,026,Apach,942,18,960
41,Lorraine,57,4,35,028,Argancy,1326,32,1358
41,Lorraine,57,1,09,027,Arraincourt,124,0,124
41,Lorraine,57,1,09,029,Arriance,230,8,238
41,Lorraine,57,4,13,030,Arry,478,1,479
41,Lorraine,57,4,23,031,Ars-Laquenexy,884,21,905
41,Lorraine,57,4,13,032,Ars-sur-Moselle,4731,50,4781
41,Lorraine,57,5,24,033,Arzviller,527,9,536
41,Lorraine,57,5,16,034,Aspach,44,0,44
41,Lorraine,57,5,25,035,Assenoncourt,139,5,144
41,Lorraine,57,2,06,036,Attilloncourt,101,2,103
41,Lorraine,57,4,23,037,Aube,254,3,257
41,Lorraine,57,8,11,038,Audun-le-Tiche,6008,81,6089
41,Lorraine,57,4,20,039,Augny,2324,43,2367
41,Lorraine,57,2,07,040,Aulnois-sur-Seille,244,9,253
41,Lorraine,57,8,11,041,Aumetz,2289,46,2335
41,Lorraine,57,5,25,042,Avricourt,674,12,686
41,Lorraine,57,4,35,043,Ay-sur-Moselle,1582,27,1609
41,Lorraine,57,5,25,044,Azoudange,115,4,119
41,Lorraine,57,2,07,045,Bacourt,116,6,122
41,Lorraine,57,6,02,046,Baerenthal,720,7,727
41,Lorraine,57,1,09,047,Bambiderstroff,1017,18,1035
41,Lorraine,57,4,37,049,Le Ban-Saint-Martin,4376,91,4467
41,Lorraine,57,1,03,048,Bannay,79,2,81
41,Lorraine,57,5,29,050,Barchain,108,3,111
41,Lorraine,57,3,14,051,Baronville,395,6,401
41,Lorraine,57,3,41,052,Barst,554,11,565
41,Lorraine,57,7,21,287,Basse-Ham,2168,38,2206
41,Lorraine,57,7,05,574,Basse-Rentgen,344,8,352
41,Lorraine,57,2,08,053,Bassing,136,6,142
41,Lorraine,57,2,07,054,Baudrecourt,177,1,178
41,Lorraine,57,4,23,055,Bazoncourt,487,11,498
41,Lorraine,57,5,29,056,Bébing,169,9,178
41,Lorraine,57,4,23,057,Béchy,532,2,534
41,Lorraine,57,3,47,058,Behren-lès-Forbach,8514,152,8666
41,Lorraine,57,2,06,059,Bellange,55,2,57
41,Lorraine,57,5,10,086,Belles-Forêts,255,5,260
41,Lorraine,57,2,01,060,Bénestroff,504,19,523
41,Lorraine,57,3,41,061,Béning-lès-Saint-Avold,1229,26,1255
41,Lorraine,57,7,05,062,Berg-sur-Moselle,419,14,433
41,Lorraine,57,3,14,063,Bérig-Vintrange,235,2,237
41,Lorraine,57,5,24,064,Berling,293,7,300
41,Lorraine,57,2,01,065,Bermering,242,1,243
41,Lorraine,57,5,10,066,Berthelming,513,16,529
41,Lorraine,57,7,21,067,Bertrange,2457,36,2493
41,Lorraine,57,1,04,069,Berviller-en-Moselle,486,6,492
41,Lorraine,57,1,03,070,Bettange,212,3,215
41,Lorraine,57,5,10,071,Bettborn,416,9,425
41,Lorraine,57,7,21,072,Bettelainville,609,7,616
41,Lorraine,57,3,41,073,Betting,885,25,910
41,Lorraine,57,6,26,074,Bettviller,842,17,859
41,Lorraine,57,4,23,075,Beux,255,3,258
41,Lorraine,57,7,05,076,Beyren-lès-Sierck,472,16,488
41,Lorraine,57,2,34,077,Bezange-la-Petite,91,0,91
41,Lorraine,57,1,04,079,Bibiche,430,7,437
41,Lorraine,57,5,10,080,Bickenholtz,73,3,76
41,Lorraine,57,2,08,081,Bidestroff,130,7,137
41,Lorraine,57,3,14,082,Biding,317,7,324
41,Lorraine,57,6,26,083,Bining,1193,30,1223
41,Lorraine,57,2,06,084,Bioncourt,309,6,315
41,Lorraine,57,1,03,085,Bionville-sur-Nied,367,5,372
41,Lorraine,57,1,03,087,Bisten-en-Lorraine,273,10,283
41,Lorraine,57,3,14,088,Bistroff,340,3,343
41,Lorraine,57,6,02,089,Bitche,5485,280,5765
41,Lorraine,57,2,08,090,Blanche-Église,144,4,148
41,Lorraine,57,6,50,092,Blies-Ébersing,578,6,584
41,Lorraine,57,6,50,093,Blies-Guersviller,602,23,625
41,Lorraine,57,6,50,091,Bliesbruck,1009,18,1027
41,Lorraine,57,1,03,095,Boucheporn,557,15,572
41,Lorraine,57,8,11,096,Boulange,2255,33,2288
41,Lorraine,57,1,03,097,Boulay-Moselle,4822,103,4925
41,Lorraine,57,2,34,099,Bourdonnay,258,4,262
41,Lorraine,57,2,08,098,Bourgaltroff,281,7,288
41,Lorraine,57,5,24,100,Bourscheid,206,1,207
41,Lorraine,57,3,47,101,Bousbach,1134,30,1164
41,Lorraine,57,7,21,102,Bousse,2813,31,2844
41,Lorraine,57,6,36,103,Bousseviller,136,5,141
41,Lorraine,57,7,05,104,Boust,1035,17,1052
41,Lorraine,57,3,14,105,Boustroff,148,5,153
41,Lorraine,57,1,04,106,Bouzonville,4183,106,4289
41,Lorraine,57,2,07,107,Bréhain,99,4,103
41,Lorraine,57,6,36,108,Breidenbach,363,13,376
41,Lorraine,57,7,05,109,Breistroff-la-Grande,564,11,575
41,Lorraine,57,1,04,110,Brettnach,418,5,423
41,Lorraine,57,4,48,111,Bronvaux,544,11,555
41,Lorraine,57,1,03,112,Brouck,71,3,74
41,Lorraine,57,5,29,113,Brouderdorff,923,15,938
41,Lorraine,57,5,24,114,Brouviller,443,14,457
41,Lorraine,57,3,14,115,Brulange,106,2,108
41,Lorraine,57,4,33,116,Buchy,112,0,112
41,Lorraine,57,7,21,117,Buding,488,5,493
41,Lorraine,57,7,21,118,Budling,168,4,172
41,Lorraine,57,5,29,119,Buhl-Lorraine,1158,32,1190
41,Lorraine,57,2,06,120,Burlioncourt,177,1,178
41,Lorraine,57,4,35,121,Burtoncourt,192,2,194
41,Lorraine,57,3,41,122,Cappel,681,18,699
41,Lorraine,57,3,49,123,Carling,3721,74,3795
41,Lorraine,57,7,05,124,Cattenom,2594,35,2629
41,Lorraine,57,4,35,125,Chailly-lès-Ennery,357,3,360
41,Lorraine,57,2,06,126,Chambrey,347,6,353
41,Lorraine,57,4,23,127,Chanville,122,1,123
41,Lorraine,57,4,35,128,Charleville-sous-Bois,274,4,278
41,Lorraine,57,4,35,129,Charly-Oradour,636,24,660
41,Lorraine,57,2,07,130,Château-Bréhain,73,1,74
41,Lorraine,57,1,04,131,Château-Rouge,222,2,224
41,Lorraine,57,2,06,132,Château-Salins,2502,219,2721
41,Lorraine,57,2,06,133,Château-Voué,115,1,116
41,Lorraine,57,4,13,134,Châtel-Saint-Germain,2246,55,2301
41,Lorraine,57,1,04,136,Chémery-les-Deux,444,16,460
41,Lorraine,57,4,33,137,Cheminot,644,10,654
41,Lorraine,57,2,07,138,Chenois,60,1,61
41,Lorraine,57,4,33,139,Chérisey,281,7,288
41,Lorraine,57,4,33,140,Chesny,489,10,499
41,Lorraine,57,2,07,141,Chicourt,96,2,98
41,Lorraine,57,4,20,142,Chieulles,376,5,381
41,Lorraine,57,8,22,143,Clouange,3904,29,3933
41,Lorraine,57,3,47,144,Cocheren,3439,54,3493
41,Lorraine,57,4,33,146,Coin-lès-Cuvry,725,14,739
41,Lorraine,57,4,33,147,Coin-sur-Seille,295,9,304
41,Lorraine,57,4,23,145,Coincy,309,4,313
41,Lorraine,57,4,23,148,Colligny,307,2,309
41,Lorraine,57,1,04,149,Colmen,217,6,223
41,Lorraine,57,1,03,150,Condé-Northen,593,6,599
41,Lorraine,57,2,06,151,Conthil,177,3,180
41,Lorraine,57,7,31,152,Contz-les-Bains,502,4,506
41,Lorraine,57,4,13,153,Corny-sur-Moselle,2176,35,2211
41,Lorraine,57,1,03,154,Coume,659,8,667
41,Lorraine,57,4,23,155,Courcelles-Chaussy,2974,200,3174
41,Lorraine,57,4,23,156,Courcelles-sur-Nied,940,20,960
41,Lorraine,57,2,07,158,Craincourt,267,2,269
41,Lorraine,57,1,09,159,Créhange,3977,46,4023
41,Lorraine,57,1,04,160,Creutzwald,13367,295,13662
41,Lorraine,57,2,08,161,Cutting,125,4,129
41,Lorraine,57,4,33,162,Cuvry,759,46,805
41,Lorraine,57,5,24,163,Dabo,2648,75,2723
41,Lorraine,57,1,04,165,Dalem,653,11,664
41,Lorraine,57,2,06,166,Dalhain,112,4,116
41,Lorraine,57,1,04,167,Dalstein,329,6,335
41,Lorraine,57,5,24,168,Danne-et-Quatre-Vents,622,15,637
41,Lorraine,57,5,24,169,Dannelbourg,474,16,490
41,Lorraine,57,2,07,171,Delme,915,15,930
41,Lorraine,57,1,03,172,Denting,210,4,214
41,Lorraine,57,5,10,173,Desseling,107,3,110
41,Lorraine,57,3,14,174,Destry,95,0,95
41,Lorraine,57,5,29,175,Diane-Capelle,222,6,228
41,Lorraine,57,3,47,176,Diebling,1636,49,1685
41,Lorraine,57,3,27,765,Diesen,1105,17,1122
41,Lorraine,57,2,08,177,Dieuze,3782,267,4049
41,Lorraine,57,3,14,178,Diffembach-lès-Hellimer,368,9,377
41,Lorraine,57,7,21,179,Distroff,1541,26,1567
41,Lorraine,57,5,10,180,Dolving,353,10,363
41,Lorraine,57,2,08,181,Domnom-lès-Dieuze,105,2,107
41,Lorraine,57,2,07,182,Donjeux,104,2,106
41,Lorraine,57,2,34,183,Donnelay,200,10,210
41,Lorraine,57,4,13,184,Dornot,192,2,194
41,Lorraine,57,1,04,186,Ébersviller,824,12,836
41,Lorraine,57,1,03,187,Éblange,311,3,314
41,Lorraine,57,6,02,188,Éguelshardt,438,130,568
41,Lorraine,57,3,14,189,Eincheville,200,1,201
41,Lorraine,57,1,09,190,Elvange,378,5,383
41,Lorraine,57,7,21,191,Elzange,772,11,783
41,Lorraine,57,6,26,192,Enchenberg,1217,28,1245
41,Lorraine,57,4,35,193,Ennery,1660,27,1687
41,Lorraine,57,7,05,194,Entrange,1311,27,1338
41,Lorraine,57,6,36,195,Epping,568,8,576
41,Lorraine,57,6,36,196,Erching,436,4,440
41,Lorraine,57,6,28,197,Ernestviller,526,6,532
41,Lorraine,57,3,14,198,Erstroff,199,2,201
41,Lorraine,57,7,05,199,Escherange,581,9,590
41,Lorraine,57,4,35,200,Les Étangs,420,6,426
41,Lorraine,57,6,26,201,Etting,769,16,785
41,Lorraine,57,3,51,202,Etzling,1150,22,1172
41,Lorraine,57,7,05,203,Évrange,203,3,206
41,Lorraine,57,4,35,204,Failly,565,13,578
41,Lorraine,57,1,04,205,Falck,2586,46,2632
41,Lorraine,57,8,45,206,Fameck,12196,174,12370
41,Lorraine,57,3,41,207,Farébersviller,5935,100,6035
41,Lorraine,57,3,47,208,Farschviller,1521,19,1540
41,Lorraine,57,1,09,209,Faulquemont,5507,72,5579
41,Lorraine,57,5,10,210,Fénétrange,715,14,729
41,Lorraine,57,4,48,211,Fèves,923,10,933
41,Lorraine,57,4,33,212,Féy,596,18,614
41,Lorraine,57,1,04,213,Filstroff,863,14,877
41,Lorraine,57,7,05,214,Fixem,380,11,391
41,Lorraine,57,7,31,215,Flastroff,304,10,314
41,Lorraine,57,5,10,216,Fleisheim,112,1,113
41,Lorraine,57,1,09,217,Flétrange,874,17,891
41,Lorraine,57,4,33,218,Fleury,1045,29,1074
41,Lorraine,57,4,35,219,Flévy,571,5,576
41,Lorraine,57,4,23,220,Flocourt,127,6,133
41,Lorraine,57,8,39,221,Florange,10916,124,11040
41,Lorraine,57,3,47,222,Folkling,1384,53,1437
41,Lorraine,57,3,27,224,Folschviller,4267,72,4339
41,Lorraine,57,2,07,225,Fonteny,120,1,121
41,Lorraine,57,8,11,226,Fontoy,3105,56,3161
41,Lorraine,57,3,98,227,Forbach,21752,424,22176
41,Lorraine,57,2,07,228,Fossieux,161,1,162
41,Lorraine,57,5,25,229,Foulcrey,188,6,194
41,Lorraine,57,1,09,230,Fouligny,203,2,205
41,Lorraine,57,4,33,231,Foville,87,0,87
41,Lorraine,57,2,01,232,Francaltroff,746,17,763
41,Lorraine,57,5,16,233,Fraquelfing,91,0,91
41,Lorraine,57,6,50,234,Frauenberg,550,8,558
41,Lorraine,57,1,04,235,Freistroff,1056,16,1072
41,Lorraine,57,2,07,236,Frémery,62,2,64
41,Lorraine,57,3,14,237,Frémestroff,294,9,303
41,Lorraine,57,2,06,238,Fresnes-en-Saulnois,181,5,186
41,Lorraine,57,3,14,239,Freybouse,391,10,401
41,Lorraine,57,3,41,240,Freyming-Merlebach,13172,209,13381
41,Lorraine,57,5,25,241,Fribourg,171,1,172
41,Lorraine,57,8,22,242,Gandrange,2749,27,2776
41,Lorraine,57,5,24,244,Garrebourg,510,3,513
41,Lorraine,57,7,05,245,Gavisse,590,12,602
41,Lorraine,57,2,08,246,Gelucourt,238,7,245
41,Lorraine,57,2,06,247,Gerbécourt,108,4,112
41,Lorraine,57,2,01,248,Givrycourt,103,1,104
41,Lorraine,57,4,35,249,Glatigny,282,4,286
41,Lorraine,57,6,02,250,Goetzenbruck,1703,28,1731
41,Lorraine,57,4,33,251,Goin,323,4,327
41,Lorraine,57,1,03,252,Gomelange,544,10,554
41,Lorraine,57,5,25,253,Gondrexange,475,17,492
41,Lorraine,57,4,13,254,Gorze,1242,11,1253
41,Lorraine,57,5,10,255,Gosselming,619,25,644
41,Lorraine,57,4,13,256,Gravelotte,697,7,704
41,Lorraine,57,2,06,257,Grémecey,102,0,102
41,Lorraine,57,3,14,258,Gréning,142,3,145
41,Lorraine,57,7,31,259,Grindorff-Bizing,327,7,334
41,Lorraine,57,6,26,261,Gros-Réderching,1345,24,1369
41,Lorraine,57,6,50,260,Grosbliederstroff,3301,51,3352
41,Lorraine,57,3,14,262,Grostenquin,549,23,572
41,Lorraine,57,6,50,263,Grundviller,670,12,682
41,Lorraine,57,6,50,264,Guebenhouse,412,8,420
41,Lorraine,57,2,08,265,Guébestroff,58,0,58
41,Lorraine,57,2,08,266,Guéblange-lès-Dieuze,169,2,171
41,Lorraine,57,2,08,268,Guébling,142,5,147
41,Lorraine,57,7,21,269,Guénange,7118,156,7274
41,Lorraine,57,3,41,271,Guenviller,673,19,692
41,Lorraine,57,5,25,272,Guermange,90,6,96
41,Lorraine,57,1,04,273,Guerstling,384,3,387
41,Lorraine,57,1,03,274,Guerting,884,16,900
41,Lorraine,57,3,14,275,Guessling-Hémering,894,24,918
41,Lorraine,57,1,09,276,Guinglange,294,4,298
41,Lorraine,57,1,03,277,Guinkirchen,191,3,194
41,Lorraine,57,2,01,278,Guinzeling,77,0,77
41,Lorraine,57,5,24,280,Guntzviller,364,5,369
41,Lorraine,57,2,06,281,Haboudange,267,2,269
41,Lorraine,57,7,05,282,Hagen,208,4,212
41,Lorraine,57,4,43,283,Hagondange,9275,135,9410
41,Lorraine,57,1,09,284,Hallering,116,1,117
41,Lorraine,57,7,31,286,Halstroff,282,3,285
41,Lorraine,57,1,03,288,Ham-sous-Varsberg,2767,65,2832
41,Lorraine,57,6,50,289,Hambach,2719,55,2774
41,Lorraine,57,2,06,290,Hampont,204,2,206
41,Lorraine,57,1,09,293,Han-sur-Nied,245,4,249
41,Lorraine,57,5,24,291,Hangviller,276,6,282
41,Lorraine,57,2,07,292,Hannocourt,14,0,14
41,Lorraine,57,6,02,294,Hanviller,258,6,264
41,Lorraine,57,2,06,295,Haraucourt-sur-Seille,121,4,125
41,Lorraine,57,1,04,296,Hargarten-aux-Mines,1135,26,1161
41,Lorraine,57,3,14,297,Harprich,195,4,199
41,Lorraine,57,5,29,298,Harreberg,385,8,393
41,Lorraine,57,5,29,299,Hartzviller,914,18,932
41,Lorraine,57,5,24,300,Haselbourg,320,9,329
41,Lorraine,57,6,02,301,Haspelschiedt,288,6,294
41,Lorraine,57,5,16,302,Hattigny,202,0,202
41,Lorraine,57,4,43,303,Hauconcourt,542,5,547
41,Lorraine,57,5,29,304,Haut-Clocher,333,16,349
41,Lorraine,57,7,31,371,Haute-Kontz,520,10,530
41,Lorraine,57,1,09,714,Haute-Vigneulles,437,6,443
41,Lorraine,57,8,11,305,Havange,445,11,456
41,Lorraine,57,8,15,306,Hayange,15374,209,15583
41,Lorraine,57,4,35,307,Hayes,203,3,206
41,Lorraine,57,6,28,308,Hazembourg,115,2,117
41,Lorraine,57,1,04,309,Heining-lès-Bouzonville,478,8,486
41,Lorraine,57,5,10,310,Hellering-lès-Fénétrange,188,4,192
41,Lorraine,57,3,14,311,Hellimer,623,16,639
41,Lorraine,57,1,03,312,Helstroff,459,7,466
41,Lorraine,57,1,09,313,Hémilly,146,1,147
41,Lorraine,57,5,16,314,Héming,488,12,500
41,Lorraine,57,5,24,315,Henridorff,654,11,665
41,Lorraine,57,3,41,316,Henriville,735,16,751
41,Lorraine,57,5,24,317,Hérange,113,8,121
41,Lorraine,57,5,16,318,Hermelange,241,4,245
41,Lorraine,57,1,09,319,Herny,461,9,470
41,Lorraine,57,5,25,320,Hertzing,194,5,199
41,Lorraine,57,5,29,321,Hesse,618,21,639
41,Lorraine,57,1,04,322,Hestroff,402,4,406
41,Lorraine,57,7,05,323,Hettange-Grande,7483,145,7628
41,Lorraine,57,5,10,324,Hilbesheim,611,10,621
41,Lorraine,57,6,28,325,Hilsprich,899,16,915
41,Lorraine,57,1,03,326,Hinckange,293,3,296
41,Lorraine,57,1,09,328,Holacourt,63,2,65
41,Lorraine,57,1,03,329,Holling,368,5,373
41,Lorraine,57,6,28,330,Holving,1198,28,1226
41,Lorraine,57,7,21,331,Hombourg-Budange,509,10,519
41,Lorraine,57,3,49,332,Hombourg-Haut,7869,102,7971
41,Lorraine,57,5,29,333,Hommarting,818,13,831
41,Lorraine,57,5,29,334,Hommert,356,7,363
41,Lorraine,57,2,01,335,Honskirch,211,3,214
41,Lorraine,57,3,49,336,L' Hôpital,5499,74,5573
41,Lorraine,57,3,41,337,Hoste,687,16,703
41,Lorraine,57,6,36,338,Hottviller,620,16,636
41,Lorraine,57,5,24,339,Hultehouse,354,3,357
41,Lorraine,57,6,50,340,Hundling,1378,43,1421
41,Lorraine,57,7,31,341,Hunting,583,16,599
41,Lorraine,57,5,25,342,Ibigny,92,9,101
41,Lorraine,57,7,38,343,Illange,2037,48,2085
41,Lorraine,57,5,29,344,Imling,701,8,709
41,Lorraine,57,7,21,345,Inglange,391,38,429
41,Lorraine,57,2,01,346,Insming,602,21,623
41,Lorraine,57,2,01,347,Insviller,187,3,190
41,Lorraine,57,6,50,348,Ippling,789,28,817
41,Lorraine,57,2,07,349,Jallaucourt,160,1,161
41,Lorraine,57,4,13,350,Jouy-aux-Arches,1581,27,1608
41,Lorraine,57,4,33,351,Jury,1166,19,1185
41,Lorraine,57,4,13,352,Jussy,457,13,470
41,Lorraine,57,2,34,353,Juvelize,92,3,95
41,Lorraine,57,2,07,354,Juville,107,0,107
41,Lorraine,57,6,26,355,Kalhausen,856,9,865
41,Lorraine,57,7,05,356,Kanfen,995,15,1010
41,Lorraine,57,6,28,357,Kappelkinger,398,6,404
41,Lorraine,57,7,21,358,Kédange-sur-Canner,1095,17,1112
41,Lorraine,57,7,21,359,Kemplich,155,3,158
41,Lorraine,57,3,51,360,Kerbach,1178,36,1214
41,Lorraine,57,7,31,361,Kerling-lès-Sierck,508,13,521
41,Lorraine,57,5,29,362,Kerprich-aux-Bois,129,2,131
41,Lorraine,57,7,31,364,Kirsch-lès-Sierck,287,9,296
41,Lorraine,57,7,31,365,Kirschnaumen,462,14,476
41,Lorraine,57,6,28,366,Kirviller,137,0,137
41,Lorraine,57,7,21,367,Klang,245,1,246
41,Lorraine,57,8,44,368,Knutange,3425,67,3492
41,Lorraine,57,7,21,370,Koenigsmacker,2034,16,2050
41,Lorraine,57,7,21,372,Kuntzig,1057,25,1082
41,Lorraine,57,3,49,373,Lachambre,769,17,786
41,Lorraine,57,5,16,374,Lafrimbolle,217,7,224
41,Lorraine,57,2,34,375,Lagarde,201,2,203
41,Lorraine,57,6,26,376,Lambach,544,12,556
41,Lorraine,57,5,16,377,Landange,251,3,254
41,Lorraine,57,3,14,379,Landroff,266,5,271
41,Lorraine,57,2,07,381,Laneuveville-en-Saulnois,265,5,270
41,Lorraine,57,5,16,380,Laneuveville-lès-Lorquin,94,0,94
41,Lorraine,57,5,29,382,Langatte,473,13,486
41,Lorraine,57,5,25,383,Languimberg,208,11,219
41,Lorraine,57,3,14,384,Laning,566,15,581
41,Lorraine,57,4,23,385,Laquenexy,993,22,1015
41,Lorraine,57,1,09,386,Laudrefang,370,14,384
41,Lorraine,57,7,31,387,Laumesfeld,251,2,253
41,Lorraine,57,7,31,388,Launstroff,253,6,259
41,Lorraine,57,3,14,389,Lelling,477,11,488
41,Lorraine,57,6,02,390,Lemberg,1527,34,1561
41,Lorraine,57,2,07,391,Lemoncourt,75,0,75
41,Lorraine,57,4,23,392,Lemud,299,8,307
41,Lorraine,57,6,36,393,Lengelsheim,211,6,217
41,Lorraine,57,2,01,394,Léning,282,2,284
41,Lorraine,57,2,07,395,Lesse,204,1,205
41,Lorraine,57,4,13,396,Lessy,830,113,943
41,Lorraine,57,2,34,397,Ley,111,2,113
41,Lorraine,57,3,14,398,Leyviller,488,12,500
41,Lorraine,57,2,34,399,Lezey,111,3,114
41,Lorraine,57,2,01,410,Lhor,140,3,143
41,Lorraine,57,2,08,401,Lidrezing,92,0,92
41,Lorraine,57,6,02,402,Liederschiedt,128,4,132
41,Lorraine,57,4,33,403,Liéhon,113,5,118
41,Lorraine,57,2,08,404,Lindre-Basse,214,13,227
41,Lorraine,57,2,08,405,Lindre-Haute,62,1,63
41,Lorraine,57,2,07,406,Liocourt,139,3,142
41,Lorraine,57,5,24,407,Lixheim,578,9,587
41,Lorraine,57,6,50,408,Lixing-lès-Rouhling,907,25,932
41,Lorraine,57,3,14,409,Lixing-lès-Saint-Avold,721,21,742
41,Lorraine,57,8,11,411,Lommerange,288,8,296
41,Lorraine,57,4,37,412,Longeville-lès-Metz,3845,80,3925
41,Lorraine,57,1,09,413,Longeville-lès-Saint-Avold,3761,76,3837
41,Lorraine,57,5,16,414,Lorquin,1243,19,1262
41,Lorraine,57,4,37,415,Lorry-lès-Metz,1404,74,1478
41,Lorraine,57,4,33,416,Lorry-Mardigny,584,8,592
41,Lorraine,57,2,01,417,Lostroff,77,1,78
41,Lorraine,57,2,01,418,Loudrefing,292,2,294
41,Lorraine,57,6,50,419,Loupershouse,943,26,969
41,Lorraine,57,6,36,421,Loutzviller,160,2,162
41,Lorraine,57,4,33,422,Louvigny,777,7,784
41,Lorraine,57,2,06,423,Lubécourt,46,0,46
41,Lorraine,57,2,07,424,Lucy,206,3,209
41,Lorraine,57,4,23,425,Luppy,476,4,480
41,Lorraine,57,7,21,426,Luttange,900,20,920
41,Lorraine,57,5,24,427,Lutzelbourg,636,13,649
41,Lorraine,57,3,49,428,Macheren,2941,97,3038
41,Lorraine,57,1,09,430,Mainvillers,272,6,278
41,Lorraine,57,4,23,431,Maizeroy,319,5,324
41,Lorraine,57,4,23,432,Maizery,175,2,177
41,Lorraine,57,4,43,433,Maizières-lès-Metz,10574,116,10690
41,Lorraine,57,2,34,434,Maizières-lès-Vic,470,3,473
41,Lorraine,57,2,07,436,Malaucourt-sur-Seille,130,6,136
41,Lorraine,57,7,31,437,Malling,508,19,527
41,Lorraine,57,4,35,438,Malroy,390,10,400
41,Lorraine,57,7,31,439,Manderen,413,13,426
41,Lorraine,57,2,06,440,Manhoué,132,1,133
41,Lorraine,57,7,38,441,Manom,2672,72,2744
41,Lorraine,57,1,09,442,Many,254,4,258
41,Lorraine,57,4,48,443,Marange-Silvange,5823,77,5900
41,Lorraine,57,1,09,444,Marange-Zondrange,295,15,310
41,Lorraine,57,4,33,445,Marieulles,582,24,606
41,Lorraine,57,2,01,446,Marimont-lès-Bénestroff,47,0,47
41,Lorraine,57,4,33,447,Marly,9545,288,9833
41,Lorraine,57,2,34,448,Marsal,276,14,290
41,Lorraine,57,4,23,449,Marsilly,472,8,480
41,Lorraine,57,2,07,451,Marthille,190,1,191
41,Lorraine,57,4,37,452,La Maxe,846,12,858
41,Lorraine,57,3,14,453,Maxstadt,283,1,284
41,Lorraine,57,4,33,454,Mécleuves,1174,20,1194
41,Lorraine,57,1,03,455,Mégange,203,5,208
41,Lorraine,57,6,02,456,Meisenthal,751,19,770
41,Lorraine,57,1,04,457,Menskirch,160,6,166
41,Lorraine,57,7,31,459,Merschweiller,186,1,187
41,Lorraine,57,1,04,460,Merten,1486,28,1514
41,Lorraine,57,5,16,461,Métairies-Saint-Quirin,304,3,307
41,Lorraine,57,5,24,462,Metting,348,4,352
41,Lorraine,57,9,99,463,Metz,122838,2123,124961
41,Lorraine,57,7,21,464,Metzeresche,810,11,821
41,Lorraine,57,7,21,465,Metzervisse,1710,23,1733
41,Lorraine,57,3,47,466,Metzing,608,11,619
41,Lorraine,57,4,20,467,Mey,236,7,243
41,Lorraine,57,5,24,468,Mittelbronn,672,6,678
41,Lorraine,57,5,10,469,Mittersheim,583,13,596
41,Lorraine,57,2,01,470,Molring,9,0,9
41,Lorraine,57,1,03,471,Momerstroff,271,6,277
41,Lorraine,57,4,33,472,Moncheux,150,4,154
41,Lorraine,57,2,34,473,Moncourt,90,1,91
41,Lorraine,57,8,45,474,Mondelange,5895,55,5950
41,Lorraine,57,7,05,475,Mondorff,568,3,571
41,Lorraine,57,7,21,476,Monneren,408,5,413
41,Lorraine,57,6,26,477,Montbronn,1672,39,1711
41,Lorraine,57,2,01,478,Montdidier,65,4,69
41,Lorraine,57,7,31,479,Montenach,443,11,454
41,Lorraine,57,4,20,480,Montigny-lès-Metz,22765,554,23319
41,Lorraine,57,4,48,481,Montois-la-Montagne,2375,40,2415
41,Lorraine,57,4,23,482,Montoy-Flanville,1160,24,1184
41,Lorraine,57,3,14,483,Morhange,3838,169,4007
41,Lorraine,57,3,47,484,Morsbach,2598,51,2649
41,Lorraine,57,2,06,485,Morville-lès-Vic,118,3,121
41,Lorraine,57,2,07,486,Morville-sur-Nied,129,6,135
41,Lorraine,57,4,37,487,Moulins-lès-Metz,5084,88,5172
41,Lorraine,57,5,25,488,Moussey,622,12,634
41,Lorraine,57,6,02,489,Mouterhouse,293,3,296
41,Lorraine,57,2,34,490,Moyenvic,363,7,370
41,Lorraine,57,8,22,491,Moyeuvre-Grande,8119,98,8217
41,Lorraine,57,8,22,492,Moyeuvre-Petite,508,9,517
41,Lorraine,57,2,08,493,Mulcey,221,5,226
41,Lorraine,57,2,01,494,Munster,214,3,217
41,Lorraine,57,1,03,495,Narbéfontaine,136,0,136
41,Lorraine,57,2,01,496,Nébing,367,1,368
41,Lorraine,57,6,28,497,Nelling,286,1,287
41,Lorraine,57,8,44,498,Neufchef,2549,44,2593
41,Lorraine,57,6,50,499,Neufgrange,1362,25,1387
41,Lorraine,57,5,16,500,Neufmoulins,36,2,38
41,Lorraine,57,2,01,501,Neufvillage,40,2,42
41,Lorraine,57,1,04,502,Neunkirchen-lès-Bouzonville,326,6,332
41,Lorraine,57,5,16,504,Niderhoff,287,6,293
41,Lorraine,57,5,29,505,Niderviller,1128,32,1160
41,Lorraine,57,5,10,506,Niederstinzel,243,2,245
41,Lorraine,57,1,03,507,Niedervisse,232,8,240
41,Lorraine,57,8,44,508,Nilvange,4939,45,4984
41,Lorraine,57,5,16,509,Nitting,472,14,486
41,Lorraine,57,4,35,510,Noisseville,1006,18,1024
41,Lorraine,57,4,48,511,Norroy-le-Veneur,1032,36,1068
41,Lorraine,57,4,35,512,Nouilly,486,9,495
41,Lorraine,57,6,36,513,Nousseviller-lès-Bitche,153,5,158
41,Lorraine,57,3,47,514,Nousseviller-Saint-Nabor,1068,24,1092
41,Lorraine,57,4,13,515,Novéant-sur-Moselle,1959,26,1985
41,Lorraine,57,1,04,516,Oberdorff,362,10,372
41,Lorraine,57,6,36,517,Obergailbach,312,2,314
41,Lorraine,57,5,10,518,Oberstinzel,304,6,310
41,Lorraine,57,1,03,519,Obervisse,152,10,162
41,Lorraine,57,2,06,520,Obreck,54,3,57
41,Lorraine,57,3,47,521,OEting,2453,76,2529
41,Lorraine,57,4,23,523,Ogy,585,9,594
41,Lorraine,57,2,34,524,Ommeray,103,2,105
41,Lorraine,57,2,07,525,Oriocourt,54,1,55
41,Lorraine,57,6,36,526,Ormersviller,344,4,348
41,Lorraine,57,4,33,527,Orny,367,0,367
41,Lorraine,57,2,07,528,Oron,107,4,111
41,Lorraine,57,8,11,529,Ottange,2685,74,2759
41,Lorraine,57,1,03,530,Ottonville,401,10,411
41,Lorraine,57,7,21,531,Oudrenne,752,18,770
41,Lorraine,57,4,33,532,Pagny-lès-Goin,233,4,237
41,Lorraine,57,4,23,533,Pange,893,13,906
41,Lorraine,57,4,33,534,Peltre,1739,141,1880
41,Lorraine,57,6,26,535,Petit-Réderching,1492,44,1536
41,Lorraine,57,3,14,536,Petit-Tenquin,220,4,224
41,Lorraine,57,3,51,537,Petite-Rosselle,6650,106,6756
41,Lorraine,57,2,06,538,Pettoncourt,293,4,297
41,Lorraine,57,2,06,539,Pévange,50,0,50
41,Lorraine,57,5,24,540,Phalsbourg,4707,269,4976
41,Lorraine,57,6,02,541,Philippsbourg,557,11,568
41,Lorraine,57,1,03,542,Piblange,905,11,916
41,Lorraine,57,4,48,543,Pierrevillers,1475,14,1489
41,Lorraine,57,5,29,544,Plaine-de-Walsch,582,13,595
41,Lorraine,57,4,37,545,Plappeville,2230,101,2331
41,Lorraine,57,4,48,546,Plesnois,763,32,795
41,Lorraine,57,4,33,547,Pommérieux,685,5,690
41,Lorraine,57,4,33,548,Pontoy,433,4,437
41,Lorraine,57,1,09,549,Pontpierre,783,17,800
41,Lorraine,57,3,27,550,Porcelette,2469,71,2540
41,Lorraine,57,5,10,551,Postroff,205,3,208
41,Lorraine,57,4,33,552,Pouilly,685,20,705
41,Lorraine,57,4,33,553,Pournoy-la-Chétive,675,17,692
41,Lorraine,57,4,33,554,Pournoy-la-Grasse,570,25,595
41,Lorraine,57,2,07,555,Prévocourt,104,4,108
41,Lorraine,57,6,28,556,Puttelange-aux-Lacs,3168,44,3212
41,Lorraine,57,7,05,557,Puttelange-lès-Thionville,898,11,909
41,Lorraine,57,2,06,558,Puttigny,71,0,71
41,Lorraine,57,2,07,559,Puzieux,170,4,174
41,Lorraine,57,3,14,560,Racrange,656,17,673
41,Lorraine,57,6,26,561,Rahling,826,29,855
41,Lorraine,57,8,15,562,Ranguevaux,788,11,799
41,Lorraine,57,4,23,563,Raville,247,2,249
41,Lorraine,57,5,25,564,Réchicourt-le-Château,572,8,580
41,Lorraine,57,8,11,565,Rédange,924,8,932
41,Lorraine,57,5,29,566,Réding,2482,50,2532
41,Lorraine,57,1,04,567,Rémelfang,141,3,144
41,Lorraine,57,6,50,568,Rémelfing,1497,30,1527
41,Lorraine,57,7,31,569,Rémeling,311,2,313
41,Lorraine,57,1,04,570,Rémering,442,10,452
41,Lorraine,57,6,28,571,Rémering-lès-Puttelange,1086,21,1107
41,Lorraine,57,4,23,572,Rémilly,2024,124,2148
41,Lorraine,57,2,01,573,Réning,133,0,133
41,Lorraine,57,4,23,575,Retonfey,1322,31,1353
41,Lorraine,57,7,31,576,Rettel,745,67,812
41,Lorraine,57,6,02,577,Reyersviller,369,8,377
41,Lorraine,57,4,13,578,Rezonville,343,6,349
41,Lorraine,57,5,29,579,Rhodes,86,4,90
41,Lorraine,57,2,06,580,Riche,195,3,198
41,Lorraine,57,6,28,581,Richeling,365,10,375
41,Lorraine,57,8,45,582,Richemont,1891,83,1974
41,Lorraine,57,5,25,583,Richeval,135,2,137
41,Lorraine,57,6,36,584,Rimling,545,7,552
41,Lorraine,57,7,31,585,Ritzing,137,8,145
41,Lorraine,57,8,11,586,Rochonvillers,217,3,220
41,Lorraine,57,2,01,587,Rodalbe,183,6,189
41,Lorraine,57,7,05,588,Rodemack,1088,22,1110
41,Lorraine,57,6,26,589,Rohrbach-lès-Bitche,2174,52,2226
41,Lorraine,57,6,36,590,Rolbing,287,10,297
41,Lorraine,57,4,42,591,Rombas,10137,112,10249
41,Lorraine,57,5,10,592,Romelfing,360,9,369
41,Lorraine,57,4,48,593,Roncourt,725,4,729
41,Lorraine,57,6,02,594,Roppeviller,128,0,128
41,Lorraine,57,2,08,595,Rorbach-lès-Dieuze,54,2,56
41,Lorraine,57,3,47,596,Rosbruck,763,13,776
41,Lorraine,57,8,22,597,Rosselange,2960,24,2984
41,Lorraine,57,6,50,598,Rouhling,2025,48,2073
41,Lorraine,57,1,03,599,Roupeldange,385,6,391
41,Lorraine,57,7,05,600,Roussy-le-Village,1165,17,1182
41,Lorraine,57,4,13,601,Rozérieulles,1404,43,1447
41,Lorraine,57,7,21,602,Rurange-lès-Thionville,2105,46,2151
41,Lorraine,57,8,11,603,Russange,1025,30,1055
41,Lorraine,57,7,31,604,Rustroff,552,8,560
41,Lorraine,57,4,33,605,Sailly-Achâtel,224,2,226
41,Lorraine,57,3,96,606,Saint-Avold,16631,458,17089
41,Lorraine,57,2,07,609,Saint-Epvre,160,1,161
41,Lorraine,57,1,04,610,Saint-François-Lacroix,257,8,265
41,Lorraine,57,5,25,611,Saint-Georges,212,3,215
41,Lorraine,57,4,35,612,Saint-Hubert,223,1,224
41,Lorraine,57,5,10,613,Saint-Jean-de-Bassel,343,4,347
41,Lorraine,57,5,24,614,Saint-Jean-Kourtzerode,729,4,733
41,Lorraine,57,6,28,615,Saint-Jean-Rohrbach,963,11,974
41,Lorraine,57,4,20,616,Saint-Julien-lès-Metz,2998,95,3093
41,Lorraine,57,4,33,617,Saint-Jure,312,0,312
41,Lorraine,57,5,24,618,Saint-Louis,698,20,718
41,Lorraine,57,6,02,619,Saint-Louis-lès-Bitche,539,8,547
41,Lorraine,57,2,08,621,Saint-Médard,102,1,103
41,Lorraine,57,4,48,622,Saint-Privat-la-Montagne,1538,20,1558
41,Lorraine,57,5,16,623,Saint-Quirin,807,90,897
41,Lorraine,57,4,35,607,Sainte-Barbe,711,16,727
41,Lorraine,57,4,48,620,Sainte-Marie-aux-Chênes,3625,47,3672
41,Lorraine,57,4,13,624,Sainte-Ruffine,530,33,563
41,Lorraine,57,2,06,625,Salonnes,172,3,175
41,Lorraine,57,4,35,626,Sanry-lès-Vigy,534,13,547
41,Lorraine,57,4,23,627,Sanry-sur-Nied,328,3,331
41,Lorraine,57,6,28,628,Sarralbe,4591,77,4668
41,Lorraine,57,5,10,629,Sarraltroff,776,20,796
41,Lorraine,57,5,29,630,Sarrebourg,12929,331,13260
41,Lorraine,57,6,30,631,Sarreguemines,22015,563,22578
41,Lorraine,57,6,50,633,Sarreinsming,1303,30,1333
41,Lorraine,57,4,48,634,Saulny,1471,44,1515
41,Lorraine,57,5,10,635,Schalbach,302,1,303
41,Lorraine,57,6,26,636,Schmittviller,346,4,350
41,Lorraine,57,5,29,637,Schneckenbusch,301,6,307
41,Lorraine,57,3,51,638,Schoeneck,2740,47,2787
41,Lorraine,57,6,02,639,Schorbach,585,24,609
41,Lorraine,57,1,04,640,Schwerdorff,448,10,458
41,Lorraine,57,6,36,641,Schweyen,312,8,320
41,Lorraine,57,4,37,642,Scy-Chazelles,2766,82,2848
41,Lorraine,57,4,33,643,Secourt,200,1,201
41,Lorraine,57,3,41,644,Seingbouse,1889,39,1928
41,Lorraine,57,4,43,645,Semécourt,855,16,871
41,Lorraine,57,8,15,647,Serémange-Erzange,4140,71,4211
41,Lorraine,57,4,23,648,Servigny-lès-Raville,354,4,358
41,Lorraine,57,4,35,649,Servigny-lès-Sainte-Barbe,425,11,436
41,Lorraine,57,7,31,650,Sierck-les-Bains,1727,40,1767
41,Lorraine,57,6,26,651,Siersthal,646,16,662
41,Lorraine,57,4,33,652,Sillegny,458,7,465
41,Lorraine,57,4,33,653,Silly-en-Saulnois,44,2,46
41,Lorraine,57,4,23,654,Silly-sur-Nied,701,16,717
41,Lorraine,57,4,33,655,Solgne,1065,63,1128
41,Lorraine,57,4,23,656,Sorbey,328,7,335
41,Lorraine,57,2,06,657,Sotzeling,17,2,19
41,Lorraine,57,6,26,658,Soucht,1179,29,1208
41,Lorraine,57,3,51,659,Spicheren,3244,51,3295
41,Lorraine,57,3,51,660,Stiring-Wendel,12311,211,12522
41,Lorraine,57,7,21,767,Stuckange,995,19,1014
41,Lorraine,57,6,02,661,Sturzelbronn,194,2,196
41,Lorraine,57,3,14,662,Suisse,103,5,108
41,Lorraine,57,4,43,663,Talange,7546,200,7746
41,Lorraine,57,2,08,664,Tarquimpol,67,2,69
41,Lorraine,57,3,47,665,Tenteling,994,33,1027
41,Lorraine,57,7,38,666,Terville,6477,107,6584
41,Lorraine,57,1,03,667,Téterchen,696,12,708
41,Lorraine,57,1,09,668,Teting-sur-Nied,1358,30,1388
41,Lorraine,57,3,47,669,Théding,2354,35,2389
41,Lorraine,57,1,09,670,Thicourt,149,2,151
41,Lorraine,57,4,23,671,Thimonville,163,1,164
41,Lorraine,57,7,97,672,Thionville,41129,873,42002
41,Lorraine,57,1,09,673,Thonville,41,1,42
41,Lorraine,57,2,07,674,Tincry,201,6,207
41,Lorraine,57,2,01,675,Torcheville,161,2,163
41,Lorraine,57,4,23,676,Tragny,115,4,119
41,Lorraine,57,4,35,677,Trémery,1095,18,1113
41,Lorraine,57,8,11,678,Tressange,1943,50,1993
41,Lorraine,57,1,09,679,Tritteling-Redlach,488,14,502
41,Lorraine,57,5,29,680,Troisfontaines,1271,31,1302
41,Lorraine,57,1,04,681,Tromborn,334,7,341
41,Lorraine,57,5,16,682,Turquestein-Blancrupt,22,1,23
41,Lorraine,57,8,39,683,Uckange,7341,95,7436
41,Lorraine,57,3,14,684,Vahl-Ebersing,558,13,571
41,Lorraine,57,2,01,685,Vahl-lès-Bénestroff,125,5,130
41,Lorraine,57,1,09,686,Vahl-lès-Faulquemont,259,6,265
41,Lorraine,57,2,08,270,Val-de-Bride,637,22,659
41,Lorraine,57,6,28,267,Le Val-de-Guéblange,863,20,883
41,Lorraine,57,3,14,687,Vallerange,217,1,218
41,Lorraine,57,7,21,689,Valmestroff,242,4,246
41,Lorraine,57,3,27,690,Valmont,3276,74,3350
41,Lorraine,57,1,03,691,Valmunster,86,2,88
41,Lorraine,57,2,06,692,Vannecourt,87,2,89
41,Lorraine,57,4,20,693,Vantoux,927,18,945
41,Lorraine,57,4,20,694,Vany,342,7,349
41,Lorraine,57,1,03,695,Varize,499,4,503
41,Lorraine,57,1,03,696,Varsberg,965,21,986
41,Lorraine,57,5,16,697,Vasperviller,296,3,299
41,Lorraine,57,1,09,698,Vatimont,351,6,357
41,Lorraine,57,1,04,700,Vaudreching,552,10,562
41,Lorraine,57,4,13,701,Vaux,870,22,892
41,Lorraine,57,2,06,702,Vaxy,155,1,156
41,Lorraine,57,5,10,703,Veckersviller,287,4,291
41,Lorraine,57,7,21,704,Veckring,677,11,688
41,Lorraine,57,1,03,705,Velving,247,3,250
41,Lorraine,57,2,08,706,Vergaville,564,7,571
41,Lorraine,57,4,13,707,Vernéville,593,17,610
41,Lorraine,57,4,33,708,Verny,1917,103,2020
41,Lorraine,57,5,24,709,Vescheim,226,6,232
41,Lorraine,57,2,01,711,Vibersviller,448,3,451
41,Lorraine,57,2,34,712,Vic-sur-Seille,1354,125,1479
41,Lorraine,57,5,10,713,Vieux-Lixheim,244,5,249
41,Lorraine,57,4,33,715,Vigny,305,2,307
41,Lorraine,57,4,35,716,Vigy,1315,24,1339
41,Lorraine,57,3,14,717,Viller,191,2,193
41,Lorraine,57,4,23,718,Villers-Stoncourt,222,5,227
41,Lorraine,57,2,07,719,Villers-sur-Nied,76,0,76
41,Lorraine,57,1,04,720,Villing,477,8,485
41,Lorraine,57,5,24,721,Vilsberg,364,6,370
41,Lorraine,57,4,13,722,Vionville,165,3,168
41,Lorraine,57,2,01,723,Virming,266,7,273
41,Lorraine,57,8,22,724,Vitry-sur-Orne,2767,38,2805
41,Lorraine,57,2,01,725,Vittersbourg,330,7,337
41,Lorraine,57,1,09,726,Vittoncourt,381,3,384
41,Lorraine,57,2,07,727,Viviers,102,4,106
41,Lorraine,57,1,04,749,Voelfling-lès-Bouzonville,189,7,196
41,Lorraine,57,1,09,728,Voimhaut,259,0,259
41,Lorraine,57,1,03,730,Volmerange-lès-Boulay,579,3,582
41,Lorraine,57,7,05,731,Volmerange-les-Mines,2017,34,2051
41,Lorraine,57,6,36,732,Volmunster,874,10,884
41,Lorraine,57,7,21,733,Volstroff,1447,33,1480
41,Lorraine,57,5,16,734,Voyer,419,8,427
41,Lorraine,57,4,35,736,Vry,552,7,559
41,Lorraine,57,4,33,737,Vulmont,40,1,41
41,Lorraine,57,6,36,738,Waldhouse,393,9,402
41,Lorraine,57,7,31,739,Waldweistroff,417,7,424
41,Lorraine,57,7,31,740,Waldwisse,688,14,702
41,Lorraine,57,6,36,741,Walschbronn,540,18,558
41,Lorraine,57,5,29,742,Walscheid,1648,29,1677
41,Lorraine,57,5,24,743,Waltembourg,228,9,237
41,Lorraine,57,6,50,745,Wiesviller,1032,25,1057
41,Lorraine,57,6,28,746,Willerwald,1465,34,1499
41,Lorraine,57,5,24,747,Wintersbourg,222,8,230
41,Lorraine,57,6,50,748,Wittring,819,17,836
41,Lorraine,57,6,50,750,Woelfling-lès-Sarreguemines,662,10,672
41,Lorraine,57,4,37,751,Woippy,12593,142,12735
41,Lorraine,57,6,50,752,Woustviller,3135,60,3195
41,Lorraine,57,2,06,753,Wuisse,61,4,65
41,Lorraine,57,2,34,754,Xanrey,108,3,111
41,Lorraine,57,2,07,755,Xocourt,76,0,76
41,Lorraine,57,5,29,756,Xouaxange,345,10,355
41,Lorraine,57,7,38,757,Yutz,16203,309,16512
41,Lorraine,57,2,08,759,Zarbeling,66,0,66
41,Lorraine,57,6,50,760,Zetting,795,15,810
41,Lorraine,57,5,24,761,Zilling,261,2,263
41,Lorraine,57,1,03,762,Zimming,634,7,641
41,Lorraine,57,2,08,763,Zommange,36,2,38
41,Lorraine,57,7,05,764,Zoufftgen,749,10,759
26,Bourgogne,58,1,04,001,Achun,147,2,149
26,Bourgogne,58,4,07,002,Alligny-Cosne,867,17,884
26,Bourgogne,58,1,14,003,Alligny-en-Morvan,651,15,666
26,Bourgogne,58,1,04,004,Alluy,428,4,432
26,Bourgogne,58,2,24,005,Amazy,241,8,249
26,Bourgogne,58,3,21,006,Anlezy,285,4,289
26,Bourgogne,58,4,31,007,Annay,309,5,314
26,Bourgogne,58,2,06,008,Anthien,175,4,179
26,Bourgogne,58,4,19,009,Arbourse,108,1,109
26,Bourgogne,58,1,03,010,Arleuf,792,24,816
26,Bourgogne,58,2,05,011,Armes,285,12,297
26,Bourgogne,58,4,20,012,Arquian,603,18,621
26,Bourgogne,58,4,19,013,Arthel,88,1,89
26,Bourgogne,58,4,19,014,Arzembouy,80,0,80
26,Bourgogne,58,2,01,015,Asnan,133,7,140
26,Bourgogne,58,2,24,016,Asnois,162,6,168
26,Bourgogne,58,1,04,017,Aunay-en-Bazois,275,2,277
26,Bourgogne,58,2,01,018,Authiou,32,1,33
26,Bourgogne,58,1,13,019,Avrée,94,1,95
26,Bourgogne,58,3,08,020,Avril-sur-Loire,245,8,253
26,Bourgogne,58,3,22,021,Azy-le-Vif,226,5,231
26,Bourgogne,58,3,26,022,Balleray,204,10,214
26,Bourgogne,58,2,12,023,Bazoches,160,8,168
26,Bourgogne,58,1,04,024,Bazolles,274,5,279
26,Bourgogne,58,3,27,025,Béard,166,5,171
26,Bourgogne,58,2,01,026,Beaulieu,33,0,33
26,Bourgogne,58,4,02,027,Beaumont-la-Ferrière,137,2,139
26,Bourgogne,58,3,21,028,Beaumont-Sardolles,119,4,123
26,Bourgogne,58,2,01,029,Beuvron,100,3,103
26,Bourgogne,58,1,04,030,Biches,335,1,336
26,Bourgogne,58,3,21,031,Billy-Chevannes,354,4,358
26,Bourgogne,58,2,05,032,Billy-sur-Oisy,417,3,420
26,Bourgogne,58,4,20,033,Bitry,313,4,317
26,Bourgogne,58,1,03,034,Blismes,163,2,165
26,Bourgogne,58,3,23,035,Bona,322,8,330
26,Bourgogne,58,4,20,036,Bouhy,460,14,474
26,Bourgogne,58,2,12,037,Brassy,632,22,654
26,Bourgogne,58,2,05,038,Breugnon,169,6,175
26,Bourgogne,58,2,05,039,Brèves,298,6,304
26,Bourgogne,58,1,04,040,Brinay,156,3,159
26,Bourgogne,58,2,01,041,Brinon-sur-Beuvron,218,7,225
26,Bourgogne,58,4,18,042,Bulcy,152,4,156
26,Bourgogne,58,2,01,043,Bussy-la-Pesle,45,1,46
26,Bourgogne,58,4,31,044,La Celle-sur-Loire,815,28,843
26,Bourgogne,58,4,02,045,La Celle-sur-Nièvre,167,5,172
26,Bourgogne,58,1,11,046,Cercy-la-Tour,2028,41,2069
26,Bourgogne,58,2,06,047,Cervon,593,23,616
26,Bourgogne,58,4,09,048,Cessy-les-Bois,124,5,129
26,Bourgogne,58,2,12,049,Chalaux,71,1,72
26,Bourgogne,58,2,01,050,Challement,62,1,63
26,Bourgogne,58,3,30,051,Challuy,1596,136,1732
26,Bourgogne,58,2,01,052,Champallement,61,1,62
26,Bourgogne,58,4,19,053,Champlemy,338,4,342
26,Bourgogne,58,4,19,054,Champlin,37,1,38
26,Bourgogne,58,3,08,055,Champvert,822,13,835
26,Bourgogne,58,4,02,056,Champvoux,298,7,305
26,Bourgogne,58,3,22,057,Chantenay-Saint-Imbert,1267,21,1288
26,Bourgogne,58,2,25,058,La Chapelle-Saint-André,341,8,349
26,Bourgogne,58,4,02,059,La Charité-sur-Loire,5278,92,5370
26,Bourgogne,58,1,11,060,Charrin,643,22,665
26,Bourgogne,58,4,02,061,Chasnay,130,6,136
26,Bourgogne,58,1,03,063,Château-Chinon (Campagne),617,14,631
26,Bourgogne,58,1,03,062,Château-Chinon (Ville),2167,287,2454
26,Bourgogne,58,4,09,064,Châteauneuf-Val-de-Bargis,581,23,604
26,Bourgogne,58,1,04,065,Châtillon-en-Bazois,978,21,999
26,Bourgogne,58,1,03,066,Châtin,105,3,108
26,Bourgogne,58,4,02,067,Chaulgnes,1349,40,1389
26,Bourgogne,58,1,14,068,Chaumard,224,4,228
26,Bourgogne,58,2,06,069,Chaumot,170,6,176
26,Bourgogne,58,2,01,070,Chazeuil,69,2,71
26,Bourgogne,58,2,01,071,Chevannes-Changy,150,9,159
26,Bourgogne,58,3,32,072,Chevenon,617,18,635
26,Bourgogne,58,2,05,073,Chevroches,145,1,146
26,Bourgogne,58,1,13,074,Chiddes,329,12,341
26,Bourgogne,58,2,06,075,Chitry-les-Mines,236,6,242
26,Bourgogne,58,1,04,076,Chougny,84,1,85
26,Bourgogne,58,4,09,077,Ciez,377,14,391
26,Bourgogne,58,3,21,078,Cizely,59,0,59
26,Bourgogne,58,2,05,079,Clamecy,4331,343,4674
26,Bourgogne,58,2,06,080,La Collancelle,172,4,176
26,Bourgogne,58,4,09,081,Colméry,323,5,328
26,Bourgogne,58,1,03,082,Corancy,341,10,351
26,Bourgogne,58,2,06,083,Corbigny,1656,158,1814
26,Bourgogne,58,2,01,084,Corvol-d'Embernard,106,2,108
26,Bourgogne,58,2,25,085,Corvol-l'Orgueilleux,757,6,763
26,Bourgogne,58,4,98,086,Cosne-Cours-sur-Loire,11065,370,11435
26,Bourgogne,58,3,10,087,Cossaye,773,30,803
26,Bourgogne,58,3,28,088,Coulanges-lès-Nevers,3489,183,3672
26,Bourgogne,58,4,09,089,Couloutre,218,4,222
26,Bourgogne,58,2,25,090,Courcelles,215,8,223
26,Bourgogne,58,3,23,092,Crux-la-Ville,404,13,417
26,Bourgogne,58,2,25,093,Cuncy-lès-Varzy,150,3,153
26,Bourgogne,58,4,20,094,Dampierre-sous-Bouhy,485,6,491
26,Bourgogne,58,3,08,095,Decize,5831,187,6018
26,Bourgogne,58,3,08,096,Devay,483,16,499
26,Bourgogne,58,3,21,097,Diennes-Aubigny,110,1,111
26,Bourgogne,58,2,24,098,Dirol,142,1,143
26,Bourgogne,58,1,03,099,Dommartin,196,2,198
26,Bourgogne,58,2,01,100,Dompierre-sur-Héry,75,0,75
26,Bourgogne,58,4,19,101,Dompierre-sur-Nièvre,171,2,173
26,Bourgogne,58,4,09,102,Donzy,1627,30,1657
26,Bourgogne,58,2,05,103,Dornecy,552,16,568
26,Bourgogne,58,3,10,104,Dornes,1323,23,1346
26,Bourgogne,58,3,27,105,Druy-Parigny,333,6,339
26,Bourgogne,58,2,12,106,Dun-les-Places,358,10,368
26,Bourgogne,58,1,04,107,Dun-sur-Grandry,148,1,149
26,Bourgogne,58,2,12,108,Empury,102,4,106
26,Bourgogne,58,2,25,109,Entrains-sur-Nohain,899,14,913
26,Bourgogne,58,2,06,110,Epiry,208,7,215
26,Bourgogne,58,1,03,111,Fâchin,114,0,114
26,Bourgogne,58,3,21,112,La Fermeté,651,13,664
26,Bourgogne,58,3,21,113,Fertrève,117,2,119
26,Bourgogne,58,1,13,114,Fléty,131,2,133
26,Bourgogne,58,3,08,115,Fleury-sur-Loire,236,9,245
26,Bourgogne,58,2,24,116,Flez-Cuzy,128,1,129
26,Bourgogne,58,3,17,117,Fourchambault,4681,161,4842
26,Bourgogne,58,1,11,118,Fours,791,15,806
26,Bourgogne,58,3,21,119,Frasnay-Reugny,69,1,70
26,Bourgogne,58,2,06,120,Gâcogne,266,10,276
26,Bourgogne,58,3,17,121,Garchizy,3669,175,3844
26,Bourgogne,58,4,18,122,Garchy,418,28,446
26,Bourgogne,58,2,01,123,Germenay,143,5,148
26,Bourgogne,58,3,17,124,Germigny-sur-Loire,680,28,708
26,Bourgogne,58,1,14,125,Gien-sur-Cure,113,3,116
26,Bourgogne,58,3,32,126,Gimouille,487,13,500
26,Bourgogne,58,4,19,127,Giry,216,5,221
26,Bourgogne,58,1,03,128,Glux-en-Glenne,106,1,107
26,Bourgogne,58,1,14,129,Gouloux,202,4,206
26,Bourgogne,58,2,01,130,Grenois,116,3,119
26,Bourgogne,58,3,26,131,Guérigny,2543,48,2591
26,Bourgogne,58,2,01,132,Guipy,248,59,307
26,Bourgogne,58,2,01,133,Héry,70,0,70
26,Bourgogne,58,3,32,134,Imphy,3751,95,3846
26,Bourgogne,58,1,15,135,Isenay,125,2,127
26,Bourgogne,58,3,23,136,Jailly,67,4,71
26,Bourgogne,58,3,10,137,Lamenay-sur-Loire,62,1,63
26,Bourgogne,58,3,22,138,Langeron,393,2,395
26,Bourgogne,58,1,13,139,Lanty,123,4,127
26,Bourgogne,58,1,13,140,Larochemillay,289,6,295
26,Bourgogne,58,1,03,141,Lavault-de-Frétoy,71,0,71
26,Bourgogne,58,1,04,142,Limanton,258,4,262
26,Bourgogne,58,3,21,143,Limon,172,6,178
26,Bourgogne,58,3,22,144,Livry,693,10,703
26,Bourgogne,58,2,12,145,Lormes,1357,23,1380
26,Bourgogne,58,3,10,146,Lucenay-lès-Aix,1051,19,1070
26,Bourgogne,58,4,19,147,Lurcy-le-Bourg,300,6,306
26,Bourgogne,58,3,22,148,Luthenay-Uxeloup,594,19,613
26,Bourgogne,58,1,13,149,Luzy,2031,65,2096
26,Bourgogne,58,2,24,150,Lys,125,1,126
26,Bourgogne,58,3,27,151,La Machine,3549,59,3608
26,Bourgogne,58,3,32,152,Magny-Cours,1443,29,1472
26,Bourgogne,58,2,06,153,Magny-Lormes,90,4,94
26,Bourgogne,58,2,24,154,La Maison-Dieu,132,5,137
26,Bourgogne,58,4,02,155,La Marche,589,14,603
26,Bourgogne,58,2,25,156,Marcy,162,4,166
26,Bourgogne,58,2,12,157,Marigny-l'Église,338,5,343
26,Bourgogne,58,2,06,159,Marigny-sur-Yonne,204,8,212
26,Bourgogne,58,3,22,158,Mars-sur-Allier,275,7,282
26,Bourgogne,58,3,30,160,Marzy,3471,212,3683
26,Bourgogne,58,1,15,161,Maux,138,2,140
26,Bourgogne,58,4,09,162,Menestreau,129,4,133
26,Bourgogne,58,2,25,163,Menou,177,10,187
26,Bourgogne,58,4,18,164,Mesves-sur-Loire,648,34,682
26,Bourgogne,58,2,24,165,Metz-le-Comte,194,8,202
26,Bourgogne,58,2,06,166,Mhère,266,7,273
26,Bourgogne,58,2,01,167,Michaugues,67,3,70
26,Bourgogne,58,1,13,168,Millay,444,13,457
26,Bourgogne,58,2,24,169,Moissy-Moulinot,26,1,27
26,Bourgogne,58,2,24,170,Monceaux-le-Comte,157,9,166
26,Bourgogne,58,1,04,175,Mont-et-Marré,178,5,183
26,Bourgogne,58,1,11,172,Montambert,135,0,135
26,Bourgogne,58,3,23,171,Montapas,286,4,290
26,Bourgogne,58,1,15,173,Montaron,167,3,170
26,Bourgogne,58,4,19,174,Montenoison,125,2,127
26,Bourgogne,58,3,21,176,Montigny-aux-Amognes,554,15,569
26,Bourgogne,58,1,03,177,Montigny-en-Morvan,324,9,333
26,Bourgogne,58,1,04,178,Montigny-sur-Canne,168,4,172
26,Bourgogne,58,1,03,179,Montreuillon,305,6,311
26,Bourgogne,58,1,14,180,Montsauche-les-Settons,544,15,559
26,Bourgogne,58,2,01,181,Moraches,115,3,118
26,Bourgogne,58,1,15,182,Moulins-Engilbert,1708,30,1738
26,Bourgogne,58,2,06,183,Mouron-sur-Yonne,94,3,97
26,Bourgogne,58,4,19,184,Moussy,115,0,115
26,Bourgogne,58,1,14,185,Moux-en-Morvan,616,13,629
26,Bourgogne,58,4,02,186,Murlin,107,2,109
26,Bourgogne,58,4,31,187,Myennes,599,12,611
26,Bourgogne,58,4,02,188,Nannay,119,0,119
26,Bourgogne,58,4,02,189,Narcy,527,17,544
26,Bourgogne,58,2,24,190,Neuffontaines,128,3,131
26,Bourgogne,58,2,01,191,Neuilly,135,0,135
26,Bourgogne,58,3,10,192,Neuville-lès-Decize,278,3,281
26,Bourgogne,58,4,31,193,Neuvy-sur-Loire,1440,35,1475
26,Bourgogne,58,3,99,194,Nevers,37556,1578,39134
26,Bourgogne,58,1,11,195,La Nocle-Maulaix,292,3,295
26,Bourgogne,58,3,26,196,Nolay,363,2,365
26,Bourgogne,58,2,24,197,Nuars,140,6,146
26,Bourgogne,58,2,05,198,Oisy,306,12,318
26,Bourgogne,58,1,15,199,Onlay,164,6,170
26,Bourgogne,58,2,05,200,Ouagne,170,2,172
26,Bourgogne,58,2,25,201,Oudan,136,1,137
26,Bourgogne,58,1,04,202,Ougny,49,0,49
26,Bourgogne,58,4,19,203,Oulon,81,3,84
26,Bourgogne,58,3,26,204,Ourouër,338,6,344
26,Bourgogne,58,1,14,205,Ouroux-en-Morvan,665,16,681
26,Bourgogne,58,2,25,206,Parigny-la-Rose,31,2,33
26,Bourgogne,58,3,17,207,Parigny-les-Vaux,973,31,1004
26,Bourgogne,58,2,06,208,Pazy,326,8,334
26,Bourgogne,58,4,09,209,Perroy,200,7,207
26,Bourgogne,58,1,14,210,Planchez,357,3,360
26,Bourgogne,58,1,13,211,Poil,157,6,163
26,Bourgogne,58,3,26,212,Poiseux,335,6,341
26,Bourgogne,58,4,07,213,Pougny,463,12,475
26,Bourgogne,58,3,17,214,Pougues-les-Eaux,2505,62,2567
26,Bourgogne,58,4,18,215,Pouilly-sur-Loire,1765,58,1823
26,Bourgogne,58,2,12,216,Pouques-Lormes,164,3,167
26,Bourgogne,58,2,05,217,Pousseaux,206,9,215
26,Bourgogne,58,4,19,218,Prémery,2023,33,2056
26,Bourgogne,58,1,15,219,Préporché,204,4,208
26,Bourgogne,58,4,02,220,Raveau,672,18,690
26,Bourgogne,58,1,13,221,Rémilly,175,3,178
26,Bourgogne,58,2,05,222,Rix,203,0,203
26,Bourgogne,58,3,23,223,Rouy,612,17,629
26,Bourgogne,58,2,24,224,Ruages,121,12,133
26,Bourgogne,58,3,32,225,Saincaize-Meauce,426,5,431
26,Bourgogne,58,1,14,226,Saint-Agnan,161,3,164
26,Bourgogne,58,4,20,227,Saint-Amand-en-Puisaye,1313,25,1338
26,Bourgogne,58,4,18,228,Saint-Andelain,545,8,553
26,Bourgogne,58,2,12,229,Saint-André-en-Morvan,296,13,309
26,Bourgogne,58,2,24,230,Saint-Aubin-des-Chaumes,68,1,69
26,Bourgogne,58,4,02,231,Saint-Aubin-les-Forges,438,8,446
26,Bourgogne,58,3,21,232,Saint-Benin-d'Azy,1263,33,1296
26,Bourgogne,58,3,23,233,Saint-Benin-des-Bois,204,3,207
26,Bourgogne,58,4,19,234,Saint-Bonnot,129,0,129
26,Bourgogne,58,1,14,235,Saint-Brisson,280,5,285
26,Bourgogne,58,2,24,237,Saint-Didier,34,2,36
26,Bourgogne,58,3,29,238,Saint-Éloi,1986,116,2102
26,Bourgogne,58,3,21,239,Saint-Firmin,153,1,154
26,Bourgogne,58,3,23,240,Saint-Franchy,72,3,75
26,Bourgogne,58,3,08,241,Saint-Germain-Chassenay,374,10,384
26,Bourgogne,58,2,24,242,Saint-Germain-des-Bois,110,4,114
26,Bourgogne,58,1,11,243,Saint-Gratien-Savigny,122,7,129
26,Bourgogne,58,1,03,244,Saint-Hilaire-en-Morvan,218,2,220
26,Bourgogne,58,1,11,245,Saint-Hilaire-Fontaine,192,2,194
26,Bourgogne,58,1,15,246,Saint-Honoré-les-Bains,843,18,861
26,Bourgogne,58,3,21,247,Saint-Jean-aux-Amognes,458,10,468
26,Bourgogne,58,4,18,248,Saint-Laurent-l'Abbaye,234,5,239
26,Bourgogne,58,1,03,249,Saint-Léger-de-Fougeret,300,8,308
26,Bourgogne,58,3,27,250,Saint-Léger-des-Vignes,2058,54,2112
26,Bourgogne,58,4,07,251,Saint-Loup,447,10,457
26,Bourgogne,58,4,09,252,Saint-Malo-en-Donziois,133,1,134
26,Bourgogne,58,3,26,254,Saint-Martin-d'Heuille,582,20,602
26,Bourgogne,58,2,12,255,Saint-Martin-du-Puy,311,9,320
26,Bourgogne,58,4,18,256,Saint-Martin-sur-Nohain,398,13,411
26,Bourgogne,58,3,23,257,Saint-Maurice,59,4,63
26,Bourgogne,58,3,27,258,Saint-Ouen-sur-Loire,503,11,514
26,Bourgogne,58,3,10,259,Saint-Parize-en-Viry,157,6,163
26,Bourgogne,58,3,22,260,Saint-Parize-le-Châtel,1294,26,1320
26,Bourgogne,58,4,07,261,Saint-Père,1106,31,1137
26,Bourgogne,58,1,03,262,Saint-Péreuse,279,7,286
26,Bourgogne,58,2,25,263,Saint-Pierre-du-Mont,198,3,201
26,Bourgogne,58,3,22,264,Saint-Pierre-le-Moûtier,1995,32,2027
26,Bourgogne,58,4,18,265,Saint-Quentin-sur-Nohain,126,2,128
26,Bourgogne,58,2,01,266,Saint-Révérien,231,1,232
26,Bourgogne,58,3,23,267,Saint-Saulge,881,100,981
26,Bourgogne,58,1,11,268,Saint-Seine,225,3,228
26,Bourgogne,58,3,21,269,Saint-Sulpice,467,14,481
26,Bourgogne,58,4,20,270,Saint-Vérain,360,6,366
26,Bourgogne,58,4,09,236,Sainte-Colombe-des-Bois,133,3,136
26,Bourgogne,58,3,23,253,Sainte-Marie,100,4,104
26,Bourgogne,58,2,24,271,Saizy,215,2,217
26,Bourgogne,58,2,06,272,Sardy-lès-Épiry,150,1,151
26,Bourgogne,58,3,32,273,Sauvigny-les-Bois,1515,35,1550
26,Bourgogne,58,1,13,274,Savigny-Poil-Fol,134,3,137
26,Bourgogne,58,3,23,275,Saxi-Bourdon,292,13,305
26,Bourgogne,58,1,13,276,Sémelay,262,7,269
26,Bourgogne,58,1,15,277,Sermages,220,4,224
26,Bourgogne,58,3,30,278,Sermoise-sur-Loire,1663,61,1724
26,Bourgogne,58,4,19,279,Sichamps,166,1,167
26,Bourgogne,58,3,27,280,Sougy-sur-Loire,601,14,615
26,Bourgogne,58,4,18,281,Suilly-la-Tour,552,13,565
26,Bourgogne,58,2,05,282,Surgy,449,14,463
26,Bourgogne,58,2,01,283,Taconnay,72,1,73
26,Bourgogne,58,2,24,284,Talon,51,0,51
26,Bourgogne,58,1,04,285,Tamnay-en-Bazois,184,4,188
26,Bourgogne,58,2,24,286,Tannay,615,16,631
26,Bourgogne,58,1,13,287,Tazilly,257,6,263
26,Bourgogne,58,2,24,288,Teigny,121,5,126
26,Bourgogne,58,1,11,289,Ternant,201,3,204
26,Bourgogne,58,1,11,290,Thaix,62,1,63
26,Bourgogne,58,3,27,291,Thianges,184,12,196
26,Bourgogne,58,1,04,292,Tintury,202,0,202
26,Bourgogne,58,3,10,293,Toury-Lurcy,418,4,422
26,Bourgogne,58,3,10,294,Toury-sur-Jour,127,2,129
26,Bourgogne,58,4,18,295,Tracy-sur-Loire,969,25,994
26,Bourgogne,58,3,10,296,Tresnay,169,2,171
26,Bourgogne,58,3,21,297,Trois-Vèvres,241,4,245
26,Bourgogne,58,4,02,298,Tronsanges,366,11,377
26,Bourgogne,58,2,05,299,Trucy-l'Orgueilleux,234,4,238
26,Bourgogne,58,3,26,300,Urzy,1822,43,1865
26,Bourgogne,58,1,15,301,Vandenesse,347,7,354
26,Bourgogne,58,4,02,302,Varennes-lès-Narcy,799,19,818
26,Bourgogne,58,3,26,303,Varennes-Vauzelles,9366,298,9664
26,Bourgogne,58,2,25,304,Varzy,1345,187,1532
26,Bourgogne,58,2,06,305,Vauclaix,117,2,119
26,Bourgogne,58,3,08,306,Verneuil,331,8,339
26,Bourgogne,58,4,18,307,Vielmanay,184,7,191
26,Bourgogne,58,2,24,308,Vignol,84,5,89
26,Bourgogne,58,1,15,309,Villapourçon,449,7,456
26,Bourgogne,58,3,21,311,Ville-Langy,286,4,290
26,Bourgogne,58,2,25,310,Villiers-le-Sec,49,1,50
26,Bourgogne,58,2,05,312,Villiers-sur-Yonne,295,10,305
26,Bourgogne,58,2,01,313,Vitry-Laché,126,1,127
31,Nord-Pas-de-Calais,59,2,14,001,Abancourt,448,12,460
31,Nord-Pas-de-Calais,59,6,21,002,Abscon,4221,38,4259
31,Nord-Pas-de-Calais,59,1,59,003,Aibes,354,6,360
31,Nord-Pas-de-Calais,59,3,47,004,Aix,1064,14,1078
31,Nord-Pas-de-Calais,59,5,57,005,Allennes-les-Marais,3380,48,3428
31,Nord-Pas-de-Calais,59,1,08,006,Amfroipret,207,0,207
31,Nord-Pas-de-Calais,59,3,22,007,Anhiers,985,15,1000
31,Nord-Pas-de-Calais,59,3,24,008,Aniche,10057,102,10159
31,Nord-Pas-de-Calais,59,2,43,010,Anneux,242,6,248
31,Nord-Pas-de-Calais,59,5,57,011,Annoeullin,9806,104,9910
31,Nord-Pas-de-Calais,59,1,64,012,Anor,3246,74,3320
31,Nord-Pas-de-Calais,59,5,33,013,Anstaing,1184,11,1195
31,Nord-Pas-de-Calais,59,6,71,014,Anzin,13895,236,14131
31,Nord-Pas-de-Calais,59,3,01,015,Arleux,2604,27,2631
31,Nord-Pas-de-Calais,59,4,09,016,Armbouts-Cappel,2440,49,2489
31,Nord-Pas-de-Calais,59,5,02,017,Armentières,24965,404,25369
31,Nord-Pas-de-Calais,59,4,16,018,Arnèke,1581,29,1610
31,Nord-Pas-de-Calais,59,6,67,019,Artres,1051,9,1060
31,Nord-Pas-de-Calais,59,1,44,021,Assevent,1721,20,1741
31,Nord-Pas-de-Calais,59,5,48,022,Attiches,2276,20,2296
31,Nord-Pas-de-Calais,59,2,14,023,Aubencheul-au-Bac,492,13,505
31,Nord-Pas-de-Calais,59,3,24,024,Auberchicourt,4591,49,4640
31,Nord-Pas-de-Calais,59,5,07,025,Aubers,1514,38,1552
31,Nord-Pas-de-Calais,59,3,01,026,Aubigny-au-Bac,1148,16,1164
31,Nord-Pas-de-Calais,59,6,66,027,Aubry-du-Hainaut,1444,20,1464
31,Nord-Pas-de-Calais,59,3,77,028,Auby,7646,47,7693
31,Nord-Pas-de-Calais,59,3,47,029,Auchy-lez-Orchies,1429,19,1448
31,Nord-Pas-de-Calais,59,1,08,031,Audignies,279,4,283
31,Nord-Pas-de-Calais,59,6,67,032,Aulnoy-lez-Valenciennes,7322,86,7408
31,Nord-Pas-de-Calais,59,1,10,033,Aulnoye-Aymeries,8757,206,8963
31,Nord-Pas-de-Calais,59,5,48,034,Avelin,2503,35,2538
31,Nord-Pas-de-Calais,59,1,04,035,Avesnelles,2556,47,2603
31,Nord-Pas-de-Calais,59,6,11,038,Avesnes-le-Sec,1350,13,1363
31,Nord-Pas-de-Calais,59,2,15,037,Avesnes-les-Aubert,3711,36,3747
31,Nord-Pas-de-Calais,59,1,86,036,Avesnes-sur-Helpe,5011,288,5299
31,Nord-Pas-de-Calais,59,2,13,039,Awoingt,549,19,568
31,Nord-Pas-de-Calais,59,1,10,041,Bachant,2387,32,2419
31,Nord-Pas-de-Calais,59,5,20,042,Bachy,1424,17,1441
31,Nord-Pas-de-Calais,59,4,87,043,Bailleul,13348,277,13625
31,Nord-Pas-de-Calais,59,5,33,044,Baisieux,4282,44,4326
31,Nord-Pas-de-Calais,59,1,64,045,Baives,155,6,161
31,Nord-Pas-de-Calais,59,4,31,046,Bambecque,708,9,717
31,Nord-Pas-de-Calais,59,2,43,047,Banteux,328,6,334
31,Nord-Pas-de-Calais,59,2,14,048,Bantigny,456,12,468
31,Nord-Pas-de-Calais,59,2,43,049,Bantouzelle,405,2,407
31,Nord-Pas-de-Calais,59,1,03,050,Bas-Lieu,317,12,329
31,Nord-Pas-de-Calais,59,5,07,051,La Bassée,6097,64,6161
31,Nord-Pas-de-Calais,59,5,57,052,Bauvin,5314,63,5377
31,Nord-Pas-de-Calais,59,1,08,053,Bavay,3475,92,3567
31,Nord-Pas-de-Calais,59,4,16,054,Bavinchove,935,27,962
31,Nord-Pas-de-Calais,59,2,17,055,Bazuel,591,7,598
31,Nord-Pas-de-Calais,59,5,74,056,Beaucamps-Ligny,901,29,930
31,Nord-Pas-de-Calais,59,1,49,057,Beaudignies,574,15,589
31,Nord-Pas-de-Calais,59,1,69,058,Beaufort,972,32,1004
31,Nord-Pas-de-Calais,59,2,17,059,Beaumont-en-Cambrésis,465,6,471
31,Nord-Pas-de-Calais,59,2,58,060,Beaurain,236,1,237
31,Nord-Pas-de-Calais,59,1,04,061,Beaurepaire-sur-Sambre,250,6,256
31,Nord-Pas-de-Calais,59,1,59,062,Beaurieux,169,1,170
31,Nord-Pas-de-Calais,59,2,15,063,Beauvois-en-Cambrésis,2105,27,2132
31,Nord-Pas-de-Calais,59,6,66,064,Bellaing,1222,11,1233
31,Nord-Pas-de-Calais,59,1,08,065,Bellignies,919,10,929
31,Nord-Pas-de-Calais,59,1,59,066,Bérelles,161,3,164
31,Nord-Pas-de-Calais,59,4,09,067,Bergues,3888,117,4005
31,Nord-Pas-de-Calais,59,1,10,068,Berlaimont,3202,46,3248
31,Nord-Pas-de-Calais,59,2,58,069,Bermerain,648,9,657
31,Nord-Pas-de-Calais,59,1,08,070,Bermeries,375,10,385
31,Nord-Pas-de-Calais,59,5,48,071,Bersée,2228,28,2256
31,Nord-Pas-de-Calais,59,1,44,072,Bersillies,273,15,288
31,Nord-Pas-de-Calais,59,4,06,073,Berthen,495,12,507
31,Nord-Pas-de-Calais,59,2,18,074,Bertry,2190,37,2227
31,Nord-Pas-de-Calais,59,2,15,075,Béthencourt,726,11,737
31,Nord-Pas-de-Calais,59,1,44,076,Bettignies,263,5,268
31,Nord-Pas-de-Calais,59,1,08,077,Bettrechies,243,4,247
31,Nord-Pas-de-Calais,59,1,03,078,Beugnies,523,8,531
31,Nord-Pas-de-Calais,59,6,71,079,Beuvrages,6900,58,6958
31,Nord-Pas-de-Calais,59,3,47,080,Beuvry-la-Forêt,2706,29,2735
31,Nord-Pas-de-Calais,59,2,15,081,Bévillers,576,8,584
31,Nord-Pas-de-Calais,59,4,09,082,Bierne,1619,39,1658
31,Nord-Pas-de-Calais,59,4,09,083,Bissezeele,189,5,194
31,Nord-Pas-de-Calais,59,4,29,084,Blaringhem,2023,46,2069
31,Nord-Pas-de-Calais,59,2,14,085,Blécourt,360,11,371
31,Nord-Pas-de-Calais,59,4,60,086,Boeschepe,2194,47,2241
31,Nord-Pas-de-Calais,59,4,30,087,Boëseghem,745,11,756
31,Nord-Pas-de-Calais,59,5,02,088,Bois-Grenier,1442,34,1476
31,Nord-Pas-de-Calais,59,4,68,089,Bollezeele,1388,20,1408
31,Nord-Pas-de-Calais,59,5,70,090,Bondues,9939,243,10182
31,Nord-Pas-de-Calais,59,4,30,091,Borre,576,11,587
31,Nord-Pas-de-Calais,59,6,11,092,Bouchain,4126,47,4173
31,Nord-Pas-de-Calais,59,1,04,093,Boulogne-sur-Helpe,333,11,344
31,Nord-Pas-de-Calais,59,4,12,094,Bourbourg,6658,101,6759
31,Nord-Pas-de-Calais,59,5,20,096,Bourghelles,1516,25,1541
31,Nord-Pas-de-Calais,59,2,43,097,Boursies,332,2,334
31,Nord-Pas-de-Calais,59,5,61,098,Bousbecque,4648,51,4699
31,Nord-Pas-de-Calais,59,1,32,099,Bousies,1680,17,1697
31,Nord-Pas-de-Calais,59,6,56,100,Bousignies,318,5,323
31,Nord-Pas-de-Calais,59,1,59,101,Bousignies-sur-Roc,409,9,418
31,Nord-Pas-de-Calais,59,2,15,102,Boussières-en-Cambrésis,418,5,423
31,Nord-Pas-de-Calais,59,1,69,103,Boussières-sur-Sambre,511,5,516
31,Nord-Pas-de-Calais,59,1,45,104,Boussois,3305,36,3341
31,Nord-Pas-de-Calais,59,3,42,105,Bouvignies,1498,22,1520
31,Nord-Pas-de-Calais,59,5,20,106,Bouvines,718,22,740
31,Nord-Pas-de-Calais,59,4,25,107,Bray-Dunes,4652,100,4752
31,Nord-Pas-de-Calais,59,2,58,108,Briastre,652,9,661
31,Nord-Pas-de-Calais,59,6,56,109,Brillon,732,19,751
31,Nord-Pas-de-Calais,59,4,12,110,Brouckerque,1274,46,1320
31,Nord-Pas-de-Calais,59,4,68,111,Broxeele,305,10,315
31,Nord-Pas-de-Calais,59,6,71,112,Bruay-sur-l'Escaut,12002,128,12130
31,Nord-Pas-de-Calais,59,3,42,113,Bruille-lez-Marchiennes,1330,21,1351
31,Nord-Pas-de-Calais,59,6,55,114,Bruille-Saint-Amand,1540,28,1568
31,Nord-Pas-de-Calais,59,3,01,115,Brunémont,551,1,552
31,Nord-Pas-de-Calais,59,1,50,116,Bry,363,6,369
31,Nord-Pas-de-Calais,59,3,01,117,Bugnicourt,906,13,919
31,Nord-Pas-de-Calais,59,2,18,118,Busigny,2534,31,2565
31,Nord-Pas-de-Calais,59,4,16,119,Buysscheure,506,3,509
31,Nord-Pas-de-Calais,59,4,29,120,Caëstre,1686,37,1723
31,Nord-Pas-de-Calais,59,2,13,121,Cagnoncles,514,9,523
31,Nord-Pas-de-Calais,59,2,88,122,Cambrai,32346,845,33191
31,Nord-Pas-de-Calais,59,5,57,123,Camphin-en-Carembault,1622,34,1656
31,Nord-Pas-de-Calais,59,5,20,124,Camphin-en-Pévèle,1702,18,1720
31,Nord-Pas-de-Calais,59,2,43,125,Cantaing-sur-Escaut,435,18,453
31,Nord-Pas-de-Calais,59,3,01,126,Cantin,1452,17,1469
31,Nord-Pas-de-Calais,59,2,58,127,Capelle,163,2,165
31,Nord-Pas-de-Calais,59,5,02,128,Capinghem,1617,22,1639
31,Nord-Pas-de-Calais,59,4,12,130,Cappelle-Brouck,1152,20,1172
31,Nord-Pas-de-Calais,59,5,20,129,Cappelle-en-Pévèle,1944,10,1954
31,Nord-Pas-de-Calais,59,4,26,131,Cappelle-la-Grande,8138,87,8225
31,Nord-Pas-de-Calais,59,2,15,132,Carnières,999,13,1012
31,Nord-Pas-de-Calais,59,5,57,133,Carnin,1039,16,1055
31,Nord-Pas-de-Calais,59,1,04,134,Cartignies,1220,18,1238
31,Nord-Pas-de-Calais,59,4,16,135,Cassel,2331,100,2431
31,Nord-Pas-de-Calais,59,2,17,136,Le Cateau-Cambrésis,7051,141,7192
31,Nord-Pas-de-Calais,59,2,17,137,Catillon-sur-Sambre,856,10,866
31,Nord-Pas-de-Calais,59,2,15,138,Cattenières,676,11,687
31,Nord-Pas-de-Calais,59,2,18,139,Caudry,13995,204,14199
31,Nord-Pas-de-Calais,59,2,18,140,Caullery,474,7,481
31,Nord-Pas-de-Calais,59,2,13,141,Cauroir,556,1,557
31,Nord-Pas-de-Calais,59,1,45,142,Cerfontaine,565,16,581
31,Nord-Pas-de-Calais,59,5,02,143,La Chapelle-d'Armentières,7857,95,7952
31,Nord-Pas-de-Calais,59,6,55,144,Château-l'Abbaye,863,11,874
31,Nord-Pas-de-Calais,59,5,57,145,Chemy,648,10,658
31,Nord-Pas-de-Calais,59,5,33,146,Chéreng,3046,61,3107
31,Nord-Pas-de-Calais,59,1,59,147,Choisies,70,4,74
31,Nord-Pas-de-Calais,59,1,59,148,Clairfayts,356,7,363
31,Nord-Pas-de-Calais,59,2,18,149,Clary,1147,23,1170
31,Nord-Pas-de-Calais,59,5,20,150,Cobrieux,530,9,539
31,Nord-Pas-de-Calais,59,1,45,151,Colleret,1686,44,1730
31,Nord-Pas-de-Calais,59,5,51,152,Comines,12438,114,12552
31,Nord-Pas-de-Calais,59,6,19,153,Condé-sur-l'Escaut,9744,91,9835
31,Nord-Pas-de-Calais,59,4,72,155,Coudekerque-Branche,22830,345,23175
31,Nord-Pas-de-Calais,59,4,72,154,Coudekerque-Village,1180,70,1250
31,Nord-Pas-de-Calais,59,3,23,156,Courchelettes,2782,19,2801
31,Nord-Pas-de-Calais,59,1,59,157,Cousolre,2470,46,2516
31,Nord-Pas-de-Calais,59,3,47,158,Coutiches,2546,41,2587
31,Nord-Pas-de-Calais,59,4,27,159,Craywick,598,18,616
31,Nord-Pas-de-Calais,59,6,19,160,Crespin,4426,18,4444
31,Nord-Pas-de-Calais,59,2,43,161,Crèvecoeur-sur-l'Escaut,689,33,722
31,Nord-Pas-de-Calais,59,4,09,162,Crochte,689,17,706
31,Nord-Pas-de-Calais,59,5,54,163,Croix,20821,280,21101
31,Nord-Pas-de-Calais,59,1,32,164,Croix-Caluyau,233,2,235
31,Nord-Pas-de-Calais,59,3,23,165,Cuincy,6693,96,6789
31,Nord-Pas-de-Calais,59,6,65,166,Curgies,1128,18,1146
31,Nord-Pas-de-Calais,59,2,14,167,Cuvillers,197,3,200
31,Nord-Pas-de-Calais,59,5,20,168,Cysoing,4457,69,4526
31,Nord-Pas-de-Calais,59,1,45,169,Damousies,222,4,226
31,Nord-Pas-de-Calais,59,3,24,170,Dechy,5093,40,5133
31,Nord-Pas-de-Calais,59,2,18,171,Dehéries,43,0,43
31,Nord-Pas-de-Calais,59,6,21,172,Denain,20221,151,20372
31,Nord-Pas-de-Calais,59,5,51,173,Deûlémont,1606,20,1626
31,Nord-Pas-de-Calais,59,1,59,174,Dimechaux,338,4,342
31,Nord-Pas-de-Calais,59,1,59,175,Dimont,324,8,332
31,Nord-Pas-de-Calais,59,2,43,176,Doignies,263,6,269
31,Nord-Pas-de-Calais,59,1,03,177,Dompierre-sur-Helpe,946,12,958
31,Nord-Pas-de-Calais,59,5,57,670,Don,1338,12,1350
31,Nord-Pas-de-Calais,59,3,89,178,Douai,42413,1236,43649
31,Nord-Pas-de-Calais,59,6,21,179,Douchy-les-Mines,9976,82,10058
31,Nord-Pas-de-Calais,59,4,46,180,Le Doulieu,1406,25,1431
31,Nord-Pas-de-Calais,59,1,03,181,Dourlers,545,13,558
31,Nord-Pas-de-Calais,59,4,12,182,Drincham,274,4,278
31,Nord-Pas-de-Calais,59,4,90,183,Dunkerque,68292,1280,69572
31,Nord-Pas-de-Calais,59,4,29,184,Ebblinghem,607,8,615
31,Nord-Pas-de-Calais,59,3,24,185,Écaillon,2055,21,2076
31,Nord-Pas-de-Calais,59,1,59,186,Eccles,107,0,107
31,Nord-Pas-de-Calais,59,1,69,187,Éclaibes,287,8,295
31,Nord-Pas-de-Calais,59,1,10,188,Écuélin,107,2,109
31,Nord-Pas-de-Calais,59,4,60,189,Eecke,1160,18,1178
31,Nord-Pas-de-Calais,59,1,44,190,Élesmes,879,33,912
31,Nord-Pas-de-Calais,59,2,18,191,Élincourt,646,8,654
31,Nord-Pas-de-Calais,59,6,11,192,Émerchicourt,912,59,971
31,Nord-Pas-de-Calais,59,5,28,193,Emmerin,3086,37,3123
31,Nord-Pas-de-Calais,59,1,49,194,Englefontaine,1329,16,1345
31,Nord-Pas-de-Calais,59,5,74,195,Englos,574,4,578
31,Nord-Pas-de-Calais,59,5,74,196,Ennetières-en-Weppes,1093,18,1111
31,Nord-Pas-de-Calais,59,5,48,197,Ennevelin,2188,38,2226
31,Nord-Pas-de-Calais,59,1,64,198,Eppe-Sauvage,254,2,256
31,Nord-Pas-de-Calais,59,3,01,199,Erchin,747,14,761
31,Nord-Pas-de-Calais,59,4,09,200,Eringhem,453,6,459
31,Nord-Pas-de-Calais,59,5,74,201,Erquinghem-le-Sec,540,3,543
31,Nord-Pas-de-Calais,59,5,02,202,Erquinghem-Lys,4474,55,4529
31,Nord-Pas-de-Calais,59,3,42,203,Erre,1400,10,1410
31,Nord-Pas-de-Calais,59,2,58,204,Escarmain,426,12,438
31,Nord-Pas-de-Calais,59,6,21,205,Escaudain,9020,85,9105
31,Nord-Pas-de-Calais,59,2,13,206,Escaudoeuvres,3417,28,3445
31,Nord-Pas-de-Calais,59,6,19,207,Escautpont,4211,72,4283
31,Nord-Pas-de-Calais,59,5,74,208,Escobecques,306,8,314
31,Nord-Pas-de-Calais,59,2,18,209,Esnes,651,10,661
31,Nord-Pas-de-Calais,59,4,68,210,Esquelbecq,2195,55,2250
31,Nord-Pas-de-Calais,59,3,23,211,Esquerchin,827,10,837
31,Nord-Pas-de-Calais,59,4,46,212,Estaires,5973,153,6126
31,Nord-Pas-de-Calais,59,2,15,213,Estourmel,450,11,461
31,Nord-Pas-de-Calais,59,3,01,214,Estrées,1006,29,1035
31,Nord-Pas-de-Calais,59,6,65,215,Estreux,932,23,955
31,Nord-Pas-de-Calais,59,2,13,219,Estrun,560,6,566
31,Nord-Pas-de-Calais,59,2,13,216,Eswars,359,7,366
31,Nord-Pas-de-Calais,59,1,50,217,Eth,334,14,348
31,Nord-Pas-de-Calais,59,1,04,218,Étroeungt,1372,19,1391
31,Nord-Pas-de-Calais,59,5,40,220,Faches-Thumesnil,16658,194,16852
31,Nord-Pas-de-Calais,59,6,67,221,Famars,2513,63,2576
31,Nord-Pas-de-Calais,59,3,47,222,Faumont,2081,47,2128
31,Nord-Pas-de-Calais,59,1,32,223,Le Favril,466,6,472
31,Nord-Pas-de-Calais,59,3,01,224,Féchain,1822,49,1871
31,Nord-Pas-de-Calais,59,1,08,225,Feignies,7245,109,7354
31,Nord-Pas-de-Calais,59,1,03,226,Felleries,1554,25,1579
31,Nord-Pas-de-Calais,59,3,42,227,Fenain,5351,50,5401
31,Nord-Pas-de-Calais,59,3,24,228,Férin,1388,21,1409
31,Nord-Pas-de-Calais,59,1,64,229,Féron,517,17,534
31,Nord-Pas-de-Calais,59,1,45,230,Ferrière-la-Grande,5430,86,5516
31,Nord-Pas-de-Calais,59,1,45,231,Ferrière-la-Petite,1000,26,1026
31,Nord-Pas-de-Calais,59,1,08,232,La Flamengrie,430,5,435
31,Nord-Pas-de-Calais,59,1,03,233,Flaumont-Waudrechies,368,3,371
31,Nord-Pas-de-Calais,59,3,77,234,Flers-en-Escrebieux,5453,57,5510
31,Nord-Pas-de-Calais,59,2,43,236,Flesquières,275,6,281
31,Nord-Pas-de-Calais,59,4,06,237,Flêtre,848,16,864
31,Nord-Pas-de-Calais,59,6,55,238,Flines-lès-Mortagne,1643,29,1672
31,Nord-Pas-de-Calais,59,3,22,239,Flines-lez-Raches,5448,91,5539
31,Nord-Pas-de-Calais,59,1,03,240,Floursies,135,0,135
31,Nord-Pas-de-Calais,59,1,04,241,Floyon,502,7,509
31,Nord-Pas-de-Calais,59,1,32,242,Fontaine-au-Bois,646,4,650
31,Nord-Pas-de-Calais,59,2,15,243,Fontaine-au-Pire,1187,23,1210
31,Nord-Pas-de-Calais,59,2,14,244,Fontaine-Notre-Dame,1663,38,1701
31,Nord-Pas-de-Calais,59,1,32,246,Forest-en-Cambrésis,549,2,551
31,Nord-Pas-de-Calais,59,5,33,247,Forest-sur-Marque,1461,23,1484
31,Nord-Pas-de-Calais,59,4,73,248,Fort-Mardyck,3563,43,3606
31,Nord-Pas-de-Calais,59,1,64,249,Fourmies,12996,284,13280
31,Nord-Pas-de-Calais,59,5,07,250,Fournes-en-Weppes,1986,99,2085
31,Nord-Pas-de-Calais,59,1,50,251,Frasnoy,335,4,339
31,Nord-Pas-de-Calais,59,5,02,252,Frelinghien,2518,27,2545
31,Nord-Pas-de-Calais,59,6,19,253,Fresnes-sur-Escaut,7689,64,7753
31,Nord-Pas-de-Calais,59,3,01,254,Fressain,880,18,898
31,Nord-Pas-de-Calais,59,2,14,255,Fressies,539,13,552
31,Nord-Pas-de-Calais,59,5,48,256,Fretin,3275,24,3299
31,Nord-Pas-de-Calais,59,5,07,257,Fromelles,876,24,900
31,Nord-Pas-de-Calais,59,5,20,258,Genech,2602,444,3046
31,Nord-Pas-de-Calais,59,1,49,259,Ghissignies,458,6,464
31,Nord-Pas-de-Calais,59,4,31,260,Ghyvelde,3197,69,3266
31,Nord-Pas-de-Calais,59,1,64,261,Glageon,1796,19,1815
31,Nord-Pas-de-Calais,59,4,60,262,Godewaersvelde,2020,35,2055
31,Nord-Pas-de-Calais,59,3,01,263,Goeulzin,1075,29,1104
31,Nord-Pas-de-Calais,59,1,44,264,Gognies-Chaussée,798,14,812
31,Nord-Pas-de-Calais,59,1,50,265,Gommegnies,2222,39,2261
31,Nord-Pas-de-Calais,59,5,57,266,Gondecourt,3934,55,3989
31,Nord-Pas-de-Calais,59,2,43,267,Gonnelieu,308,4,312
31,Nord-Pas-de-Calais,59,4,46,268,La Gorgue,5857,63,5920
31,Nord-Pas-de-Calais,59,2,43,269,Gouzeaucourt,1411,19,1430
31,Nord-Pas-de-Calais,59,1,04,270,Grand-Fayt,495,7,502
31,Nord-Pas-de-Calais,59,4,27,272,Grand-Fort-Philippe,5546,63,5609
31,Nord-Pas-de-Calais,59,4,73,271,Grande-Synthe,21031,306,21337
31,Nord-Pas-de-Calais,59,4,27,273,Gravelines,11473,348,11821
31,Nord-Pas-de-Calais,59,2,17,274,La Groise,458,6,464
31,Nord-Pas-de-Calais,59,5,33,275,Gruson,1140,46,1186
31,Nord-Pas-de-Calais,59,3,24,276,Guesnain,4550,47,4597
31,Nord-Pas-de-Calais,59,1,08,277,Gussignies,342,5,347
31,Nord-Pas-de-Calais,59,5,74,278,Hallennes-lez-Haubourdin,4046,26,4072
31,Nord-Pas-de-Calais,59,5,61,279,Halluin,19887,169,20056
31,Nord-Pas-de-Calais,59,3,01,280,Hamel,743,9,752
31,Nord-Pas-de-Calais,59,5,07,281,Hantay,1043,15,1058
31,Nord-Pas-de-Calais,59,4,16,282,Hardifort,384,6,390
31,Nord-Pas-de-Calais,59,1,10,283,Hargnies,571,10,581
31,Nord-Pas-de-Calais,59,6,55,284,Hasnon,3526,30,3556
31,Nord-Pas-de-Calais,59,6,11,285,Haspres,2713,29,2742
31,Nord-Pas-de-Calais,59,5,28,286,Haubourdin,14547,104,14651
31,Nord-Pas-de-Calais,59,2,18,287,Haucourt-en-Cambrésis,201,4,205
31,Nord-Pas-de-Calais,59,6,67,288,Haulchin,2363,31,2394
31,Nord-Pas-de-Calais,59,2,58,289,Haussy,1549,119,1668
31,Nord-Pas-de-Calais,59,1,04,290,Haut-Lieu,401,4,405
31,Nord-Pas-de-Calais,59,1,69,291,Hautmont,14744,172,14916
31,Nord-Pas-de-Calais,59,6,21,292,Haveluy,3153,30,3183
31,Nord-Pas-de-Calais,59,4,46,293,Haverskerque,1485,18,1503
31,Nord-Pas-de-Calais,59,2,14,294,Haynecourt,561,5,566
31,Nord-Pas-de-Calais,59,4,91,295,Hazebrouck,21711,507,22218
31,Nord-Pas-de-Calais,59,1,49,296,Hecq,341,2,343
31,Nord-Pas-de-Calais,59,6,21,297,Hélesmes,1929,14,1943
31,Nord-Pas-de-Calais,59,5,33,299,Hem,17734,173,17907
31,Nord-Pas-de-Calais,59,2,14,300,Hem-Lenglet,543,9,552
31,Nord-Pas-de-Calais,59,6,19,301,Hergnies,4235,46,4281
31,Nord-Pas-de-Calais,59,6,67,302,Hérin,3801,31,3832
31,Nord-Pas-de-Calais,59,5,07,303,Herlies,2080,29,2109
31,Nord-Pas-de-Calais,59,5,57,304,Herrin,415,4,419
31,Nord-Pas-de-Calais,59,4,68,305,Herzeele,1439,35,1474
31,Nord-Pas-de-Calais,59,1,59,306,Hestrud,273,6,279
31,Nord-Pas-de-Calais,59,4,12,307,Holque,960,8,968
31,Nord-Pas-de-Calais,59,1,08,310,Hon-Hergies,823,14,837
31,Nord-Pas-de-Calais,59,4,29,308,Hondeghem,948,22,970
31,Nord-Pas-de-Calais,59,4,31,309,Hondschoote,3956,113,4069
31,Nord-Pas-de-Calais,59,2,17,311,Honnechy,522,6,528
31,Nord-Pas-de-Calais,59,2,43,312,Honnecourt-sur-Escaut,779,15,794
31,Nord-Pas-de-Calais,59,6,11,313,Hordain,1484,22,1506
31,Nord-Pas-de-Calais,59,3,42,314,Hornaing,3238,36,3274
31,Nord-Pas-de-Calais,59,1,08,315,Houdain-lez-Bavay,845,14,859
31,Nord-Pas-de-Calais,59,5,78,316,Houplin-Ancoisne,3485,47,3532
31,Nord-Pas-de-Calais,59,5,02,317,Houplines,7533,136,7669
31,Nord-Pas-de-Calais,59,4,60,318,Houtkerque,852,15,867
31,Nord-Pas-de-Calais,59,4,09,319,Hoymille,3032,161,3193
31,Nord-Pas-de-Calais,59,5,07,320,Illies,1414,21,1435
31,Nord-Pas-de-Calais,59,2,17,321,Inchy,724,7,731
31,Nord-Pas-de-Calais,59,2,13,322,Iwuy,3156,39,3195
31,Nord-Pas-de-Calais,59,1,50,323,Jenlain,1085,24,1109
31,Nord-Pas-de-Calais,59,1,44,324,Jeumont,9935,164,10099
31,Nord-Pas-de-Calais,59,1,49,325,Jolimetz,921,22,943
31,Nord-Pas-de-Calais,59,4,31,326,Killem,962,26,988
31,Nord-Pas-de-Calais,59,3,22,327,Lallaing,6527,36,6563
31,Nord-Pas-de-Calais,59,5,38,328,Lambersart,28047,443,28490
31,Nord-Pas-de-Calais,59,3,23,329,Lambres-lez-Douai,5200,103,5303
31,Nord-Pas-de-Calais,59,3,47,330,Landas,2351,36,2387
31,Nord-Pas-de-Calais,59,1,32,331,Landrecies,3638,85,3723
31,Nord-Pas-de-Calais,59,5,33,332,Lannoy,1696,7,1703
31,Nord-Pas-de-Calais,59,1,04,333,Larouillies,277,5,282
31,Nord-Pas-de-Calais,59,3,23,334,Lauwin-Planque,1796,29,1825
31,Nord-Pas-de-Calais,59,6,56,335,Lecelles,2694,46,2740
31,Nord-Pas-de-Calais,59,3,01,336,Lécluse,1523,16,1539
31,Nord-Pas-de-Calais,59,4,68,337,Lederzeele,600,11,611
31,Nord-Pas-de-Calais,59,4,68,338,Ledringhem,663,13,676
31,Nord-Pas-de-Calais,59,5,33,339,Leers,9189,69,9258
31,Nord-Pas-de-Calais,59,4,25,340,Leffrinckoucke,4456,113,4569
31,Nord-Pas-de-Calais,59,2,43,341,Lesdain,403,7,410
31,Nord-Pas-de-Calais,59,5,78,343,Lesquin,6356,46,6402
31,Nord-Pas-de-Calais,59,1,10,344,Leval,2270,33,2303
31,Nord-Pas-de-Calais,59,3,24,345,Lewarde,2767,42,2809
31,Nord-Pas-de-Calais,59,1,59,342,Lez-Fontaine,205,8,213
31,Nord-Pas-de-Calais,59,5,40,346,Lezennes,3056,35,3091
31,Nord-Pas-de-Calais,59,1,59,347,Liessies,539,9,548
31,Nord-Pas-de-Calais,59,6,11,348,Lieu-Saint-Amand,1254,14,1268
31,Nord-Pas-de-Calais,59,2,18,349,Ligny-en-Cambrésis,1733,27,1760
31,Nord-Pas-de-Calais,59,5,92,350,Lille,225784,6298,232082
31,Nord-Pas-de-Calais,59,1,69,351,Limont-Fontaine,564,7,571
31,Nord-Pas-de-Calais,59,5,61,352,Linselles,8278,112,8390
31,Nord-Pas-de-Calais,59,1,49,353,Locquignol,331,4,335
31,Nord-Pas-de-Calais,59,3,24,354,Loffre,756,16,772
31,Nord-Pas-de-Calais,59,5,51,356,Lompret,2356,55,2411
31,Nord-Pas-de-Calais,59,1,08,357,La Longueville,2207,39,2246
31,Nord-Pas-de-Calais,59,4,12,358,Looberghe,1177,30,1207
31,Nord-Pas-de-Calais,59,4,27,359,Loon-Plage,6302,84,6386
31,Nord-Pas-de-Calais,59,5,28,360,Loos,21373,483,21856
31,Nord-Pas-de-Calais,59,6,11,361,Lourches,3957,43,4000
31,Nord-Pas-de-Calais,59,1,49,363,Louvignies-Quesnoy,959,21,980
31,Nord-Pas-de-Calais,59,5,20,364,Louvil,847,22,869
31,Nord-Pas-de-Calais,59,1,45,365,Louvroil,6849,65,6914
31,Nord-Pas-de-Calais,59,4,29,366,Lynde,658,10,668
31,Nord-Pas-de-Calais,59,5,33,367,Lys-lez-Lannoy,12812,122,12934
31,Nord-Pas-de-Calais,59,5,36,368,La Madeleine,22245,314,22559
31,Nord-Pas-de-Calais,59,6,67,369,Maing,3940,37,3977
31,Nord-Pas-de-Calais,59,1,44,370,Mairieux,758,18,776
31,Nord-Pas-de-Calais,59,5,74,371,Le Maisnil,532,21,553
31,Nord-Pas-de-Calais,59,2,18,372,Malincourt,495,6,501
31,Nord-Pas-de-Calais,59,1,04,374,Marbaix,462,12,474
31,Nord-Pas-de-Calais,59,3,42,375,Marchiennes,4726,66,4792
31,Nord-Pas-de-Calais,59,2,43,377,Marcoing,1856,35,1891
31,Nord-Pas-de-Calais,59,5,70,378,Marcq-en-Baroeul,38874,849,39723
31,Nord-Pas-de-Calais,59,3,01,379,Marcq-en-Ostrevent,545,10,555
31,Nord-Pas-de-Calais,59,1,50,381,Maresches,907,20,927
31,Nord-Pas-de-Calais,59,2,18,382,Maretz,1499,16,1515
31,Nord-Pas-de-Calais,59,6,65,383,Marly,11887,101,11988
31,Nord-Pas-de-Calais,59,1,32,384,Maroilles,1433,20,1453
31,Nord-Pas-de-Calais,59,1,44,385,Marpent,2636,33,2669
31,Nord-Pas-de-Calais,59,6,11,387,Marquette-en-Ostrevant,1606,17,1623
31,Nord-Pas-de-Calais,59,5,38,386,Marquette-lez-Lille,9760,76,9836
31,Nord-Pas-de-Calais,59,5,07,388,Marquillies,1796,23,1819
31,Nord-Pas-de-Calais,59,2,43,389,Masnières,2597,38,2635
31,Nord-Pas-de-Calais,59,3,24,390,Masny,4475,48,4523
31,Nord-Pas-de-Calais,59,6,11,391,Mastaing,920,18,938
31,Nord-Pas-de-Calais,59,1,93,392,Maubeuge,32374,408,32782
31,Nord-Pas-de-Calais,59,6,56,393,Maulde,976,10,986
31,Nord-Pas-de-Calais,59,2,17,394,Maurois,434,5,439
31,Nord-Pas-de-Calais,59,2,17,395,Mazinghien,330,2,332
31,Nord-Pas-de-Calais,59,1,08,396,Mecquignies,609,8,617
31,Nord-Pas-de-Calais,59,4,68,397,Merckeghem,577,10,587
31,Nord-Pas-de-Calais,59,5,48,398,Mérignies,2327,142,2469
31,Nord-Pas-de-Calais,59,4,06,399,Merris,1046,26,1072
31,Nord-Pas-de-Calais,59,4,46,400,Merville,8720,103,8823
31,Nord-Pas-de-Calais,59,4,06,401,Méteren,2159,33,2192
31,Nord-Pas-de-Calais,59,4,12,402,Millam,778,12,790
31,Nord-Pas-de-Calais,59,6,56,403,Millonfosse,678,7,685
31,Nord-Pas-de-Calais,59,4,31,404,Les Moëres,738,7,745
31,Nord-Pas-de-Calais,59,2,43,405,Moeuvres,479,3,482
31,Nord-Pas-de-Calais,59,1,10,406,Monceau-Saint-Waast,502,3,505
31,Nord-Pas-de-Calais,59,6,67,407,Monchaux-sur-Écaillon,558,13,571
31,Nord-Pas-de-Calais,59,5,48,408,Moncheaux,1437,19,1456
31,Nord-Pas-de-Calais,59,3,01,409,Monchecourt,2639,34,2673
31,Nord-Pas-de-Calais,59,5,37,410,Mons-en-Baroeul,22117,181,22298
31,Nord-Pas-de-Calais,59,5,48,411,Mons-en-Pévèle,2152,40,2192
31,Nord-Pas-de-Calais,59,2,17,412,Montay,354,3,357
31,Nord-Pas-de-Calais,59,2,18,413,Montigny-en-Cambrésis,584,14,598
31,Nord-Pas-de-Calais,59,3,24,414,Montigny-en-Ostrevent,4905,45,4950
31,Nord-Pas-de-Calais,59,2,58,415,Montrécourt,228,3,231
31,Nord-Pas-de-Calais,59,4,30,416,Morbecque,2692,60,2752
31,Nord-Pas-de-Calais,59,6,55,418,Mortagne-du-Nord,1636,17,1653
31,Nord-Pas-de-Calais,59,5,20,419,Mouchin,1351,21,1372
31,Nord-Pas-de-Calais,59,1,64,420,Moustier-en-Fagne,69,6,75
31,Nord-Pas-de-Calais,59,5,63,421,Mouvaux,13157,195,13352
31,Nord-Pas-de-Calais,59,2,13,422,Naves,612,11,623
31,Nord-Pas-de-Calais,59,4,46,423,Neuf-Berquin,1234,28,1262
31,Nord-Pas-de-Calais,59,1,69,424,Neuf-Mesnil,1264,15,1279
31,Nord-Pas-de-Calais,59,5,48,427,La Neuville,686,15,701
31,Nord-Pas-de-Calais,59,1,49,425,Neuville-en-Avesnois,289,11,300
31,Nord-Pas-de-Calais,59,5,62,426,Neuville-en-Ferrain,9731,87,9818
31,Nord-Pas-de-Calais,59,2,14,428,Neuville-Saint-Rémy,3739,52,3791
31,Nord-Pas-de-Calais,59,6,11,429,Neuville-sur-Escaut,2630,23,2653
31,Nord-Pas-de-Calais,59,2,17,430,Neuvilly,1013,4,1017
31,Nord-Pas-de-Calais,59,4,05,431,Nieppe,7689,105,7794
31,Nord-Pas-de-Calais,59,2,13,432,Niergnies,502,17,519
31,Nord-Pas-de-Calais,59,4,68,433,Nieurlet,976,16,992
31,Nord-Pas-de-Calais,59,6,56,434,Nivelle,1261,20,1281
31,Nord-Pas-de-Calais,59,3,47,435,Nomain,2454,40,2494
31,Nord-Pas-de-Calais,59,4,16,436,Noordpeene,785,17,802
31,Nord-Pas-de-Calais,59,5,78,437,Noyelles-lès-Seclin,896,10,906
31,Nord-Pas-de-Calais,59,2,43,438,Noyelles-sur-Escaut,765,12,777
31,Nord-Pas-de-Calais,59,1,10,439,Noyelles-sur-Sambre,326,8,334
31,Nord-Pas-de-Calais,59,6,11,440,Noyelles-sur-Selle,780,13,793
31,Nord-Pas-de-Calais,59,1,08,441,Obies,673,20,693
31,Nord-Pas-de-Calais,59,1,45,442,Obrechies,262,11,273
31,Nord-Pas-de-Calais,59,4,16,443,Ochtezeele,318,5,323
31,Nord-Pas-de-Calais,59,6,19,444,Odomez,946,10,956
31,Nord-Pas-de-Calais,59,1,64,445,Ohain,1285,20,1305
31,Nord-Pas-de-Calais,59,6,67,446,Oisy,529,9,538
31,Nord-Pas-de-Calais,59,6,65,447,Onnaing,8668,77,8745
31,Nord-Pas-de-Calais,59,4,31,448,Oost-Cappel,493,4,497
31,Nord-Pas-de-Calais,59,3,47,449,Orchies,8305,174,8479
31,Nord-Pas-de-Calais,59,2,17,450,Ors,663,16,679
31,Nord-Pas-de-Calais,59,1,50,451,Orsinval,486,8,494
31,Nord-Pas-de-Calais,59,5,48,452,Ostricourt,5175,52,5227
31,Nord-Pas-de-Calais,59,4,60,453,Oudezeele,636,10,646
31,Nord-Pas-de-Calais,59,4,16,454,Oxelaëre,482,16,498
31,Nord-Pas-de-Calais,59,2,14,455,Paillencourt,989,12,1001
31,Nord-Pas-de-Calais,59,3,42,456,Pecquencourt,5939,225,6164
31,Nord-Pas-de-Calais,59,5,51,457,Pérenchies,7853,48,7901
31,Nord-Pas-de-Calais,59,5,20,458,Péronne-en-Mélantois,871,11,882
31,Nord-Pas-de-Calais,59,1,04,461,Petit-Fayt,292,5,297
31,Nord-Pas-de-Calais,59,6,66,459,Petite-Forêt,4923,54,4977
31,Nord-Pas-de-Calais,59,5,48,462,Phalempin,4484,107,4591
31,Nord-Pas-de-Calais,59,4,09,463,Pitgam,917,28,945
31,Nord-Pas-de-Calais,59,1,49,464,Poix-du-Nord,2013,30,2043
31,Nord-Pas-de-Calais,59,2,17,465,Pommereuil,749,1,750
31,Nord-Pas-de-Calais,59,5,48,466,Pont-à-Marcq,2476,110,2586
31,Nord-Pas-de-Calais,59,1,10,467,Pont-sur-Sambre,2598,38,2636
31,Nord-Pas-de-Calais,59,1,49,468,Potelle,365,8,373
31,Nord-Pas-de-Calais,59,4,30,469,Pradelles,361,5,366
31,Nord-Pas-de-Calais,59,5,02,470,Prémesques,2106,21,2127
31,Nord-Pas-de-Calais,59,6,65,471,Préseau,1899,26,1925
31,Nord-Pas-de-Calais,59,1,32,472,Preux-au-Bois,801,4,805
31,Nord-Pas-de-Calais,59,1,50,473,Preux-au-Sart,277,6,283
31,Nord-Pas-de-Calais,59,1,32,474,Prisches,988,24,1012
31,Nord-Pas-de-Calais,59,6,67,475,Prouvy,2363,39,2402
31,Nord-Pas-de-Calais,59,2,14,476,Proville,3441,93,3534
31,Nord-Pas-de-Calais,59,5,57,477,Provin,3936,19,3955
31,Nord-Pas-de-Calais,59,4,09,478,Quaëdypre,1144,18,1162
31,Nord-Pas-de-Calais,59,6,65,479,Quarouble,3150,33,3183
31,Nord-Pas-de-Calais,59,6,67,480,Quérénaing,955,9,964
31,Nord-Pas-de-Calais,59,1,94,481,Le Quesnoy,5034,143,5177
31,Nord-Pas-de-Calais,59,5,51,482,Quesnoy-sur-Deûle,7138,67,7205
31,Nord-Pas-de-Calais,59,1,45,483,Quiévelon,152,4,156
31,Nord-Pas-de-Calais,59,6,65,484,Quiévrechain,5766,50,5816
31,Nord-Pas-de-Calais,59,2,15,485,Quiévy,1701,24,1725
31,Nord-Pas-de-Calais,59,3,77,486,Râches,2734,34,2768
31,Nord-Pas-de-Calais,59,5,74,487,Radinghem-en-Weppes,1259,32,1291
31,Nord-Pas-de-Calais,59,2,14,488,Raillencourt-Sainte-Olle,2373,42,2415
31,Nord-Pas-de-Calais,59,3,77,489,Raimbeaucourt,4222,58,4280
31,Nord-Pas-de-Calais,59,1,04,490,Rainsars,220,3,223
31,Nord-Pas-de-Calais,59,6,55,491,Raismes,13168,108,13276
31,Nord-Pas-de-Calais,59,2,13,492,Ramillies,575,9,584
31,Nord-Pas-de-Calais,59,1,03,493,Ramousies,238,0,238
31,Nord-Pas-de-Calais,59,1,49,494,Raucourt-au-Bois,161,1,162
31,Nord-Pas-de-Calais,59,1,45,495,Recquignies,2333,36,2369
31,Nord-Pas-de-Calais,59,2,17,496,Rejet-de-Beaulieu,234,2,236
31,Nord-Pas-de-Calais,59,4,29,497,Renescure,2044,39,2083
31,Nord-Pas-de-Calais,59,2,17,498,Reumont,365,1,366
31,Nord-Pas-de-Calais,59,4,31,499,Rexpoëde,1763,33,1796
31,Nord-Pas-de-Calais,59,2,43,500,Ribécourt-la-Tour,374,12,386
31,Nord-Pas-de-Calais,59,3,42,501,Rieulay,1409,27,1436
31,Nord-Pas-de-Calais,59,2,15,502,Rieux-en-Cambrésis,1480,15,1495
31,Nord-Pas-de-Calais,59,1,32,503,Robersart,179,6,185
31,Nord-Pas-de-Calais,59,6,11,504,Roeulx,3669,29,3698
31,Nord-Pas-de-Calais,59,6,65,505,Rombies-et-Marchipont,735,12,747
31,Nord-Pas-de-Calais,59,2,58,506,Romeries,431,2,433
31,Nord-Pas-de-Calais,59,5,40,507,Ronchin,18297,126,18423
31,Nord-Pas-de-Calais,59,5,61,508,Roncq,12677,171,12848
31,Nord-Pas-de-Calais,59,3,77,509,Roost-Warendin,6169,70,6239
31,Nord-Pas-de-Calais,59,6,56,511,Rosult,1876,42,1918
31,Nord-Pas-de-Calais,59,5,95,512,Roubaix,95893,789,96682
31,Nord-Pas-de-Calais,59,3,24,513,Roucourt,375,10,385
31,Nord-Pas-de-Calais,59,1,45,514,Rousies,4213,86,4299
31,Nord-Pas-de-Calais,59,6,67,515,Rouvignies,682,4,686
31,Nord-Pas-de-Calais,59,4,16,516,Rubrouck,925,8,933
31,Nord-Pas-de-Calais,59,2,43,517,Les Rues-des-Vignes,684,12,696
31,Nord-Pas-de-Calais,59,1,49,518,Ruesnes,450,7,457
31,Nord-Pas-de-Calais,59,6,56,519,Rumegies,1610,19,1629
31,Nord-Pas-de-Calais,59,2,43,520,Rumilly-en-Cambrésis,1481,10,1491
31,Nord-Pas-de-Calais,59,2,14,521,Sailly-lez-Cambrai,457,31,488
31,Nord-Pas-de-Calais,59,5,33,522,Sailly-lez-Lannoy,1779,38,1817
31,Nord-Pas-de-Calais,59,5,20,523,Sainghin-en-Mélantois,2364,54,2418
31,Nord-Pas-de-Calais,59,5,07,524,Sainghin-en-Weppes,5499,68,5567
31,Nord-Pas-de-Calais,59,1,04,525,Sains-du-Nord,3042,58,3100
31,Nord-Pas-de-Calais,59,6,96,526,Saint-Amand-les-Eaux,16692,184,16876
31,Nord-Pas-de-Calais,59,5,38,527,Saint-André-lez-Lille,10770,129,10899
31,Nord-Pas-de-Calais,59,2,15,528,Saint-Aubert,1466,15,1481
31,Nord-Pas-de-Calais,59,1,03,529,Saint-Aubin,372,15,387
31,Nord-Pas-de-Calais,59,6,19,530,Saint-Aybert,359,6,365
31,Nord-Pas-de-Calais,59,2,17,531,Saint-Benin,356,3,359
31,Nord-Pas-de-Calais,59,4,27,532,Saint-Georges-sur-l'Aa,290,9,299
31,Nord-Pas-de-Calais,59,2,15,533,Saint-Hilaire-lez-Cambrai,1637,21,1658
31,Nord-Pas-de-Calais,59,1,03,534,Saint-Hilaire-sur-Helpe,774,37,811
31,Nord-Pas-de-Calais,59,4,05,535,Saint-Jans-Cappel,1479,51,1530
31,Nord-Pas-de-Calais,59,2,58,537,Saint-Martin-sur-Écaillon,520,1,521
31,Nord-Pas-de-Calais,59,4,12,538,Saint-Momelin,381,8,389
31,Nord-Pas-de-Calais,59,4,12,539,Saint-Pierre-Brouck,918,23,941
31,Nord-Pas-de-Calais,59,4,26,540,Saint-Pol-sur-Mer,21783,237,22020
31,Nord-Pas-de-Calais,59,2,58,541,Saint-Python,1030,6,1036
31,Nord-Pas-de-Calais,59,1,10,542,Saint-Remy-Chaussée,454,13,467
31,Nord-Pas-de-Calais,59,1,69,543,Saint-Remy-du-Nord,1227,20,1247
31,Nord-Pas-de-Calais,59,6,71,544,Saint-Saulve,11196,155,11351
31,Nord-Pas-de-Calais,59,2,17,545,Saint-Souplet,1286,12,1298
31,Nord-Pas-de-Calais,59,4,60,546,Saint-Sylvestre-Cappel,1091,25,1116
31,Nord-Pas-de-Calais,59,2,58,547,Saint-Vaast-en-Cambrésis,866,11,877
31,Nord-Pas-de-Calais,59,1,08,548,Saint-Waast,588,17,605
31,Nord-Pas-de-Calais,59,4,16,536,Sainte-Marie-Cappel,831,28,859
31,Nord-Pas-de-Calais,59,1,49,549,Salesches,310,2,312
31,Nord-Pas-de-Calais,59,5,07,550,Salomé,3002,33,3035
31,Nord-Pas-de-Calais,59,3,47,551,Saméon,1489,21,1510
31,Nord-Pas-de-Calais,59,2,14,552,Sancourt,208,2,210
31,Nord-Pas-de-Calais,59,5,28,553,Santes,5360,65,5425
31,Nord-Pas-de-Calais,59,6,56,554,Sars-et-Rosières,510,6,516
31,Nord-Pas-de-Calais,59,1,59,555,Sars-Poteries,1469,14,1483
31,Nord-Pas-de-Calais,59,1,10,556,Sassegnies,280,1,281
31,Nord-Pas-de-Calais,59,6,65,557,Saultain,1950,33,1983
31,Nord-Pas-de-Calais,59,2,58,558,Saulzoir,1698,19,1717
31,Nord-Pas-de-Calais,59,6,65,559,Sebourg,1844,55,1899
31,Nord-Pas-de-Calais,59,5,85,560,Seclin,12249,122,12371
31,Nord-Pas-de-Calais,59,1,03,562,Sémeries,525,8,533
31,Nord-Pas-de-Calais,59,1,03,563,Semousies,237,4,241
31,Nord-Pas-de-Calais,59,6,67,564,La Sentinelle,3300,85,3385
31,Nord-Pas-de-Calais,59,1,50,565,Sepmeries,555,6,561
31,Nord-Pas-de-Calais,59,5,74,566,Sequedin,4417,28,4445
31,Nord-Pas-de-Calais,59,2,13,567,Séranvillers-Forenville,298,5,303
31,Nord-Pas-de-Calais,59,4,29,568,Sercus,397,6,403
31,Nord-Pas-de-Calais,59,3,22,569,Sin-le-Noble,16545,131,16676
31,Nord-Pas-de-Calais,59,4,09,570,Socx,979,50,1029
31,Nord-Pas-de-Calais,59,2,58,571,Solesmes,4583,146,4729
31,Nord-Pas-de-Calais,59,1,59,572,Solre-le-Château,1806,42,1848
31,Nord-Pas-de-Calais,59,1,59,573,Solrinnes,120,2,122
31,Nord-Pas-de-Calais,59,3,42,574,Somain,12212,121,12333
31,Nord-Pas-de-Calais,59,2,58,575,Sommaing,334,12,346
31,Nord-Pas-de-Calais,59,4,12,576,Spycker,1500,23,1523
31,Nord-Pas-de-Calais,59,4,29,577,Staple,656,6,662
31,Nord-Pas-de-Calais,59,4,30,578,Steenbecque,1714,29,1743
31,Nord-Pas-de-Calais,59,4,09,579,Steene,1235,30,1265
31,Nord-Pas-de-Calais,59,4,60,580,Steenvoorde,4024,87,4111
31,Nord-Pas-de-Calais,59,4,05,581,Steenwerck,3465,44,3509
31,Nord-Pas-de-Calais,59,4,30,582,Strazeele,677,6,683
31,Nord-Pas-de-Calais,59,1,03,583,Taisnières-en-Thiérache,497,18,515
31,Nord-Pas-de-Calais,59,1,08,584,Taisnières-sur-Hon,899,15,914
31,Nord-Pas-de-Calais,59,5,78,585,Templemars,3319,47,3366
31,Nord-Pas-de-Calais,59,5,20,586,Templeuve,5749,88,5837
31,Nord-Pas-de-Calais,59,4,60,587,Terdeghem,519,17,536
31,Nord-Pas-de-Calais,59,4,25,588,Téteghem,7213,254,7467
31,Nord-Pas-de-Calais,59,6,67,589,Thiant,2530,40,2570
31,Nord-Pas-de-Calais,59,4,30,590,Thiennes,805,13,818
31,Nord-Pas-de-Calais,59,6,19,591,Thivencelle,802,6,808
31,Nord-Pas-de-Calais,59,5,48,592,Thumeries,3889,30,3919
31,Nord-Pas-de-Calais,59,2,13,593,Thun-l'Évêque,628,2,630
31,Nord-Pas-de-Calais,59,6,56,594,Thun-Saint-Amand,1113,19,1132
31,Nord-Pas-de-Calais,59,2,13,595,Thun-Saint-Martin,532,9,541
31,Nord-Pas-de-Calais,59,2,14,597,Tilloy-lez-Cambrai,603,15,618
31,Nord-Pas-de-Calais,59,3,42,596,Tilloy-lez-Marchiennes,545,9,554
31,Nord-Pas-de-Calais,59,5,33,598,Toufflers,3790,24,3814
31,Nord-Pas-de-Calais,59,5,97,599,Tourcoing,92614,716,93330
31,Nord-Pas-de-Calais,59,5,48,600,Tourmignies,690,10,700
31,Nord-Pas-de-Calais,59,1,64,601,Trélon,3004,108,3112
31,Nord-Pas-de-Calais,59,5,33,602,Tressin,1210,65,1275
31,Nord-Pas-de-Calais,59,6,67,603,Trith-Saint-Léger,6504,81,6585
31,Nord-Pas-de-Calais,59,2,17,604,Troisvilles,777,7,784
31,Nord-Pas-de-Calais,59,4,25,605,Uxem,1285,33,1318
31,Nord-Pas-de-Calais,59,6,98,606,Valenciennes,42656,919,43575
31,Nord-Pas-de-Calais,59,1,49,607,Vendegies-au-Bois,476,6,482
31,Nord-Pas-de-Calais,59,2,58,608,Vendegies-sur-Écaillon,1095,12,1107
31,Nord-Pas-de-Calais,59,5,78,609,Vendeville,1644,20,1664
31,Nord-Pas-de-Calais,59,6,67,610,Verchain-Maugré,903,19,922
31,Nord-Pas-de-Calais,59,5,51,611,Verlinghem,2293,34,2327
31,Nord-Pas-de-Calais,59,2,58,612,Vertain,469,15,484
31,Nord-Pas-de-Calais,59,6,19,613,Vicq,1381,21,1402
31,Nord-Pas-de-Calais,59,2,58,614,Viesly,1412,12,1424
31,Nord-Pas-de-Calais,59,4,06,615,Vieux-Berquin,2304,34,2338
31,Nord-Pas-de-Calais,59,6,19,616,Vieux-Condé,10780,117,10897
31,Nord-Pas-de-Calais,59,1,10,617,Vieux-Mesnil,567,8,575
31,Nord-Pas-de-Calais,59,1,44,618,Vieux-Reng,817,17,834
31,Nord-Pas-de-Calais,59,5,84,009,Villeneuve-d'Ascq,62717,814,63531
31,Nord-Pas-de-Calais,59,1,50,619,Villereau,870,13,883
31,Nord-Pas-de-Calais,59,3,01,620,Villers-au-Tertre,607,11,618
31,Nord-Pas-de-Calais,59,2,15,622,Villers-en-Cauchies,1227,14,1241
31,Nord-Pas-de-Calais,59,2,43,623,Villers-Guislain,710,9,719
31,Nord-Pas-de-Calais,59,2,18,624,Villers-Outréaux,2162,50,2212
31,Nord-Pas-de-Calais,59,2,43,625,Villers-Plouich,397,8,405
31,Nord-Pas-de-Calais,59,1,50,626,Villers-Pol,1237,32,1269
31,Nord-Pas-de-Calais,59,1,44,627,Villers-Sire-Nicole,977,20,997
31,Nord-Pas-de-Calais,59,4,68,628,Volckerinckhove,474,10,484
31,Nord-Pas-de-Calais,59,3,42,629,Vred,1387,21,1408
31,Nord-Pas-de-Calais,59,5,48,630,Wahagnies,2591,57,2648
31,Nord-Pas-de-Calais,59,2,18,631,Walincourt-Selvigny,2089,37,2126
31,Nord-Pas-de-Calais,59,6,66,632,Wallers,5559,38,5597
31,Nord-Pas-de-Calais,59,1,64,633,Wallers-en-Fagne,272,2,274
31,Nord-Pas-de-Calais,59,4,29,634,Wallon-Cappel,911,26,937
31,Nord-Pas-de-Calais,59,2,15,635,Wambaix,306,17,323
31,Nord-Pas-de-Calais,59,5,38,636,Wambrechies,9828,111,9939
31,Nord-Pas-de-Calais,59,3,42,637,Wandignies-Hamage,1243,14,1257
31,Nord-Pas-de-Calais,59,5,20,638,Wannehain,902,9,911
31,Nord-Pas-de-Calais,59,1,50,639,Wargnies-le-Grand,1052,10,1062
31,Nord-Pas-de-Calais,59,1,50,640,Wargnies-le-Petit,783,11,794
31,Nord-Pas-de-Calais,59,4,31,641,Warhem,2069,59,2128
31,Nord-Pas-de-Calais,59,3,42,642,Warlaing,572,6,578
31,Nord-Pas-de-Calais,59,5,51,643,Warneton,191,1,192
31,Nord-Pas-de-Calais,59,6,11,645,Wasnes-au-Bac,571,5,576
31,Nord-Pas-de-Calais,59,5,54,646,Wasquehal,19026,274,19300
31,Nord-Pas-de-Calais,59,4,12,647,Watten,2704,33,2737
31,Nord-Pas-de-Calais,59,5,78,648,Wattignies,12803,207,13010
31,Nord-Pas-de-Calais,59,1,45,649,Wattignies-la-Victoire,269,10,279
31,Nord-Pas-de-Calais,59,5,99,650,Wattrelos,41829,281,42110
31,Nord-Pas-de-Calais,59,6,21,651,Wavrechain-sous-Denain,1704,16,1720
31,Nord-Pas-de-Calais,59,6,11,652,Wavrechain-sous-Faulx,422,4,426
31,Nord-Pas-de-Calais,59,5,28,653,Wavrin,7683,65,7748
31,Nord-Pas-de-Calais,59,3,22,654,Waziers,7651,57,7708
31,Nord-Pas-de-Calais,59,4,16,655,Wemaers-Cappel,256,1,257
31,Nord-Pas-de-Calais,59,5,51,656,Wervicq-Sud,4697,70,4767
31,Nord-Pas-de-Calais,59,4,09,657,West-Cappel,579,13,592
31,Nord-Pas-de-Calais,59,5,07,658,Wicres,314,5,319
31,Nord-Pas-de-Calais,59,1,64,659,Wignehies,3149,43,3192
31,Nord-Pas-de-Calais,59,5,33,660,Willems,2987,29,3016
31,Nord-Pas-de-Calais,59,1,64,661,Willies,158,3,161
31,Nord-Pas-de-Calais,59,4,60,662,Winnezeele,1233,27,1260
31,Nord-Pas-de-Calais,59,4,68,663,Wormhout,5254,88,5342
31,Nord-Pas-de-Calais,59,4,12,664,Wulverdinghe,260,9,269
31,Nord-Pas-de-Calais,59,4,09,665,Wylder,319,4,323
31,Nord-Pas-de-Calais,59,4,68,666,Zegerscappel,1479,21,1500
31,Nord-Pas-de-Calais,59,4,16,667,Zermezeele,194,3,197
31,Nord-Pas-de-Calais,59,4,25,668,Zuydcoote,1694,70,1764
31,Nord-Pas-de-Calais,59,4,16,669,Zuytpeene,563,11,574
22,Picardie,60,1,15,001,Abancourt,652,14,666
22,Picardie,60,1,28,002,Abbecourt,764,14,778
22,Picardie,60,2,16,003,Abbeville-Saint-Lucien,542,11,553
22,Picardie,60,1,22,004,Achy,335,3,338
22,Picardie,60,4,05,005,Acy-en-Multien,756,7,763
22,Picardie,60,2,20,006,Les Ageux,1147,21,1168
22,Picardie,60,2,08,007,Agnetz,2882,209,3091
22,Picardie,60,2,08,008,Airion,494,97,591
22,Picardie,60,1,04,009,Allonne,1500,55,1555
22,Picardie,60,1,23,010,Amblainville,1722,20,1742
22,Picardie,60,3,19,011,Amy,380,10,390
22,Picardie,60,1,23,012,Andeville,3332,40,3372
22,Picardie,60,2,20,013,Angicourt,1640,27,1667
22,Picardie,60,2,33,014,Angivillers,188,4,192
22,Picardie,60,2,24,015,Angy,1197,13,1210
22,Picardie,60,2,24,016,Ansacq,269,7,276
22,Picardie,60,2,06,017,Ansauvillers,1186,19,1205
22,Picardie,60,1,23,018,Anserville,481,8,489
22,Picardie,60,3,31,019,Antheuil-Portes,425,12,437
22,Picardie,60,4,05,020,Antilly,333,6,339
22,Picardie,60,3,29,021,Appilly,489,7,496
22,Picardie,60,4,36,022,Apremont,729,29,758
22,Picardie,60,3,41,023,Armancourt,543,15,558
22,Picardie,60,3,14,024,Arsy,784,31,815
22,Picardie,60,3,01,025,Attichy,1935,20,1955
22,Picardie,60,1,13,026,Auchy-la-Montagne,469,10,479
22,Picardie,60,4,12,027,Auger-Saint-Vincent,504,4,508
22,Picardie,60,4,34,028,Aumont-en-Halatte,564,22,586
22,Picardie,60,1,02,029,Auneuil,2775,40,2815
22,Picardie,60,1,02,030,Auteuil,586,9,595
22,Picardie,60,4,05,031,Autheuil-en-Valois,270,3,273
22,Picardie,60,3,01,032,Autrêches,744,12,756
22,Picardie,60,4,34,033,Avilly-Saint-Léonard,989,32,1021
22,Picardie,60,2,08,034,Avrechy,1100,13,1113
22,Picardie,60,3,19,035,Avricourt,257,5,262
22,Picardie,60,2,08,036,Avrigny,330,4,334
22,Picardie,60,3,29,037,Baboeuf,503,9,512
22,Picardie,60,1,07,038,Bachivillers,418,5,423
22,Picardie,60,2,06,039,Bacouël,464,10,474
22,Picardie,60,2,08,040,Bailleul-le-Soc,661,5,666
22,Picardie,60,1,27,041,Bailleul-sur-Thérain,2114,34,2148
22,Picardie,60,2,20,042,Bailleval,1469,36,1505
22,Picardie,60,3,32,043,Bailly,624,11,635
22,Picardie,60,4,26,044,Balagny-sur-Thérain,1412,21,1433
22,Picardie,60,4,34,045,Barbery,535,14,549
22,Picardie,60,4,05,046,Bargny,273,4,277
22,Picardie,60,4,25,047,Baron,798,23,821
22,Picardie,60,3,31,048,Baugy,291,6,297
22,Picardie,60,1,35,049,Bazancourt,131,6,137
22,Picardie,60,2,20,050,Bazicourt,327,6,333
22,Picardie,60,1,17,051,Beaudéduit,184,6,190
22,Picardie,60,3,18,052,Beaugies-sous-Bois,85,0,85
22,Picardie,60,3,19,053,Beaulieu-les-Fontaines,587,52,639
22,Picardie,60,1,02,054,Beaumont-les-Nonains,350,5,355
22,Picardie,60,3,29,055,Beaurains-lès-Noyon,284,5,289
22,Picardie,60,4,30,056,Beaurepaire,57,1,58
22,Picardie,60,1,99,057,Beauvais,54953,1429,56382
22,Picardie,60,2,06,058,Beauvoir,284,2,286
22,Picardie,60,3,29,059,Béhéricourt,217,5,222
22,Picardie,60,4,26,060,Belle-Église,571,11,582
22,Picardie,60,3,31,061,Belloy,85,1,86
22,Picardie,60,3,18,062,Berlancourt,319,4,323
22,Picardie,60,1,02,063,Berneuil-en-Bray,791,25,816
22,Picardie,60,3,01,064,Berneuil-sur-Aisne,1008,12,1020
22,Picardie,60,1,28,065,Berthecourt,1538,16,1554
22,Picardie,60,4,12,066,Béthancourt-en-Valois,251,14,265
22,Picardie,60,4,12,067,Béthisy-Saint-Martin,1094,27,1121
22,Picardie,60,4,12,068,Béthisy-Saint-Pierre,3234,41,3275
22,Picardie,60,4,05,069,Betz,1045,22,1067
22,Picardie,60,3,09,070,Bienville,460,48,508
22,Picardie,60,3,31,071,Biermont,163,5,168
22,Picardie,60,3,01,072,Bitry,300,3,303
22,Picardie,60,1,10,073,Blacourt,498,8,506
22,Picardie,60,4,39,074,Blaincourt-lès-Précy,1205,20,1225
22,Picardie,60,1,13,075,Blancfossé,133,2,135
22,Picardie,60,1,15,076,Blargies,489,6,495
22,Picardie,60,1,22,077,Blicourt,317,6,323
22,Picardie,60,2,08,078,Blincourt,111,0,111
22,Picardie,60,4,25,079,Boissy-Fresnoy,903,15,918
22,Picardie,60,1,07,080,Boissy-le-Bois,187,3,190
22,Picardie,60,1,27,081,Bonlier,384,3,387
22,Picardie,60,4,12,083,Bonneuil-en-Valois,1017,14,1031
22,Picardie,60,2,06,082,Bonneuil-les-Eaux,810,7,817
22,Picardie,60,1,22,084,Bonnières,161,7,168
22,Picardie,60,2,06,085,Bonvillers,201,3,204
22,Picardie,60,4,26,086,Boran-sur-Oise,2105,54,2159
22,Picardie,60,4,25,087,Borest,349,17,366
22,Picardie,60,1,23,088,Bornel,3627,42,3669
22,Picardie,60,1,07,089,Boubiers,366,4,370
22,Picardie,60,1,07,090,Bouconvillers,373,5,378
22,Picardie,60,4,05,091,Bouillancy,387,10,397
22,Picardie,60,4,05,092,Boullarre,222,3,225
22,Picardie,60,3,31,093,Boulogne-la-Grasse,441,5,446
22,Picardie,60,4,05,094,Boursonne,278,7,285
22,Picardie,60,1,07,095,Boury-en-Vexin,344,7,351
22,Picardie,60,1,15,096,Boutavent,69,3,72
22,Picardie,60,1,07,097,Boutencourt,252,4,256
22,Picardie,60,1,15,098,Bouvresse,164,5,169
22,Picardie,60,3,31,099,Braisnes,161,8,169
22,Picardie,60,4,30,100,Brasseuse,121,1,122
22,Picardie,60,4,05,101,Brégy,574,8,582
22,Picardie,60,2,20,102,Brenouille,2153,57,2210
22,Picardie,60,1,27,103,Bresles,4176,67,4243
22,Picardie,60,2,06,104,Breteuil,4307,105,4412
22,Picardie,60,3,29,105,Brétigny,365,10,375
22,Picardie,60,2,08,106,Breuil-le-Sec,2360,56,2416
22,Picardie,60,2,08,107,Breuil-le-Vert,2816,132,2948
22,Picardie,60,1,17,108,Briot,306,9,315
22,Picardie,60,1,17,109,Brombos,244,3,247
22,Picardie,60,1,15,110,Broquiers,223,0,223
22,Picardie,60,2,06,111,Broyes,149,4,153
22,Picardie,60,2,33,112,Brunvillers-la-Motte,328,3,331
22,Picardie,60,2,16,113,Bucamps,153,2,155
22,Picardie,60,1,35,114,Buicourt,140,4,144
22,Picardie,60,2,08,115,Bulles,893,14,907
22,Picardie,60,2,24,116,Bury,2980,44,3024
22,Picardie,60,3,18,117,Bussy,313,10,323
22,Picardie,60,3,29,118,Caisnes,483,6,489
22,Picardie,60,2,24,120,Cambronne-lès-Clermont,1039,20,1059
22,Picardie,60,3,32,119,Cambronne-lès-Ribécourt,1878,37,1915
22,Picardie,60,3,18,121,Campagne,143,2,145
22,Picardie,60,1,15,122,Campeaux,529,5,534
22,Picardie,60,2,16,123,Campremy,383,8,391
22,Picardie,60,3,19,124,Candor,252,7,259
22,Picardie,60,3,14,125,Canly,766,18,784
22,Picardie,60,3,19,126,Cannectancourt,543,8,551
22,Picardie,60,3,19,127,Canny-sur-Matz,350,4,354
22,Picardie,60,1,15,128,Canny-sur-Thérain,195,1,196
22,Picardie,60,3,32,129,Carlepont,1408,34,1442
22,Picardie,60,2,20,130,Catenoy,1070,69,1139
22,Picardie,60,1,13,131,Catheux,109,4,113
22,Picardie,60,3,18,132,Catigny,195,7,202
22,Picardie,60,2,33,133,Catillon-Fumechon,579,3,582
22,Picardie,60,2,20,134,Cauffry,2348,41,2389
22,Picardie,60,1,28,135,Cauvigny,1421,32,1453
22,Picardie,60,1,17,136,Cempuis,428,101,529
22,Picardie,60,2,33,137,Cernoy,226,2,228
22,Picardie,60,4,34,138,Chamant,921,30,951
22,Picardie,60,4,26,139,Chambly,9351,126,9477
22,Picardie,60,1,07,140,Chambors,321,10,331
22,Picardie,60,4,36,141,Chantilly,10957,236,11193
22,Picardie,60,4,34,142,La Chapelle-en-Serval,2684,53,2737
22,Picardie,60,1,07,143,Chaumont-en-Vexin,3014,49,3063
22,Picardie,60,1,23,144,Chavençon,143,0,143
22,Picardie,60,3,01,145,Chelles,448,14,462
22,Picardie,60,2,06,146,Chepoix,373,6,379
22,Picardie,60,3,32,147,Chevincourt,832,14,846
22,Picardie,60,4,25,148,Chèvreville,464,14,478
22,Picardie,60,3,14,149,Chevrières,1728,55,1783
22,Picardie,60,3,32,150,Chiry-Ourscamp,1143,25,1168
22,Picardie,60,3,09,151,Choisy-au-Bac,3448,171,3619
22,Picardie,60,2,08,152,Choisy-la-Victoire,202,1,203
22,Picardie,60,1,13,153,Choqueuse-les-Bénards,93,1,94
22,Picardie,60,2,20,154,Cinqueux,1578,53,1631
22,Picardie,60,4,26,155,Cires-lès-Mello,3513,68,3581
22,Picardie,60,3,09,156,Clairoix,2049,76,2125
22,Picardie,60,2,08,157,Clermont,10498,195,10693
22,Picardie,60,2,21,158,Coivrel,256,2,258
22,Picardie,60,3,97,159,Compiègne,41648,1599,43247
22,Picardie,60,3,31,160,Conchy-les-Pots,616,9,625
22,Picardie,60,1,13,161,Conteville,80,2,82
22,Picardie,60,1,23,162,Corbeil-Cerf,322,2,324
22,Picardie,60,1,13,163,Cormeilles,345,3,348
22,Picardie,60,1,10,164,Le Coudray-Saint-Germer,884,24,908
22,Picardie,60,1,28,165,Le Coudray-sur-Thelle,510,13,523
22,Picardie,60,3,31,166,Coudun,914,36,950
22,Picardie,60,3,01,167,Couloisy,478,5,483
22,Picardie,60,2,21,168,Courcelles-Epayelles,192,0,192
22,Picardie,60,1,07,169,Courcelles-lès-Gisors,862,20,882
22,Picardie,60,4,34,170,Courteuil,638,32,670
22,Picardie,60,3,01,171,Courtieux,184,3,187
22,Picardie,60,4,36,172,Coye-la-Forêt,3755,229,3984
22,Picardie,60,4,39,173,Cramoisy,649,3,652
22,Picardie,60,3,19,174,Crapeaumesnil,150,4,154
22,Picardie,60,4,98,175,Creil,34580,428,35008
22,Picardie,60,4,12,176,Crépy-en-Valois,13794,297,14091
22,Picardie,60,2,33,177,Cressonsacq,427,13,440
22,Picardie,60,1,13,178,Crèvecoeur-le-Grand,3336,122,3458
22,Picardie,60,2,21,179,Crèvecoeur-le-Petit,114,1,115
22,Picardie,60,1,35,180,Crillon,436,10,446
22,Picardie,60,3,18,181,Crisolles,1017,18,1035
22,Picardie,60,1,13,182,Le Crocq,166,3,169
22,Picardie,60,1,13,183,Croissy-sur-Celle,248,4,252
22,Picardie,60,3,01,184,Croutoy,231,6,237
22,Picardie,60,4,26,185,Crouy-en-Thelle,1046,13,1059
22,Picardie,60,2,33,186,Cuignières,211,1,212
22,Picardie,60,1,10,187,Cuigy-en-Bray,986,9,995
22,Picardie,60,3,01,188,Cuise-la-Motte,2205,127,2332
22,Picardie,60,3,29,189,Cuts,956,20,976
22,Picardie,60,4,05,190,Cuvergnon,315,8,323
22,Picardie,60,3,31,191,Cuvilly,601,8,609
22,Picardie,60,3,19,192,Cuy,229,3,232
22,Picardie,60,1,17,193,Daméraucourt,216,2,218
22,Picardie,60,1,17,194,Dargies,242,4,246
22,Picardie,60,1,07,195,Delincourt,537,11,548
22,Picardie,60,1,28,196,Le Déluge,481,8,489
22,Picardie,60,4,26,197,Dieudonné,846,12,858
22,Picardie,60,3,19,198,Dives,329,1,330
22,Picardie,60,1,13,199,Doméliers,227,4,231
22,Picardie,60,2,21,200,Domfront,326,2,328
22,Picardie,60,2,21,201,Dompierre,232,5,237
22,Picardie,60,4,12,203,Duvy,453,6,459
22,Picardie,60,3,19,204,Écuvilly,249,8,257
22,Picardie,60,1,17,205,Élencourt,54,2,56
22,Picardie,60,3,19,206,Élincourt-Sainte-Marguerite,842,21,863
22,Picardie,60,4,12,207,Éméville,285,7,292
22,Picardie,60,1,07,209,Énencourt-le-Sec,201,4,205
22,Picardie,60,1,07,208,Énencourt-Léage,119,2,121
22,Picardie,60,2,08,210,Épineuse,277,1,278
22,Picardie,60,1,07,211,Éragny-sur-Epte,581,4,585
22,Picardie,60,4,26,212,Ercuis,1425,12,1437
22,Picardie,60,4,25,213,Ermenonville,918,17,935
22,Picardie,60,1,35,214,Ernemont-Boutavent,191,1,192
22,Picardie,60,2,08,215,Erquery,520,15,535
22,Picardie,60,2,33,216,Erquinvillers,158,0,158
22,Picardie,60,1,35,217,Escames,204,7,211
22,Picardie,60,1,23,218,Esches,1238,18,1256
22,Picardie,60,1,15,219,Escles-Saint-Pierre,141,3,144
22,Picardie,60,1,10,220,Espaubourg,409,11,420
22,Picardie,60,2,06,221,Esquennoy,770,6,776
22,Picardie,60,2,33,222,Essuiles,531,5,536
22,Picardie,60,3,14,223,Estrées-Saint-Denis,3614,134,3748
22,Picardie,60,4,05,224,Étavigny,175,3,178
22,Picardie,60,2,08,225,Étouy,795,16,811
22,Picardie,60,4,25,226,Ève,433,5,438
22,Picardie,60,3,19,227,Évricourt,207,4,211
22,Picardie,60,1,07,228,Fay-les-Étangs,405,3,408
22,Picardie,60,1,27,230,Le Fay-Saint-Quentin,524,8,532
22,Picardie,60,3,14,229,Le Fayel,238,4,242
22,Picardie,60,4,12,231,Feigneux,425,19,444
22,Picardie,60,2,21,232,Ferrières,475,7,482
22,Picardie,60,1,17,233,Feuquières,1574,32,1606
22,Picardie,60,2,08,234,Fitz-James,2451,43,2494
22,Picardie,60,1,10,235,Flavacourt,710,20,730
22,Picardie,60,3,18,236,Flavy-le-Meldeux,176,1,177
22,Picardie,60,2,06,237,Fléchy,94,1,95
22,Picardie,60,4,30,238,Fleurines,1784,109,1893
22,Picardie,60,1,07,239,Fleury,494,8,502
22,Picardie,60,1,13,240,Fontaine-Bonneleau,283,3,286
22,Picardie,60,4,25,241,Fontaine-Chaalis,371,13,384
22,Picardie,60,1,22,242,Fontaine-Lavaganne,413,4,417
22,Picardie,60,1,27,243,Fontaine-Saint-Lucien,151,7,158
22,Picardie,60,1,35,244,Fontenay-Torcy,127,4,131
22,Picardie,60,1,15,245,Formerie,2121,34,2155
22,Picardie,60,1,23,246,Fosseuse,738,21,759
22,Picardie,60,2,08,247,Fouilleuse,107,1,108
22,Picardie,60,1,15,248,Fouilloy,204,1,205
22,Picardie,60,4,26,249,Foulangues,208,4,212
22,Picardie,60,1,40,250,Fouquenies,457,16,473
22,Picardie,60,1,27,251,Fouquerolles,261,9,270
22,Picardie,60,2,33,252,Fournival,481,10,491
22,Picardie,60,1,13,253,Francastel,402,5,407
22,Picardie,60,3,14,254,Francières,513,10,523
22,Picardie,60,3,18,255,Fréniches,304,4,308
22,Picardie,60,1,07,257,Fresne-Léguillon,472,4,476
22,Picardie,60,1,23,256,Fresneaux-Montchevreuil,747,7,754
22,Picardie,60,3,19,258,Fresnières,168,0,168
22,Picardie,60,4,26,259,Fresnoy-en-Thelle,953,7,960
22,Picardie,60,4,12,260,Fresnoy-la-Rivière,624,13,637
22,Picardie,60,4,25,261,Fresnoy-le-Luat,477,16,493
22,Picardie,60,2,21,262,Le Frestoy-Vaux,210,1,211
22,Picardie,60,3,18,263,Frétoy-le-Château,227,5,232
22,Picardie,60,1,02,264,Frocourt,550,1,551
22,Picardie,60,2,16,265,Froissy,905,18,923
22,Picardie,60,1,13,267,Le Gallet,151,3,154
22,Picardie,60,2,33,268,Gannes,322,1,323
22,Picardie,60,1,22,269,Gaudechart,338,59,397
22,Picardie,60,3,29,270,Genvry,860,8,868
22,Picardie,60,1,35,271,Gerberoy,92,4,96
22,Picardie,60,4,12,272,Gilocourt,598,7,605
22,Picardie,60,3,31,273,Giraumont,569,15,584
22,Picardie,60,4,12,274,Glaignes,358,16,374
22,Picardie,60,1,35,275,Glatigny,173,2,175
22,Picardie,60,2,21,276,Godenvillers,145,1,146
22,Picardie,60,1,04,277,Goincourt,1263,28,1291
22,Picardie,60,3,18,278,Golancourt,399,6,405
22,Picardie,60,4,05,279,Gondreville,235,3,238
22,Picardie,60,1,15,280,Gourchelles,132,2,134
22,Picardie,60,3,31,281,Gournay-sur-Aronde,593,7,600
22,Picardie,60,4,36,282,Gouvieux,9540,374,9914
22,Picardie,60,2,06,283,Gouy-les-Groseillers,36,0,36
22,Picardie,60,3,14,284,Grandfresnoy,1595,73,1668
22,Picardie,60,3,29,287,Grandrû,280,8,288
22,Picardie,60,2,33,285,Grandvillers-aux-Bois,290,8,298
22,Picardie,60,1,17,286,Grandvilliers,3056,123,3179
22,Picardie,60,1,35,288,Grémévillers,347,9,356
22,Picardie,60,1,17,289,Grez,241,2,243
22,Picardie,60,1,27,290,Guignecourt,400,15,415
22,Picardie,60,3,18,291,Guiscard,1913,27,1940
22,Picardie,60,3,19,292,Gury,206,6,212
22,Picardie,60,1,07,293,Hadancourt-le-Haut-Clocher,348,9,357
22,Picardie,60,3,31,294,Hainvillers,89,2,91
22,Picardie,60,1,17,295,Halloy,460,2,462
22,Picardie,60,1,17,297,Le Hamel,175,3,178
22,Picardie,60,1,35,296,Hannaches,126,2,128
22,Picardie,60,1,35,298,Hanvoile,590,9,599
22,Picardie,60,2,16,299,Hardivillers,575,3,578
22,Picardie,60,1,07,300,Hardivillers-en-Vexin,127,1,128
22,Picardie,60,1,35,301,Haucourt,142,3,145
22,Picardie,60,1,27,302,Haudivillers,788,17,805
22,Picardie,60,1,17,303,Hautbos,131,6,137
22,Picardie,60,1,22,304,Haute-Épine,293,9,302
22,Picardie,60,3,01,305,Hautefontaine,252,17,269
22,Picardie,60,1,35,306,Hécourt,149,3,152
22,Picardie,60,2,24,307,Heilles,590,5,595
22,Picardie,60,3,14,308,Hémévillers,415,12,427
22,Picardie,60,1,23,309,Hénonville,778,15,793
22,Picardie,60,1,40,310,Herchies,603,13,616
22,Picardie,60,2,06,311,La Hérelle,182,1,183
22,Picardie,60,1,15,312,Héricourt-sur-Thérain,112,1,113
22,Picardie,60,1,28,313,Hermes,2490,26,2516
22,Picardie,60,1,22,314,Hétomesnil,207,4,211
22,Picardie,60,1,10,315,Hodenc-en-Bray,436,13,449
22,Picardie,60,1,28,316,Hodenc-l'Évêque,233,4,237
22,Picardie,60,2,24,317,Hondainville,605,5,610
22,Picardie,60,3,14,318,Houdancourt,556,11,567
22,Picardie,60,1,02,319,La Houssoye,589,16,605
22,Picardie,60,4,05,320,Ivors,238,7,245
22,Picardie,60,1,23,321,Ivry-le-Temple,658,9,667
22,Picardie,60,1,07,322,Jaméricourt,253,3,256
22,Picardie,60,3,09,323,Janville,707,8,715
22,Picardie,60,3,01,324,Jaulzy,921,20,941
22,Picardie,60,3,41,325,Jaux,2281,65,2346
22,Picardie,60,3,41,326,Jonquières,590,27,617
22,Picardie,60,1,02,327,Jouy-sous-Thelle,876,13,889
22,Picardie,60,1,27,328,Juvignies,285,6,291
22,Picardie,60,3,19,329,Laberlière,174,0,174
22,Picardie,60,1,28,330,Laboissière-en-Thelle,1268,20,1288
22,Picardie,60,1,10,331,Labosse,450,13,463
22,Picardie,60,2,20,332,Labruyère,639,11,650
22,Picardie,60,1,10,333,Lachapelle-aux-Pots,1632,56,1688
22,Picardie,60,1,28,334,Lachapelle-Saint-Pierre,863,23,886
22,Picardie,60,1,35,335,Lachapelle-sous-Gerberoy,164,12,176
22,Picardie,60,1,13,336,Lachaussée-du-Bois-d'Écu,199,7,206
22,Picardie,60,3,14,337,Lachelle,593,30,623
22,Picardie,60,3,37,338,Lacroix-Saint-Ouen,4475,243,4718
22,Picardie,60,1,27,339,Lafraye,354,6,360
22,Picardie,60,3,19,340,Lagny,504,8,512
22,Picardie,60,4,25,341,Lagny-le-Sec,1817,38,1855
22,Picardie,60,2,20,342,Laigneville,3987,82,4069
22,Picardie,60,1,10,343,Lalande-en-Son,680,11,691
22,Picardie,60,1,10,344,Lalandelle,446,11,457
22,Picardie,60,2,08,345,Lamécourt,220,1,221
22,Picardie,60,4,36,346,Lamorlaye,9422,222,9644
22,Picardie,60,1,15,347,Lannoy-Cuillère,217,5,222
22,Picardie,60,3,29,348,Larbroye,470,14,484
22,Picardie,60,3,19,350,Lassigny,1377,19,1396
22,Picardie,60,3,31,351,Lataule,121,3,124
22,Picardie,60,1,07,352,Lattainville,146,4,150
22,Picardie,60,1,17,353,Lavacquerie,217,1,218
22,Picardie,60,1,17,354,Laverrière,39,0,39
22,Picardie,60,1,27,355,Laversines,1128,60,1188
22,Picardie,60,1,07,356,Lavilletertre,493,14,507
22,Picardie,60,2,21,357,Léglantiers,532,3,535
22,Picardie,60,4,05,358,Lévignen,870,12,882
22,Picardie,60,1,35,359,Lhéraule,163,6,169
22,Picardie,60,2,20,360,Liancourt,7150,88,7238
22,Picardie,60,1,07,361,Liancourt-Saint-Pierre,544,6,550
22,Picardie,60,3,18,362,Libermont,206,5,211
22,Picardie,60,1,07,363,Lierville,224,6,230
22,Picardie,60,2,33,364,Lieuvillers,608,19,627
22,Picardie,60,1,22,365,Lihus,372,5,377
22,Picardie,60,2,08,366,Litz,342,3,345
22,Picardie,60,1,07,367,Loconville,337,9,346
22,Picardie,60,3,32,368,Longueil-Annel,2301,37,2338
22,Picardie,60,3,14,369,Longueil-Sainte-Marie,1660,34,1694
22,Picardie,60,1,23,370,Lormaison,1318,16,1334
22,Picardie,60,1,35,371,Loueuse,150,2,152
22,Picardie,60,1,13,372,Luchy,552,3,555
22,Picardie,60,3,32,373,Machemont,733,12,745
22,Picardie,60,2,21,374,Maignelay-Montigny,2505,31,2536
22,Picardie,60,2,08,375,Maimbeville,360,6,366
22,Picardie,60,1,27,376,Maisoncelle-Saint-Pierre,158,4,162
22,Picardie,60,2,16,377,Maisoncelle-Tuilerie,313,3,316
22,Picardie,60,1,04,703,Aux Marais,738,15,753
22,Picardie,60,3,32,378,Marest-sur-Matz,398,13,411
22,Picardie,60,3,19,379,Mareuil-la-Motte,604,18,622
22,Picardie,60,4,05,380,Mareuil-sur-Ourcq,1564,9,1573
22,Picardie,60,3,19,381,Margny-aux-Cerises,240,3,243
22,Picardie,60,3,09,382,Margny-lès-Compiègne,7857,187,8044
22,Picardie,60,3,31,383,Margny-sur-Matz,506,7,513
22,Picardie,60,4,05,385,Marolles,667,13,680
22,Picardie,60,3,31,386,Marquéglise,383,4,387
22,Picardie,60,1,22,387,Marseille-en-Beauvaisis,1152,9,1161
22,Picardie,60,1,35,388,Martincourt,149,3,152
22,Picardie,60,3,18,389,Maucourt,264,2,266
22,Picardie,60,1,13,390,Maulers,195,4,199
22,Picardie,60,4,39,391,Maysel,262,5,267
22,Picardie,60,3,32,392,Mélicocq,665,12,677
22,Picardie,60,4,39,393,Mello,464,14,478
22,Picardie,60,2,21,394,Ménévillers,96,1,97
22,Picardie,60,1,23,395,Méru,12812,201,13013
22,Picardie,60,2,21,396,Méry-la-Bataille,622,4,626
22,Picardie,60,1,17,397,Le Mesnil-Conteville,108,2,110
22,Picardie,60,4,26,398,Le Mesnil-en-Thelle,2286,23,2309
22,Picardie,60,2,06,399,Le Mesnil-Saint-Firmin,146,68,214
22,Picardie,60,2,33,400,Le Mesnil-sur-Bulles,231,2,233
22,Picardie,60,1,02,401,Le Mesnil-Théribus,798,39,837
22,Picardie,60,3,41,402,Le Meux,2040,100,2140
22,Picardie,60,1,22,403,Milly-sur-Thérain,1656,26,1682
22,Picardie,60,2,20,404,Mogneville,1486,44,1530
22,Picardie,60,1,15,405,Moliens,1047,18,1065
22,Picardie,60,2,20,406,Monceaux,755,21,776
22,Picardie,60,1,15,407,Monceaux-l'Abbaye,177,2,179
22,Picardie,60,3,31,408,Monchy-Humières,633,40,673
22,Picardie,60,2,20,409,Monchy-Saint-Éloi,1996,58,2054
22,Picardie,60,3,29,410,Mondescourt,271,8,279
22,Picardie,60,1,07,411,Monneville,840,9,849
22,Picardie,60,4,34,421,Mont-l'Évêque,442,12,454
22,Picardie,60,1,02,428,Le Mont-Saint-Adrien,576,18,594
22,Picardie,60,1,07,412,Montagny-en-Vexin,540,26,566
22,Picardie,60,4,25,413,Montagny-Sainte-Félicité,413,15,428
22,Picardie,60,4,39,414,Montataire,12495,157,12652
22,Picardie,60,4,34,415,Montépilloy,159,5,164
22,Picardie,60,2,21,416,Montgérain,156,1,157
22,Picardie,60,1,23,417,Montherlant,119,5,124
22,Picardie,60,2,33,418,Montiers,425,4,429
22,Picardie,60,1,07,420,Montjavoult,497,9,506
22,Picardie,60,4,25,422,Montlognon,227,10,237
22,Picardie,60,3,32,423,Montmacq,1114,23,1137
22,Picardie,60,3,14,424,Montmartin,208,6,214
22,Picardie,60,2,16,425,Montreuil-sur-Brêche,529,3,532
22,Picardie,60,1,28,426,Montreuil-sur-Thérain,231,1,232
22,Picardie,60,1,23,427,Monts,178,2,180
22,Picardie,60,4,26,429,Morangles,342,2,344
22,Picardie,60,4,12,430,Morienval,1030,25,1055
22,Picardie,60,3,29,431,Morlincourt,476,14,490
22,Picardie,60,4,34,432,Mortefontaine,885,25,910
22,Picardie,60,1,28,433,Mortefontaine-en-Thelle,831,9,840
22,Picardie,60,3,31,434,Mortemer,192,4,196
22,Picardie,60,1,35,435,Morvillers,440,14,454
22,Picardie,60,2,06,436,Mory-Montcrux,94,1,95
22,Picardie,60,1,28,437,Mouchy-le-Châtel,72,5,77
22,Picardie,60,3,01,438,Moulin-sous-Touvent,214,3,217
22,Picardie,60,2,24,439,Mouy,5378,96,5474
22,Picardie,60,2,33,440,Moyenneville,597,13,610
22,Picardie,60,3,14,441,Moyvillers,601,17,618
22,Picardie,60,1,13,442,Muidorge,156,1,157
22,Picardie,60,3,18,443,Muirancourt,551,9,560
22,Picardie,60,1,15,444,Mureaumont,158,2,160
22,Picardie,60,3,01,445,Nampcel,341,9,350
22,Picardie,60,4,25,446,Nanteuil-le-Haudouin,3330,101,3431
22,Picardie,60,4,12,447,Néry,713,12,725
22,Picardie,60,4,05,448,Neufchelles,373,5,378
22,Picardie,60,3,31,449,Neufvy-sur-Aronde,221,1,222
22,Picardie,60,4,26,450,Neuilly-en-Thelle,3132,37,3169
22,Picardie,60,2,24,451,Neuilly-sous-Clermont,1655,31,1686
22,Picardie,60,1,23,452,Neuville-Bosc,522,6,528
22,Picardie,60,1,28,453,La Neuville-d'Aumont,272,8,280
22,Picardie,60,2,08,454,La Neuville-en-Hez,977,13,990
22,Picardie,60,1,02,455,La Neuville-Garnier,273,6,279
22,Picardie,60,2,33,456,La Neuville-Roy,1002,23,1025
22,Picardie,60,2,16,457,La Neuville-Saint-Pierre,164,0,164
22,Picardie,60,1,22,458,La Neuville-sur-Oudeuil,312,5,317
22,Picardie,60,3,31,459,La Neuville-sur-Ressons,225,4,229
22,Picardie,60,1,22,460,La Neuville-Vault,152,6,158
22,Picardie,60,1,27,461,Nivillers,206,29,235
22,Picardie,60,1,28,462,Noailles,2685,54,2739
22,Picardie,60,4,11,463,Nogent-sur-Oise,19643,390,20033
22,Picardie,60,2,20,464,Nointel,1007,27,1034
22,Picardie,60,2,16,465,Noirémont,169,4,173
22,Picardie,60,2,33,466,Noroy,194,7,201
22,Picardie,60,2,33,468,Nourard-le-Franc,342,15,357
22,Picardie,60,1,28,469,Novillers,369,4,373
22,Picardie,60,2,16,470,Noyers-Saint-Martin,730,18,748
22,Picardie,60,3,29,471,Noyon,13821,353,14174
22,Picardie,60,1,17,472,Offoy,102,0,102
22,Picardie,60,4,25,473,Ognes,260,7,267
22,Picardie,60,3,18,474,Ognolles,271,1,272
22,Picardie,60,4,34,475,Ognon,144,0,144
22,Picardie,60,1,15,476,Omécourt,155,4,159
22,Picardie,60,1,02,477,Ons-en-Bray,1273,34,1307
22,Picardie,60,4,05,478,Ormoy-le-Davien,291,2,293
22,Picardie,60,4,12,479,Ormoy-Villers,640,7,647
22,Picardie,60,1,27,480,Oroër,532,11,543
22,Picardie,60,4,12,481,Orrouy,579,12,591
22,Picardie,60,4,34,482,Orry-la-Ville,3313,76,3389
22,Picardie,60,3,31,483,Orvillers-Sorel,510,84,594
22,Picardie,60,1,22,484,Oudeuil,244,6,250
22,Picardie,60,2,16,485,Oursel-Maison,259,7,266
22,Picardie,60,2,06,486,Paillart,609,5,614
22,Picardie,60,1,07,487,Parnes,375,14,389
22,Picardie,60,3,29,488,Passel,307,5,312
22,Picardie,60,4,25,489,Péroy-les-Gombries,1046,19,1065
22,Picardie,60,1,40,490,Pierrefitte-en-Beauvaisis,383,15,398
22,Picardie,60,3,01,491,Pierrefonds,2015,172,2187
22,Picardie,60,3,32,492,Pimprez,726,17,743
22,Picardie,60,1,22,493,Pisseleu,412,11,423
22,Picardie,60,4,34,494,Plailly,1658,27,1685
22,Picardie,60,2,33,495,Plainval,350,7,357
22,Picardie,60,2,06,496,Plainville,175,0,175
22,Picardie,60,2,33,497,Le Plessier-sur-Bulles,157,2,159
22,Picardie,60,2,33,498,Le Plessier-sur-Saint-Just,491,7,498
22,Picardie,60,4,25,500,Le Plessis-Belleville,3149,44,3193
22,Picardie,60,3,32,501,Le Plessis-Brion,1456,26,1482
22,Picardie,60,3,19,499,Plessis-de-Roye,234,11,245
22,Picardie,60,3,18,502,Le Plessis-Patte-d'Oie,86,2,88
22,Picardie,60,2,21,503,Le Ployron,105,2,107
22,Picardie,60,1,28,504,Ponchon,1100,23,1123
22,Picardie,60,3,29,506,Pont-l'Évêque,722,8,730
22,Picardie,60,4,30,509,Pont-Sainte-Maxence,11887,172,12059
22,Picardie,60,4,34,505,Pontarmé,738,13,751
22,Picardie,60,3,29,507,Pontoise-lès-Noyon,474,7,481
22,Picardie,60,4,30,508,Pontpoint,2963,50,3013
22,Picardie,60,1,02,510,Porcheux,296,2,298
22,Picardie,60,3,29,511,Porquéricourt,348,2,350
22,Picardie,60,1,23,512,Pouilly,168,8,176
22,Picardie,60,4,39,513,Précy-sur-Oise,3306,75,3381
22,Picardie,60,1,22,514,Prévillers,156,0,156
22,Picardie,60,2,33,515,Pronleroy,406,9,415
22,Picardie,60,1,10,516,Puiseux-en-Bray,399,3,402
22,Picardie,60,4,26,517,Puiseux-le-Hauberger,844,8,852
22,Picardie,60,2,16,518,Puits-la-Vallée,204,6,210
22,Picardie,60,3,18,519,Quesmy,192,3,195
22,Picardie,60,2,16,520,Le Quesnel-Aubry,153,5,158
22,Picardie,60,1,15,521,Quincampoix-Fleuzy,409,10,419
22,Picardie,60,2,33,522,Quinquempoix,329,6,335
22,Picardie,60,1,02,523,Rainvillers,874,34,908
22,Picardie,60,2,20,524,Rantigny,2542,34,2576
22,Picardie,60,4,30,525,Raray,151,0,151
22,Picardie,60,2,33,526,Ravenel,1142,9,1151
22,Picardie,60,4,05,527,Réez-Fosse-Martin,170,5,175
22,Picardie,60,1,07,528,Reilly,148,6,154
22,Picardie,60,2,08,529,Rémécourt,87,1,88
22,Picardie,60,2,08,530,Rémérangles,227,4,231
22,Picardie,60,3,14,531,Remy,1746,69,1815
22,Picardie,60,1,23,532,Ressons-l'Abbaye,98,1,99
22,Picardie,60,3,31,533,Ressons-sur-Matz,1570,53,1623
22,Picardie,60,3,01,534,Rethondes,705,29,734
22,Picardie,60,2,16,535,Reuil-sur-Brêche,277,3,280
22,Picardie,60,4,30,536,Rhuis,137,0,137
22,Picardie,60,3,32,537,Ribécourt-Dreslincourt,3895,177,4072
22,Picardie,60,3,31,538,Ricquebourg,208,4,212
22,Picardie,60,2,20,539,Rieux,1615,29,1644
22,Picardie,60,3,14,540,Rivecourt,538,7,545
22,Picardie,60,4,30,541,Roberval,373,5,378
22,Picardie,60,1,27,542,Rochy-Condé,857,10,867
22,Picardie,60,4,12,543,Rocquemont,100,5,105
22,Picardie,60,2,06,544,Rocquencourt,184,2,186
22,Picardie,60,1,15,545,Romescamps,530,6,536
22,Picardie,60,4,25,546,Rosières,135,0,135
22,Picardie,60,2,20,547,Rosoy,617,12,629
22,Picardie,60,4,05,548,Rosoy-en-Multien,496,1,497
22,Picardie,60,1,13,549,Rotangy,197,9,206
22,Picardie,60,1,22,550,Rothois,191,2,193
22,Picardie,60,2,24,551,Rousseloy,304,11,315
22,Picardie,60,4,12,552,Rouville,297,13,310
22,Picardie,60,2,33,553,Rouvillers,257,7,264
22,Picardie,60,4,05,554,Rouvres-en-Multien,475,7,482
22,Picardie,60,2,06,555,Rouvroy-les-Merles,77,61,138
22,Picardie,60,1,22,557,Roy-Boissy,339,5,344
22,Picardie,60,2,21,556,Royaucourt,219,1,220
22,Picardie,60,3,19,558,Roye-sur-Matz,432,7,439
22,Picardie,60,2,08,559,La Rue-Saint-Pierre,757,16,773
22,Picardie,60,4,30,560,Rully,727,36,763
22,Picardie,60,4,12,561,Russy-Bémont,183,3,186
22,Picardie,60,2,20,562,Sacy-le-Grand,1362,24,1386
22,Picardie,60,2,20,563,Sacy-le-Petit,557,10,567
22,Picardie,60,2,21,564,Sains-Morainvillers,268,2,270
22,Picardie,60,2,16,565,Saint-André-Farivillers,511,9,520
22,Picardie,60,1,15,566,Saint-Arnoult,179,5,184
22,Picardie,60,1,10,567,Saint-Aubin-en-Bray,1061,33,1094
22,Picardie,60,2,08,568,Saint-Aubin-sous-Erquery,321,4,325
22,Picardie,60,3,01,569,Saint-Crépin-aux-Bois,251,13,264
22,Picardie,60,1,23,570,Saint-Crépin-Ibouvillers,1185,10,1195
22,Picardie,60,1,35,571,Saint-Deniscourt,89,5,94
22,Picardie,60,3,01,572,Saint-Étienne-Roilaye,325,9,334
22,Picardie,60,2,24,574,Saint-Félix,546,6,552
22,Picardie,60,1,02,576,Saint-Germain-la-Poterie,414,17,431
22,Picardie,60,1,10,577,Saint-Germer-de-Fly,1755,37,1792
22,Picardie,60,3,37,579,Saint-Jean-aux-Bois,309,27,336
22,Picardie,60,2,33,581,Saint-Just-en-Chaussée,5522,87,5609
22,Picardie,60,3,32,582,Saint-Léger-aux-Bois,836,25,861
22,Picardie,60,1,02,583,Saint-Léger-en-Bray,332,9,341
22,Picardie,60,4,39,584,Saint-Leu-d'Esserent,4696,100,4796
22,Picardie,60,2,21,585,Saint-Martin-aux-Bois,292,2,294
22,Picardie,60,1,04,586,Saint-Martin-le-Noeud,1066,31,1097
22,Picardie,60,2,20,587,Saint-Martin-Longueau,1470,27,1497
22,Picardie,60,1,17,588,Saint-Maur,388,6,394
22,Picardie,60,4,36,589,Saint-Maximin,2519,136,2655
22,Picardie,60,1,22,590,Saint-Omer-en-Chaussée,1321,23,1344
22,Picardie,60,1,02,591,Saint-Paul,1574,53,1627
22,Picardie,60,1,10,592,Saint-Pierre-es-Champs,676,3,679
22,Picardie,60,3,01,593,Saint-Pierre-lès-Bitry,128,0,128
22,Picardie,60,1,35,594,Saint-Quentin-des-Prés,280,6,286
22,Picardie,60,2,33,595,Saint-Remy-en-l'Eau,412,7,419
22,Picardie,60,1,15,596,Saint-Samson-la-Poterie,247,2,249
22,Picardie,60,3,37,597,Saint-Sauveur,1561,76,1637
22,Picardie,60,1,28,598,Saint-Sulpice,934,107,1041
22,Picardie,60,1,17,599,Saint-Thibault,259,5,264
22,Picardie,60,4,30,600,Saint-Vaast-de-Longmont,601,14,615
22,Picardie,60,4,39,601,Saint-Vaast-lès-Mello,899,17,916
22,Picardie,60,1,15,602,Saint-Valery,56,0,56
22,Picardie,60,2,16,573,Sainte-Eusoye,241,5,246
22,Picardie,60,1,28,575,Sainte-Geneviève,2647,49,2696
22,Picardie,60,4,12,578,Saintines,898,12,910
22,Picardie,60,3,29,603,Salency,904,16,920
22,Picardie,60,1,17,604,Sarcus,269,3,272
22,Picardie,60,1,17,605,Sarnois,313,3,316
22,Picardie,60,1,13,608,Le Saulchoy,104,1,105
22,Picardie,60,1,40,609,Savignies,747,30,777
22,Picardie,60,3,29,610,Sempigny,828,17,845
22,Picardie,60,1,35,611,Senantes,668,18,686
22,Picardie,60,4,34,612,Senlis,16285,665,16950
22,Picardie,60,1,07,613,Senots,317,15,332
22,Picardie,60,1,07,614,Serans,227,2,229
22,Picardie,60,2,06,615,Sérévillers,118,3,121
22,Picardie,60,1,10,616,Sérifontaine,2616,44,2660
22,Picardie,60,3,18,617,Sermaize,237,7,244
22,Picardie,60,4,12,618,Séry-Magneval,305,6,311
22,Picardie,60,4,25,619,Silly-le-Long,1131,16,1147
22,Picardie,60,1,28,620,Silly-Tillard,469,12,481
22,Picardie,60,3,18,621,Solente,115,2,117
22,Picardie,60,1,17,622,Sommereux,393,12,405
22,Picardie,60,1,35,623,Songeons,1111,70,1181
22,Picardie,60,1,35,624,Sully,152,4,156
22,Picardie,60,3,29,625,Suzoy,528,6,534
22,Picardie,60,1,10,626,Talmontiers,731,14,745
22,Picardie,60,2,06,627,Tartigny,251,0,251
22,Picardie,60,1,27,628,Therdonne,908,18,926
22,Picardie,60,1,35,629,Thérines,186,4,190
22,Picardie,60,1,07,630,Thibivillers,202,3,205
22,Picardie,60,4,34,631,Thiers-sur-Thève,1098,27,1125
22,Picardie,60,3,19,632,Thiescourt,733,16,749
22,Picardie,60,1,17,633,Thieuloy-Saint-Antoine,334,2,336
22,Picardie,60,2,16,634,Thieux,421,2,423
22,Picardie,60,4,39,635,Thiverny,948,20,968
22,Picardie,60,3,32,636,Thourotte,4846,117,4963
22,Picardie,60,4,05,637,Thury-en-Valois,473,7,480
22,Picardie,60,2,24,638,Thury-sous-Clermont,667,9,676
22,Picardie,60,1,27,639,Tillé,1073,17,1090
22,Picardie,60,1,07,640,Tourly,183,4,187
22,Picardie,60,3,01,641,Tracy-le-Mont,1709,32,1741
22,Picardie,60,3,32,642,Tracy-le-Val,931,26,957
22,Picardie,60,2,21,643,Tricot,1433,24,1457
22,Picardie,60,1,07,644,Trie-Château,1517,18,1535
22,Picardie,60,1,07,645,Trie-la-Ville,332,12,344
22,Picardie,60,1,27,646,Troissereux,1153,33,1186
22,Picardie,60,3,01,647,Trosly-Breuil,2061,59,2120
22,Picardie,60,2,06,648,Troussencourt,331,6,337
22,Picardie,60,1,02,649,Troussures,188,8,196
22,Picardie,60,4,12,650,Trumilly,554,8,562
22,Picardie,60,4,26,651,Ully-Saint-Georges,1888,41,1929
22,Picardie,60,1,02,652,Valdampierre,903,16,919
22,Picardie,60,2,33,653,Valescourt,278,2,280
22,Picardie,60,3,32,654,Vandélicourt,236,5,241
22,Picardie,60,3,29,655,Varesnes,393,18,411
22,Picardie,60,4,05,656,Varinfroy,233,8,241
22,Picardie,60,3,29,657,Vauchelles,311,2,313
22,Picardie,60,4,12,658,Vauciennes,566,12,578
22,Picardie,60,1,07,659,Vaudancourt,165,4,169
22,Picardie,60,1,10,660,Le Vaumain,344,4,348
22,Picardie,60,4,12,661,Vaumoise,852,131,983
22,Picardie,60,1,10,662,Le Vauroux,471,17,488
22,Picardie,60,1,27,663,Velennes,256,3,259
22,Picardie,60,2,06,664,Vendeuil-Caply,450,10,460
22,Picardie,60,3,41,665,Venette,2709,109,2818
22,Picardie,60,4,25,666,Ver-sur-Launette,1163,28,1191
22,Picardie,60,4,30,667,Verberie,3694,99,3793
22,Picardie,60,1,27,668,Verderel-lès-Sauqueuse,761,13,774
22,Picardie,60,2,20,669,Verderonne,520,19,539
22,Picardie,60,4,30,670,Verneuil-en-Halatte,4443,96,4539
22,Picardie,60,4,25,671,Versigny,377,6,383
22,Picardie,60,4,12,672,Vez,320,7,327
22,Picardie,60,1,13,673,Viefvillers,179,0,179
22,Picardie,60,3,37,674,Vieux-Moulin,609,27,636
22,Picardie,60,3,31,675,Vignemont,380,12,392
22,Picardie,60,3,29,676,Ville,771,5,776
22,Picardie,60,1,35,677,Villembray,246,3,249
22,Picardie,60,1,23,678,Villeneuve-les-Sablons,1254,16,1270
22,Picardie,60,4,05,679,La Villeneuve-sous-Thury,172,0,172
22,Picardie,60,4,30,680,Villeneuve-sur-Verberie,694,14,708
22,Picardie,60,1,02,681,Villers-Saint-Barthélemy,456,18,474
22,Picardie,60,4,34,682,Villers-Saint-Frambourg,605,32,637
22,Picardie,60,4,05,683,Villers-Saint-Genest,397,10,407
22,Picardie,60,4,11,684,Villers-Saint-Paul,5877,75,5952
22,Picardie,60,1,28,685,Villers-Saint-Sépulcre,924,21,945
22,Picardie,60,4,39,686,Villers-sous-Saint-Leu,2213,48,2261
22,Picardie,60,1,35,687,Villers-sur-Auchy,345,1,346
22,Picardie,60,1,22,688,Villers-sur-Bonnières,165,5,170
22,Picardie,60,3,31,689,Villers-sur-Coudun,1409,44,1453
22,Picardie,60,1,07,690,Villers-sur-Trie,349,4,353
22,Picardie,60,1,15,691,Villers-Vermont,115,1,116
22,Picardie,60,2,06,692,Villers-Vicomte,154,3,157
22,Picardie,60,3,18,693,Villeselve,388,6,394
22,Picardie,60,1,02,694,Villotran,284,10,294
22,Picardie,60,4,34,695,Vineuil-Saint-Firmin,1486,49,1535
22,Picardie,60,1,35,697,Vrocourt,40,0,40
22,Picardie,60,2,21,698,Wacquemoulin,293,1,294
22,Picardie,60,1,35,699,Wambez,153,1,154
22,Picardie,60,1,28,700,Warluis,1129,28,1157
22,Picardie,60,2,33,701,Wavignies,1096,14,1110
22,Picardie,60,2,21,702,Welles-Pérennes,240,4,244
25,Basse-Normandie,61,3,98,214,L' Aigle,8314,220,8534
25,Basse-Normandie,61,1,99,001,Alençon,27653,1161,28814
25,Basse-Normandie,61,2,24,002,Almenêches,694,8,702
25,Basse-Normandie,61,2,13,003,Anceins,223,1,224
25,Basse-Normandie,61,1,14,004,Antoigny,116,6,122
25,Basse-Normandie,61,3,06,005,Appenai-sous-Bellême,235,3,238
25,Basse-Normandie,61,2,97,006,Argentan,14439,560,14999
25,Basse-Normandie,61,3,25,422,Les Aspres,694,13,707
25,Basse-Normandie,61,2,04,007,Athis-de-l'Orne,2624,70,2694
25,Basse-Normandie,61,3,37,008,Aube,1428,57,1485
25,Basse-Normandie,61,2,35,009,Aubry-en-Exmes,283,6,289
25,Basse-Normandie,61,2,36,010,Aubry-le-Panthou,98,3,101
25,Basse-Normandie,61,2,15,011,Aubusson,408,15,423
25,Basse-Normandie,61,3,25,012,Auguaise,145,5,150
25,Basse-Normandie,61,1,20,013,Aunay-les-Bois,155,3,158
25,Basse-Normandie,61,2,03,014,Aunou-le-Faucon,265,17,282
25,Basse-Normandie,61,1,31,015,Aunou-sur-Orne,262,11,273
25,Basse-Normandie,61,3,34,016,Autheuil,146,1,147
25,Basse-Normandie,61,2,21,017,Les Authieux-du-Puits,66,2,68
25,Basse-Normandie,61,2,36,018,Avernes-Saint-Gourgon,68,4,72
25,Basse-Normandie,61,2,12,019,Avernes-sous-Exmes,69,0,69
25,Basse-Normandie,61,2,11,020,Avoine,251,6,257
25,Basse-Normandie,61,1,10,021,Avrilly,121,2,123
25,Basse-Normandie,61,1,17,483,Bagnoles-de-l'Orne,2502,59,2561
25,Basse-Normandie,61,2,35,023,Bailleul,616,17,633
25,Basse-Normandie,61,2,22,024,Banvou,619,10,629
25,Basse-Normandie,61,1,17,025,La Baroche-sous-Lucé,386,15,401
25,Basse-Normandie,61,3,28,026,Barville,198,5,203
25,Basse-Normandie,61,2,11,027,Batilly,173,6,179
25,Basse-Normandie,61,2,29,028,Bazoches-au-Houlme,427,12,439
25,Basse-Normandie,61,3,05,029,Bazoches-sur-Hoëne,930,12,942
25,Basse-Normandie,61,2,15,030,La Bazoque,242,11,253
25,Basse-Normandie,61,2,33,031,Beauchêne,241,1,242
25,Basse-Normandie,61,3,37,032,Beaufai,348,3,351
25,Basse-Normandie,61,1,17,033,Beaulandais,152,5,157
25,Basse-Normandie,61,3,34,034,Beaulieu,210,7,217
25,Basse-Normandie,61,1,08,035,Beauvain,280,11,291
25,Basse-Normandie,61,1,31,036,Belfonds,173,4,177
25,Basse-Normandie,61,3,28,037,Bellavilliers,163,0,163
25,Basse-Normandie,61,3,06,038,Bellême,1568,21,1589
25,Basse-Normandie,61,2,24,039,La Bellière,109,6,115
25,Basse-Normandie,61,2,22,040,Bellou-en-Houlme,1080,24,1104
25,Basse-Normandie,61,3,32,041,Bellou-le-Trichard,240,6,246
25,Basse-Normandie,61,3,30,042,Bellou-sur-Huisne,444,10,454
25,Basse-Normandie,61,3,26,043,Berd'huis,1073,24,1097
25,Basse-Normandie,61,2,04,044,Berjou,474,20,494
25,Basse-Normandie,61,3,34,045,Bivilliers,63,0,63
25,Basse-Normandie,61,3,19,046,Bizou,123,7,130
25,Basse-Normandie,61,2,13,047,Bocquencé,159,2,161
25,Basse-Normandie,61,3,05,048,Boëcé,133,1,134
25,Basse-Normandie,61,2,24,049,Boissei-la-Lande,121,4,125
25,Basse-Normandie,61,3,30,050,Boissy-Maugis,386,11,397
25,Basse-Normandie,61,1,20,051,Boitron,336,3,339
25,Basse-Normandie,61,3,25,052,Bonnefoi,168,2,170
25,Basse-Normandie,61,3,25,053,Bonsmoulins,218,3,221
25,Basse-Normandie,61,2,36,054,Le Bosc-Renoult,234,1,235
25,Basse-Normandie,61,2,11,055,Boucé,586,11,597
25,Basse-Normandie,61,1,31,056,Le Bouillon,141,5,146
25,Basse-Normandie,61,2,12,057,Le Bourg-Saint-Léonard,440,17,457
25,Basse-Normandie,61,2,04,058,Bréel,132,1,133
25,Basse-Normandie,61,3,34,059,Bresolettes,18,2,20
25,Basse-Normandie,61,3,25,060,Brethel,123,3,126
25,Basse-Normandie,61,3,30,061,Bretoncelles,1415,24,1439
25,Basse-Normandie,61,2,35,062,Brieux,92,3,95
25,Basse-Normandie,61,2,07,063,Briouze,1600,65,1665
25,Basse-Normandie,61,1,09,064,Brullemail,112,5,117
25,Basse-Normandie,61,3,34,065,Bubertré,153,2,155
25,Basse-Normandie,61,3,05,066,Buré,115,5,120
25,Basse-Normandie,61,1,09,067,Bures,174,5,179
25,Basse-Normandie,61,1,20,068,Bursard,196,6,202
25,Basse-Normandie,61,2,04,069,Cahan,190,7,197
25,Basse-Normandie,61,2,15,070,Caligny,846,31,877
25,Basse-Normandie,61,2,36,071,Camembert,211,7,218
25,Basse-Normandie,61,2,36,072,Canapville,185,2,187
25,Basse-Normandie,61,2,04,073,La Carneille,571,11,582
25,Basse-Normandie,61,1,08,074,Carrouges,733,13,746
25,Basse-Normandie,61,1,10,075,Ceaucé,1217,37,1254
25,Basse-Normandie,61,1,08,076,Le Cercueil,148,3,151
25,Basse-Normandie,61,1,38,077,Cerisé,742,21,763
25,Basse-Normandie,61,2,15,078,Cerisy-Belle-Étoile,740,45,785
25,Basse-Normandie,61,3,32,079,Ceton,1922,26,1948
25,Basse-Normandie,61,1,08,080,Chahains,100,2,102
25,Basse-Normandie,61,1,31,081,Chailloué,531,8,539
25,Basse-Normandie,61,1,09,082,Le Chalange,87,0,87
25,Basse-Normandie,61,2,35,083,Chambois,415,5,420
25,Basse-Normandie,61,1,08,085,Le Champ-de-la-Pierre,35,0,35
25,Basse-Normandie,61,2,21,088,Champ-Haut,51,1,52
25,Basse-Normandie,61,2,29,084,Champcerie,129,3,132
25,Basse-Normandie,61,2,36,086,Les Champeaux,128,6,134
25,Basse-Normandie,61,3,05,087,Champeaux-sur-Sarthe,180,5,185
25,Basse-Normandie,61,2,36,089,Champosoult,107,1,108
25,Basse-Normandie,61,3,34,090,Champs,109,1,110
25,Basse-Normandie,61,1,10,091,Champsecret,1025,29,1054
25,Basse-Normandie,61,3,18,092,Chandai,657,19,676
25,Basse-Normandie,61,2,33,093,Chanu,1284,21,1305
25,Basse-Normandie,61,2,40,094,La Chapelle-au-Moine,596,27,623
25,Basse-Normandie,61,2,40,095,La Chapelle-Biche,503,19,522
25,Basse-Normandie,61,1,17,096,La Chapelle-d'Andaine,1559,62,1621
25,Basse-Normandie,61,3,23,097,La Chapelle-Montligeon,648,17,665
25,Basse-Normandie,61,1,31,098,La Chapelle-près-Sées,380,34,414
25,Basse-Normandie,61,3,06,099,La Chapelle-Souëf,297,4,301
25,Basse-Normandie,61,3,25,100,La Chapelle-Viel,268,11,279
25,Basse-Normandie,61,2,24,101,Le Château-d'Almenêches,187,5,192
25,Basse-Normandie,61,2,22,102,Le Châtellier,378,9,387
25,Basse-Normandie,61,2,16,103,Chaumont,163,3,166
25,Basse-Normandie,61,1,08,104,La Chaux,59,1,60
25,Basse-Normandie,61,3,06,105,Chemilli,234,3,237
25,Basse-Normandie,61,2,29,106,Chênedouit,176,4,180
25,Basse-Normandie,61,1,08,107,Ciral,430,10,440
25,Basse-Normandie,61,2,16,108,Cisai-Saint-Aubin,190,6,196
25,Basse-Normandie,61,2,33,109,Clairefougère,117,1,118
25,Basse-Normandie,61,2,12,110,La Cochère,153,7,160
25,Basse-Normandie,61,1,02,111,Colombiers,335,9,344
25,Basse-Normandie,61,3,26,112,Colonard-Corubert,243,11,254
25,Basse-Normandie,61,3,23,113,Comblot,72,3,75
25,Basse-Normandie,61,2,39,114,Commeaux,134,12,146
25,Basse-Normandie,61,3,30,116,Condé-sur-Huisne,1272,21,1293
25,Basse-Normandie,61,1,02,117,Condé-sur-Sarthe,2142,82,2224
25,Basse-Normandie,61,3,30,115,Condeau,403,5,408
25,Basse-Normandie,61,3,23,118,Corbon,139,4,143
25,Basse-Normandie,61,2,35,120,Coudehard,82,2,84
25,Basse-Normandie,61,3,28,121,Coulimer,287,5,292
25,Basse-Normandie,61,2,16,122,Coulmer,93,2,95
25,Basse-Normandie,61,2,35,123,Coulonces,209,6,215
25,Basse-Normandie,61,2,22,124,La Coulonche,511,7,518
25,Basse-Normandie,61,3,30,125,Coulonges-les-Sablons,404,12,416
25,Basse-Normandie,61,1,20,126,Coulonges-sur-Sarthe,494,8,502
25,Basse-Normandie,61,2,11,127,La Courbe,66,0,66
25,Basse-Normandie,61,3,26,128,Courcerault,171,0,171
25,Basse-Normandie,61,3,23,129,Courgeon,362,2,364
25,Basse-Normandie,61,3,05,130,Courgeoût,458,9,467
25,Basse-Normandie,61,2,12,131,Courménil,130,4,134
25,Basse-Normandie,61,1,09,133,Courtomer,732,10,742
25,Basse-Normandie,61,1,14,135,Couterne,1012,23,1035
25,Basse-Normandie,61,2,13,136,Couvains,195,9,204
25,Basse-Normandie,61,2,07,137,Craménil,165,2,167
25,Basse-Normandie,61,2,16,138,Croisilles,211,4,215
25,Basse-Normandie,61,2,36,139,Crouttes,301,7,308
25,Basse-Normandie,61,3,18,140,Crulai,936,33,969
25,Basse-Normandie,61,1,02,141,Cuissai,407,22,429
25,Basse-Normandie,61,3,06,142,Dame-Marie,170,3,173
25,Basse-Normandie,61,1,02,143,Damigny,2859,121,2980
25,Basse-Normandie,61,3,26,144,Dancé,377,18,395
25,Basse-Normandie,61,1,10,145,Domfront,3901,122,4023
25,Basse-Normandie,61,2,22,146,Dompierre,347,7,354
25,Basse-Normandie,61,3,30,147,Dorceau,413,14,427
25,Basse-Normandie,61,2,04,148,Durcet,248,4,252
25,Basse-Normandie,61,2,22,149,Échalou,347,5,352
25,Basse-Normandie,61,2,21,150,Échauffour,754,14,768
25,Basse-Normandie,61,3,37,151,Écorcei,340,7,347
25,Basse-Normandie,61,2,35,152,Écorches,97,6,103
25,Basse-Normandie,61,2,11,153,Écouché,1361,38,1399
25,Basse-Normandie,61,3,28,154,Eperrais,115,2,117
25,Basse-Normandie,61,1,27,155,L' Épinay-le-Comte,183,7,190
25,Basse-Normandie,61,1,20,156,Essay,522,3,525
25,Basse-Normandie,61,2,12,157,Exmes,305,11,316
25,Basse-Normandie,61,2,07,158,Faverolles,149,4,153
25,Basse-Normandie,61,3,25,159,Fay,62,1,63
25,Basse-Normandie,61,3,23,160,Feings,221,8,229
25,Basse-Normandie,61,2,12,161,Fel,265,7,272
25,Basse-Normandie,61,3,25,162,La Ferrière-au-Doyen,200,7,207
25,Basse-Normandie,61,2,22,163,La Ferrière-aux-Étangs,1568,37,1605
25,Basse-Normandie,61,1,31,164,La Ferrière-Béchet,208,5,213
25,Basse-Normandie,61,1,02,165,La Ferrière-Bochard,704,13,717
25,Basse-Normandie,61,1,09,166,Ferrières-la-Verrerie,212,3,215
25,Basse-Normandie,61,2,13,167,La Ferté-Frênel,708,8,716
25,Basse-Normandie,61,1,14,168,La Ferté-Macé,6045,425,6470
25,Basse-Normandie,61,2,96,169,Flers,15716,478,16194
25,Basse-Normandie,61,2,11,170,Fleuré,234,13,247
25,Basse-Normandie,61,2,35,171,Fontaine-les-Bassets,115,2,117
25,Basse-Normandie,61,1,08,172,Fontenai-les-Louvets,252,10,262
25,Basse-Normandie,61,2,39,173,Fontenai-sur-Orne,254,11,265
25,Basse-Normandie,61,2,29,174,La Forêt-Auvray,204,4,208
25,Basse-Normandie,61,1,38,175,Forges,235,11,246
25,Basse-Normandie,61,2,24,176,Francheville,134,3,137
25,Basse-Normandie,61,2,33,177,Frênes,806,23,829
25,Basse-Normandie,61,2,16,178,La Fresnaie-Fayel,55,2,57
25,Basse-Normandie,61,2,36,180,Fresnay-le-Samson,110,2,112
25,Basse-Normandie,61,2,29,179,La Fresnaye-au-Sauvage,232,1,233
25,Basse-Normandie,61,2,16,181,Gacé,2088,65,2153
25,Basse-Normandie,61,1,02,182,Gandelain,422,8,430
25,Basse-Normandie,61,1,09,183,Gâprée,138,1,139
25,Basse-Normandie,61,2,13,184,Gauville,573,13,586
25,Basse-Normandie,61,3,32,185,Gémages,115,3,118
25,Basse-Normandie,61,1,17,186,Geneslay,275,4,279
25,Basse-Normandie,61,3,25,187,Les Genettes,173,6,179
25,Basse-Normandie,61,2,21,188,La Genevraie,101,5,106
25,Basse-Normandie,61,2,29,189,Giel-Courteilles,481,300,781
25,Basse-Normandie,61,2,12,190,Ginai,80,2,82
25,Basse-Normandie,61,2,13,191,Glos-la-Ferrière,558,12,570
25,Basse-Normandie,61,1,09,192,Godisson,110,2,112
25,Basse-Normandie,61,2,13,193,La Gonfrière,286,9,295
25,Basse-Normandie,61,2,11,194,Goulet,354,8,362
25,Basse-Normandie,61,2,07,195,Le Grais,195,8,203
25,Basse-Normandie,61,3,06,196,Le Gué-de-la-Chaîne,762,16,778
25,Basse-Normandie,61,2,35,197,Guêprei,146,4,150
25,Basse-Normandie,61,2,36,198,Guerquesalles,132,6,138
25,Basse-Normandie,61,2,29,199,Habloville,319,6,325
25,Basse-Normandie,61,1,17,200,Haleine,259,73,332
25,Basse-Normandie,61,1,10,201,La Haute-Chapelle,614,18,632
25,Basse-Normandie,61,1,20,202,Hauterive,481,7,488
25,Basse-Normandie,61,1,02,203,Héloup,987,35,1022
25,Basse-Normandie,61,3,32,204,L' Hermitière,269,6,275
25,Basse-Normandie,61,2,13,205,Heugon,226,1,227
25,Basse-Normandie,61,3,19,206,L' Hôme-Chamondot,216,3,219
25,Basse-Normandie,61,3,06,207,Igé,687,13,700
25,Basse-Normandie,61,3,18,208,Irai,551,12,563
25,Basse-Normandie,61,1,08,209,Joué-du-Bois,439,4,443
25,Basse-Normandie,61,2,11,210,Joué-du-Plain,252,3,255
25,Basse-Normandie,61,1,17,211,Juvigny-sous-Andaine,1059,26,1085
25,Basse-Normandie,61,2,03,212,Juvigny-sur-Orne,104,1,105
25,Basse-Normandie,61,1,02,213,Lalacelle,272,6,278
25,Basse-Normandie,61,1,20,215,Laleu,378,5,383
25,Basse-Normandie,61,1,08,216,La Lande-de-Goult,139,8,147
25,Basse-Normandie,61,2,07,217,La Lande-de-Lougé,52,0,52
25,Basse-Normandie,61,2,40,218,La Lande-Patry,1781,38,1819
25,Basse-Normandie,61,2,04,219,La Lande-Saint-Siméon,143,3,146
25,Basse-Normandie,61,3,19,220,La Lande-sur-Eure,171,12,183
25,Basse-Normandie,61,2,40,221,Landigou,490,13,503
25,Basse-Normandie,61,2,40,222,Landisacq,753,24,777
25,Basse-Normandie,61,2,33,223,Larchamp,301,3,304
25,Basse-Normandie,61,1,38,224,Larré,412,15,427
25,Basse-Normandie,61,2,21,225,Lignères,29,1,30
25,Basse-Normandie,61,3,34,226,Lignerolles,168,4,172
25,Basse-Normandie,61,2,07,227,Lignou,136,1,137
25,Basse-Normandie,61,1,08,228,Livaie,186,2,188
25,Basse-Normandie,61,3,23,229,Loisail,129,2,131
25,Basse-Normandie,61,3,19,230,Longny-au-Perche,1628,23,1651
25,Basse-Normandie,61,1,08,231,Longuenoë,120,3,123
25,Basse-Normandie,61,1,10,232,Lonlay-l'Abbaye,1207,24,1231
25,Basse-Normandie,61,1,14,233,Lonlay-le-Tesson,245,5,250
25,Basse-Normandie,61,1,02,234,Lonrai,983,39,1022
25,Basse-Normandie,61,1,17,235,Loré,156,4,160
25,Basse-Normandie,61,2,11,236,Loucé,98,2,100
25,Basse-Normandie,61,2,07,237,Lougé-sur-Maire,379,3,382
25,Basse-Normandie,61,2,35,238,Louvières-en-Auge,83,3,86
25,Basse-Normandie,61,1,17,239,Lucé,88,0,88
25,Basse-Normandie,61,1,31,240,Macé,493,8,501
25,Basse-Normandie,61,3,30,241,La Madeleine-Bouvet,399,3,402
25,Basse-Normandie,61,3,19,242,Le Mage,254,3,257
25,Basse-Normandie,61,1,14,243,Magny-le-Désert,1453,47,1500
25,Basse-Normandie,61,3,25,244,Mahéru,257,9,266
25,Basse-Normandie,61,3,30,245,Maison-Maugis,55,0,55
25,Basse-Normandie,61,3,32,246,Mâle,766,19,785
25,Basse-Normandie,61,3,19,247,Malétable,100,0,100
25,Basse-Normandie,61,1,27,248,Mantilly,597,15,612
25,Basse-Normandie,61,2,24,249,Marcei,204,2,206
25,Basse-Normandie,61,3,19,250,Marchainville,209,6,215
25,Basse-Normandie,61,1,20,251,Marchemaisons,157,3,160
25,Basse-Normandie,61,2,16,252,Mardilly,131,1,132
25,Basse-Normandie,61,2,24,253,Marmouillé,158,2,160
25,Basse-Normandie,61,3,23,255,Mauves-sur-Huisne,629,24,653
25,Basse-Normandie,61,2,24,256,Médavy,152,2,154
25,Basse-Normandie,61,1,14,257,Méhoudin,110,2,112
25,Basse-Normandie,61,1,20,258,Le Mêle-sur-Sarthe,783,11,794
25,Basse-Normandie,61,3,25,259,Le Ménil-Bérard,71,3,74
25,Basse-Normandie,61,1,20,261,Le Ménil-Broût,180,4,184
25,Basse-Normandie,61,2,33,262,Le Ménil-Ciboult,115,6,121
25,Basse-Normandie,61,2,07,260,Le Ménil-de-Briouze,525,17,542
25,Basse-Normandie,61,1,20,263,Ménil-Erreux,236,1,237
25,Basse-Normandie,61,2,21,264,Ménil-Froger,66,0,66
25,Basse-Normandie,61,2,29,265,Ménil-Gondouin,172,5,177
25,Basse-Normandie,61,1,09,266,Le Ménil-Guyon,83,1,84
25,Basse-Normandie,61,2,29,267,Ménil-Hermei,201,4,205
25,Basse-Normandie,61,2,16,268,Ménil-Hubert-en-Exmes,112,0,112
25,Basse-Normandie,61,2,04,269,Ménil-Hubert-sur-Orne,394,3,397
25,Basse-Normandie,61,2,29,270,Ménil-Jean,112,3,115
25,Basse-Normandie,61,1,08,271,Le Ménil-Scelleur,112,1,113
25,Basse-Normandie,61,2,21,272,Le Ménil-Vicomte,47,0,47
25,Basse-Normandie,61,2,29,273,Ménil-Vin,64,0,64
25,Basse-Normandie,61,3,19,274,Les Menus,194,4,198
25,Basse-Normandie,61,2,21,275,Le Merlerault,912,25,937
25,Basse-Normandie,61,2,35,276,Merri,154,3,157
25,Basse-Normandie,61,3,05,277,La Mesnière,317,7,324
25,Basse-Normandie,61,2,22,278,Messei,1925,65,1990
25,Basse-Normandie,61,1,02,279,Mieuxcé,591,21,612
25,Basse-Normandie,61,3,19,280,Monceaux-au-Perche,84,1,85
25,Basse-Normandie,61,2,33,281,Moncy,236,9,245
25,Basse-Normandie,61,2,13,282,Monnai,215,9,224
25,Basse-Normandie,61,2,35,289,Mont-Ormel,57,1,58
25,Basse-Normandie,61,2,35,283,Montabard,304,7,311
25,Basse-Normandie,61,1,09,284,Montchevrel,229,1,230
25,Basse-Normandie,61,2,11,285,Montgaroult,352,10,362
25,Basse-Normandie,61,3,28,286,Montgaudry,111,2,113
25,Basse-Normandie,61,2,15,287,Montilly-sur-Noireau,751,28,779
25,Basse-Normandie,61,2,24,288,Montmerrei,442,9,451
25,Basse-Normandie,61,2,07,290,Montreuil-au-Houlme,121,4,125
25,Basse-Normandie,61,2,35,291,Montreuil-la-Cambe,83,2,85
25,Basse-Normandie,61,2,33,292,Montsecret,578,14,592
25,Basse-Normandie,61,3,23,293,Mortagne-au-Perche,4111,314,4425
25,Basse-Normandie,61,2,24,294,Mortrée,994,27,1021
25,Basse-Normandie,61,1,08,295,La Motte-Fouquet,168,0,168
25,Basse-Normandie,61,3,19,296,Moulicent,291,6,297
25,Basse-Normandie,61,3,25,297,Moulins-la-Marche,785,8,793
25,Basse-Normandie,61,2,39,298,Moulins-sur-Orne,304,15,319
25,Basse-Normandie,61,3,34,299,Moussonvilliers,219,7,226
25,Basse-Normandie,61,3,30,300,Moutiers-au-Perche,441,12,453
25,Basse-Normandie,61,1,31,301,Neauphe-sous-Essai,204,3,207
25,Basse-Normandie,61,2,35,302,Neauphe-sur-Dive,137,2,139
25,Basse-Normandie,61,2,35,303,Nécy,498,7,505
25,Basse-Normandie,61,1,20,304,Neuilly-le-Bisson,259,6,265
25,Basse-Normandie,61,3,19,305,Neuilly-sur-Eure,519,14,533
25,Basse-Normandie,61,1,31,306,Neuville-près-Sées,118,3,121
25,Basse-Normandie,61,2,16,307,Neuville-sur-Touques,248,4,252
25,Basse-Normandie,61,2,29,308,Neuvy-au-Houlme,231,5,236
25,Basse-Normandie,61,3,26,309,Nocé,780,11,791
25,Basse-Normandie,61,2,21,310,Nonant-le-Pin,545,27,572
25,Basse-Normandie,61,3,34,311,Normandel,98,1,99
25,Basse-Normandie,61,2,04,313,Notre-Dame-du-Rocher,62,0,62
25,Basse-Normandie,61,2,39,314,Occagnes,585,18,603
25,Basse-Normandie,61,2,12,315,Omméel,115,1,116
25,Basse-Normandie,61,2,35,316,Ommoy,113,1,114
25,Basse-Normandie,61,2,16,317,Orgères,176,5,181
25,Basse-Normandie,61,3,06,318,Origny-le-Butin,116,2,118
25,Basse-Normandie,61,3,06,319,Origny-le-Roux,278,13,291
25,Basse-Normandie,61,2,36,320,Orville,103,1,104
25,Basse-Normandie,61,1,02,321,Pacé,383,8,391
25,Basse-Normandie,61,3,28,322,Parfondeval,106,1,107
25,Basse-Normandie,61,3,19,323,Le Pas-Saint-l'Homer,120,1,121
25,Basse-Normandie,61,1,27,324,Passais,798,27,825
25,Basse-Normandie,61,3,28,325,La Perrière,287,9,296
25,Basse-Normandie,61,1,17,326,Perrou,394,14,408
25,Basse-Normandie,61,3,28,327,Pervenchères,390,6,396
25,Basse-Normandie,61,2,12,328,Le Pin-au-Haras,354,7,361
25,Basse-Normandie,61,3,28,329,Le Pin-la-Garenne,634,9,643
25,Basse-Normandie,61,2,21,330,Planches,183,4,187
25,Basse-Normandie,61,1,09,331,Le Plantis,149,0,149
25,Basse-Normandie,61,2,07,332,Pointel,334,71,405
25,Basse-Normandie,61,2,36,333,Pontchardon,232,2,234
25,Basse-Normandie,61,3,34,335,La Poterie-au-Perche,146,1,147
25,Basse-Normandie,61,3,06,336,Pouvrai,110,2,112
25,Basse-Normandie,61,3,26,337,Préaux-du-Perche,550,24,574
25,Basse-Normandie,61,3,34,338,Prépotin,115,1,116
25,Basse-Normandie,61,2,29,339,Putanges-Pont-Écrepin,1029,19,1048
25,Basse-Normandie,61,2,29,340,Rabodanges,157,3,160
25,Basse-Normandie,61,1,38,341,Radon,1030,39,1069
25,Basse-Normandie,61,3,37,342,Rai,1612,44,1656
25,Basse-Normandie,61,3,34,343,Randonnai,806,8,814
25,Basse-Normandie,61,2,11,344,Rânes,1044,23,1067
25,Basse-Normandie,61,3,30,345,Rémalard,1269,23,1292
25,Basse-Normandie,61,2,36,346,Le Renouard,189,11,200
25,Basse-Normandie,61,2,16,347,Résenlieu,194,6,200
25,Basse-Normandie,61,3,23,348,Réveillon,355,4,359
25,Basse-Normandie,61,2,29,349,Ri,174,4,178
25,Basse-Normandie,61,1,02,350,La Roche-Mabile,146,0,146
25,Basse-Normandie,61,2,36,351,Roiville,122,0,122
25,Basse-Normandie,61,2,29,352,Rônai,162,1,163
25,Basse-Normandie,61,2,04,353,Ronfeugerai,305,6,311
25,Basse-Normandie,61,2,29,354,Les Rotours,89,2,91
25,Basse-Normandie,61,1,10,355,Rouellé,199,4,203
25,Basse-Normandie,61,3,32,356,La Rouge,640,16,656
25,Basse-Normandie,61,1,08,357,Rouperroux,174,2,176
25,Basse-Normandie,61,2,03,358,Sai,206,11,217
25,Basse-Normandie,61,3,32,359,Saint-Agnan-sur-Erre,169,4,173
25,Basse-Normandie,61,1,09,360,Saint-Agnan-sur-Sarthe,115,4,119
25,Basse-Normandie,61,2,07,361,Saint-André-de-Briouze,183,1,184
25,Basse-Normandie,61,2,22,362,Saint-André-de-Messei,535,28,563
25,Basse-Normandie,61,3,25,363,Saint-Aquilin-de-Corbion,70,2,72
25,Basse-Normandie,61,2,29,364,Saint-Aubert-sur-Orne,117,5,122
25,Basse-Normandie,61,1,20,365,Saint-Aubin-d'Appenai,403,13,416
25,Basse-Normandie,61,2,36,366,Saint-Aubin-de-Bonneval,160,5,165
25,Basse-Normandie,61,3,05,367,Saint-Aubin-de-Courteraie,140,5,145
25,Basse-Normandie,61,3,26,368,Saint-Aubin-des-Grois,63,0,63
25,Basse-Normandie,61,1,10,369,Saint-Bômer-les-Forges,1020,29,1049
25,Basse-Normandie,61,1,10,370,Saint-Brice,157,1,158
25,Basse-Normandie,61,2,11,371,Saint-Brice-sous-Rânes,168,1,169
25,Basse-Normandie,61,1,02,372,Saint-Céneri-le-Gérei,140,3,143
25,Basse-Normandie,61,2,33,374,Saint-Christophe-de-Chaulieu,121,3,124
25,Basse-Normandie,61,2,24,375,Saint-Christophe-le-Jajolet,235,7,242
25,Basse-Normandie,61,1,10,376,Saint-Clair-de-Halouze,861,24,885
25,Basse-Normandie,61,2,33,377,Saint-Cornier-des-Landes,687,16,703
25,Basse-Normandie,61,3,26,379,Saint-Cyr-la-Rosière,254,5,259
25,Basse-Normandie,61,1,17,380,Saint-Denis-de-Villenette,141,7,148
25,Basse-Normandie,61,3,23,381,Saint-Denis-sur-Huisne,62,2,64
25,Basse-Normandie,61,1,02,382,Saint-Denis-sur-Sarthon,1159,24,1183
25,Basse-Normandie,61,1,08,383,Saint-Didier-sous-Écouves,153,3,156
25,Basse-Normandie,61,1,08,384,Saint-Ellier-les-Bois,252,4,256
25,Basse-Normandie,61,2,16,385,Saint-Evroult-de-Montfort,318,6,324
25,Basse-Normandie,61,2,13,386,Saint-Evroult-Notre-Dame-du-Bois,445,29,474
25,Basse-Normandie,61,1,27,387,Saint-Fraimbault,624,14,638
25,Basse-Normandie,61,3,06,388,Saint-Fulgent-des-Ormes,162,2,164
25,Basse-Normandie,61,2,07,390,Saint-Georges-d'Annebecq,151,7,158
25,Basse-Normandie,61,2,15,391,Saint-Georges-des-Groseillers,3175,148,3323
25,Basse-Normandie,61,2,36,392,Saint-Germain-d'Aunay,172,3,175
25,Basse-Normandie,61,2,21,393,Saint-Germain-de-Clairefeuille,162,4,166
25,Basse-Normandie,61,3,32,394,Saint-Germain-de-la-Coudre,854,21,875
25,Basse-Normandie,61,3,05,396,Saint-Germain-de-Martigny,97,1,98
25,Basse-Normandie,61,3,30,395,Saint-Germain-des-Grois,228,11,239
25,Basse-Normandie,61,1,02,397,Saint-Germain-du-Corbéis,3690,150,3840
25,Basse-Normandie,61,1,09,398,Saint-Germain-le-Vieux,57,2,59
25,Basse-Normandie,61,2,35,399,Saint-Gervais-des-Sablons,68,0,68
25,Basse-Normandie,61,1,31,400,Saint-Gervais-du-Perron,320,8,328
25,Basse-Normandie,61,1,10,401,Saint-Gilles-des-Marais,96,2,98
25,Basse-Normandie,61,2,07,402,Saint-Hilaire-de-Briouze,286,4,290
25,Basse-Normandie,61,1,31,403,Saint-Hilaire-la-Gérard,104,3,107
25,Basse-Normandie,61,3,23,404,Saint-Hilaire-le-Châtel,711,32,743
25,Basse-Normandie,61,3,32,405,Saint-Hilaire-sur-Erre,596,13,609
25,Basse-Normandie,61,3,25,406,Saint-Hilaire-sur-Risle,314,1,315
25,Basse-Normandie,61,3,26,409,Saint-Jean-de-la-Forêt,131,7,138
25,Basse-Normandie,61,2,33,410,Saint-Jean-des-Bois,186,9,195
25,Basse-Normandie,61,3,28,411,Saint-Jouin-de-Blavou,281,7,288
25,Basse-Normandie,61,3,28,412,Saint-Julien-sur-Sarthe,661,11,672
25,Basse-Normandie,61,2,35,413,Saint-Lambert-sur-Dive,145,1,146
25,Basse-Normandie,61,3,23,414,Saint-Langis-lès-Mortagne,907,25,932
25,Basse-Normandie,61,1,20,415,Saint-Léger-sur-Sarthe,340,5,345
25,Basse-Normandie,61,1,09,416,Saint-Léonard-des-Parcs,70,4,74
25,Basse-Normandie,61,2,24,417,Saint-Loyer-des-Champs,388,4,392
25,Basse-Normandie,61,3,23,418,Saint-Mard-de-Réno,432,12,444
25,Basse-Normandie,61,1,27,421,Saint-Mars-d'Égrenne,709,19,728
25,Basse-Normandie,61,3,18,423,Saint-Martin-d'Écublei,582,10,592
25,Basse-Normandie,61,1,08,424,Saint-Martin-des-Landes,197,8,205
25,Basse-Normandie,61,3,25,425,Saint-Martin-des-Pézerits,111,3,114
25,Basse-Normandie,61,3,06,426,Saint-Martin-du-Vieux-Bellême,630,17,647
25,Basse-Normandie,61,1,08,427,Saint-Martin-l'Aiguillon,185,3,188
25,Basse-Normandie,61,1,14,428,Saint-Maurice-du-Désert,690,31,721
25,Basse-Normandie,61,3,34,429,Saint-Maurice-lès-Charencey,554,24,578
25,Basse-Normandie,61,3,26,430,Saint-Maurice-sur-Huisne,72,1,73
25,Basse-Normandie,61,1,14,431,Saint-Michel-des-Andaines,331,11,342
25,Basse-Normandie,61,3,18,432,Saint-Michel-Tuboeuf,579,12,591
25,Basse-Normandie,61,2,13,435,Saint-Nicolas-de-Sommaire,268,5,273
25,Basse-Normandie,61,1,02,433,Saint-Nicolas-des-Bois,256,7,263
25,Basse-Normandie,61,2,13,434,Saint-Nicolas-des-Laitiers,92,2,94
25,Basse-Normandie,61,3,06,437,Saint-Ouen-de-la-Cour,65,2,67
25,Basse-Normandie,61,3,05,438,Saint-Ouen-de-Sécherouvre,192,2,194
25,Basse-Normandie,61,1,08,439,Saint-Ouen-le-Brisoult,140,9,149
25,Basse-Normandie,61,3,18,440,Saint-Ouen-sur-Iton,881,17,898
25,Basse-Normandie,61,2,11,441,Saint-Ouen-sur-Maire,108,3,111
25,Basse-Normandie,61,1,08,442,Saint-Patrice-du-Désert,187,4,191
25,Basse-Normandie,61,2,40,443,Saint-Paul,656,16,672
25,Basse-Normandie,61,2,29,444,Saint-Philbert-sur-Orne,129,0,129
25,Basse-Normandie,61,2,33,445,Saint-Pierre-d'Entremont,708,24,732
25,Basse-Normandie,61,3,25,446,Saint-Pierre-des-Loges,157,4,161
25,Basse-Normandie,61,2,04,447,Saint-Pierre-du-Regard,1242,15,1257
25,Basse-Normandie,61,3,26,448,Saint-Pierre-la-Bruyère,418,11,429
25,Basse-Normandie,61,2,12,449,Saint-Pierre-la-Rivière,170,0,170
25,Basse-Normandie,61,3,28,450,Saint-Quentin-de-Blavou,73,3,76
25,Basse-Normandie,61,2,33,451,Saint-Quentin-les-Chardonnets,282,8,290
25,Basse-Normandie,61,1,27,452,Saint-Roch-sur-Égrenne,205,5,210
25,Basse-Normandie,61,1,08,453,Saint-Sauveur-de-Carrouges,262,13,275
25,Basse-Normandie,61,1,27,455,Saint-Siméon,270,7,277
25,Basse-Normandie,61,3,18,456,Saint-Sulpice-sur-Risle,1661,42,1703
25,Basse-Normandie,61,3,37,457,Saint-Symphorien-des-Bruyères,480,23,503
25,Basse-Normandie,61,3,19,458,Saint-Victor-de-Réno,205,4,209
25,Basse-Normandie,61,3,05,373,Sainte-Céronne-lès-Mortagne,288,15,303
25,Basse-Normandie,61,2,29,378,Sainte-Croix-sur-Orne,79,4,83
25,Basse-Normandie,61,2,21,389,Sainte-Gauburge-Sainte-Colombe,1150,14,1164
25,Basse-Normandie,61,2,04,407,Sainte-Honorine-la-Chardonne,701,22,723
25,Basse-Normandie,61,2,29,408,Sainte-Honorine-la-Guillaume,377,8,385
25,Basse-Normandie,61,1,08,419,Sainte-Marguerite-de-Carrouges,214,1,215
25,Basse-Normandie,61,1,08,420,Sainte-Marie-la-Robert,83,2,85
25,Basse-Normandie,61,2,07,436,Sainte-Opportune,228,4,232
25,Basse-Normandie,61,1,09,454,Sainte-Scolasse-sur-Sarthe,584,11,595
25,Basse-Normandie,61,2,22,459,Saires-la-Verrerie,282,13,295
25,Basse-Normandie,61,2,36,460,Le Sap,936,20,956
25,Basse-Normandie,61,2,16,461,Le Sap-André,134,3,137
25,Basse-Normandie,61,2,39,462,Sarceaux,908,33,941
25,Basse-Normandie,61,1,14,463,La Sauvagère,942,11,953
25,Basse-Normandie,61,1,31,464,Sées,4552,457,5009
25,Basse-Normandie,61,2,04,465,Ségrie-Fontaine,406,8,414
25,Basse-Normandie,61,2,40,466,La Selle-la-Forge,1291,47,1338
25,Basse-Normandie,61,1,38,467,Semallé,383,21,404
25,Basse-Normandie,61,2,11,468,Sentilly,142,14,156
25,Basse-Normandie,61,1,17,469,Sept-Forges,290,4,294
25,Basse-Normandie,61,2,11,470,Serans,213,9,222
25,Basse-Normandie,61,3,06,471,Sérigny,370,14,384
25,Basse-Normandie,61,2,03,472,Sévigny,326,11,337
25,Basse-Normandie,61,2,11,473,Sevrai,223,8,231
25,Basse-Normandie,61,2,12,474,Silly-en-Gouffern,433,10,443
25,Basse-Normandie,61,3,05,475,Soligny-la-Trappe,712,20,732
25,Basse-Normandie,61,3,28,476,Suré,279,11,290
25,Basse-Normandie,61,2,12,477,Survie,147,6,153
25,Basse-Normandie,61,2,04,478,Taillebois,156,4,160
25,Basse-Normandie,61,2,11,479,Tanques,169,5,174
25,Basse-Normandie,61,1,31,480,Tanville,264,4,268
25,Basse-Normandie,61,1,09,481,Tellières-le-Plessis,74,0,74
25,Basse-Normandie,61,1,17,482,Tessé-Froulay,370,15,385
25,Basse-Normandie,61,3,32,484,Le Theil,1943,37,1980
25,Basse-Normandie,61,2,36,485,Ticheville,223,9,232
25,Basse-Normandie,61,2,33,486,Tinchebray,2604,106,2710
25,Basse-Normandie,61,1,27,487,Torchamp,286,0,286
25,Basse-Normandie,61,2,13,488,Touquettes,84,2,86
25,Basse-Normandie,61,2,04,489,Les Tourailles,74,5,79
25,Basse-Normandie,61,2,35,490,Tournai-sur-Dive,316,9,325
25,Basse-Normandie,61,3,34,491,Tourouvre,1642,36,1678
25,Basse-Normandie,61,1,09,492,Trémont,103,2,105
25,Basse-Normandie,61,2,16,493,La Trinité-des-Laitiers,90,0,90
25,Basse-Normandie,61,2,35,494,Trun,1312,57,1369
25,Basse-Normandie,61,2,03,496,Urou-et-Crennes,733,22,755
25,Basse-Normandie,61,1,38,497,Valframbert,1562,65,1627
25,Basse-Normandie,61,3,06,498,Vaunoise,111,1,112
25,Basse-Normandie,61,1,20,499,Les Ventes-de-Bourse,148,2,150
25,Basse-Normandie,61,3,34,500,La Ventrouze,134,1,135
25,Basse-Normandie,61,3,26,501,Verrières,408,15,423
25,Basse-Normandie,61,3,28,502,Vidai,74,1,75
25,Basse-Normandie,61,2,11,503,Vieux-Pont,214,4,218
25,Basse-Normandie,61,2,12,504,Villebadin,140,2,142
25,Basse-Normandie,61,2,35,505,Villedieu-lès-Bailleul,238,8,246
25,Basse-Normandie,61,2,13,506,Villers-en-Ouche,345,3,348
25,Basse-Normandie,61,3,23,507,Villiers-sous-Mortagne,327,6,333
25,Basse-Normandie,61,2,36,508,Vimoutiers,3873,166,4039
25,Basse-Normandie,61,1,38,509,Vingt-Hanaps,427,8,435
25,Basse-Normandie,61,3,18,510,Vitrai-sous-Laigle,226,6,232
25,Basse-Normandie,61,2,24,511,Vrigny,337,4,341
25,Basse-Normandie,61,2,07,512,Les Yveteaux,123,2,125
25,Basse-Normandie,61,2,33,513,Yvrandes,161,0,161
31,Nord-Pas-de-Calais,62,1,45,001,Ablain-Saint-Nazaire,1865,47,1912
31,Nord-Pas-de-Calais,62,1,20,002,Ablainzevelle,193,3,196
31,Nord-Pas-de-Calais,62,1,45,003,Acheville,604,9,613
31,Nord-Pas-de-Calais,62,1,04,004,Achicourt,7676,138,7814
31,Nord-Pas-de-Calais,62,1,09,005,Achiet-le-Grand,1057,13,1070
31,Nord-Pas-de-Calais,62,1,09,006,Achiet-le-Petit,331,2,333
31,Nord-Pas-de-Calais,62,1,71,007,Acq,442,17,459
31,Nord-Pas-de-Calais,62,5,34,008,Acquin-Westbécourt,671,18,689
31,Nord-Pas-de-Calais,62,1,10,009,Adinfer,223,6,229
31,Nord-Pas-de-Calais,62,5,34,010,Affringues,223,6,229
31,Nord-Pas-de-Calais,62,1,10,011,Agnez-lès-Duisans,677,28,705
31,Nord-Pas-de-Calais,62,1,05,012,Agnières,224,4,228
31,Nord-Pas-de-Calais,62,1,04,013,Agny,1913,42,1955
31,Nord-Pas-de-Calais,62,5,01,014,Aire-sur-la-Lys,9710,326,10036
31,Nord-Pas-de-Calais,62,4,69,015,Airon-Notre-Dame,198,2,200
31,Nord-Pas-de-Calais,62,4,69,016,Airon-Saint-Vaast,212,8,220
31,Nord-Pas-de-Calais,62,4,29,017,Aix-en-Ergny,161,0,161
31,Nord-Pas-de-Calais,62,4,18,018,Aix-en-Issart,273,2,275
31,Nord-Pas-de-Calais,62,7,77,019,Aix-Noulette,3776,56,3832
31,Nord-Pas-de-Calais,62,6,25,020,Alembon,557,6,563
31,Nord-Pas-de-Calais,62,4,29,021,Alette,334,6,340
31,Nord-Pas-de-Calais,62,3,21,022,Alincthun,349,10,359
31,Nord-Pas-de-Calais,62,2,53,023,Allouagne,3091,73,3164
31,Nord-Pas-de-Calais,62,5,34,024,Alquines,863,13,876
31,Nord-Pas-de-Calais,62,3,36,025,Ambleteuse,1854,29,1883
31,Nord-Pas-de-Calais,62,4,24,026,Ambricourt,120,0,120
31,Nord-Pas-de-Calais,62,1,05,027,Ambrines,211,1,212
31,Nord-Pas-de-Calais,62,2,63,028,Ames,580,6,586
31,Nord-Pas-de-Calais,62,2,63,029,Amettes,499,1,500
31,Nord-Pas-de-Calais,62,1,40,030,Amplier,299,3,302
31,Nord-Pas-de-Calais,62,6,25,031,Andres,1525,16,1541
31,Nord-Pas-de-Calais,62,7,60,032,Angres,4001,74,4075
31,Nord-Pas-de-Calais,62,7,49,033,Annay,4346,30,4376
31,Nord-Pas-de-Calais,62,2,17,034,Annequin,2320,18,2338
31,Nord-Pas-de-Calais,62,2,12,035,Annezin,5585,67,5652
31,Nord-Pas-de-Calais,62,1,27,036,Anvin,818,25,843
31,Nord-Pas-de-Calais,62,1,71,037,Anzin-Saint-Aubin,2788,113,2901
31,Nord-Pas-de-Calais,62,5,02,038,Ardres,4203,68,4271
31,Nord-Pas-de-Calais,62,1,45,039,Arleux-en-Gohelle,834,22,856
31,Nord-Pas-de-Calais,62,5,62,040,Arques,9696,160,9856
31,Nord-Pas-de-Calais,62,1,96,041,Arras,42780,1524,44304
31,Nord-Pas-de-Calais,62,1,03,042,Athies,1001,17,1018
31,Nord-Pas-de-Calais,62,6,16,043,Les Attaques,2021,21,2042
31,Nord-Pas-de-Calais,62,4,22,044,Attin,733,19,752
31,Nord-Pas-de-Calais,62,1,05,045,Aubigny-en-Artois,1332,30,1362
31,Nord-Pas-de-Calais,62,4,26,046,Aubin-Saint-Vaast,779,12,791
31,Nord-Pas-de-Calais,62,1,07,047,Aubrometz,144,2,146
31,Nord-Pas-de-Calais,62,2,63,048,Auchel,11219,111,11330
31,Nord-Pas-de-Calais,62,2,38,049,Auchy-au-Bois,447,3,450
31,Nord-Pas-de-Calais,62,4,39,050,Auchy-lès-Hesdin,1776,12,1788
31,Nord-Pas-de-Calais,62,2,17,051,Auchy-les-Mines,4452,24,4476
31,Nord-Pas-de-Calais,62,3,36,052,Audembert,406,9,415
31,Nord-Pas-de-Calais,62,5,23,053,Audincthun,654,15,669
31,Nord-Pas-de-Calais,62,3,36,054,Audinghen,582,10,592
31,Nord-Pas-de-Calais,62,5,02,055,Audrehem,447,3,450
31,Nord-Pas-de-Calais,62,3,36,056,Audresselles,712,4,716
31,Nord-Pas-de-Calais,62,5,06,057,Audruicq,4729,102,4831
31,Nord-Pas-de-Calais,62,1,27,058,Aumerval,191,0,191
31,Nord-Pas-de-Calais,62,5,02,059,Autingues,305,11,316
31,Nord-Pas-de-Calais,62,1,07,060,Auxi-le-Château,2938,60,2998
31,Nord-Pas-de-Calais,62,1,05,061,Averdoingt,266,5,271
31,Nord-Pas-de-Calais,62,4,29,062,Avesnes,34,1,35
31,Nord-Pas-de-Calais,62,1,08,063,Avesnes-le-Comte,2083,33,2116
31,Nord-Pas-de-Calais,62,1,09,064,Avesnes-lès-Bapaume,139,5,144
31,Nord-Pas-de-Calais,62,7,52,065,Avion,17614,165,17779
31,Nord-Pas-de-Calais,62,4,24,066,Avondance,41,0,41
31,Nord-Pas-de-Calais,62,5,23,067,Avroult,533,12,545
31,Nord-Pas-de-Calais,62,1,20,068,Ayette,318,8,326
31,Nord-Pas-de-Calais,62,4,39,069,Azincourt,297,5,302
31,Nord-Pas-de-Calais,62,1,05,070,Bailleul-aux-Cornailles,256,12,268
31,Nord-Pas-de-Calais,62,1,27,071,Bailleul-lès-Pernes,358,8,366
31,Nord-Pas-de-Calais,62,1,45,073,Bailleul-Sir-Berthoult,1265,27,1292
31,Nord-Pas-de-Calais,62,1,10,072,Bailleulmont,247,2,249
31,Nord-Pas-de-Calais,62,1,10,074,Bailleulval,268,6,274
31,Nord-Pas-de-Calais,62,3,14,075,Baincthun,1357,42,1399
31,Nord-Pas-de-Calais,62,3,21,076,Bainghen,168,2,170
31,Nord-Pas-de-Calais,62,1,05,077,Bajus,303,5,308
31,Nord-Pas-de-Calais,62,5,02,078,Balinghem,1047,16,1063
31,Nord-Pas-de-Calais,62,1,09,079,Bancourt,78,1,79
31,Nord-Pas-de-Calais,62,1,09,080,Bapaume,4119,250,4369
31,Nord-Pas-de-Calais,62,1,35,081,Baralle,489,10,499
31,Nord-Pas-de-Calais,62,1,11,082,Barastre,244,6,250
31,Nord-Pas-de-Calais,62,2,64,083,Barlin,7584,46,7630
31,Nord-Pas-de-Calais,62,1,08,084,Barly,239,6,245
31,Nord-Pas-de-Calais,62,1,10,085,Basseux,145,4,149
31,Nord-Pas-de-Calais,62,1,08,086,Bavincourt,351,9,360
31,Nord-Pas-de-Calais,62,5,02,087,Bayenghem-lès-Éperlecques,924,15,939
31,Nord-Pas-de-Calais,62,5,34,088,Bayenghem-lès-Seninghem,332,7,339
31,Nord-Pas-de-Calais,62,3,36,089,Bazinghen,430,14,444
31,Nord-Pas-de-Calais,62,4,39,090,Béalencourt,115,4,119
31,Nord-Pas-de-Calais,62,1,08,091,Beaudricourt,102,3,105
31,Nord-Pas-de-Calais,62,1,08,092,Beaufort-Blavincourt,430,5,435
31,Nord-Pas-de-Calais,62,1,09,093,Beaulencourt,204,2,206
31,Nord-Pas-de-Calais,62,4,37,094,Beaumerie-Saint-Martin,361,9,370
31,Nord-Pas-de-Calais,62,5,23,095,Beaumetz-lès-Aire,219,3,222
31,Nord-Pas-de-Calais,62,1,11,096,Beaumetz-lès-Cambrai,538,11,549
31,Nord-Pas-de-Calais,62,1,10,097,Beaumetz-lès-Loges,982,14,996
31,Nord-Pas-de-Calais,62,1,04,099,Beaurains,5068,101,5169
31,Nord-Pas-de-Calais,62,4,18,100,Beaurainville,1924,46,1970
31,Nord-Pas-de-Calais,62,1,07,881,Beauvoir-Wavans,389,8,397
31,Nord-Pas-de-Calais,62,1,43,101,Beauvois,131,2,133
31,Nord-Pas-de-Calais,62,4,29,102,Bécourt,277,3,280
31,Nord-Pas-de-Calais,62,1,09,103,Béhagnies,134,4,138
31,Nord-Pas-de-Calais,62,3,21,105,Belle-et-Houllefort,535,17,552
31,Nord-Pas-de-Calais,62,3,21,104,Bellebrune,337,10,347
31,Nord-Pas-de-Calais,62,1,46,106,Bellonne,253,7,260
31,Nord-Pas-de-Calais,62,7,68,107,Bénifontaine,309,3,312
31,Nord-Pas-de-Calais,62,4,69,108,Berck,15124,456,15580
31,Nord-Pas-de-Calais,62,1,27,109,Bergueneuse,217,6,223
31,Nord-Pas-de-Calais,62,1,08,111,Berlencourt-le-Cauroy,280,98,378
31,Nord-Pas-de-Calais,62,1,10,112,Berles-au-Bois,501,6,507
31,Nord-Pas-de-Calais,62,1,05,113,Berles-Monchel,462,10,472
31,Nord-Pas-de-Calais,62,1,43,114,Bermicourt,155,2,157
31,Nord-Pas-de-Calais,62,1,10,115,Berneville,427,13,440
31,Nord-Pas-de-Calais,62,4,22,116,Bernieulles,195,8,203
31,Nord-Pas-de-Calais,62,1,11,117,Bertincourt,944,21,965
31,Nord-Pas-de-Calais,62,1,05,118,Béthonsart,167,2,169
31,Nord-Pas-de-Calais,62,2,92,119,Béthune,25697,710,26407
31,Nord-Pas-de-Calais,62,2,28,120,Beugin,445,8,453
31,Nord-Pas-de-Calais,62,1,09,121,Beugnâtre,132,0,132
31,Nord-Pas-de-Calais,62,1,11,122,Beugny,345,7,352
31,Nord-Pas-de-Calais,62,4,29,123,Beussent,490,10,500
31,Nord-Pas-de-Calais,62,4,22,124,Beutin,502,9,511
31,Nord-Pas-de-Calais,62,3,36,125,Beuvrequen,415,12,427
31,Nord-Pas-de-Calais,62,2,57,126,Beuvry,8944,167,9111
31,Nord-Pas-de-Calais,62,4,29,127,Bezinghem,335,3,338
31,Nord-Pas-de-Calais,62,1,46,128,Biache-Saint-Vaast,3866,33,3899
31,Nord-Pas-de-Calais,62,1,09,129,Biefvillers-lès-Bapaume,102,1,103
31,Nord-Pas-de-Calais,62,1,40,130,Bienvillers-au-Bois,608,12,620
31,Nord-Pas-de-Calais,62,1,09,131,Bihucourt,364,8,372
31,Nord-Pas-de-Calais,62,2,73,132,Billy-Berclau,4274,45,4319
31,Nord-Pas-de-Calais,62,7,75,133,Billy-Montigny,8023,51,8074
31,Nord-Pas-de-Calais,62,4,29,134,Bimont,125,9,134
31,Nord-Pas-de-Calais,62,1,10,135,Blairville,302,5,307
31,Nord-Pas-de-Calais,62,1,43,137,Blangerval-Blangermont,93,2,95
31,Nord-Pas-de-Calais,62,4,39,138,Blangy-sur-Ternoise,741,13,754
31,Nord-Pas-de-Calais,62,5,62,139,Blendecques,5162,119,5281
31,Nord-Pas-de-Calais,62,5,34,140,Bléquin,374,3,377
31,Nord-Pas-de-Calais,62,2,38,141,Blessy,822,9,831
31,Nord-Pas-de-Calais,62,4,39,142,Blingel,104,1,105
31,Nord-Pas-de-Calais,62,1,07,143,Boffles,46,3,49
31,Nord-Pas-de-Calais,62,1,20,144,Boiry-Becquerelle,408,11,419
31,Nord-Pas-de-Calais,62,1,46,145,Boiry-Notre-Dame,438,6,444
31,Nord-Pas-de-Calais,62,1,10,146,Boiry-Saint-Martin,301,4,305
31,Nord-Pas-de-Calais,62,1,10,147,Boiry-Sainte-Rictrude,364,8,372
31,Nord-Pas-de-Calais,62,1,45,148,Bois-Bernard,812,10,822
31,Nord-Pas-de-Calais,62,5,34,149,Boisdinghem,221,3,224
31,Nord-Pas-de-Calais,62,4,18,150,Boisjean,437,6,443
31,Nord-Pas-de-Calais,62,1,20,151,Boisleux-au-Mont,496,12,508
31,Nord-Pas-de-Calais,62,1,20,152,Boisleux-Saint-Marc,200,2,202
31,Nord-Pas-de-Calais,62,5,23,153,Bomy,601,3,604
31,Nord-Pas-de-Calais,62,1,07,154,Bonnières,616,31,647
31,Nord-Pas-de-Calais,62,5,02,155,Bonningues-lès-Ardres,633,10,643
31,Nord-Pas-de-Calais,62,6,15,156,Bonningues-lès-Calais,639,25,664
31,Nord-Pas-de-Calais,62,4,18,157,Boubers-lès-Hesmond,70,0,70
31,Nord-Pas-de-Calais,62,1,07,158,Boubers-sur-Canche,596,14,610
31,Nord-Pas-de-Calais,62,4,26,661,Bouin-Plumoison,453,10,463
31,Nord-Pas-de-Calais,62,3,97,160,Boulogne-sur-Mer,43757,762,44519
31,Nord-Pas-de-Calais,62,6,25,161,Bouquehault,686,6,692
31,Nord-Pas-de-Calais,62,2,38,162,Bourecq,544,2,546
31,Nord-Pas-de-Calais,62,1,07,163,Bouret-sur-Canche,246,11,257
31,Nord-Pas-de-Calais,62,1,35,164,Bourlon,1203,30,1233
31,Nord-Pas-de-Calais,62,3,21,165,Bournonville,228,3,231
31,Nord-Pas-de-Calais,62,1,27,166,Bours,561,12,573
31,Nord-Pas-de-Calais,62,6,25,167,Boursin,257,5,262
31,Nord-Pas-de-Calais,62,4,29,168,Bourthes,675,8,683
31,Nord-Pas-de-Calais,62,5,34,169,Bouvelinghem,207,7,214
31,Nord-Pas-de-Calais,62,7,77,170,Bouvigny-Boyeffles,2448,89,2537
31,Nord-Pas-de-Calais,62,1,27,171,Boyaval,132,0,132
31,Nord-Pas-de-Calais,62,1,20,172,Boyelles,232,2,234
31,Nord-Pas-de-Calais,62,1,46,173,Brebières,4929,42,4971
31,Nord-Pas-de-Calais,62,5,02,174,Brêmes,1311,22,1333
31,Nord-Pas-de-Calais,62,4,26,175,Brévillers,140,3,143
31,Nord-Pas-de-Calais,62,4,22,176,Bréxent-Énocq,637,18,655
31,Nord-Pas-de-Calais,62,1,43,180,Brias,287,7,294
31,Nord-Pas-de-Calais,62,4,18,177,Brimeux,736,17,753
31,Nord-Pas-de-Calais,62,2,88,178,Bruay-la-Buissière,23737,428,24165
31,Nord-Pas-de-Calais,62,3,21,179,Brunembert,356,1,357
31,Nord-Pas-de-Calais,62,1,20,181,Bucquoy,1462,85,1547
31,Nord-Pas-de-Calais,62,1,07,182,Buire-au-Bois,204,7,211
31,Nord-Pas-de-Calais,62,4,18,183,Buire-le-Sec,793,8,801
31,Nord-Pas-de-Calais,62,1,35,184,Buissy,242,2,244
31,Nord-Pas-de-Calais,62,1,20,185,Bullecourt,242,5,247
31,Nord-Pas-de-Calais,62,7,51,186,Bully-les-Mines,12037,123,12160
31,Nord-Pas-de-Calais,62,1,43,187,Buneville,169,2,171
31,Nord-Pas-de-Calais,62,2,63,188,Burbure,2940,29,2969
31,Nord-Pas-de-Calais,62,1,11,189,Bus,113,1,114
31,Nord-Pas-de-Calais,62,2,33,190,Busnes,1250,30,1280
31,Nord-Pas-de-Calais,62,6,25,191,Caffiers,682,12,694
31,Nord-Pas-de-Calais,62,1,46,192,Cagnicourt,420,9,429
31,Nord-Pas-de-Calais,62,6,98,193,Calais,74817,894,75711
31,Nord-Pas-de-Calais,62,2,72,194,Calonne-Ricouart,5870,64,5934
31,Nord-Pas-de-Calais,62,2,33,195,Calonne-sur-la-Lys,1600,29,1629
31,Nord-Pas-de-Calais,62,4,37,196,La Calotterie,616,15,631
31,Nord-Pas-de-Calais,62,2,28,197,Camblain-Châtelain,1625,21,1646
31,Nord-Pas-de-Calais,62,1,05,199,Camblain-l'Abbé,640,137,777
31,Nord-Pas-de-Calais,62,1,05,198,Cambligneul,333,12,345
31,Nord-Pas-de-Calais,62,2,17,200,Cambrin,993,17,1010
31,Nord-Pas-de-Calais,62,4,22,201,Camiers,2703,39,2742
31,Nord-Pas-de-Calais,62,4,29,202,Campagne-lès-Boulonnais,577,89,666
31,Nord-Pas-de-Calais,62,6,25,203,Campagne-lès-Guines,456,10,466
31,Nord-Pas-de-Calais,62,4,18,204,Campagne-lès-Hesdin,1798,32,1830
31,Nord-Pas-de-Calais,62,5,62,205,Campagne-lès-Wardrecques,1073,29,1102
31,Nord-Pas-de-Calais,62,4,37,206,Campigneulles-les-Grandes,285,8,293
31,Nord-Pas-de-Calais,62,4,37,207,Campigneulles-les-Petites,593,17,610
31,Nord-Pas-de-Calais,62,1,08,208,Canettemont,61,0,61
31,Nord-Pas-de-Calais,62,4,24,209,Canlers,192,0,192
31,Nord-Pas-de-Calais,62,1,07,210,Canteleux,16,0,16
31,Nord-Pas-de-Calais,62,1,05,211,Capelle-Fermont,187,0,187
31,Nord-Pas-de-Calais,62,3,14,908,La Capelle-lès-Boulogne,1493,50,1543
31,Nord-Pas-de-Calais,62,4,26,212,Capelle-lès-Hesdin,454,16,470
31,Nord-Pas-de-Calais,62,1,45,213,Carency,715,11,726
31,Nord-Pas-de-Calais,62,3,44,214,Carly,549,8,557
31,Nord-Pas-de-Calais,62,7,19,215,Carvin,17430,140,17570
31,Nord-Pas-de-Calais,62,1,10,216,La Cauchie,213,2,215
31,Nord-Pas-de-Calais,62,2,63,217,Cauchy-à-la-Tour,2951,31,2982
31,Nord-Pas-de-Calais,62,2,28,218,Caucourt,318,5,323
31,Nord-Pas-de-Calais,62,4,26,219,Caumont,186,11,197
31,Nord-Pas-de-Calais,62,4,26,220,Cavron-Saint-Martin,470,15,485
31,Nord-Pas-de-Calais,62,1,05,221,Chelers,285,7,292
31,Nord-Pas-de-Calais,62,4,26,222,Chériennes,161,3,164
31,Nord-Pas-de-Calais,62,1,20,223,Chérisy,265,3,268
31,Nord-Pas-de-Calais,62,2,12,224,Chocques,2977,34,3011
31,Nord-Pas-de-Calais,62,5,41,225,Clairmarais,639,16,655
31,Nord-Pas-de-Calais,62,5,01,226,Clarques,271,8,279
31,Nord-Pas-de-Calais,62,4,29,227,Clenleu,176,11,187
31,Nord-Pas-de-Calais,62,5,02,228,Clerques,246,3,249
31,Nord-Pas-de-Calais,62,5,34,229,Cléty,661,19,680
31,Nord-Pas-de-Calais,62,3,21,230,Colembert,721,18,739
31,Nord-Pas-de-Calais,62,4,69,231,Colline-Beaumont,138,4,142
31,Nord-Pas-de-Calais,62,1,05,232,La Comté,832,11,843
31,Nord-Pas-de-Calais,62,4,69,233,Conchil-le-Temple,974,21,995
31,Nord-Pas-de-Calais,62,1,07,234,Conchy-sur-Canche,193,5,198
31,Nord-Pas-de-Calais,62,3,44,235,Condette,2600,80,2680
31,Nord-Pas-de-Calais,62,4,26,236,Contes,310,7,317
31,Nord-Pas-de-Calais,62,1,27,238,Conteville-en-Ternois,81,3,84
31,Nord-Pas-de-Calais,62,3,13,237,Conteville-lès-Boulogne,445,12,457
31,Nord-Pas-de-Calais,62,6,15,239,Coquelles,2330,38,2368
31,Nord-Pas-de-Calais,62,1,46,240,Corbehem,2223,20,2243
31,Nord-Pas-de-Calais,62,4,22,241,Cormont,285,7,292
31,Nord-Pas-de-Calais,62,1,40,242,Couin,120,3,123
31,Nord-Pas-de-Calais,62,1,08,243,Coullemont,106,1,107
31,Nord-Pas-de-Calais,62,6,16,244,Coulogne,5792,235,6027
31,Nord-Pas-de-Calais,62,5,34,245,Coulomby,641,13,654
31,Nord-Pas-de-Calais,62,4,24,246,Coupelle-Neuve,202,3,205
31,Nord-Pas-de-Calais,62,4,24,247,Coupelle-Vieille,515,2,517
31,Nord-Pas-de-Calais,62,1,20,248,Courcelles-le-Comte,454,12,466
31,Nord-Pas-de-Calais,62,7,56,249,Courcelles-lès-Lens,5943,52,5995
31,Nord-Pas-de-Calais,62,7,59,250,Courrières,10265,88,10353
31,Nord-Pas-de-Calais,62,3,21,251,Courset,455,206,661
31,Nord-Pas-de-Calais,62,2,70,252,La Couture,2607,47,2654
31,Nord-Pas-de-Calais,62,1,08,253,Couturelle,97,2,99
31,Nord-Pas-de-Calais,62,5,23,254,Coyecques,581,13,594
31,Nord-Pas-de-Calais,62,3,21,255,Crémarest,716,9,725
31,Nord-Pas-de-Calais,62,4,24,256,Crépy,149,4,153
31,Nord-Pas-de-Calais,62,4,24,257,Créquy,511,15,526
31,Nord-Pas-de-Calais,62,1,43,258,Croisette,311,7,318
31,Nord-Pas-de-Calais,62,1,20,259,Croisilles,1333,17,1350
31,Nord-Pas-de-Calais,62,1,43,260,Croix-en-Ternois,293,0,293
31,Nord-Pas-de-Calais,62,4,37,261,Cucq,5173,93,5266
31,Nord-Pas-de-Calais,62,2,17,262,Cuinchy,1766,25,1791
31,Nord-Pas-de-Calais,62,1,71,263,Dainville,5444,102,5546
31,Nord-Pas-de-Calais,62,3,44,264,Dannes,1312,18,1330
31,Nord-Pas-de-Calais,62,5,34,265,Delettes,1082,16,1098
31,Nord-Pas-de-Calais,62,1,08,266,Denier,51,1,52
31,Nord-Pas-de-Calais,62,5,23,267,Dennebroeucq,359,4,363
31,Nord-Pas-de-Calais,62,3,21,268,Desvres,5133,45,5178
31,Nord-Pas-de-Calais,62,1,43,269,Diéval,731,13,744
31,Nord-Pas-de-Calais,62,2,72,270,Divion,7153,81,7234
31,Nord-Pas-de-Calais,62,5,34,271,Dohem,755,18,773
31,Nord-Pas-de-Calais,62,1,20,272,Douchy-lès-Ayette,325,5,330
31,Nord-Pas-de-Calais,62,3,44,273,Doudeauville,483,12,495
31,Nord-Pas-de-Calais,62,7,56,274,Dourges,5617,43,5660
31,Nord-Pas-de-Calais,62,4,18,275,Douriez,299,6,305
31,Nord-Pas-de-Calais,62,2,73,276,Douvrin,5062,62,5124
31,Nord-Pas-de-Calais,62,7,67,277,Drocourt,2974,29,3003
31,Nord-Pas-de-Calais,62,2,64,278,Drouvin-le-Marais,527,13,540
31,Nord-Pas-de-Calais,62,1,71,279,Duisans,1174,284,1458
31,Nord-Pas-de-Calais,62,1,46,280,Dury,345,10,355
31,Nord-Pas-de-Calais,62,3,14,281,Echinghen,387,6,393
31,Nord-Pas-de-Calais,62,4,39,282,Éclimeux,162,7,169
31,Nord-Pas-de-Calais,62,1,43,283,Écoivres,104,1,105
31,Nord-Pas-de-Calais,62,1,35,284,Écourt-Saint-Quentin,1745,22,1767
31,Nord-Pas-de-Calais,62,1,20,285,Écoust-Saint-Mein,486,11,497
31,Nord-Pas-de-Calais,62,2,63,286,Ecquedecques,474,5,479
31,Nord-Pas-de-Calais,62,5,01,288,Ecques,1955,55,2010
31,Nord-Pas-de-Calais,62,4,37,289,Écuires,781,36,817
31,Nord-Pas-de-Calais,62,1,71,290,Écurie,411,8,419
31,Nord-Pas-de-Calais,62,7,60,291,Éleu-dit-Leauwette,2973,34,3007
31,Nord-Pas-de-Calais,62,5,34,292,Elnes,839,20,859
31,Nord-Pas-de-Calais,62,4,24,293,Embry,230,5,235
31,Nord-Pas-de-Calais,62,5,23,294,Enguinegatte,406,5,411
31,Nord-Pas-de-Calais,62,5,23,295,Enquin-les-Mines,1022,8,1030
31,Nord-Pas-de-Calais,62,4,29,296,Enquin-sur-Baillons,206,5,211
31,Nord-Pas-de-Calais,62,5,02,297,Éperlecques,3131,74,3205
31,Nord-Pas-de-Calais,62,1,35,298,Épinoy,520,0,520
31,Nord-Pas-de-Calais,62,1,27,299,Eps,257,4,261
31,Nord-Pas-de-Calais,62,3,61,300,Équihen-Plage,2929,30,2959
31,Nord-Pas-de-Calais,62,1,27,301,Équirre,55,4,59
31,Nord-Pas-de-Calais,62,4,29,302,Ergny,220,3,223
31,Nord-Pas-de-Calais,62,1,27,303,Érin,193,1,194
31,Nord-Pas-de-Calais,62,5,23,304,Erny-Saint-Julien,300,2,302
31,Nord-Pas-de-Calais,62,1,20,306,Ervillers,392,8,400
31,Nord-Pas-de-Calais,62,6,15,307,Escalles,312,5,317
31,Nord-Pas-de-Calais,62,5,34,308,Escoeuilles,443,10,453
31,Nord-Pas-de-Calais,62,5,34,309,Esquerdes,1588,29,1617
31,Nord-Pas-de-Calais,62,2,70,310,Essars,1642,24,1666
31,Nord-Pas-de-Calais,62,7,55,311,Estevelles,1719,19,1738
31,Nord-Pas-de-Calais,62,4,22,312,Estrée,305,8,313
31,Nord-Pas-de-Calais,62,2,38,313,Estrée-Blanche,926,14,940
31,Nord-Pas-de-Calais,62,2,28,314,Estrée-Cauchy,375,5,380
31,Nord-Pas-de-Calais,62,1,08,316,Estrée-Wamin,161,3,164
31,Nord-Pas-de-Calais,62,4,22,315,Estréelles,327,9,336
31,Nord-Pas-de-Calais,62,1,46,317,Étaing,430,6,436
31,Nord-Pas-de-Calais,62,4,22,318,Étaples,11689,149,11838
31,Nord-Pas-de-Calais,62,1,46,319,Éterpigny,222,6,228
31,Nord-Pas-de-Calais,62,1,71,320,Étrun,332,8,340
31,Nord-Pas-de-Calais,62,7,56,321,Évin-Malmaison,4515,34,4549
31,Nord-Pas-de-Calais,62,1,40,322,Famechon,124,3,127
31,Nord-Pas-de-Calais,62,1,04,323,Fampoux,1094,33,1127
31,Nord-Pas-de-Calais,62,1,45,324,Farbus,537,11,548
31,Nord-Pas-de-Calais,62,5,23,325,Fauquembergues,968,27,995
31,Nord-Pas-de-Calais,62,1,09,326,Favreuil,250,2,252
31,Nord-Pas-de-Calais,62,5,23,327,Febvin-Palfart,506,7,513
31,Nord-Pas-de-Calais,62,2,63,328,Ferfay,963,12,975
31,Nord-Pas-de-Calais,62,3,36,329,Ferques,1878,14,1892
31,Nord-Pas-de-Calais,62,2,17,330,Festubert,1259,29,1288
31,Nord-Pas-de-Calais,62,1,04,331,Feuchy,1043,15,1058
31,Nord-Pas-de-Calais,62,1,10,332,Ficheux,528,15,543
31,Nord-Pas-de-Calais,62,1,27,333,Fiefs,382,5,387
31,Nord-Pas-de-Calais,62,6,25,334,Fiennes,868,2,870
31,Nord-Pas-de-Calais,62,4,39,335,Fillièvres,523,10,533
31,Nord-Pas-de-Calais,62,5,23,336,Fléchin,533,15,548
31,Nord-Pas-de-Calais,62,1,43,337,Flers,185,1,186
31,Nord-Pas-de-Calais,62,2,30,338,Fleurbaix,2684,96,2780
31,Nord-Pas-de-Calais,62,1,27,339,Fleury,106,1,107
31,Nord-Pas-de-Calais,62,1,27,340,Floringhem,840,21,861
31,Nord-Pas-de-Calais,62,1,40,341,Foncquevillers,474,7,481
31,Nord-Pas-de-Calais,62,1,07,345,Fontaine-l'Étalon,123,4,127
31,Nord-Pas-de-Calais,62,1,27,342,Fontaine-lès-Boulans,87,0,87
31,Nord-Pas-de-Calais,62,1,20,343,Fontaine-lès-Croisilles,283,6,289
31,Nord-Pas-de-Calais,62,1,27,344,Fontaine-lès-Hermans,105,1,106
31,Nord-Pas-de-Calais,62,1,07,346,Fortel-en-Artois,211,4,215
31,Nord-Pas-de-Calais,62,1,10,347,Fosseux,138,0,138
31,Nord-Pas-de-Calais,62,1,43,348,Foufflin-Ricametz,121,8,129
31,Nord-Pas-de-Calais,62,2,53,349,Fouquereuil,1187,17,1204
31,Nord-Pas-de-Calais,62,2,53,350,Fouquières-lès-Béthune,1097,24,1121
31,Nord-Pas-de-Calais,62,7,75,351,Fouquières-lès-Lens,6571,60,6631
31,Nord-Pas-de-Calais,62,1,43,352,Framecourt,123,2,125
31,Nord-Pas-de-Calais,62,1,09,353,Frémicourt,312,4,316
31,Nord-Pas-de-Calais,62,4,22,354,Frencq,772,19,791
31,Nord-Pas-de-Calais,62,1,46,355,Fresnes-lès-Montauban,481,13,494
31,Nord-Pas-de-Calais,62,2,28,356,Fresnicourt-le-Dolmen,840,5,845
31,Nord-Pas-de-Calais,62,4,39,357,Fresnoy,77,1,78
31,Nord-Pas-de-Calais,62,1,45,358,Fresnoy-en-Gohelle,250,9,259
31,Nord-Pas-de-Calais,62,4,24,359,Fressin,543,13,556
31,Nord-Pas-de-Calais,62,6,15,360,Fréthun,1202,19,1221
31,Nord-Pas-de-Calais,62,1,07,361,Frévent,3759,94,3853
31,Nord-Pas-de-Calais,62,1,05,362,Frévillers,240,8,248
31,Nord-Pas-de-Calais,62,1,05,363,Frévin-Capelle,410,8,418
31,Nord-Pas-de-Calais,62,4,24,364,Fruges,2544,284,2828
31,Nord-Pas-de-Calais,62,4,39,365,Galametz,174,2,176
31,Nord-Pas-de-Calais,62,2,28,366,Gauchin-Légal,350,9,359
31,Nord-Pas-de-Calais,62,1,43,367,Gauchin-Verloingt,920,23,943
31,Nord-Pas-de-Calais,62,1,40,368,Gaudiempré,174,2,176
31,Nord-Pas-de-Calais,62,1,45,369,Gavrelle,567,10,577
31,Nord-Pas-de-Calais,62,1,07,370,Gennes-Ivergny,124,9,133
31,Nord-Pas-de-Calais,62,1,45,371,Givenchy-en-Gohelle,2084,26,2110
31,Nord-Pas-de-Calais,62,1,08,372,Givenchy-le-Noble,141,4,145
31,Nord-Pas-de-Calais,62,2,73,373,Givenchy-lès-la-Bassée,884,12,896
31,Nord-Pas-de-Calais,62,1,20,374,Gomiécourt,159,1,160
31,Nord-Pas-de-Calais,62,1,40,375,Gommecourt,112,1,113
31,Nord-Pas-de-Calais,62,2,33,376,Gonnehem,2327,34,2361
31,Nord-Pas-de-Calais,62,2,64,377,Gosnay,1063,10,1073
31,Nord-Pas-de-Calais,62,1,10,378,Gouves,191,4,195
31,Nord-Pas-de-Calais,62,1,10,379,Gouy-en-Artois,352,5,357
31,Nord-Pas-de-Calais,62,1,05,381,Gouy-en-Ternois,167,1,168
31,Nord-Pas-de-Calais,62,4,18,382,Gouy-Saint-André,621,6,627
31,Nord-Pas-de-Calais,62,7,77,380,Gouy-Servins,313,10,323
31,Nord-Pas-de-Calais,62,1,46,383,Gouy-sous-Bellonne,1212,26,1238
31,Nord-Pas-de-Calais,62,1,35,384,Graincourt-lès-Havrincourt,614,16,630
31,Nord-Pas-de-Calais,62,1,08,385,Grand-Rullecourt,382,3,385
31,Nord-Pas-de-Calais,62,7,32,386,Grenay,6632,51,6683
31,Nord-Pas-de-Calais,62,1,09,387,Grévillers,373,4,377
31,Nord-Pas-de-Calais,62,4,39,388,Grigny,300,6,306
31,Nord-Pas-de-Calais,62,1,40,389,Grincourt-lès-Pas,42,0,42
31,Nord-Pas-de-Calais,62,4,69,390,Groffliers,1476,45,1521
31,Nord-Pas-de-Calais,62,2,33,391,Guarbecque,1410,25,1435
31,Nord-Pas-de-Calais,62,1,20,392,Guémappe,356,13,369
31,Nord-Pas-de-Calais,62,5,06,393,Guemps,962,8,970
31,Nord-Pas-de-Calais,62,4,26,395,Guigny,155,8,163
31,Nord-Pas-de-Calais,62,1,43,396,Guinecourt,19,0,19
31,Nord-Pas-de-Calais,62,6,25,397,Guînes,5356,73,5429
31,Nord-Pas-de-Calais,62,4,26,398,Guisy,300,8,308
31,Nord-Pas-de-Calais,62,1,10,399,Habarcq,670,11,681
31,Nord-Pas-de-Calais,62,2,64,400,Haillicourt,4957,40,4997
31,Nord-Pas-de-Calais,62,2,73,401,Haisnes,4341,27,4368
31,Nord-Pas-de-Calais,62,3,44,402,Halinghen,298,3,301
31,Nord-Pas-de-Calais,62,5,34,403,Hallines,1340,39,1379
31,Nord-Pas-de-Calais,62,1,40,404,Halloy,232,3,235
31,Nord-Pas-de-Calais,62,2,38,407,Ham-en-Artois,992,13,1005
31,Nord-Pas-de-Calais,62,1,46,405,Hamblain-les-Prés,486,12,498
31,Nord-Pas-de-Calais,62,1,20,406,Hamelincourt,261,4,265
31,Nord-Pas-de-Calais,62,6,25,408,Hames-Boucres,1342,18,1360
31,Nord-Pas-de-Calais,62,1,40,409,Hannescamps,187,4,191
31,Nord-Pas-de-Calais,62,1,11,410,Haplincourt,197,6,203
31,Nord-Pas-de-Calais,62,1,07,411,Haravesnes,46,1,47
31,Nord-Pas-de-Calais,62,6,25,412,Hardinghen,1070,15,1085
31,Nord-Pas-de-Calais,62,7,55,413,Harnes,12698,69,12767
31,Nord-Pas-de-Calais,62,1,46,414,Haucourt,234,4,238
31,Nord-Pas-de-Calais,62,5,34,419,Haut-Loquin,151,4,155
31,Nord-Pas-de-Calais,62,1,10,415,Haute-Avesnes,398,6,404
31,Nord-Pas-de-Calais,62,1,43,416,Hautecloque,215,5,220
31,Nord-Pas-de-Calais,62,1,08,418,Hauteville,295,5,300
31,Nord-Pas-de-Calais,62,1,11,421,Havrincourt,359,14,373
31,Nord-Pas-de-Calais,62,1,40,422,Hébuterne,559,5,564
31,Nord-Pas-de-Calais,62,5,62,423,Helfaut,1750,43,1793
31,Nord-Pas-de-Calais,62,1,46,424,Hendecourt-lès-Cagnicourt,323,6,329
31,Nord-Pas-de-Calais,62,1,10,425,Hendecourt-lès-Ransart,121,1,122
31,Nord-Pas-de-Calais,62,7,89,427,Hénin-Beaumont,25612,423,26035
31,Nord-Pas-de-Calais,62,1,20,428,Hénin-sur-Cojeul,452,9,461
31,Nord-Pas-de-Calais,62,1,20,426,Héninel,208,6,214
31,Nord-Pas-de-Calais,62,3,21,429,Henneveux,303,7,310
31,Nord-Pas-de-Calais,62,1,40,430,Hénu,164,3,167
31,Nord-Pas-de-Calais,62,5,01,431,Herbelles,488,19,507
31,Nord-Pas-de-Calais,62,6,25,432,Herbinghen,366,7,373
31,Nord-Pas-de-Calais,62,1,43,433,Héricourt,102,3,105
31,Nord-Pas-de-Calais,62,1,10,434,La Herlière,152,1,153
31,Nord-Pas-de-Calais,62,1,43,436,Herlin-le-Sec,158,7,165
31,Nord-Pas-de-Calais,62,1,43,435,Herlincourt,106,7,113
31,Nord-Pas-de-Calais,62,4,29,437,Herly,324,1,325
31,Nord-Pas-de-Calais,62,1,05,438,Hermaville,536,19,555
31,Nord-Pas-de-Calais,62,6,25,439,Hermelinghen,313,9,322
31,Nord-Pas-de-Calais,62,1,11,440,Hermies,1160,20,1180
31,Nord-Pas-de-Calais,62,2,28,441,Hermin,213,3,216
31,Nord-Pas-de-Calais,62,1,43,442,Hernicourt,458,4,462
31,Nord-Pas-de-Calais,62,7,77,443,Hersin-Coupigny,6359,67,6426
31,Nord-Pas-de-Calais,62,3,36,444,Hervelinghen,238,4,242
31,Nord-Pas-de-Calais,62,2,64,445,Hesdigneul-lès-Béthune,815,14,829
31,Nord-Pas-de-Calais,62,3,44,446,Hesdigneul-lès-Boulogne,691,55,746
31,Nord-Pas-de-Calais,62,4,26,447,Hesdin,2451,58,2509
31,Nord-Pas-de-Calais,62,3,44,448,Hesdin-l'Abbé,1878,34,1912
31,Nord-Pas-de-Calais,62,4,18,449,Hesmond,176,5,181
31,Nord-Pas-de-Calais,62,1,27,450,Hestrus,233,2,235
31,Nord-Pas-de-Calais,62,1,27,451,Heuchin,555,10,565
31,Nord-Pas-de-Calais,62,5,01,452,Heuringhem,1303,43,1346
31,Nord-Pas-de-Calais,62,4,24,453,Hézecques,118,1,119
31,Nord-Pas-de-Calais,62,2,70,454,Hinges,2192,67,2259
31,Nord-Pas-de-Calais,62,6,25,455,Hocquinghen,104,1,105
31,Nord-Pas-de-Calais,62,2,64,456,Houchin,715,11,726
31,Nord-Pas-de-Calais,62,2,28,457,Houdain,7632,81,7713
31,Nord-Pas-de-Calais,62,5,41,458,Houlle,960,16,976
31,Nord-Pas-de-Calais,62,1,08,459,Houvin-Houvigneul,230,3,233
31,Nord-Pas-de-Calais,62,4,22,460,Hubersent,248,0,248
31,Nord-Pas-de-Calais,62,4,26,461,Huby-Saint-Leu,950,14,964
31,Nord-Pas-de-Calais,62,1,27,462,Huclier,116,0,116
31,Nord-Pas-de-Calais,62,4,29,463,Hucqueliers,531,68,599
31,Nord-Pas-de-Calais,62,7,68,464,Hulluch,3137,33,3170
31,Nord-Pas-de-Calais,62,1,40,465,Humbercamps,229,1,230
31,Nord-Pas-de-Calais,62,4,29,466,Humbert,255,3,258
31,Nord-Pas-de-Calais,62,1,43,467,Humeroeuille,147,8,155
31,Nord-Pas-de-Calais,62,1,43,468,Humières,221,11,232
31,Nord-Pas-de-Calais,62,1,35,469,Inchy-en-Artois,569,12,581
31,Nord-Pas-de-Calais,62,4,39,470,Incourt,84,2,86
31,Nord-Pas-de-Calais,62,5,01,471,Inghem,357,4,361
31,Nord-Pas-de-Calais,62,4,22,472,Inxent,154,11,165
31,Nord-Pas-de-Calais,62,2,38,473,Isbergues,9395,115,9510
31,Nord-Pas-de-Calais,62,3,44,474,Isques,1162,20,1182
31,Nord-Pas-de-Calais,62,1,08,475,Ivergny,250,5,255
31,Nord-Pas-de-Calais,62,1,45,476,Izel-lès-Équerchin,910,5,915
31,Nord-Pas-de-Calais,62,1,05,477,Izel-lès-Hameau,690,19,709
31,Nord-Pas-de-Calais,62,5,02,478,Journy,273,3,276
31,Nord-Pas-de-Calais,62,2,53,479,Labeuvrière,1679,19,1698
31,Nord-Pas-de-Calais,62,2,57,480,Labourse,2215,26,2241
31,Nord-Pas-de-Calais,62,4,26,481,Labroye,175,3,178
31,Nord-Pas-de-Calais,62,3,44,483,Lacres,233,2,235
31,Nord-Pas-de-Calais,62,1,35,484,Lagnicourt-Marcel,325,4,329
31,Nord-Pas-de-Calais,62,5,23,485,Laires,313,2,315
31,Nord-Pas-de-Calais,62,2,38,486,Lambres,1069,9,1078
31,Nord-Pas-de-Calais,62,3,36,487,Landrethun-le-Nord,1145,16,1161
31,Nord-Pas-de-Calais,62,5,02,488,Landrethun-lès-Ardres,692,12,704
31,Nord-Pas-de-Calais,62,2,53,489,Lapugnoy,3286,29,3315
31,Nord-Pas-de-Calais,62,1,08,490,Lattre-Saint-Quentin,224,10,234
31,Nord-Pas-de-Calais,62,2,30,491,Laventie,4790,96,4886
31,Nord-Pas-de-Calais,62,4,24,492,Lebiez,246,3,249
31,Nord-Pas-de-Calais,62,1,11,493,Lebucquière,238,3,241
31,Nord-Pas-de-Calais,62,1,11,494,Léchelle,61,1,62
31,Nord-Pas-de-Calais,62,5,34,495,Ledinghem,271,0,271
31,Nord-Pas-de-Calais,62,4,22,496,Lefaux,264,7,271
31,Nord-Pas-de-Calais,62,7,56,497,Leforest,7139,58,7197
31,Nord-Pas-de-Calais,62,7,95,498,Lens,36120,702,36822
31,Nord-Pas-de-Calais,62,4,37,499,Lépine,282,16,298
31,Nord-Pas-de-Calais,62,2,63,500,Lespesses,421,7,428
31,Nord-Pas-de-Calais,62,4,18,501,Lespinoy,209,3,212
31,Nord-Pas-de-Calais,62,2,30,502,Lestrem,4147,91,4238
31,Nord-Pas-de-Calais,62,3,36,503,Leubringhen,315,5,320
31,Nord-Pas-de-Calais,62,5,34,504,Leulinghem,219,6,225
31,Nord-Pas-de-Calais,62,3,36,505,Leulinghen-Bernes,413,4,417
31,Nord-Pas-de-Calais,62,7,19,907,Libercourt,8881,43,8924
31,Nord-Pas-de-Calais,62,6,25,506,Licques,1529,33,1562
31,Nord-Pas-de-Calais,62,1,08,507,Liencourt,284,2,286
31,Nord-Pas-de-Calais,62,2,63,508,Lières,371,5,376
31,Nord-Pas-de-Calais,62,2,38,509,Liettres,289,1,290
31,Nord-Pas-de-Calais,62,7,91,510,Liévin,32026,447,32473
31,Nord-Pas-de-Calais,62,1,08,511,Lignereuil,137,2,139
31,Nord-Pas-de-Calais,62,2,38,512,Ligny-lès-Aire,580,7,587
31,Nord-Pas-de-Calais,62,1,43,514,Ligny-Saint-Flochel,235,5,240
31,Nord-Pas-de-Calais,62,1,07,513,Ligny-sur-Canche,205,3,208
31,Nord-Pas-de-Calais,62,1,09,515,Ligny-Thilloy,553,12,565
31,Nord-Pas-de-Calais,62,2,33,516,Lillers,9967,142,10109
31,Nord-Pas-de-Calais,62,2,38,517,Linghem,212,2,214
31,Nord-Pas-de-Calais,62,1,43,518,Linzeux,154,5,159
31,Nord-Pas-de-Calais,62,1,27,519,Lisbourg,561,7,568
31,Nord-Pas-de-Calais,62,2,70,520,Locon,2388,48,2436
31,Nord-Pas-de-Calais,62,4,26,521,La Loge,193,3,196
31,Nord-Pas-de-Calais,62,7,49,523,Loison-sous-Lens,5468,43,5511
31,Nord-Pas-de-Calais,62,4,18,522,Loison-sur-Créquoise,239,15,254
31,Nord-Pas-de-Calais,62,3,21,524,Longfossé,1319,19,1338
31,Nord-Pas-de-Calais,62,5,42,525,Longuenesse,11048,696,11744
31,Nord-Pas-de-Calais,62,3,21,526,Longueville,136,4,140
31,Nord-Pas-de-Calais,62,4,22,527,Longvilliers,236,4,240
31,Nord-Pas-de-Calais,62,7,50,528,Loos-en-Gohelle,6801,116,6917
31,Nord-Pas-de-Calais,62,2,30,529,Lorgies,1603,28,1631
31,Nord-Pas-de-Calais,62,3,21,530,Lottinghen,515,3,518
31,Nord-Pas-de-Calais,62,5,02,531,Louches,878,11,889
31,Nord-Pas-de-Calais,62,2,63,532,Lozinghem,1196,16,1212
31,Nord-Pas-de-Calais,62,4,24,533,Lugy,141,1,142
31,Nord-Pas-de-Calais,62,5,34,534,Lumbres,3720,128,3848
31,Nord-Pas-de-Calais,62,4,37,535,La Madelaine-sous-Montreuil,171,8,179
31,Nord-Pas-de-Calais,62,1,05,536,Magnicourt-en-Comte,624,9,633
31,Nord-Pas-de-Calais,62,1,08,537,Magnicourt-sur-Canche,106,3,109
31,Nord-Pas-de-Calais,62,4,18,538,Maintenay,381,3,384
31,Nord-Pas-de-Calais,62,1,43,539,Maisnil,250,6,256
31,Nord-Pas-de-Calais,62,2,28,540,Maisnil-lès-Ruitz,1435,10,1445
31,Nord-Pas-de-Calais,62,4,39,541,Maisoncelle,115,2,117
31,Nord-Pas-de-Calais,62,1,05,542,Maizières,165,3,168
31,Nord-Pas-de-Calais,62,5,01,543,Mametz,1923,54,1977
31,Nord-Pas-de-Calais,62,1,08,544,Manin,182,2,184
31,Nord-Pas-de-Calais,62,4,29,545,Maninghem,144,4,148
31,Nord-Pas-de-Calais,62,3,36,546,Maninghen-Henne,305,9,314
31,Nord-Pas-de-Calais,62,4,18,547,Marant,68,1,69
31,Nord-Pas-de-Calais,62,6,54,548,Marck,9137,129,9266
31,Nord-Pas-de-Calais,62,4,26,549,Marconne,1145,76,1221
31,Nord-Pas-de-Calais,62,4,26,550,Marconnelle,1222,14,1236
31,Nord-Pas-de-Calais,62,4,18,551,Marenla,216,7,223
31,Nord-Pas-de-Calais,62,4,18,552,Maresquel-Ecquemicourt,868,21,889
31,Nord-Pas-de-Calais,62,1,27,553,Marest,266,14,280
31,Nord-Pas-de-Calais,62,4,22,554,Maresville,75,2,77
31,Nord-Pas-de-Calais,62,2,72,555,Marles-les-Mines,5783,50,5833
31,Nord-Pas-de-Calais,62,4,18,556,Marles-sur-Canche,293,17,310
31,Nord-Pas-de-Calais,62,1,71,557,Maroeuil,2428,114,2542
31,Nord-Pas-de-Calais,62,1,43,558,Marquay,171,2,173
31,Nord-Pas-de-Calais,62,1,35,559,Marquion,946,26,972
31,Nord-Pas-de-Calais,62,3,36,560,Marquise,5104,64,5168
31,Nord-Pas-de-Calais,62,1,09,561,Martinpuich,197,5,202
31,Nord-Pas-de-Calais,62,4,24,562,Matringhem,179,6,185
31,Nord-Pas-de-Calais,62,7,51,563,Mazingarbe,7487,55,7542
31,Nord-Pas-de-Calais,62,2,38,564,Mazinghem,422,8,430
31,Nord-Pas-de-Calais,62,4,24,565,Mencas,82,1,83
31,Nord-Pas-de-Calais,62,3,21,566,Menneville,687,17,704
31,Nord-Pas-de-Calais,62,5,02,567,Mentque-Nortbécourt,565,7,572
31,Nord-Pas-de-Calais,62,1,10,568,Mercatel,618,6,624
31,Nord-Pas-de-Calais,62,5,23,569,Merck-Saint-Liévin,577,8,585
31,Nord-Pas-de-Calais,62,7,90,570,Méricourt,12085,76,12161
31,Nord-Pas-de-Calais,62,4,37,571,Merlimont,3059,81,3140
31,Nord-Pas-de-Calais,62,1,11,572,Metz-en-Couture,629,10,639
31,Nord-Pas-de-Calais,62,7,68,573,Meurchin,3676,31,3707
31,Nord-Pas-de-Calais,62,1,05,574,Mingoval,201,3,204
31,Nord-Pas-de-Calais,62,1,43,576,Moncheaux-lès-Frévent,143,0,143
31,Nord-Pas-de-Calais,62,1,07,577,Monchel-sur-Canche,67,2,69
31,Nord-Pas-de-Calais,62,1,10,578,Monchiet,99,1,100
31,Nord-Pas-de-Calais,62,1,10,579,Monchy-au-Bois,505,16,521
31,Nord-Pas-de-Calais,62,1,05,580,Monchy-Breton,414,4,418
31,Nord-Pas-de-Calais,62,1,27,581,Monchy-Cayeux,284,9,293
31,Nord-Pas-de-Calais,62,1,46,582,Monchy-le-Preux,591,29,620
31,Nord-Pas-de-Calais,62,1,40,583,Mondicourt,656,11,667
31,Nord-Pas-de-Calais,62,2,33,584,Mont-Bernanchon,1360,22,1382
31,Nord-Pas-de-Calais,62,1,71,589,Mont-Saint-Éloi,1011,38,1049
31,Nord-Pas-de-Calais,62,4,22,585,Montcavrel,359,9,368
31,Nord-Pas-de-Calais,62,1,10,586,Montenescourt,420,13,433
31,Nord-Pas-de-Calais,62,7,74,587,Montigny-en-Gohelle,10249,53,10302
31,Nord-Pas-de-Calais,62,4,37,588,Montreuil,2300,210,2510
31,Nord-Pas-de-Calais,62,1,43,590,Monts-en-Ternois,53,3,56
31,Nord-Pas-de-Calais,62,1,11,591,Morchies,178,3,181
31,Nord-Pas-de-Calais,62,5,41,592,Moringhem,475,17,492
31,Nord-Pas-de-Calais,62,1,09,593,Morval,88,3,91
31,Nord-Pas-de-Calais,62,1,20,594,Mory,340,5,345
31,Nord-Pas-de-Calais,62,5,41,595,Moulle,937,20,957
31,Nord-Pas-de-Calais,62,4,26,596,Mouriez,249,8,257
31,Nord-Pas-de-Calais,62,1,20,597,Moyenneville,285,4,289
31,Nord-Pas-de-Calais,62,5,02,598,Muncq-Nieurlet,619,14,633
31,Nord-Pas-de-Calais,62,3,21,599,Nabringhen,165,2,167
31,Nord-Pas-de-Calais,62,1,27,600,Nédon,160,0,160
31,Nord-Pas-de-Calais,62,1,27,601,Nédonchel,240,2,242
31,Nord-Pas-de-Calais,62,4,37,602,Nempont-Saint-Firmin,202,2,204
31,Nord-Pas-de-Calais,62,3,44,603,Nesles,1019,12,1031
31,Nord-Pas-de-Calais,62,3,44,604,Neufchâtel-Hardelot,3793,112,3905
31,Nord-Pas-de-Calais,62,4,39,605,Neulette,16,1,17
31,Nord-Pas-de-Calais,62,2,30,606,Neuve-Chapelle,1391,16,1407
31,Nord-Pas-de-Calais,62,1,43,607,Neuville-au-Cornet,80,0,80
31,Nord-Pas-de-Calais,62,1,11,608,Neuville-Bourjonval,168,0,168
31,Nord-Pas-de-Calais,62,1,45,609,Neuville-Saint-Vaast,1467,52,1519
31,Nord-Pas-de-Calais,62,4,37,610,Neuville-sous-Montreuil,664,27,691
31,Nord-Pas-de-Calais,62,1,04,611,Neuville-Vitasse,477,10,487
31,Nord-Pas-de-Calais,62,1,45,612,Neuvireuil,463,9,472
31,Nord-Pas-de-Calais,62,5,02,614,Nielles-lès-Ardres,500,12,512
31,Nord-Pas-de-Calais,62,5,34,613,Nielles-lès-Bléquin,851,25,876
31,Nord-Pas-de-Calais,62,6,15,615,Nielles-lès-Calais,221,6,227
31,Nord-Pas-de-Calais,62,1,07,616,Noeux-lès-Auxi,170,3,173
31,Nord-Pas-de-Calais,62,2,57,617,Noeux-les-Mines,12113,139,12252
31,Nord-Pas-de-Calais,62,5,02,618,Nordausques,871,15,886
31,Nord-Pas-de-Calais,62,1,20,619,Noreuil,132,2,134
31,Nord-Pas-de-Calais,62,2,38,620,Norrent-Fontes,1431,29,1460
31,Nord-Pas-de-Calais,62,5,02,622,Nort-Leulinghem,203,4,207
31,Nord-Pas-de-Calais,62,5,06,621,Nortkerque,1623,20,1643
31,Nord-Pas-de-Calais,62,5,06,623,Nouvelle-Église,488,8,496
31,Nord-Pas-de-Calais,62,1,08,630,Noyelle-Vion,244,4,248
31,Nord-Pas-de-Calais,62,7,48,624,Noyelles-Godault,5175,48,5223
31,Nord-Pas-de-Calais,62,4,39,625,Noyelles-lès-Humières,64,0,64
31,Nord-Pas-de-Calais,62,2,17,626,Noyelles-lès-Vermelles,2102,16,2118
31,Nord-Pas-de-Calais,62,1,46,627,Noyelles-sous-Bellonne,786,17,803
31,Nord-Pas-de-Calais,62,7,75,628,Noyelles-sous-Lens,7005,39,7044
31,Nord-Pas-de-Calais,62,1,08,629,Noyellette,182,4,186
31,Nord-Pas-de-Calais,62,1,43,631,Nuncq-Hautecôte,383,14,397
31,Nord-Pas-de-Calais,62,2,12,632,Oblinghem,210,10,220
31,Nord-Pas-de-Calais,62,1,43,633,OEuf-en-Ternois,252,6,258
31,Nord-Pas-de-Calais,62,5,06,634,Offekerque,1076,19,1095
31,Nord-Pas-de-Calais,62,4,18,635,Offin,199,4,203
31,Nord-Pas-de-Calais,62,3,36,636,Offrethun,251,7,258
31,Nord-Pas-de-Calais,62,7,59,637,Oignies,10231,66,10297
31,Nord-Pas-de-Calais,62,1,35,638,Oisy-le-Verger,1289,12,1301
31,Nord-Pas-de-Calais,62,1,45,639,Oppy,377,10,387
31,Nord-Pas-de-Calais,62,1,40,640,Orville,358,5,363
31,Nord-Pas-de-Calais,62,1,43,641,Ostreville,265,18,283
31,Nord-Pas-de-Calais,62,2,28,642,Ourton,777,10,787
31,Nord-Pas-de-Calais,62,3,61,643,Outreau,14445,219,14664
31,Nord-Pas-de-Calais,62,5,34,644,Ouve-Wirquin,541,7,548
31,Nord-Pas-de-Calais,62,5,06,645,Oye-Plage,5557,111,5668
31,Nord-Pas-de-Calais,62,1,35,646,Palluel,564,8,572
31,Nord-Pas-de-Calais,62,4,39,647,Le Parcq,770,16,786
31,Nord-Pas-de-Calais,62,4,29,648,Parenty,421,5,426
31,Nord-Pas-de-Calais,62,1,40,649,Pas-en-Artois,802,14,816
31,Nord-Pas-de-Calais,62,1,46,650,Pelves,718,9,727
31,Nord-Pas-de-Calais,62,1,05,651,Penin,418,4,422
31,Nord-Pas-de-Calais,62,1,27,652,Pernes,1646,15,1661
31,Nord-Pas-de-Calais,62,3,13,653,Pernes-lès-Boulogne,478,13,491
31,Nord-Pas-de-Calais,62,6,15,654,Peuplingues,619,11,630
31,Nord-Pas-de-Calais,62,1,43,655,Pierremont,260,11,271
31,Nord-Pas-de-Calais,62,5,34,656,Pihem,962,18,980
31,Nord-Pas-de-Calais,62,6,25,657,Pihen-lès-Guînes,490,11,501
31,Nord-Pas-de-Calais,62,3,13,658,Pittefaux,123,5,128
31,Nord-Pas-de-Calais,62,4,24,659,Planques,107,5,112
31,Nord-Pas-de-Calais,62,1,46,660,Plouvain,474,7,481
31,Nord-Pas-de-Calais,62,5,06,662,Polincove,739,11,750
31,Nord-Pas-de-Calais,62,1,40,663,Pommera,291,2,293
31,Nord-Pas-de-Calais,62,1,40,664,Pommier,241,0,241
31,Nord-Pas-de-Calais,62,1,07,665,Le Ponchel,222,5,227
31,Nord-Pas-de-Calais,62,7,55,666,Pont-à-Vendin,3102,27,3129
31,Nord-Pas-de-Calais,62,3,76,667,Le Portel,10099,108,10207
31,Nord-Pas-de-Calais,62,1,27,668,Prédefin,187,6,193
31,Nord-Pas-de-Calais,62,1,27,669,Pressy,283,2,285
31,Nord-Pas-de-Calais,62,4,29,670,Preures,539,8,547
31,Nord-Pas-de-Calais,62,1,35,671,Pronville,312,2,314
31,Nord-Pas-de-Calais,62,1,40,672,Puisieux,628,9,637
31,Nord-Pas-de-Calais,62,1,35,673,Quéant,595,8,603
31,Nord-Pas-de-Calais,62,5,34,674,Quelmes,573,9,582
31,Nord-Pas-de-Calais,62,5,34,675,Quercamps,279,3,282
31,Nord-Pas-de-Calais,62,2,38,676,Quernes,452,7,459
31,Nord-Pas-de-Calais,62,4,39,677,Le Quesnoy-en-Artois,352,2,354
31,Nord-Pas-de-Calais,62,3,21,678,Quesques,569,13,582
31,Nord-Pas-de-Calais,62,3,44,679,Questrecques,351,4,355
31,Nord-Pas-de-Calais,62,1,45,680,Quiéry-la-Motte,734,15,749
31,Nord-Pas-de-Calais,62,5,01,681,Quiestède,659,26,685
31,Nord-Pas-de-Calais,62,4,29,682,Quilen,60,2,62
31,Nord-Pas-de-Calais,62,1,07,683,Quoeux-Haut-Maînil,243,6,249
31,Nord-Pas-de-Calais,62,5,01,684,Racquinghem,2283,30,2313
31,Nord-Pas-de-Calais,62,4,24,685,Radinghem,288,139,427
31,Nord-Pas-de-Calais,62,1,43,686,Ramecourt,322,17,339
31,Nord-Pas-de-Calais,62,4,69,688,Rang-du-Fliers,4062,125,4187
31,Nord-Pas-de-Calais,62,1,10,689,Ransart,375,12,387
31,Nord-Pas-de-Calais,62,4,26,690,Raye-sur-Authie,227,2,229
31,Nord-Pas-de-Calais,62,5,01,691,Rebecques,427,12,439
31,Nord-Pas-de-Calais,62,5,02,692,Rebergues,215,3,218
31,Nord-Pas-de-Calais,62,2,28,693,Rebreuve-Ranchicourt,1091,27,1118
31,Nord-Pas-de-Calais,62,1,08,694,Rebreuve-sur-Canche,218,3,221
31,Nord-Pas-de-Calais,62,1,08,695,Rebreuviette,262,2,264
31,Nord-Pas-de-Calais,62,5,23,696,Reclinghem,179,0,179
31,Nord-Pas-de-Calais,62,1,46,697,Récourt,232,13,245
31,Nord-Pas-de-Calais,62,4,22,698,Recques-sur-Course,270,8,278
31,Nord-Pas-de-Calais,62,5,02,699,Recques-sur-Hem,607,13,620
31,Nord-Pas-de-Calais,62,4,26,700,Regnauville,224,3,227
31,Nord-Pas-de-Calais,62,2,38,701,Rely,432,2,434
31,Nord-Pas-de-Calais,62,5,34,702,Remilly-Wirquin,351,5,356
31,Nord-Pas-de-Calais,62,1,46,703,Rémy,256,4,260
31,Nord-Pas-de-Calais,62,5,23,704,Renty,536,11,547
31,Nord-Pas-de-Calais,62,3,36,705,Rety,2034,25,2059
31,Nord-Pas-de-Calais,62,2,17,706,Richebourg,2395,60,2455
31,Nord-Pas-de-Calais,62,1,09,708,Riencourt-lès-Bapaume,34,0,34
31,Nord-Pas-de-Calais,62,1,46,709,Riencourt-lès-Cagnicourt,278,4,282
31,Nord-Pas-de-Calais,62,4,24,710,Rimboval,129,3,132
31,Nord-Pas-de-Calais,62,3,36,711,Rinxent,2743,20,2763
31,Nord-Pas-de-Calais,62,1,10,712,Rivière,1126,30,1156
31,Nord-Pas-de-Calais,62,2,33,713,Robecq,1220,24,1244
31,Nord-Pas-de-Calais,62,1,71,714,Roclincourt,789,17,806
31,Nord-Pas-de-Calais,62,1,11,715,Rocquigny,288,8,296
31,Nord-Pas-de-Calais,62,5,02,716,Rodelinghem,537,8,545
31,Nord-Pas-de-Calais,62,1,43,717,Roëllecourt,632,7,639
31,Nord-Pas-de-Calais,62,1,46,718,Roeux,1393,14,1407
31,Nord-Pas-de-Calais,62,4,39,719,Rollancourt,374,39,413
31,Nord-Pas-de-Calais,62,2,38,720,Rombly,33,0,33
31,Nord-Pas-de-Calais,62,5,01,721,Roquetoire,1785,36,1821
31,Nord-Pas-de-Calais,62,1,07,722,Rougefay,99,0,99
31,Nord-Pas-de-Calais,62,4,18,723,Roussent,193,3,196
31,Nord-Pas-de-Calais,62,7,67,724,Rouvroy,8856,55,8911
31,Nord-Pas-de-Calais,62,4,24,725,Royon,117,7,124
31,Nord-Pas-de-Calais,62,4,24,726,Ruisseauville,149,2,151
31,Nord-Pas-de-Calais,62,2,64,727,Ruitz,1501,29,1530
31,Nord-Pas-de-Calais,62,1,35,728,Rumaucourt,699,8,707
31,Nord-Pas-de-Calais,62,4,29,729,Rumilly,269,7,276
31,Nord-Pas-de-Calais,62,5,06,730,Ruminghem,1502,21,1523
31,Nord-Pas-de-Calais,62,1,11,731,Ruyaulcourt,266,2,268
31,Nord-Pas-de-Calais,62,1,27,732,Sachin,266,6,272
31,Nord-Pas-de-Calais,62,1,40,733,Sailly-au-Bois,276,3,279
31,Nord-Pas-de-Calais,62,1,46,734,Sailly-en-Ostrevent,694,3,697
31,Nord-Pas-de-Calais,62,2,57,735,Sailly-Labourse,2151,16,2167
31,Nord-Pas-de-Calais,62,2,30,736,Sailly-sur-la-Lys,4066,77,4143
31,Nord-Pas-de-Calais,62,7,77,737,Sains-en-Gohelle,6039,59,6098
31,Nord-Pas-de-Calais,62,4,24,738,Sains-lès-Fressin,183,1,184
31,Nord-Pas-de-Calais,62,1,35,739,Sains-lès-Marquion,337,3,340
31,Nord-Pas-de-Calais,62,1,27,740,Sains-lès-Pernes,257,6,263
31,Nord-Pas-de-Calais,62,1,40,741,Saint-Amand,149,6,155
31,Nord-Pas-de-Calais,62,4,37,742,Saint-Aubin,249,14,263
31,Nord-Pas-de-Calais,62,4,18,745,Saint-Denoeux,124,0,124
31,Nord-Pas-de-Calais,62,3,44,746,Saint-Étienne-au-Mont,5097,53,5150
31,Nord-Pas-de-Calais,62,2,33,747,Saint-Floris,478,9,487
31,Nord-Pas-de-Calais,62,5,06,748,Saint-Folquin,2238,61,2299
31,Nord-Pas-de-Calais,62,4,39,749,Saint-Georges,303,7,310
31,Nord-Pas-de-Calais,62,2,38,750,Saint-Hilaire-Cottes,816,9,825
31,Nord-Pas-de-Calais,62,3,36,751,Saint-Inglevert,721,11,732
31,Nord-Pas-de-Calais,62,4,37,752,Saint-Josse,1197,35,1232
31,Nord-Pas-de-Calais,62,1,03,753,Saint-Laurent-Blangy,5685,71,5756
31,Nord-Pas-de-Calais,62,1,20,754,Saint-Léger,401,8,409
31,Nord-Pas-de-Calais,62,3,44,755,Saint-Léonard,3587,59,3646
31,Nord-Pas-de-Calais,62,5,41,757,Saint-Martin-au-Laërt,3775,77,3852
31,Nord-Pas-de-Calais,62,3,14,758,Saint-Martin-Boulogne,11469,274,11743
31,Nord-Pas-de-Calais,62,3,21,759,Saint-Martin-Choquel,462,10,472
31,Nord-Pas-de-Calais,62,5,23,760,Saint-Martin-d'Hardinghem,309,13,322
31,Nord-Pas-de-Calais,62,1,20,761,Saint-Martin-sur-Cojeul,206,6,212
31,Nord-Pas-de-Calais,62,4,29,762,Saint-Michel-sous-Bois,113,4,117
31,Nord-Pas-de-Calais,62,1,43,763,Saint-Michel-sur-Ternoise,930,24,954
31,Nord-Pas-de-Calais,62,1,03,764,Saint-Nicolas,5009,73,5082
31,Nord-Pas-de-Calais,62,5,99,765,Saint-Omer,15022,712,15734
31,Nord-Pas-de-Calais,62,5,06,766,Saint-Omer-Capelle,1054,10,1064
31,Nord-Pas-de-Calais,62,1,43,767,Saint-Pol-sur-Ternoise,5120,207,5327
31,Nord-Pas-de-Calais,62,4,18,768,Saint-Rémy-au-Bois,117,2,119
31,Nord-Pas-de-Calais,62,6,15,769,Saint-Tricat,656,25,681
31,Nord-Pas-de-Calais,62,2,33,770,Saint-Venant,3291,110,3401
31,Nord-Pas-de-Calais,62,4,26,743,Sainte-Austreberthe,379,19,398
31,Nord-Pas-de-Calais,62,1,71,744,Sainte-Catherine,3437,92,3529
31,Nord-Pas-de-Calais,62,5,06,756,Sainte-Marie-Kerque,1517,23,1540
31,Nord-Pas-de-Calais,62,7,31,771,Sallaumines,10144,133,10277
31,Nord-Pas-de-Calais,62,5,41,772,Salperwick,500,8,508
31,Nord-Pas-de-Calais,62,3,44,773,Samer,3483,102,3585
31,Nord-Pas-de-Calais,62,6,15,774,Sangatte,4611,105,4716
31,Nord-Pas-de-Calais,62,6,25,775,Sanghen,261,1,262
31,Nord-Pas-de-Calais,62,1,09,776,Sapignies,187,4,191
31,Nord-Pas-de-Calais,62,1,09,777,Le Sars,165,2,167
31,Nord-Pas-de-Calais,62,1,08,778,Sars-le-Bois,67,0,67
31,Nord-Pas-de-Calais,62,1,40,779,Sarton,174,0,174
31,Nord-Pas-de-Calais,62,1,35,780,Sauchy-Cauchy,400,8,408
31,Nord-Pas-de-Calais,62,1,35,781,Sauchy-Lestrée,456,4,460
31,Nord-Pas-de-Calais,62,1,46,782,Saudemont,439,6,445
31,Nord-Pas-de-Calais,62,4,18,783,Saulchoy,335,4,339
31,Nord-Pas-de-Calais,62,1,08,784,Saulty,697,5,702
31,Nord-Pas-de-Calais,62,1,05,785,Savy-Berlette,959,108,1067
31,Nord-Pas-de-Calais,62,3,21,786,Selles,317,8,325
31,Nord-Pas-de-Calais,62,4,18,787,Sempy,272,4,276
31,Nord-Pas-de-Calais,62,5,34,788,Seninghem,612,14,626
31,Nord-Pas-de-Calais,62,3,21,789,Senlecques,237,3,240
31,Nord-Pas-de-Calais,62,4,24,790,Senlis,189,6,195
31,Nord-Pas-de-Calais,62,1,43,791,Séricourt,53,2,55
31,Nord-Pas-de-Calais,62,5,41,792,Serques,1113,36,1149
31,Nord-Pas-de-Calais,62,7,77,793,Servins,1041,24,1065
31,Nord-Pas-de-Calais,62,5,34,794,Setques,635,12,647
31,Nord-Pas-de-Calais,62,1,43,795,Sibiville,89,5,94
31,Nord-Pas-de-Calais,62,1,10,796,Simencourt,539,12,551
31,Nord-Pas-de-Calais,62,1,43,797,Siracourt,242,11,253
31,Nord-Pas-de-Calais,62,1,08,798,Sombrin,236,5,241
31,Nord-Pas-de-Calais,62,4,37,799,Sorrus,620,19,639
31,Nord-Pas-de-Calais,62,1,40,800,Souastre,353,0,353
31,Nord-Pas-de-Calais,62,1,45,801,Souchez,2394,32,2426
31,Nord-Pas-de-Calais,62,1,08,802,Le Souich,184,3,187
31,Nord-Pas-de-Calais,62,5,34,803,Surques,475,3,478
31,Nord-Pas-de-Calais,62,1,08,804,Sus-Saint-Léger,345,3,348
31,Nord-Pas-de-Calais,62,1,27,805,Tangry,244,2,246
31,Nord-Pas-de-Calais,62,3,36,806,Tardinghen,167,4,171
31,Nord-Pas-de-Calais,62,5,42,807,Tatinghem,1812,42,1854
31,Nord-Pas-de-Calais,62,1,27,808,Teneur,274,2,276
31,Nord-Pas-de-Calais,62,1,43,809,Ternas,135,0,135
31,Nord-Pas-de-Calais,62,1,45,810,Thélus,1186,15,1201
31,Nord-Pas-de-Calais,62,5,01,811,Thérouanne,1055,31,1086
31,Nord-Pas-de-Calais,62,5,23,812,Thiembronne,695,18,713
31,Nord-Pas-de-Calais,62,1,05,813,La Thieuloye,454,6,460
31,Nord-Pas-de-Calais,62,1,40,814,Thièvres,120,1,121
31,Nord-Pas-de-Calais,62,4,69,815,Tigny-Noyelle,157,3,160
31,Nord-Pas-de-Calais,62,1,05,816,Tilloy-lès-Hermaville,224,1,225
31,Nord-Pas-de-Calais,62,1,04,817,Tilloy-lès-Mofflaines,1400,104,1504
31,Nord-Pas-de-Calais,62,1,27,818,Tilly-Capelle,163,6,169
31,Nord-Pas-de-Calais,62,5,41,819,Tilques,1067,34,1101
31,Nord-Pas-de-Calais,62,1,05,820,Tincques,883,10,893
31,Nord-Pas-de-Calais,62,3,44,821,Tingry,316,6,322
31,Nord-Pas-de-Calais,62,1,07,822,Tollent,89,3,92
31,Nord-Pas-de-Calais,62,4,24,823,Torcy,162,5,167
31,Nord-Pas-de-Calais,62,4,26,824,Tortefontaine,234,6,240
31,Nord-Pas-de-Calais,62,1,46,825,Tortequesne,717,10,727
31,Nord-Pas-de-Calais,62,4,37,826,Le Touquet-Paris-Plage,5076,352,5428
31,Nord-Pas-de-Calais,62,5,02,827,Tournehem-sur-la-Hem,1302,19,1321
31,Nord-Pas-de-Calais,62,4,39,828,Tramecourt,54,1,55
31,Nord-Pas-de-Calais,62,1,09,829,Le Transloy,430,8,438
31,Nord-Pas-de-Calais,62,1,11,830,Trescault,187,6,193
31,Nord-Pas-de-Calais,62,1,43,831,Troisvaux,289,7,296
31,Nord-Pas-de-Calais,62,4,22,832,Tubersent,520,8,528
31,Nord-Pas-de-Calais,62,1,07,833,Vacquerie-le-Boucq,83,3,86
31,Nord-Pas-de-Calais,62,4,39,834,Vacqueriette-Erquières,244,6,250
31,Nord-Pas-de-Calais,62,1,27,835,Valhuon,561,9,570
31,Nord-Pas-de-Calais,62,2,64,836,Vaudricourt,914,36,950
31,Nord-Pas-de-Calais,62,5,34,837,Vaudringhem,472,3,475
31,Nord-Pas-de-Calais,62,1,07,838,Vaulx,85,0,85
31,Nord-Pas-de-Calais,62,1,20,839,Vaulx-Vraucourt,1070,13,1083
31,Nord-Pas-de-Calais,62,1,11,840,Vélu,127,3,130
31,Nord-Pas-de-Calais,62,7,68,842,Vendin-le-Vieil,7354,56,7410
31,Nord-Pas-de-Calais,62,2,12,841,Vendin-lès-Béthune,2402,43,2445
31,Nord-Pas-de-Calais,62,4,24,843,Verchin,208,5,213
31,Nord-Pas-de-Calais,62,4,29,844,Verchocq,589,11,600
31,Nord-Pas-de-Calais,62,3,44,845,Verlincthun,371,4,375
31,Nord-Pas-de-Calais,62,2,17,846,Vermelles,4305,41,4346
31,Nord-Pas-de-Calais,62,2,70,847,Verquigneul,2014,37,2051
31,Nord-Pas-de-Calais,62,2,53,848,Verquin,3273,47,3320
31,Nord-Pas-de-Calais,62,4,69,849,Verton,2276,85,2361
31,Nord-Pas-de-Calais,62,4,39,850,Vieil-Hesdin,367,16,383
31,Nord-Pas-de-Calais,62,3,21,853,Vieil-Moutier,385,2,387
31,Nord-Pas-de-Calais,62,2,70,851,Vieille-Chapelle,735,11,746
31,Nord-Pas-de-Calais,62,5,06,852,Vieille-Église,1279,20,1299
31,Nord-Pas-de-Calais,62,1,45,854,Villers-au-Bois,469,10,479
31,Nord-Pas-de-Calais,62,1,09,855,Villers-au-Flos,196,7,203
31,Nord-Pas-de-Calais,62,1,05,856,Villers-Brûlin,309,12,321
31,Nord-Pas-de-Calais,62,1,05,857,Villers-Châtel,118,3,121
31,Nord-Pas-de-Calais,62,1,07,859,Villers-l'Hôpital,269,7,276
31,Nord-Pas-de-Calais,62,1,46,858,Villers-lès-Cagnicourt,240,10,250
31,Nord-Pas-de-Calais,62,1,05,860,Villers-Sir-Simon,132,4,136
31,Nord-Pas-de-Calais,62,1,45,861,Vimy,4426,112,4538
31,Nord-Pas-de-Calais,62,4,24,862,Vincly,153,0,153
31,Nord-Pas-de-Calais,62,2,73,863,Violaines,3676,61,3737
31,Nord-Pas-de-Calais,62,1,46,864,Vis-en-Artois,613,15,628
31,Nord-Pas-de-Calais,62,1,46,865,Vitry-en-Artois,4381,53,4434
31,Nord-Pas-de-Calais,62,4,69,866,Waben,393,4,397
31,Nord-Pas-de-Calais,62,3,36,867,Wacquinghen,236,6,242
31,Nord-Pas-de-Calais,62,4,39,868,Wail,265,2,267
31,Nord-Pas-de-Calais,62,1,04,869,Wailly,1017,23,1040
31,Nord-Pas-de-Calais,62,4,37,870,Wailly-Beaucamp,981,25,1006
31,Nord-Pas-de-Calais,62,4,26,871,Wambercourt,228,4,232
31,Nord-Pas-de-Calais,62,4,39,872,Wamin,252,8,260
31,Nord-Pas-de-Calais,62,1,20,873,Wancourt,644,11,655
31,Nord-Pas-de-Calais,62,1,10,874,Wanquetin,684,14,698
31,Nord-Pas-de-Calais,62,5,01,875,Wardrecques,1153,29,1182
31,Nord-Pas-de-Calais,62,1,09,876,Warlencourt-Eaucourt,151,2,153
31,Nord-Pas-de-Calais,62,1,40,877,Warlincourt-lès-Pas,146,3,149
31,Nord-Pas-de-Calais,62,1,10,878,Warlus,359,5,364
31,Nord-Pas-de-Calais,62,1,08,879,Warluzel,249,1,250
31,Nord-Pas-de-Calais,62,3,21,880,Le Wast,198,6,204
31,Nord-Pas-de-Calais,62,5,34,882,Wavrans-sur-l'Aa,1318,25,1343
31,Nord-Pas-de-Calais,62,1,43,883,Wavrans-sur-Ternoise,223,4,227
31,Nord-Pas-de-Calais,62,2,38,885,Westrehem,232,11,243
31,Nord-Pas-de-Calais,62,4,29,886,Wicquinghem,190,4,194
31,Nord-Pas-de-Calais,62,4,22,887,Widehem,264,2,266
31,Nord-Pas-de-Calais,62,3,44,888,Wierre-au-Bois,209,0,209
31,Nord-Pas-de-Calais,62,3,36,889,Wierre-Effroy,803,17,820
31,Nord-Pas-de-Calais,62,4,39,890,Willeman,174,3,177
31,Nord-Pas-de-Calais,62,1,07,891,Willencourt,146,1,147
31,Nord-Pas-de-Calais,62,1,45,892,Willerval,628,16,644
31,Nord-Pas-de-Calais,62,3,65,893,Wimereux,7386,178,7564
31,Nord-Pas-de-Calais,62,3,13,894,Wimille,4319,100,4419
31,Nord-Pas-de-Calais,62,7,68,895,Wingles,8288,74,8362
31,Nord-Pas-de-Calais,62,3,21,896,Wirwignes,721,22,743
31,Nord-Pas-de-Calais,62,5,34,897,Wismes,509,19,528
31,Nord-Pas-de-Calais,62,5,34,898,Wisques,247,3,250
31,Nord-Pas-de-Calais,62,3,36,899,Wissant,1051,21,1072
31,Nord-Pas-de-Calais,62,2,38,900,Witternesse,571,5,576
31,Nord-Pas-de-Calais,62,5,01,901,Wittes,828,10,838
31,Nord-Pas-de-Calais,62,5,42,902,Wizernes,3375,59,3434
31,Nord-Pas-de-Calais,62,1,11,909,Ytres,421,4,425
31,Nord-Pas-de-Calais,62,4,29,903,Zoteux,482,5,487
31,Nord-Pas-de-Calais,62,5,02,904,Zouafques,537,4,541
31,Nord-Pas-de-Calais,62,5,34,905,Zudausques,804,31,835
31,Nord-Pas-de-Calais,62,5,06,906,Zutkerque,1712,22,1734
83,Auvergne,63,4,01,001,Aigueperse,2524,32,2556
83,Auvergne,63,1,41,002,Aix-la-Fayette,78,0,78
83,Auvergne,63,1,02,003,Ambert,6975,296,7271
83,Auvergne,63,4,23,004,Les Ancizes-Comps,1772,24,1796
83,Auvergne,63,3,40,005,Antoingt,374,15,389
83,Auvergne,63,3,03,006,Anzat-le-Luguet,194,2,196
83,Auvergne,63,3,03,007,Apchat,192,6,198
83,Auvergne,63,5,43,008,Arconsat,652,10,662
83,Auvergne,63,3,03,009,Ardes,605,21,626
83,Auvergne,63,1,04,010,Arlanc,1910,58,1968
83,Auvergne,63,4,26,011,Ars-les-Favets,236,3,239
83,Auvergne,63,4,01,012,Artonne,773,16,789
83,Auvergne,63,4,01,013,Aubiat,838,23,861
83,Auvergne,63,2,55,014,Aubière,9977,201,10178
83,Auvergne,63,5,15,015,Aubusson-d'Auvergne,228,4,232
83,Auvergne,63,5,15,016,Augerolles,909,18,927
83,Auvergne,63,3,03,017,Augnat,136,4,140
83,Auvergne,63,3,19,018,Aulhat-Saint-Privat,348,4,352
83,Auvergne,63,2,59,019,Aulnat,4272,50,4322
83,Auvergne,63,2,35,020,Aurières,316,3,319
83,Auvergne,63,2,48,021,Authezat,650,10,660
83,Auvergne,63,3,20,022,Auzat-la-Combelle,2040,48,2088
83,Auvergne,63,1,16,023,Auzelles,338,13,351
83,Auvergne,63,3,45,024,Avèze,212,7,219
83,Auvergne,63,4,42,025,Ayat-sur-Sioule,141,4,145
83,Auvergne,63,2,37,026,Aydat,2051,38,2089
83,Auvergne,63,1,50,027,Baffie,116,2,118
83,Auvergne,63,3,21,028,Bagnols,500,11,511
83,Auvergne,63,3,44,029,Bansat,243,2,245
83,Auvergne,63,4,32,030,Bas-et-Lezat,246,2,248
83,Auvergne,63,3,40,031,Beaulieu,404,11,415
83,Auvergne,63,2,56,032,Beaumont,10953,264,11217
83,Auvergne,63,4,32,033,Beaumont-lès-Randan,245,3,248
83,Auvergne,63,2,47,034,Beauregard-l'Évêque,1315,25,1340
83,Auvergne,63,4,14,035,Beauregard-Vendon,987,14,1001
83,Auvergne,63,3,19,036,Bergonne,355,11,366
83,Auvergne,63,1,36,037,Bertignat,485,19,504
83,Auvergne,63,3,05,038,Besse-et-Saint-Anastaise,1720,26,1746
83,Auvergne,63,1,04,039,Beurières,306,16,322
83,Auvergne,63,2,06,040,Billom,4667,61,4728
83,Auvergne,63,4,42,041,Biollet,326,15,341
83,Auvergne,63,2,59,042,Blanzat,3886,79,3965
83,Auvergne,63,4,25,043,Blot-l'Église,395,22,417
83,Auvergne,63,2,06,044,Bongheat,333,6,339
83,Auvergne,63,2,06,045,Bort-l'Étang,548,5,553
83,Auvergne,63,3,40,046,Boudes,260,3,263
83,Auvergne,63,2,35,047,La Bourboule,1998,63,2061
83,Auvergne,63,2,07,048,Bourg-Lastic,945,12,957
83,Auvergne,63,2,47,049,Bouzel,693,9,702
83,Auvergne,63,3,20,050,Brassac-les-Mines,3252,150,3402
83,Auvergne,63,3,44,051,Brenat,554,20,574
83,Auvergne,63,3,40,052,Le Breuil-sur-Couze,949,79,1028
83,Auvergne,63,2,07,053,Briffons,311,5,316
83,Auvergne,63,3,19,054,Le Broc,609,20,629
83,Auvergne,63,4,31,055,Bromont-Lamothe,943,16,959
83,Auvergne,63,1,16,056,Brousse,365,9,374
83,Auvergne,63,1,27,057,Le Brugeron,260,11,271
83,Auvergne,63,5,22,058,Bulhon,466,5,471
83,Auvergne,63,2,49,059,Busséol,189,1,190
83,Auvergne,63,4,28,060,Bussières,109,1,110
83,Auvergne,63,4,01,061,Bussières-et-Pruns,411,7,418
83,Auvergne,63,4,26,062,Buxières-sous-Montaigut,250,5,255
83,Auvergne,63,2,59,063,Cébazat,7730,126,7856
83,Auvergne,63,2,39,065,Ceilloux,155,8,163
83,Auvergne,63,4,29,064,La Celle,86,4,90
83,Auvergne,63,5,43,066,Celles-sur-Durolle,1812,29,1841
83,Auvergne,63,4,28,067,La Cellette,163,4,167
83,Auvergne,63,4,33,068,Cellule,973,12,985
83,Auvergne,63,2,48,069,Le Cendre,4611,73,4684
83,Auvergne,63,2,56,070,Ceyrat,5400,211,5611
83,Auvergne,63,2,35,071,Ceyssat,628,12,640
83,Auvergne,63,5,43,072,Chabreloche,1294,25,1319
83,Auvergne,63,3,08,073,Chadeleuf,388,11,399
83,Auvergne,63,3,40,074,Chalus,180,1,181
83,Auvergne,63,2,57,075,Chamalières,17148,583,17731
83,Auvergne,63,1,41,076,Chambon-sur-Dolore,174,4,178
83,Auvergne,63,3,05,077,Chambon-sur-Lac,355,6,361
83,Auvergne,63,3,44,078,Chaméane,142,3,145
83,Auvergne,63,3,20,079,Champagnat-le-Jeune,121,1,122
83,Auvergne,63,3,08,080,Champeix,1312,18,1330
83,Auvergne,63,1,02,081,Champétières,253,6,259
83,Auvergne,63,4,14,082,Champs,300,4,304
83,Auvergne,63,2,61,083,Chanat-la-Mouteyre,941,25,966
83,Auvergne,63,2,37,084,Chanonat,1607,40,1647
83,Auvergne,63,4,31,085,Chapdes-Beaufort,992,30,1022
83,Auvergne,63,1,16,086,La Chapelle-Agnon,388,13,401
83,Auvergne,63,3,03,087,La Chapelle-Marcousse,70,2,72
83,Auvergne,63,3,20,088,La Chapelle-sur-Usson,73,1,74
83,Auvergne,63,4,17,089,Chappes,1477,7,1484
83,Auvergne,63,4,01,090,Chaptuzat,420,13,433
83,Auvergne,63,3,40,091,Charbonnier-les-Mines,883,35,918
83,Auvergne,63,4,23,092,Charbonnières-les-Varennes,1478,52,1530
83,Auvergne,63,4,23,093,Charbonnières-les-Vieilles,930,10,940
83,Auvergne,63,4,42,094,Charensat,511,12,523
83,Auvergne,63,5,22,095,Charnat,201,10,211
83,Auvergne,63,2,47,096,Chas,391,5,396
83,Auvergne,63,3,03,097,Chassagne,93,1,94
83,Auvergne,63,3,21,098,Chastreix,246,10,256
83,Auvergne,63,4,28,101,Château-sur-Cher,92,1,93
83,Auvergne,63,4,34,099,Châteaugay,3105,87,3192
83,Auvergne,63,4,23,100,Châteauneuf-les-Bains,299,8,307
83,Auvergne,63,4,33,103,Châtel-Guyon,6225,196,6421
83,Auvergne,63,5,09,102,Châteldon,754,11,765
83,Auvergne,63,1,38,104,La Chaulme,132,3,135
83,Auvergne,63,1,04,105,Chaumont-le-Bourg,215,6,221
83,Auvergne,63,2,47,106,Chauriat,1524,35,1559
83,Auvergne,63,4,17,107,Chavaroux,436,2,438
83,Auvergne,63,4,33,108,Le Cheix,610,5,615
83,Auvergne,63,3,08,109,Chidrac,483,4,487
83,Auvergne,63,4,31,110,Cisternes-la-Forêt,488,6,494
83,Auvergne,63,3,08,111,Clémensat,106,3,109
83,Auvergne,63,4,17,112,Clerlande,357,7,364
83,Auvergne,63,2,98,113,Clermont-Ferrand,139006,3401,142407
83,Auvergne,63,3,40,114,Collanges,167,3,170
83,Auvergne,63,4,29,115,Combrailles,207,2,209
83,Auvergne,63,4,14,116,Combronde,1974,51,2025
83,Auvergne,63,3,05,117,Compains,154,0,154
83,Auvergne,63,4,29,118,Condat-en-Combraille,497,7,504
83,Auvergne,63,1,41,119,Condat-lès-Montboissier,234,5,239
83,Auvergne,63,2,48,120,Corent,662,8,670
83,Auvergne,63,3,19,121,Coudes,1129,22,1151
83,Auvergne,63,3,08,122,Courgoul,64,5,69
83,Auvergne,63,2,37,123,Cournols,226,11,237
83,Auvergne,63,2,58,124,Cournon-d'Auvergne,19124,482,19606
83,Auvergne,63,5,15,125,Courpière,4523,192,4715
83,Auvergne,63,2,48,126,Le Crest,1219,29,1248
83,Auvergne,63,3,08,127,Creste,53,2,55
83,Auvergne,63,5,22,128,Crevant-Laveine,954,30,984
83,Auvergne,63,3,21,129,Cros,179,7,186
83,Auvergne,63,4,26,130,La Crouzille,283,3,286
83,Auvergne,63,5,22,131,Culhat,1044,27,1071
83,Auvergne,63,1,16,132,Cunlhat,1315,40,1355
83,Auvergne,63,2,30,133,Dallet,1327,28,1355
83,Auvergne,63,3,03,134,Dauzat-sur-Vodable,81,2,83
83,Auvergne,63,4,14,135,Davayat,565,9,574
83,Auvergne,63,2,39,136,Domaize,371,6,377
83,Auvergne,63,1,04,137,Doranges,150,10,160
83,Auvergne,63,5,46,138,Dorat,675,21,696
83,Auvergne,63,1,04,139,Dore-l'Église,640,20,660
83,Auvergne,63,4,26,140,Durmignat,202,8,210
83,Auvergne,63,2,61,141,Durtol,1944,46,1990
83,Auvergne,63,1,41,142,Échandelys,233,6,239
83,Auvergne,63,4,01,143,Effiat,989,14,1003
83,Auvergne,63,3,05,144,Égliseneuve-d'Entraigues,477,24,501
83,Auvergne,63,3,44,145,Égliseneuve-des-Liards,144,3,147
83,Auvergne,63,2,06,146,Égliseneuve-près-Billom,835,62,897
83,Auvergne,63,1,50,147,Églisolles,244,0,244
83,Auvergne,63,4,17,148,Ennezat,2293,53,2346
83,Auvergne,63,4,17,149,Entraigues,651,10,661
83,Auvergne,63,4,34,150,Enval,1444,34,1478
83,Auvergne,63,5,46,151,Escoutoux,1274,51,1325
83,Auvergne,63,4,42,152,Espinasse,322,4,326
83,Auvergne,63,3,05,153,Espinchal,105,0,105
83,Auvergne,63,2,47,154,Espirat,328,11,339
83,Auvergne,63,2,39,155,Estandeuil,349,8,357
83,Auvergne,63,3,20,156,Esteil,75,1,76
83,Auvergne,63,2,39,157,Fayet-le-Château,277,5,282
83,Auvergne,63,1,41,158,Fayet-Ronaye,108,4,112
83,Auvergne,63,4,29,159,Fernoël,133,2,135
83,Auvergne,63,3,19,160,Flat,479,11,490
83,Auvergne,63,1,02,161,La Forie,350,14,364
83,Auvergne,63,1,41,162,Fournols,382,7,389
83,Auvergne,63,2,35,163,Gelles,907,71,978
83,Auvergne,63,2,59,164,Gerzat,10364,170,10534
83,Auvergne,63,4,29,165,Giat,901,43,944
83,Auvergne,63,3,40,166,Gignat,234,13,247
83,Auvergne,63,4,14,167,Gimeaux,396,7,403
83,Auvergne,63,2,06,168,Glaine-Montaigut,536,15,551
83,Auvergne,63,3,03,169,La Godivelle,22,1,23
83,Auvergne,63,4,31,170,La Goutelle,560,12,572
83,Auvergne,63,4,42,171,Gouttières,363,12,375
83,Auvergne,63,3,08,172,Grandeyrolles,62,0,62
83,Auvergne,63,1,38,173,Grandrif,177,6,183
83,Auvergne,63,1,36,174,Grandval,108,7,115
83,Auvergne,63,2,18,175,Herment,274,6,280
83,Auvergne,63,2,35,176,Heume-l'Église,116,5,121
83,Auvergne,63,2,49,177,Isserteaux,410,8,418
83,Auvergne,63,3,19,178,Issoire,14163,472,14635
83,Auvergne,63,1,02,179,Job,1064,24,1088
83,Auvergne,63,5,24,180,Joze,1034,26,1060
83,Auvergne,63,4,14,181,Jozerand,420,12,432
83,Auvergne,63,3,20,182,Jumeaux,685,12,697
83,Auvergne,63,3,45,183,Labessette,74,1,75
83,Auvergne,63,5,09,184,Lachaux,301,4,305
83,Auvergne,63,3,20,185,Lamontgie,554,9,563
83,Auvergne,63,4,29,186,Landogne,212,7,219
83,Auvergne,63,4,26,187,Lapeyrouse,568,11,579
83,Auvergne,63,2,49,188,Laps,543,8,551
83,Auvergne,63,2,35,189,Laqueuille,393,7,400
83,Auvergne,63,3,45,190,Larodde,283,8,291
83,Auvergne,63,2,07,191,Lastic,113,8,121
83,Auvergne,63,2,30,193,Lempdes,8312,337,8649
83,Auvergne,63,5,22,194,Lempty,337,7,344
83,Auvergne,63,5,22,195,Lezoux,5541,107,5648
83,Auvergne,63,5,24,196,Limons,705,11,716
83,Auvergne,63,4,25,197,Lisseuil,86,13,99
83,Auvergne,63,4,23,198,Loubeyrat,1128,18,1146
83,Auvergne,63,3,08,199,Ludesse,436,5,441
83,Auvergne,63,2,30,200,Lussat,858,17,875
83,Auvergne,63,5,24,201,Luzillat,897,29,926
83,Auvergne,63,3,03,202,Madriat,106,3,109
83,Auvergne,63,4,34,203,Malauzat,1021,30,1051
83,Auvergne,63,2,59,204,Malintrat,993,17,1010
83,Auvergne,63,2,49,205,Manglieu,434,8,442
83,Auvergne,63,4,23,206,Manzat,1212,52,1264
83,Auvergne,63,1,27,207,Marat,816,24,840
83,Auvergne,63,4,25,208,Marcillat,198,4,202
83,Auvergne,63,3,40,209,Mareugheol,175,5,180
83,Auvergne,63,5,24,210,Maringues,2722,60,2782
83,Auvergne,63,1,02,211,Marsac-en-Livradois,1446,60,1506
83,Auvergne,63,4,34,212,Marsat,1203,41,1244
83,Auvergne,63,2,30,213,Les Martres-d'Artière,1888,55,1943
83,Auvergne,63,2,48,214,Les Martres-de-Veyre,3980,120,4100
83,Auvergne,63,4,17,215,Martres-sur-Morge,530,13,543
83,Auvergne,63,2,06,216,Mauzun,89,2,91
83,Auvergne,63,1,04,218,Mayres,182,5,187
83,Auvergne,63,2,35,219,Mazaye,660,16,676
83,Auvergne,63,3,03,220,Mazoires,103,7,110
83,Auvergne,63,1,50,221,Medeyrolles,113,3,116
83,Auvergne,63,3,19,222,Meilhaud,532,14,546
83,Auvergne,63,4,25,223,Menat,588,18,606
83,Auvergne,63,4,33,224,Ménétrol,1561,30,1591
83,Auvergne,63,2,07,225,Messeix,1181,36,1217
83,Auvergne,63,2,47,226,Mezel,1809,44,1853
83,Auvergne,63,2,49,227,Mirefleurs,2199,59,2258
83,Auvergne,63,4,29,228,Miremont,329,9,338
83,Auvergne,63,2,47,229,Moissat,1001,16,1017
83,Auvergne,63,1,36,230,Le Monestier,185,7,192
83,Auvergne,63,5,43,231,La Monnerie-le-Montel,2042,30,2072
83,Auvergne,63,4,32,232,Mons,403,15,418
83,Auvergne,63,2,35,236,Mont-Dore,1384,37,1421
83,Auvergne,63,4,26,233,Montaigut,1063,33,1096
83,Auvergne,63,3,08,234,Montaigut-le-Blanc,728,15,743
83,Auvergne,63,4,14,235,Montcel,384,9,393
83,Auvergne,63,4,29,237,Montel-de-Gelat,504,9,513
83,Auvergne,63,4,31,238,Montfermy,195,4,199
83,Auvergne,63,2,06,239,Montmorin,570,9,579
83,Auvergne,63,4,01,240,Montpensier,385,8,393
83,Auvergne,63,3,19,241,Montpeyroux,358,13,371
83,Auvergne,63,3,40,242,Moriat,356,4,360
83,Auvergne,63,4,26,243,Moureuille,299,11,310
83,Auvergne,63,4,33,244,La Moutade,474,10,484
83,Auvergne,63,4,34,245,Mozac,3565,105,3670
83,Auvergne,63,2,35,246,Murat-le-Quaire,477,21,498
83,Auvergne,63,3,05,247,Murol,548,16,564
83,Auvergne,63,2,35,248,Nébouzat,760,14,774
83,Auvergne,63,5,22,249,Néronde-sur-Dore,447,19,466
83,Auvergne,63,3,08,250,Neschers,819,22,841
83,Auvergne,63,4,25,251,Neuf-Église,287,5,292
83,Auvergne,63,2,06,252,Neuville,335,13,348
83,Auvergne,63,5,09,253,Noalhat,222,7,229
83,Auvergne,63,2,61,254,Nohanent,1873,39,1912
83,Auvergne,63,3,40,255,Nonette,321,6,327
83,Auvergne,63,1,04,256,Novacelles,151,4,155
83,Auvergne,63,2,35,257,Olby,647,9,656
83,Auvergne,63,1,27,258,Olliergues,841,27,868
83,Auvergne,63,2,37,259,Olloix,304,2,306
83,Auvergne,63,5,15,260,Olmet,139,2,141
83,Auvergne,63,3,19,261,Orbeil,777,14,791
83,Auvergne,63,2,48,262,Orcet,2725,56,2781
83,Auvergne,63,2,61,263,Orcines,3259,102,3361
83,Auvergne,63,2,35,264,Orcival,254,10,264
83,Auvergne,63,5,22,265,Orléat,1941,51,1992
83,Auvergne,63,3,40,266,Orsonnette,212,4,216
83,Auvergne,63,5,43,267,Palladuc,489,20,509
83,Auvergne,63,3,19,268,Pardines,193,3,196
83,Auvergne,63,2,49,269,Parent,759,20,779
83,Auvergne,63,3,44,270,Parentignat,488,29,517
83,Auvergne,63,5,09,271,Paslières,1529,33,1562
83,Auvergne,63,2,55,272,Pérignat-lès-Sarliève,2719,60,2779
83,Auvergne,63,2,06,273,Pérignat-sur-Allier,1370,25,1395
83,Auvergne,63,2,35,274,Perpezat,395,11,406
83,Auvergne,63,3,19,275,Perrier,822,24,846
83,Auvergne,63,5,22,276,Peschadoires,2041,52,2093
83,Auvergne,63,3,20,277,Peslières,69,2,71
83,Auvergne,63,4,33,278,Pessat-Villeneuve,495,9,504
83,Auvergne,63,3,21,279,Picherande,360,19,379
83,Auvergne,63,2,49,280,Pignols,280,6,286
83,Auvergne,63,4,28,281,Pionsat,1067,26,1093
83,Auvergne,63,2,48,282,Plauzat,1422,29,1451
83,Auvergne,63,2,30,284,Pont-du-Château,10446,278,10724
83,Auvergne,63,4,29,283,Pontaumur,756,118,874
83,Auvergne,63,4,31,285,Pontgibaud,751,53,804
83,Auvergne,63,4,25,286,Pouzol,268,2,270
83,Auvergne,63,3,44,287,Les Pradeaux,311,12,323
83,Auvergne,63,4,14,288,Prompsat,416,7,423
83,Auvergne,63,2,18,289,Prondines,255,5,260
83,Auvergne,63,4,31,290,Pulvérières,361,8,369
83,Auvergne,63,5,09,291,Puy-Guillaume,2675,53,2728
83,Auvergne,63,4,29,292,Puy-Saint-Gulmier,154,2,156
83,Auvergne,63,4,28,293,Le Quartier,214,9,223
83,Auvergne,63,4,23,294,Queuille,272,8,280
83,Auvergne,63,4,32,295,Randan,1480,68,1548
83,Auvergne,63,2,47,296,Ravel,699,15,714
83,Auvergne,63,2,47,297,Reignat,321,5,326
83,Auvergne,63,5,15,298,La Renaudie,115,6,121
83,Auvergne,63,3,03,299,Rentières,108,3,111
83,Auvergne,63,4,99,300,Riom,17841,727,18568
83,Auvergne,63,5,09,301,Ris,734,14,748
83,Auvergne,63,2,48,302,La Roche-Blanche,3191,53,3244
83,Auvergne,63,3,03,303,Roche-Charles-la-Mayrand,49,0,49
83,Auvergne,63,4,28,304,Roche-d'Agoux,90,2,92
83,Auvergne,63,2,49,306,La Roche-Noire,626,13,639
83,Auvergne,63,2,35,305,Rochefort-Montagne,896,96,992
83,Auvergne,63,2,55,307,Romagnat,8175,275,8450
83,Auvergne,63,2,61,308,Royat,4522,96,4618
83,Auvergne,63,1,50,309,Saillant,281,12,293
83,Auvergne,63,4,01,311,Saint-Agoulin,283,8,291
83,Auvergne,63,1,04,312,Saint-Alyre-d'Arlanc,175,3,178
83,Auvergne,63,3,03,313,Saint-Alyre-ès-Montagne,165,5,170
83,Auvergne,63,1,36,314,Saint-Amant-Roche-Savine,544,22,566
83,Auvergne,63,2,37,315,Saint-Amant-Tallende,1812,37,1849
83,Auvergne,63,4,32,317,Saint-André-le-Coq,490,18,508
83,Auvergne,63,4,23,318,Saint-Angel,395,10,405
83,Auvergne,63,1,38,319,Saint-Anthème,754,26,780
83,Auvergne,63,4,29,320,Saint-Avit,255,9,264
83,Auvergne,63,3,19,321,Saint-Babel,871,27,898
83,Auvergne,63,4,17,322,Saint-Beauzire,2100,44,2144
83,Auvergne,63,1,41,323,Saint-Bonnet-le-Bourg,145,4,149
83,Auvergne,63,1,41,324,Saint-Bonnet-le-Chastel,237,9,246
83,Auvergne,63,2,47,325,Saint-Bonnet-lès-Allier,404,5,409
83,Auvergne,63,2,35,326,Saint-Bonnet-près-Orcival,438,6,444
83,Auvergne,63,4,33,327,Saint-Bonnet-près-Riom,1873,37,1910
83,Auvergne,63,3,08,330,Saint-Cirgues-sur-Couze,288,3,291
83,Auvergne,63,4,32,332,Saint-Clément-de-Régnat,468,33,501
83,Auvergne,63,1,38,331,Saint-Clément-de-Valorgue,219,2,221
83,Auvergne,63,4,32,333,Saint-Denis-Combarnazat,215,6,221
83,Auvergne,63,2,39,334,Saint-Dier-d'Auvergne,564,48,612
83,Auvergne,63,3,05,335,Saint-Diéry,367,2,369
83,Auvergne,63,3,21,336,Saint-Donat,237,8,245
83,Auvergne,63,1,36,337,Saint-Éloy-la-Glacière,62,1,63
83,Auvergne,63,4,26,338,Saint-Éloy-les-Mines,3748,186,3934
83,Auvergne,63,4,29,339,Saint-Étienne-des-Champs,145,1,146
83,Auvergne,63,3,44,340,Saint-Étienne-sur-Usson,254,2,256
83,Auvergne,63,1,02,341,Saint-Ferréol-des-Côtes,545,29,574
83,Auvergne,63,3,08,342,Saint-Floret,268,4,272
83,Auvergne,63,2,39,343,Saint-Flour,232,12,244
83,Auvergne,63,4,25,344,Saint-Gal-sur-Sioule,130,1,131
83,Auvergne,63,2,56,345,Saint-Genès-Champanelle,3082,141,3223
83,Auvergne,63,3,21,346,Saint-Genès-Champespe,237,4,241
83,Auvergne,63,4,01,347,Saint-Genès-du-Retz,491,17,508
83,Auvergne,63,3,44,348,Saint-Genès-la-Tourette,186,2,188
83,Auvergne,63,4,23,349,Saint-Georges-de-Mons,2196,57,2253
83,Auvergne,63,2,49,350,Saint-Georges-sur-Allier,1142,31,1173
83,Auvergne,63,1,41,353,Saint-Germain-l'Herm,519,24,543
83,Auvergne,63,3,40,352,Saint-Germain-Lembron,1778,31,1809
83,Auvergne,63,2,18,351,Saint-Germain-près-Herment,76,5,81
83,Auvergne,63,4,42,354,Saint-Gervais-d'Auvergne,1308,142,1450
83,Auvergne,63,1,27,355,Saint-Gervais-sous-Meymont,253,5,258
83,Auvergne,63,3,40,356,Saint-Gervazy,300,6,306
83,Auvergne,63,3,03,357,Saint-Hérent,106,2,108
83,Auvergne,63,4,28,360,Saint-Hilaire,199,4,203
83,Auvergne,63,4,14,358,Saint-Hilaire-la-Croix,307,6,313
83,Auvergne,63,4,29,359,Saint-Hilaire-les-Monges,106,2,108
83,Auvergne,63,4,17,362,Saint-Ignat,747,11,758
83,Auvergne,63,4,31,363,Saint-Jacques-d'Ambur,294,10,304
83,Auvergne,63,5,22,364,Saint-Jean-d'Heurs,590,5,595
83,Auvergne,63,2,39,365,Saint-Jean-des-Ollières,457,8,465
83,Auvergne,63,3,44,366,Saint-Jean-en-Val,334,9,343
83,Auvergne,63,3,20,367,Saint-Jean-Saint-Gervais,99,2,101
83,Auvergne,63,2,06,368,Saint-Julien-de-Coppel,1100,26,1126
83,Auvergne,63,4,42,369,Saint-Julien-la-Geneste,137,6,143
83,Auvergne,63,2,07,370,Saint-Julien-Puy-Lavèze,340,6,346
83,Auvergne,63,1,50,371,Saint-Just,153,4,157
83,Auvergne,63,4,17,372,Saint-Laure,442,13,455
83,Auvergne,63,4,28,373,Saint-Maigner,200,5,205
83,Auvergne,63,3,20,376,Saint-Martin-d'Ollières,144,4,148
83,Auvergne,63,1,02,374,Saint-Martin-des-Olmes,276,11,287
83,Auvergne,63,3,44,375,Saint-Martin-des-Plains,150,1,151
83,Auvergne,63,2,49,378,Saint-Maurice,798,20,818
83,Auvergne,63,4,28,377,Saint-Maurice-près-Pionsat,376,5,381
83,Auvergne,63,4,14,379,Saint-Myon,416,3,419
83,Auvergne,63,3,08,380,Saint-Nectaire,724,17,741
83,Auvergne,63,4,31,381,Saint-Ours,1556,41,1597
83,Auvergne,63,4,25,382,Saint-Pardoux,403,19,422
83,Auvergne,63,3,05,383,Saint-Pierre-Colamine,234,8,242
83,Auvergne,63,1,27,384,Saint-Pierre-la-Bourlhonne,149,4,153
83,Auvergne,63,4,31,385,Saint-Pierre-le-Chastel,368,3,371
83,Auvergne,63,2,35,386,Saint-Pierre-Roche,397,10,407
83,Auvergne,63,4,32,387,Saint-Priest-Bramefant,835,27,862
83,Auvergne,63,4,42,388,Saint-Priest-des-Champs,699,25,724
83,Auvergne,63,3,44,389,Saint-Quentin-sur-Sauxillanges,106,3,109
83,Auvergne,63,4,25,390,Saint-Quintin-sur-Sioule,320,5,325
83,Auvergne,63,4,25,391,Saint-Rémy-de-Blot,211,6,217
83,Auvergne,63,3,44,392,Saint-Rémy-de-Chargnat,562,7,569
83,Auvergne,63,5,43,393,Saint-Rémy-sur-Durolle,1822,34,1856
83,Auvergne,63,1,38,394,Saint-Romain,229,5,234
83,Auvergne,63,2,37,395,Saint-Sandoux,845,22,867
83,Auvergne,63,2,37,396,Saint-Saturnin,1101,107,1208
83,Auvergne,63,3,45,397,Saint-Sauves-d'Auvergne,1140,38,1178
83,Auvergne,63,1,04,398,Saint-Sauveur-la-Sagne,110,5,115
83,Auvergne,63,2,07,399,Saint-Sulpice,104,1,105
83,Auvergne,63,4,32,400,Saint-Sylvestre-Pragoulin,1080,31,1111
83,Auvergne,63,3,05,401,Saint-Victor-la-Rivière,240,5,245
83,Auvergne,63,5,43,402,Saint-Victor-Montvianeix,272,14,286
83,Auvergne,63,3,08,403,Saint-Vincent,418,7,425
83,Auvergne,63,3,19,404,Saint-Yvoine,482,13,495
83,Auvergne,63,5,15,310,Sainte-Agathe,192,3,195
83,Auvergne,63,1,41,328,Sainte-Catherine,60,0,60
83,Auvergne,63,4,42,329,Sainte-Christine,146,6,152
83,Auvergne,63,2,49,405,Sallèdes,532,11,543
83,Auvergne,63,4,01,406,Sardon,287,6,293
83,Auvergne,63,2,37,407,Saulzet-le-Froid,253,4,257
83,Auvergne,63,4,42,408,Sauret-Besserve,182,4,186
83,Auvergne,63,3,08,409,Saurier,225,5,230
83,Auvergne,63,2,18,410,Sauvagnat,146,0,146
83,Auvergne,63,3,19,411,Sauvagnat-Sainte-Marthe,514,7,521
83,Auvergne,63,1,50,412,Sauvessanges,546,9,555
83,Auvergne,63,2,48,413,La Sauvetat,650,6,656
83,Auvergne,63,5,15,414,Sauviat,523,10,533
83,Auvergne,63,3,44,415,Sauxillanges,1148,32,1180
83,Auvergne,63,2,07,416,Savennes,103,3,106
83,Auvergne,63,2,59,417,Sayat,2241,46,2287
83,Auvergne,63,5,15,418,Sermentizon,522,13,535
83,Auvergne,63,4,25,419,Servant,546,16,562
83,Auvergne,63,5,22,420,Seychalles,573,29,602
83,Auvergne,63,3,45,421,Singles,181,8,189
83,Auvergne,63,3,19,422,Solignat,449,9,458
83,Auvergne,63,3,44,423,Sugères,555,14,569
83,Auvergne,63,4,17,424,Surat,510,14,524
83,Auvergne,63,2,48,425,Tallende,1574,57,1631
83,Auvergne,63,3,45,426,Tauves,778,13,791
83,Auvergne,63,4,14,427,Teilhède,408,13,421
83,Auvergne,63,4,25,428,Teilhet,299,4,303
83,Auvergne,63,3,03,429,Ternant-les-Eaux,46,1,47
83,Auvergne,63,5,46,430,Thiers,12045,401,12446
83,Auvergne,63,1,02,431,Thiolières,154,3,157
83,Auvergne,63,4,01,432,Thuret,765,40,805
83,Auvergne,63,2,18,433,Tortebesse,53,0,53
83,Auvergne,63,3,21,192,La Tour-d'Auvergne,657,46,703
83,Auvergne,63,2,39,434,Tours-sur-Meymont,507,18,525
83,Auvergne,63,3,08,435,Tourzel-Ronzières,244,2,246
83,Auvergne,63,4,29,436,Tralaigues,83,2,85
83,Auvergne,63,3,21,437,Trémouille-Saint-Loup,146,4,150
83,Auvergne,63,2,39,438,Trézioux,416,11,427
83,Auvergne,63,3,44,439,Usson,263,5,268
83,Auvergne,63,3,05,440,Valbeleix,154,2,156
83,Auvergne,63,1,02,441,Valcivières,219,4,223
83,Auvergne,63,3,20,442,Valz-sous-Châteauneuf,58,2,60
83,Auvergne,63,4,17,443,Varennes-sur-Morge,383,13,396
83,Auvergne,63,3,44,444,Varennes-sur-Usson,188,3,191
83,Auvergne,63,2,47,445,Vassel,214,7,221
83,Auvergne,63,4,01,446,Vensat,426,18,444
83,Auvergne,63,4,28,447,Vergheas,72,2,74
83,Auvergne,63,3,44,448,Vernet-la-Varenne,718,92,810
83,Auvergne,63,2,37,449,Le Vernet-Sainte-Marguerite,255,4,259
83,Auvergne,63,2,18,450,Verneugheol,265,4,269
83,Auvergne,63,2,35,451,Vernines,362,45,407
83,Auvergne,63,3,08,452,Verrières,66,2,68
83,Auvergne,63,2,47,453,Vertaizon,2958,79,3037
83,Auvergne,63,1,27,454,Vertolaye,598,15,613
83,Auvergne,63,2,48,455,Veyre-Monton,3349,90,3439
83,Auvergne,63,2,49,457,Vic-le-Comte,4677,106,4783
83,Auvergne,63,3,40,456,Vichel,288,7,295
83,Auvergne,63,3,40,458,Villeneuve,146,5,151
83,Auvergne,63,4,32,459,Villeneuve-les-Cerfs,478,14,492
83,Auvergne,63,4,29,460,Villosanges,381,7,388
83,Auvergne,63,5,22,461,Vinzelles,310,5,315
83,Auvergne,63,4,26,462,Virlet,264,3,267
83,Auvergne,63,5,43,463,Viscomtat,628,10,638
83,Auvergne,63,4,23,464,Vitrac,328,12,340
83,Auvergne,63,1,50,465,Viverols,391,8,399
83,Auvergne,63,3,19,466,Vodable,198,8,206
83,Auvergne,63,4,29,467,Voingt,63,2,65
83,Auvergne,63,5,15,468,Vollore-Montagne,342,9,351
83,Auvergne,63,5,15,469,Vollore-Ville,713,21,734
83,Auvergne,63,4,34,470,Volvic,4594,171,4765
83,Auvergne,63,4,26,471,Youx,1012,14,1026
83,Auvergne,63,2,49,472,Yronde-et-Buron,585,22,607
83,Auvergne,63,4,14,473,Yssac-la-Tourette,356,12,368
72,Aquitaine,64,3,22,001,Aast,181,2,183
72,Aquitaine,64,3,23,002,Abère,146,3,149
72,Aquitaine,64,3,15,003,Abidos,233,7,240
72,Aquitaine,64,2,38,004,Abitain,101,2,103
72,Aquitaine,64,2,21,005,Abos,476,7,483
72,Aquitaine,64,2,01,006,Accous,431,16,447
72,Aquitaine,64,2,28,007,Agnos,842,56,898
72,Aquitaine,64,1,35,008,Ahaxe-Alciette-Bascassan,290,10,300
72,Aquitaine,64,1,41,009,Ahetze,1585,32,1617
72,Aquitaine,64,1,36,010,Aïcirits-Camou-Suhast,665,15,680
72,Aquitaine,64,1,35,011,Aincille,127,1,128
72,Aquitaine,64,2,20,012,Ainharp,151,2,153
72,Aquitaine,64,1,35,013,Ainhice-Mongelos,166,4,170
72,Aquitaine,64,1,10,014,Ainhoa,665,15,680
72,Aquitaine,64,1,33,016,Aldudes,373,4,377
72,Aquitaine,64,2,39,017,Alos-Sibas-Abense,269,19,288
72,Aquitaine,64,2,39,015,Alçay-Alçabéhéty-Sunharette,223,9,232
72,Aquitaine,64,1,36,018,Amendeuix-Oneix,417,12,429
72,Aquitaine,64,1,36,019,Amorots-Succos,220,5,225
72,Aquitaine,64,2,02,020,Ance,244,12,256
72,Aquitaine,64,3,23,021,Andoins,623,12,635
72,Aquitaine,64,2,38,022,Andrein,130,4,134
72,Aquitaine,64,3,25,023,Angaïs,811,31,842
72,Aquitaine,64,1,90,024,Anglet,37897,1367,39264
72,Aquitaine,64,2,24,025,Angous,103,0,103
72,Aquitaine,64,1,33,026,Anhaux,290,2,292
72,Aquitaine,64,3,23,027,Anos,194,2,196
72,Aquitaine,64,3,18,028,Anoye,145,8,153
72,Aquitaine,64,2,02,029,Aramits,669,29,698
72,Aquitaine,64,1,09,031,Arancou,111,1,112
72,Aquitaine,64,2,24,032,Araujuzon,184,5,189
72,Aquitaine,64,2,24,033,Araux,126,0,126
72,Aquitaine,64,1,36,034,Arbérats-Sillègue,314,5,319
72,Aquitaine,64,1,41,035,Arbonne,1924,33,1957
72,Aquitaine,64,1,36,036,Arbouet-Sussaute,267,7,274
72,Aquitaine,64,3,19,037,Arbus,1094,29,1123
72,Aquitaine,64,1,41,038,Arcangues,3120,101,3221
72,Aquitaine,64,2,28,039,Aren,192,4,196
72,Aquitaine,64,3,47,041,Aressy,590,5,595
72,Aquitaine,64,2,02,040,Arette,1091,43,1134
72,Aquitaine,64,3,03,042,Argagnon,731,27,758
72,Aquitaine,64,3,40,043,Argelos,261,9,270
72,Aquitaine,64,3,05,044,Arget,91,3,94
72,Aquitaine,64,1,13,045,Arhansus,75,0,75
72,Aquitaine,64,1,13,046,Armendarits,381,12,393
72,Aquitaine,64,1,35,047,Arnéguy,273,5,278
72,Aquitaine,64,3,03,048,Arnos,67,0,67
72,Aquitaine,64,1,36,049,Aroue-Ithorots-Olhaïby,250,6,256
72,Aquitaine,64,2,20,050,Arrast-Larrebieu,99,0,99
72,Aquitaine,64,1,36,051,Arraute-Charritte,344,7,351
72,Aquitaine,64,3,18,052,Arricau-Bordes,102,4,106
72,Aquitaine,64,3,23,053,Arrien,132,3,135
72,Aquitaine,64,3,26,054,Arros-de-Nay,742,13,755
72,Aquitaine,64,3,18,056,Arrosès,153,2,155
72,Aquitaine,64,3,26,058,Arthez-d'Asson,501,10,511
72,Aquitaine,64,3,03,057,Arthez-de-Béarn,1711,44,1755
72,Aquitaine,64,3,31,059,Artigueloutan,867,15,882
72,Aquitaine,64,3,19,060,Artiguelouve,1495,38,1533
72,Aquitaine,64,3,03,061,Artix,3352,61,3413
72,Aquitaine,64,2,04,062,Arudy,2267,72,2339
72,Aquitaine,64,3,05,063,Arzacq-Arraziguet,1005,43,1048
72,Aquitaine,64,2,28,064,Asasp-Arros,517,17,534
72,Aquitaine,64,1,34,065,Ascain,3791,93,3884
72,Aquitaine,64,1,33,066,Ascarat,307,9,316
72,Aquitaine,64,3,47,067,Assat,1666,41,1707
72,Aquitaine,64,3,26,068,Asson,1912,44,1956
72,Aquitaine,64,2,16,069,Aste-Béon,272,11,283
72,Aquitaine,64,3,40,070,Astis,289,7,296
72,Aquitaine,64,2,38,071,Athos-Aspis,185,8,193
72,Aquitaine,64,2,17,072,Aubertin,642,15,657
72,Aquitaine,64,3,40,073,Aubin,240,7,247
72,Aquitaine,64,3,11,074,Aubous,51,0,51
72,Aquitaine,64,2,24,075,Audaux,188,120,308
72,Aquitaine,64,3,40,077,Auga,147,6,153
72,Aquitaine,64,3,40,078,Auriac,252,7,259
72,Aquitaine,64,3,18,079,Aurions-Idernes,113,1,114
72,Aquitaine,64,3,19,080,Aussevielle,712,13,725
72,Aquitaine,64,2,20,081,Aussurucq,250,3,253
72,Aquitaine,64,3,37,082,Auterrive,128,5,133
72,Aquitaine,64,2,38,083,Autevielle-Saint-Martin-Bideren,145,5,150
72,Aquitaine,64,3,11,084,Aydie,148,0,148
72,Aquitaine,64,2,01,085,Aydius,102,1,103
72,Aquitaine,64,1,14,086,Ayherre,966,22,988
72,Aquitaine,64,3,29,087,Baigts-de-Béarn,802,18,820
72,Aquitaine,64,3,29,088,Balansun,238,5,243
72,Aquitaine,64,3,22,089,Baleix,125,5,130
72,Aquitaine,64,3,11,090,Baliracq-Maumusson,132,3,135
72,Aquitaine,64,3,26,091,Baliros,371,11,382
72,Aquitaine,64,1,33,092,Banca,343,14,357
72,Aquitaine,64,2,20,093,Barcus,732,17,749
72,Aquitaine,64,1,09,094,Bardos,1580,45,1625
72,Aquitaine,64,3,23,095,Barinque,573,20,593
72,Aquitaine,64,2,38,096,Barraute-Camu,151,12,163
72,Aquitaine,64,3,32,097,Barzun,604,6,610
72,Aquitaine,64,3,18,098,Bassillon-Vauzé,73,1,74
72,Aquitaine,64,1,41,100,Bassussarry,2406,95,2501
72,Aquitaine,64,2,24,099,Bastanès,102,32,134
72,Aquitaine,64,1,14,289,La Bastide-Clairence,971,27,998
72,Aquitaine,64,3,25,101,Baudreix,545,109,654
72,Aquitaine,64,1,96,102,Bayonne,44506,1216,45722
72,Aquitaine,64,3,22,103,Bédeille,193,6,199
72,Aquitaine,64,2,01,104,Bedous,534,12,546
72,Aquitaine,64,1,36,105,Béguios,270,10,280
72,Aquitaine,64,1,36,106,Béhasque-Lapiste,443,16,459
72,Aquitaine,64,1,35,107,Béhorléguy,74,2,76
72,Aquitaine,64,3,37,108,Bellocq,857,32,889
72,Aquitaine,64,3,25,109,Bénéjacq,1844,42,1886
72,Aquitaine,64,3,22,111,Bentayou-Sérée,113,2,115
72,Aquitaine,64,2,16,110,Béost,212,8,220
72,Aquitaine,64,3,37,112,Bérenx,482,6,488
72,Aquitaine,64,1,09,113,Bergouey-Viellenave,116,2,118
72,Aquitaine,64,3,23,114,Bernadets,502,26,528
72,Aquitaine,64,2,20,115,Berrogain-Laruns,105,6,111
72,Aquitaine,64,2,04,116,Bescat,265,2,267
72,Aquitaine,64,3,15,117,Bésingrand,125,4,129
72,Aquitaine,64,3,18,118,Bétracq,48,3,51
72,Aquitaine,64,3,25,119,Beuste,531,14,545
72,Aquitaine,64,3,19,121,Beyrie-en-Béarn,172,7,179
72,Aquitaine,64,1,36,120,Beyrie-sur-Joyeuse,505,9,514
72,Aquitaine,64,1,91,122,Biarritz,26273,656,26929
72,Aquitaine,64,1,09,123,Bidache,1250,43,1293
72,Aquitaine,64,1,33,124,Bidarray,633,15,648
72,Aquitaine,64,1,34,125,Bidart,6038,140,6178
72,Aquitaine,64,2,27,126,Bidos,1182,42,1224
72,Aquitaine,64,2,16,127,Bielle,456,17,473
72,Aquitaine,64,2,16,128,Bilhères,152,2,154
72,Aquitaine,64,3,51,129,Billère,13279,295,13574
72,Aquitaine,64,1,45,130,Biriatou,986,29,1015
72,Aquitaine,64,3,15,131,Biron,572,14,586
72,Aquitaine,64,3,47,132,Bizanos,4722,158,4880
72,Aquitaine,64,3,25,133,Boeil-Bezing,1230,35,1265
72,Aquitaine,64,1,12,134,Bonloc,351,7,358
72,Aquitaine,64,3,29,135,Bonnut,668,18,686
72,Aquitaine,64,2,01,136,Borce,178,0,178
72,Aquitaine,64,3,25,137,Bordères,659,25,684
72,Aquitaine,64,3,25,138,Bordes,2345,46,2391
72,Aquitaine,64,3,46,139,Bosdarros,1022,21,1043
72,Aquitaine,64,1,07,140,Boucau,7588,170,7758
72,Aquitaine,64,3,11,141,Boueilh-Boueilho-Lasque,357,15,372
72,Aquitaine,64,3,19,142,Bougarber,697,17,714
72,Aquitaine,64,3,05,143,Bouillon,137,1,138
72,Aquitaine,64,3,03,144,Boumourt,128,2,130
72,Aquitaine,64,3,26,145,Bourdettes,350,8,358
72,Aquitaine,64,3,40,146,Bournos,311,6,317
72,Aquitaine,64,1,14,147,Briscous,2512,63,2575
72,Aquitaine,64,3,26,148,Bruges-Capbis-Mifaget,899,16,915
72,Aquitaine,64,2,24,149,Bugnein,237,6,243
72,Aquitaine,64,1,13,150,Bunus,141,2,143
72,Aquitaine,64,2,38,151,Burgaronne,96,6,102
72,Aquitaine,64,3,23,152,Buros,1792,77,1869
72,Aquitaine,64,3,11,153,Burosse-Mendousse,61,2,63
72,Aquitaine,64,1,35,154,Bussunarits-Sarrasquette,168,8,176
72,Aquitaine,64,1,35,155,Bustince-Iriberry,88,7,95
72,Aquitaine,64,2,27,156,Buziet,429,6,435
72,Aquitaine,64,2,04,157,Buzy,904,11,915
72,Aquitaine,64,3,05,158,Cabidos,164,5,169
72,Aquitaine,64,3,18,159,Cadillon,104,1,105
72,Aquitaine,64,1,10,160,Cambo-les-Bains,6177,155,6332
72,Aquitaine,64,1,09,161,Came,800,22,822
72,Aquitaine,64,2,39,162,Camou-Cihigue,105,1,106
72,Aquitaine,64,2,27,165,Cardesse,246,4,250
72,Aquitaine,64,1,35,166,Caro,191,10,201
72,Aquitaine,64,3,40,167,Carrère,175,6,181
72,Aquitaine,64,3,37,168,Carresse-Cassaber,568,12,580
72,Aquitaine,64,3,37,170,Castagnède,199,8,207
72,Aquitaine,64,3,03,171,Casteide-Cami,242,3,245
72,Aquitaine,64,3,03,172,Casteide-Candau,213,6,219
72,Aquitaine,64,3,22,173,Casteide-Doat,131,6,137
72,Aquitaine,64,3,22,174,Castéra-Loubix,54,0,54
72,Aquitaine,64,2,04,175,Castet,162,2,164
72,Aquitaine,64,2,38,176,Castetbon,179,4,183
72,Aquitaine,64,3,29,177,Castétis,610,14,624
72,Aquitaine,64,2,24,178,Castetnau-Camblong,415,12,427
72,Aquitaine,64,3,15,179,Castetner,156,3,159
72,Aquitaine,64,3,11,180,Castetpugon,179,3,182
72,Aquitaine,64,3,03,181,Castillon (Canton d'Arthez-de-Béarn),269,10,279
72,Aquitaine,64,3,18,182,Castillon (Canton de Lembeye),65,2,67
72,Aquitaine,64,3,19,183,Caubios-Loos,476,14,490
72,Aquitaine,64,3,03,184,Cescau,512,11,523
72,Aquitaine,64,2,01,185,Cette-Eygun,80,3,83
72,Aquitaine,64,2,24,186,Charre,210,14,224
72,Aquitaine,64,2,20,187,Charritte-de-Bas,239,8,247
72,Aquitaine,64,2,20,188,Chéraute,1161,163,1324
72,Aquitaine,64,1,45,189,Ciboure,6719,195,6914
72,Aquitaine,64,3,40,190,Claracq,217,8,225
72,Aquitaine,64,3,25,191,Coarraze,2115,140,2255
72,Aquitaine,64,3,11,192,Conchez-de-Béarn,114,3,117
72,Aquitaine,64,3,18,193,Corbère-Abères,101,4,105
72,Aquitaine,64,3,18,194,Coslédaà-Lube-Boast,347,2,349
72,Aquitaine,64,3,05,195,Coublucq,106,1,107
72,Aquitaine,64,3,18,196,Crouseilles,146,5,151
72,Aquitaine,64,2,21,197,Cuqueron,176,7,183
72,Aquitaine,64,3,19,198,Denguin,1692,37,1729
72,Aquitaine,64,3,11,199,Diusse,156,3,159
72,Aquitaine,64,3,03,200,Doazon,184,2,186
72,Aquitaine,64,2,24,201,Dognen,215,4,219
72,Aquitaine,64,1,36,202,Domezain-Berraute,488,50,538
72,Aquitaine,64,3,40,203,Doumy,258,7,265
72,Aquitaine,64,2,16,204,Eaux-Bonnes,424,8,432
72,Aquitaine,64,3,37,205,Escos,238,6,244
72,Aquitaine,64,2,01,206,Escot,129,5,134
72,Aquitaine,64,2,27,207,Escou,394,9,403
72,Aquitaine,64,3,23,208,Escoubès,308,5,313
72,Aquitaine,64,2,27,209,Escout,404,17,421
72,Aquitaine,64,3,18,210,Escurès,159,6,165
72,Aquitaine,64,3,23,211,Eslourenties-Daban,222,6,228
72,Aquitaine,64,3,23,212,Espéchède,163,6,169
72,Aquitaine,64,1,10,213,Espelette,1953,55,2008
72,Aquitaine,64,2,20,214,Espès-Undurein,491,17,508
72,Aquitaine,64,2,38,215,Espiute,114,1,115
72,Aquitaine,64,3,32,216,Espoey,980,16,996
72,Aquitaine,64,2,28,217,Esquiule,538,12,550
72,Aquitaine,64,1,35,218,Estérençuby,363,1,364
72,Aquitaine,64,2,17,219,Estialescq,247,7,254
72,Aquitaine,64,2,27,220,Estos,481,21,502
72,Aquitaine,64,1,36,221,Etcharry,129,1,130
72,Aquitaine,64,2,39,222,Etchebar,65,0,65
72,Aquitaine,64,2,01,223,Etsaut,77,2,79
72,Aquitaine,64,2,27,224,Eysus,686,22,708
72,Aquitaine,64,2,02,225,Féas,421,22,443
72,Aquitaine,64,3,05,226,Fichous-Riumayou,153,5,158
72,Aquitaine,64,3,23,227,Gabaston,594,11,605
72,Aquitaine,64,1,36,228,Gabat,205,10,215
72,Aquitaine,64,1,35,229,Gamarthe,115,1,116
72,Aquitaine,64,3,46,230,Gan,5278,137,5415
72,Aquitaine,64,2,20,231,Garindein,536,23,559
72,Aquitaine,64,3,40,232,Garlède-Mondebat,194,4,198
72,Aquitaine,64,3,11,233,Garlin,1338,40,1378
72,Aquitaine,64,3,05,234,Garos,216,2,218
72,Aquitaine,64,1,36,235,Garris,278,8,286
72,Aquitaine,64,3,18,236,Gayon,62,7,69
72,Aquitaine,64,3,48,237,Gelos,3687,142,3829
72,Aquitaine,64,3,32,238,Ger,1999,51,2050
72,Aquitaine,64,3,18,239,Gerderest,127,3,130
72,Aquitaine,64,2,16,240,Gère-Bélesten,162,3,165
72,Aquitaine,64,2,28,241,Géronce,426,8,434
72,Aquitaine,64,1,36,242,Gestas,68,2,70
72,Aquitaine,64,3,05,243,Géus-d'Arzacq,170,3,173
72,Aquitaine,64,2,28,244,Geüs-d'Oloron,205,6,211
72,Aquitaine,64,2,27,245,Goès,560,16,576
72,Aquitaine,64,3,32,246,Gomer,215,4,219
72,Aquitaine,64,2,20,247,Gotein-Libarrenx,478,15,493
72,Aquitaine,64,1,34,249,Guéthary,1332,46,1378
72,Aquitaine,64,1,09,250,Guiche,878,24,902
72,Aquitaine,64,2,38,251,Guinarthe-Parenties,233,17,250
72,Aquitaine,64,2,28,252,Gurmençon,822,30,852
72,Aquitaine,64,2,24,253,Gurs,382,49,431
72,Aquitaine,64,3,03,254,Hagetaubin,526,14,540
72,Aquitaine,64,1,41,255,Halsou,484,7,491
72,Aquitaine,64,1,12,256,Hasparren,6131,300,6431
72,Aquitaine,64,3,26,257,Haut-de-Bosdarros,265,7,272
72,Aquitaine,64,2,39,258,Haux,99,2,101
72,Aquitaine,64,1,13,259,Hélette,688,8,696
72,Aquitaine,64,1,45,260,Hendaye,14081,453,14534
72,Aquitaine,64,2,27,261,Herrère,365,16,381
72,Aquitaine,64,3,23,262,Higuères-Souye,272,6,278
72,Aquitaine,64,2,38,263,L' Hôpital-d'Orion,165,6,171
72,Aquitaine,64,2,20,264,L' Hôpital-Saint-Blaise,78,0,78
72,Aquitaine,64,1,13,265,Hosta,78,4,82
72,Aquitaine,64,3,32,266,Hours,204,2,206
72,Aquitaine,64,1,13,267,Ibarrolle,98,0,98
72,Aquitaine,64,2,20,268,Idaux-Mendy,259,7,266
72,Aquitaine,64,3,31,269,Idron,3801,168,3969
72,Aquitaine,64,3,25,270,Igon,925,118,1043
72,Aquitaine,64,1,13,271,Iholdy,456,9,465
72,Aquitaine,64,1,36,272,Ilharre,135,3,138
72,Aquitaine,64,1,13,273,Irissarry,867,27,894
72,Aquitaine,64,1,33,274,Irouléguy,324,8,332
72,Aquitaine,64,1,35,275,Ispoure,597,17,614
72,Aquitaine,64,2,02,276,Issor,251,1,252
72,Aquitaine,64,1,14,277,Isturits,425,5,430
72,Aquitaine,64,1,10,279,Itxassou,2026,75,2101
72,Aquitaine,64,2,04,280,Izeste,446,12,458
72,Aquitaine,64,2,24,281,Jasses,146,2,148
72,Aquitaine,64,1,41,282,Jatxou,1046,27,1073
72,Aquitaine,64,1,35,283,Jaxu,156,6,162
72,Aquitaine,64,3,46,284,Jurançon,6986,281,7267
72,Aquitaine,64,1,13,285,Juxue,254,0,254
72,Aquitaine,64,3,15,286,Laà-Mondrans,395,20,415
72,Aquitaine,64,2,38,287,Laàs,113,3,116
72,Aquitaine,64,3,03,288,Labastide-Cézéracq,540,9,549
72,Aquitaine,64,3,03,290,Labastide-Monréjeau,495,15,510
72,Aquitaine,64,3,37,291,Labastide-Villefranche,323,4,327
72,Aquitaine,64,3,32,292,Labatmale,257,2,259
72,Aquitaine,64,3,22,293,Labatut,158,1,159
72,Aquitaine,64,1,36,294,Labets-Biscay,153,6,159
72,Aquitaine,64,3,03,295,Labeyrie,97,2,99
72,Aquitaine,64,3,03,296,Lacadée,123,3,126
72,Aquitaine,64,1,35,297,Lacarre,139,4,143
72,Aquitaine,64,2,39,298,Lacarry-Arhan-Charritte-de-Haut,128,1,129
72,Aquitaine,64,2,17,299,Lacommande,242,5,247
72,Aquitaine,64,3,95,300,Lacq,701,22,723
72,Aquitaine,64,3,15,301,Lagor,1215,24,1239
72,Aquitaine,64,3,25,302,Lagos,468,18,486
72,Aquitaine,64,2,39,303,Laguinge-Restoue,168,3,171
72,Aquitaine,64,1,52,304,Lahonce,1998,56,2054
72,Aquitaine,64,3,37,305,Lahontan,458,9,467
72,Aquitaine,64,2,21,306,Lahourcade,710,25,735
72,Aquitaine,64,3,18,307,Lalongue,209,6,215
72,Aquitaine,64,3,40,308,Lalonquette,281,11,292
72,Aquitaine,64,3,22,309,Lamayou,182,5,187
72,Aquitaine,64,2,02,310,Lanne-en-Barétous,493,17,510
72,Aquitaine,64,3,18,311,Lannecaube,164,3,167
72,Aquitaine,64,3,29,312,Lanneplaà,300,7,307
72,Aquitaine,64,1,13,313,Lantabat,295,6,301
72,Aquitaine,64,1,13,314,Larceveau-Arros-Cibits,400,3,403
72,Aquitaine,64,3,46,315,Laroin,957,14,971
72,Aquitaine,64,2,39,316,Larrau,208,1,209
72,Aquitaine,64,1,41,317,Larressore,1474,41,1515
72,Aquitaine,64,3,05,318,Larreule,154,3,157
72,Aquitaine,64,1,36,319,Larribar-Sorhapuru,192,6,198
72,Aquitaine,64,2,16,320,Laruns,1343,47,1390
72,Aquitaine,64,3,40,321,Lasclaveries,265,4,269
72,Aquitaine,64,1,33,322,Lasse,289,3,292
72,Aquitaine,64,3,18,323,Lasserre,97,4,101
72,Aquitaine,64,2,17,324,Lasseube,1608,45,1653
72,Aquitaine,64,2,17,325,Lasseubetat,176,6,182
72,Aquitaine,64,2,24,326,Lay-Lamidou,119,0,119
72,Aquitaine,64,1,35,327,Lecumberry,182,3,185
72,Aquitaine,64,2,27,328,Ledeuix,1000,44,1044
72,Aquitaine,64,3,31,329,Lée,1170,43,1213
72,Aquitaine,64,2,01,330,Lées-Athas,291,10,301
72,Aquitaine,64,3,18,331,Lembeye,776,16,792
72,Aquitaine,64,3,40,332,Lème,148,2,150
72,Aquitaine,64,3,37,334,Léren,228,8,236
72,Aquitaine,64,3,19,335,Lescar,9771,533,10304
72,Aquitaine,64,2,01,336,Lescun,181,1,182
72,Aquitaine,64,3,18,337,Lespielle,141,2,143
72,Aquitaine,64,3,23,338,Lespourcy,157,0,157
72,Aquitaine,64,3,25,339,Lestelle-Bétharram,819,145,964
72,Aquitaine,64,2,39,340,Lichans-Sunhar,72,5,77
72,Aquitaine,64,2,24,341,Lichos,137,2,139
72,Aquitaine,64,2,39,342,Licq-Athérey,235,8,243
72,Aquitaine,64,3,32,343,Limendous,426,12,438
72,Aquitaine,64,3,32,344,Livron,408,4,412
72,Aquitaine,64,1,36,345,Lohitzun-Oyhercq,212,5,217
72,Aquitaine,64,3,23,346,Lombia,199,5,204
72,Aquitaine,64,3,19,348,Lons,11851,348,12199
72,Aquitaine,64,3,05,347,Lonçon,144,6,150
72,Aquitaine,64,3,15,349,Loubieng,451,10,461
72,Aquitaine,64,1,10,350,Louhossoa,842,13,855
72,Aquitaine,64,2,01,351,Lourdios-Ichère,144,7,151
72,Aquitaine,64,3,32,352,Lourenties,338,9,347
72,Aquitaine,64,2,04,353,Louvie-Juzon,1127,18,1145
72,Aquitaine,64,2,16,354,Louvie-Soubiron,111,10,121
72,Aquitaine,64,3,05,355,Louvigny,121,3,124
72,Aquitaine,64,3,18,356,Luc-Armau,107,3,110
72,Aquitaine,64,3,18,357,Lucarré,55,0,55
72,Aquitaine,64,3,32,358,Lucgarier,290,8,298
72,Aquitaine,64,2,21,359,Lucq-de-Béarn,972,36,1008
72,Aquitaine,64,2,27,360,Lurbe-Saint-Christau,226,3,229
72,Aquitaine,64,3,18,361,Lussagnet-Lusson,171,7,178
72,Aquitaine,64,1,36,362,Luxe-Sumberraute,286,31,317
72,Aquitaine,64,2,04,363,Lys,355,10,365
72,Aquitaine,64,1,12,364,Macaye,539,14,553
72,Aquitaine,64,3,05,365,Malaussanne,416,10,426
72,Aquitaine,64,3,11,366,Mascaraàs-Haron,125,7,132
72,Aquitaine,64,3,15,367,Maslacq,763,27,790
72,Aquitaine,64,1,36,368,Masparraute,248,4,252
72,Aquitaine,64,3,18,369,Maspie-Lalonquère-Juillacq,267,8,275
72,Aquitaine,64,3,23,370,Maucor,511,25,536
72,Aquitaine,64,2,20,371,Mauléon-Licharre,3216,224,3440
72,Aquitaine,64,3,22,372,Maure,111,3,114
72,Aquitaine,64,3,48,373,Mazères-Lezons,2000,70,2070
72,Aquitaine,64,3,05,374,Mazerolles,979,36,1015
72,Aquitaine,64,1,12,375,Méharin,263,2,265
72,Aquitaine,64,3,47,376,Meillon,827,14,841
72,Aquitaine,64,1,12,377,Mendionde,799,19,818
72,Aquitaine,64,2,20,378,Menditte,219,118,337
72,Aquitaine,64,1,35,379,Mendive,196,1,197
72,Aquitaine,64,3,05,380,Méracq,204,4,208
72,Aquitaine,64,2,24,381,Méritein,289,1,290
72,Aquitaine,64,3,03,382,Mesplède,324,13,337
72,Aquitaine,64,3,05,383,Mialos,94,2,96
72,Aquitaine,64,3,40,385,Miossens-Lanusse,192,9,201
72,Aquitaine,64,3,25,386,Mirepeix,1144,22,1166
72,Aquitaine,64,3,19,387,Momas,540,4,544
72,Aquitaine,64,3,18,388,Momy,127,3,130
72,Aquitaine,64,3,18,389,Monassut-Audiracq,311,6,317
72,Aquitaine,64,3,18,390,Moncaup,157,3,160
72,Aquitaine,64,2,20,391,Moncayolle-Larrory-Mendibieu,335,17,352
72,Aquitaine,64,3,11,392,Moncla,101,4,105
72,Aquitaine,64,2,21,393,Monein,4452,109,4561
72,Aquitaine,64,3,18,394,Monpezat,89,5,94
72,Aquitaine,64,3,22,395,Monségur,135,4,139
72,Aquitaine,64,3,15,396,Mont,990,100,1090
72,Aquitaine,64,3,11,401,Mont-Disse,79,1,80
72,Aquitaine,64,3,05,397,Montagut,112,4,116
72,Aquitaine,64,3,22,398,Montaner,456,10,466
72,Aquitaine,64,3,23,399,Montardon,2230,250,2480
72,Aquitaine,64,3,25,400,Montaut,1016,79,1095
72,Aquitaine,64,2,38,403,Montfort,163,8,171
72,Aquitaine,64,2,39,404,Montory,333,12,345
72,Aquitaine,64,3,23,405,Morlaàs,4238,226,4464
72,Aquitaine,64,3,05,406,Morlanne,539,12,551
72,Aquitaine,64,1,52,407,Mouguerre,4557,140,4697
72,Aquitaine,64,3,11,408,Mouhous,35,1,36
72,Aquitaine,64,2,28,409,Moumour,809,29,838
72,Aquitaine,64,3,15,410,Mourenx,7406,177,7583
72,Aquitaine,64,2,20,411,Musculdy,249,6,255
72,Aquitaine,64,2,24,412,Nabas,113,3,116
72,Aquitaine,64,3,48,413,Narcastet,584,12,596
72,Aquitaine,64,2,38,414,Narp,118,0,118
72,Aquitaine,64,3,40,415,Navailles-Angos,1312,40,1352
72,Aquitaine,64,2,24,416,Navarrenx,1132,107,1239
72,Aquitaine,64,3,97,417,Nay,3317,267,3584
72,Aquitaine,64,3,15,418,Noguères,152,3,155
72,Aquitaine,64,3,31,419,Nousty,1316,22,1338
72,Aquitaine,64,2,24,420,Ogenne-Camptort,238,4,242
72,Aquitaine,64,2,27,421,Ogeu-les-Bains,1170,36,1206
72,Aquitaine,64,2,98,422,Oloron-Sainte-Marie,11200,677,11877
72,Aquitaine,64,2,38,423,Oraàs,169,3,172
72,Aquitaine,64,2,20,424,Ordiarp,537,10,547
72,Aquitaine,64,1,36,425,Orègue,483,14,497
72,Aquitaine,64,2,28,426,Orin,195,9,204
72,Aquitaine,64,2,38,427,Orion,150,8,158
72,Aquitaine,64,2,38,428,Orriule,132,2,134
72,Aquitaine,64,1,36,429,Orsanco,94,1,95
72,Aquitaine,64,3,29,430,Orthez,10406,731,11137
72,Aquitaine,64,3,15,431,Os-Marsillon,463,14,477
72,Aquitaine,64,2,39,432,Ossas-Suhare,84,5,89
72,Aquitaine,64,2,01,433,Osse-en-Aspe,332,8,340
72,Aquitaine,64,2,38,434,Ossenx,42,3,45
72,Aquitaine,64,1,36,435,Osserain-Rivareyte,235,9,244
72,Aquitaine,64,1,33,436,Ossès,824,21,845
72,Aquitaine,64,1,13,437,Ostabat-Asme,193,5,198
72,Aquitaine,64,3,23,438,Ouillon,436,12,448
72,Aquitaine,64,3,31,439,Ousse,1393,38,1431
72,Aquitaine,64,3,15,440,Ozenx-Montestrucq,347,11,358
72,Aquitaine,64,1,36,441,Pagolle,255,3,258
72,Aquitaine,64,2,21,442,Parbayse,245,6,251
72,Aquitaine,64,2,21,443,Pardies,923,31,954
72,Aquitaine,64,3,26,444,Pardies-Piétat,448,11,459
72,Aquitaine,64,3,99,445,Pau,84036,1768,85804
72,Aquitaine,64,3,18,446,Peyrelongue-Abos,147,7,154
72,Aquitaine,64,3,05,447,Piets-Plasence-Moustrou,135,1,136
72,Aquitaine,64,2,27,449,Poey-d'Oloron,187,9,196
72,Aquitaine,64,3,19,448,Poey-de-Lescar,1569,52,1621
72,Aquitaine,64,3,05,450,Pomps,231,4,235
72,Aquitaine,64,3,22,451,Ponson-Debat-Pouts,88,0,88
72,Aquitaine,64,3,22,452,Ponson-Dessus,253,4,257
72,Aquitaine,64,3,32,453,Pontacq,2823,56,2879
72,Aquitaine,64,3,22,454,Pontiacq-Viellepinte,124,4,128
72,Aquitaine,64,3,11,455,Portet,169,9,178
72,Aquitaine,64,3,40,456,Pouliacq,36,0,36
72,Aquitaine,64,3,05,457,Poursiugues-Boucoue,198,9,207
72,Aquitaine,64,2,24,458,Préchacq-Josbaig,271,14,285
72,Aquitaine,64,2,24,459,Préchacq-Navarrenx,165,4,169
72,Aquitaine,64,2,27,460,Précilhon,358,18,376
72,Aquitaine,64,3,29,461,Puyoô,1172,21,1193
72,Aquitaine,64,3,29,462,Ramous,459,8,467
72,Aquitaine,64,2,04,463,Rébénacq,664,22,686
72,Aquitaine,64,3,11,464,Ribarrouy,81,3,84
72,Aquitaine,64,3,23,465,Riupeyrous,163,11,174
72,Aquitaine,64,2,24,466,Rivehaute,231,38,269
72,Aquitaine,64,3,48,467,Rontignon,737,23,760
72,Aquitaine,64,2,20,468,Roquiague,123,5,128
72,Aquitaine,64,3,26,469,Saint-Abit,362,14,376
72,Aquitaine,64,3,23,470,Saint-Armou,591,8,599
72,Aquitaine,64,3,29,471,Saint-Boès,372,11,383
72,Aquitaine,64,3,23,472,Saint-Castin,803,16,819
72,Aquitaine,64,3,37,474,Saint-Dos,124,4,128
72,Aquitaine,64,1,12,476,Saint-Esteben,399,9,408
72,Aquitaine,64,1,33,477,Saint-Étienne-de-Baïgorry,1634,16,1650
72,Aquitaine,64,3,46,478,Saint-Faust,756,27,783
72,Aquitaine,64,3,29,479,Saint-Girons-en-Béarn,159,0,159
72,Aquitaine,64,2,38,480,Saint-Gladie-Arrive-Munein,179,9,188
72,Aquitaine,64,2,28,481,Saint-Goin,222,5,227
72,Aquitaine,64,3,23,482,Saint-Jammes,630,19,649
72,Aquitaine,64,1,34,483,Saint-Jean-de-Luz,13844,478,14322
72,Aquitaine,64,1,35,484,Saint-Jean-le-Vieux,866,25,891
72,Aquitaine,64,1,35,485,Saint-Jean-Pied-de-Port,1483,260,1743
72,Aquitaine,64,3,11,486,Saint-Jean-Poudge,84,1,85
72,Aquitaine,64,1,13,487,Saint-Just-Ibarre,235,54,289
72,Aquitaine,64,3,23,488,Saint-Laurent-Bretagne,421,5,426
72,Aquitaine,64,1,12,489,Saint-Martin-d'Arberoue,304,6,310
72,Aquitaine,64,1,33,490,Saint-Martin-d'Arrossa,468,10,478
72,Aquitaine,64,3,03,491,Saint-Médard,198,6,204
72,Aquitaine,64,1,35,492,Saint-Michel,244,3,247
72,Aquitaine,64,1,36,493,Saint-Palais,1882,113,1995
72,Aquitaine,64,3,37,494,Saint-Pé-de-Léren,243,7,250
72,Aquitaine,64,1,41,495,Saint-Pée-sur-Nivelle,5391,113,5504
72,Aquitaine,64,1,52,496,Saint-Pierre-d'Irube,4452,104,4556
72,Aquitaine,64,3,25,498,Saint-Vincent,370,10,380
72,Aquitaine,64,2,04,473,Sainte-Colome,338,4,342
72,Aquitaine,64,2,39,475,Sainte-Engrâce,201,8,209
72,Aquitaine,64,3,37,499,Salies-de-Béarn,4812,187,4999
72,Aquitaine,64,3,29,500,Salles-Mongiscard,302,5,307
72,Aquitaine,64,3,29,501,Sallespisse,590,21,611
72,Aquitaine,64,1,09,502,Sames,571,10,581
72,Aquitaine,64,3,18,503,Samsons-Lion,72,2,74
72,Aquitaine,64,1,10,504,Sare,2361,50,2411
72,Aquitaine,64,3,15,505,Sarpourenx,271,8,279
72,Aquitaine,64,2,01,506,Sarrance,209,11,220
72,Aquitaine,64,3,23,507,Saubole,116,2,118
72,Aquitaine,64,2,27,508,Saucède,124,6,130
72,Aquitaine,64,2,39,509,Sauguis-Saint-Étienne,170,9,179
72,Aquitaine,64,3,29,510,Sault-de-Navailles,823,16,839
72,Aquitaine,64,3,19,511,Sauvagnon,2940,93,3033
72,Aquitaine,64,3,15,512,Sauvelade,245,5,250
72,Aquitaine,64,2,38,513,Sauveterre-de-Béarn,1347,101,1448
72,Aquitaine,64,3,05,514,Séby,178,6,184
72,Aquitaine,64,3,22,515,Sedze-Maubecq,192,4,196
72,Aquitaine,64,3,23,516,Sedzère,404,11,415
72,Aquitaine,64,3,18,517,Séméacq-Blachon,173,8,181
72,Aquitaine,64,3,23,518,Sendets,837,26,863
72,Aquitaine,64,3,23,519,Serres-Castet,3548,114,3662
72,Aquitaine,64,3,23,520,Serres-Morlaàs,689,23,712
72,Aquitaine,64,3,03,521,Serres-Sainte-Marie,467,12,479
72,Aquitaine,64,3,40,523,Sévignacq,671,13,684
72,Aquitaine,64,2,04,522,Sévignacq-Meyracq,489,17,506
72,Aquitaine,64,3,18,524,Simacourbe,354,6,360
72,Aquitaine,64,3,19,525,Siros,698,36,734
72,Aquitaine,64,3,32,526,Soumoulou,1273,39,1312
72,Aquitaine,64,1,10,527,Souraïde,1194,33,1227
72,Aquitaine,64,1,13,528,Suhescun,195,5,200
72,Aquitaine,64,2,24,529,Sus,363,9,372
72,Aquitaine,64,2,24,530,Susmiou,297,13,310
72,Aquitaine,64,2,38,531,Tabaille-Usquain,52,4,56
72,Aquitaine,64,3,11,532,Tadousse-Ussau,72,4,76
72,Aquitaine,64,2,39,533,Tardets-Sorholus,611,5,616
72,Aquitaine,64,3,11,534,Taron-Sadirac-Viellenave,184,7,191
72,Aquitaine,64,2,21,535,Tarsacq,509,4,513
72,Aquitaine,64,3,40,536,Thèze,789,35,824
72,Aquitaine,64,2,39,537,Trois-Villes,129,5,134
72,Aquitaine,64,1,35,538,Uhart-Cize,653,20,673
72,Aquitaine,64,1,36,539,Uhart-Mixe,223,4,227
72,Aquitaine,64,1,52,540,Urcuit,2099,49,2148
72,Aquitaine,64,3,03,541,Urdès,264,8,272
72,Aquitaine,64,2,01,542,Urdos,68,3,71
72,Aquitaine,64,1,33,543,Urepel,345,6,351
72,Aquitaine,64,3,23,544,Urost,59,1,60
72,Aquitaine,64,1,45,545,Urrugne,8196,222,8418
72,Aquitaine,64,1,14,546,Urt,2092,67,2159
72,Aquitaine,64,1,41,547,Ustaritz,5576,282,5858
72,Aquitaine,64,3,05,548,Uzan,149,3,152
72,Aquitaine,64,3,19,549,Uzein,1218,16,1234
72,Aquitaine,64,3,48,550,Uzos,739,22,761
72,Aquitaine,64,2,27,551,Verdets,274,8,282
72,Aquitaine,64,3,11,552,Vialer,192,2,194
72,Aquitaine,64,3,03,554,Viellenave-d'Arthez,171,4,175
72,Aquitaine,64,2,24,555,Viellenave-de-Navarrenx,158,2,160
72,Aquitaine,64,3,15,556,Vielleségure,406,2,408
72,Aquitaine,64,3,05,557,Vignes,412,11,423
72,Aquitaine,64,1,52,558,Villefranque,2172,43,2215
72,Aquitaine,64,2,20,559,Viodos-Abense-de-Bas,747,28,775
72,Aquitaine,64,3,40,560,Viven,170,7,177
73,Midi-Pyrénées,65,1,01,001,Adast,250,8,258
73,Midi-Pyrénées,65,1,27,002,Adé,738,18,756
73,Midi-Pyrénées,65,2,06,003,Adervielle-Pouchergues,100,4,104
73,Midi-Pyrénées,65,1,01,004,Agos-Vidalos,367,12,379
73,Midi-Pyrénées,65,3,22,005,Allier,378,9,387
73,Midi-Pyrénées,65,2,02,006,Ancizan,323,7,330
73,Midi-Pyrénées,65,3,25,007,Andrest,1339,33,1372
73,Midi-Pyrénées,65,2,19,009,Anères,186,4,190
73,Midi-Pyrénées,65,1,12,011,Les Angles,126,8,134
73,Midi-Pyrénées,65,3,22,010,Angos,232,7,239
73,Midi-Pyrénées,65,2,15,012,Anla,76,2,78
73,Midi-Pyrénées,65,3,18,013,Ansost,53,3,56
73,Midi-Pyrénées,65,2,15,014,Antichan,34,0,34
73,Midi-Pyrénées,65,3,24,015,Antin,108,2,110
73,Midi-Pyrénées,65,2,04,016,Antist,133,1,134
73,Midi-Pyrénées,65,2,26,017,Aragnouet,241,9,250
73,Midi-Pyrénées,65,1,03,018,Arbéost,95,4,99
73,Midi-Pyrénées,65,3,34,019,Arcizac-Adour,514,12,526
73,Midi-Pyrénées,65,1,12,020,Arcizac-ez-Angles,254,5,259
73,Midi-Pyrénées,65,1,01,021,Arcizans-Avant,359,14,373
73,Midi-Pyrénées,65,1,03,022,Arcizans-Dessus,104,7,111
73,Midi-Pyrénées,65,2,02,023,Ardengost,16,0,16
73,Midi-Pyrénées,65,2,04,024,Argelès-Bagnères,122,7,129
73,Midi-Pyrénées,65,1,01,025,Argelès-Gazost,3309,205,3514
73,Midi-Pyrénées,65,3,08,026,Aries-Espénan,66,1,67
73,Midi-Pyrénées,65,2,06,027,Armenteule,63,1,64
73,Midi-Pyrénées,65,3,08,028,Arné,196,0,196
73,Midi-Pyrénées,65,1,03,029,Arras-en-Lavedan,526,12,538
73,Midi-Pyrénées,65,1,12,247,Arrayou-Lahitte,98,5,103
73,Midi-Pyrénées,65,2,02,031,Arreau,776,26,802
73,Midi-Pyrénées,65,1,03,032,Arrens-Marsous,757,26,783
73,Midi-Pyrénées,65,2,05,034,Arrodets,24,0,24
73,Midi-Pyrénées,65,1,12,033,Arrodets-ez-Angles,111,4,115
73,Midi-Pyrénées,65,3,25,035,Artagnan,484,14,498
73,Midi-Pyrénées,65,1,01,036,Artalens-Souin,108,2,110
73,Midi-Pyrénées,65,2,11,037,Artiguemy,80,2,82
73,Midi-Pyrénées,65,1,12,038,Artigues,23,1,24
73,Midi-Pyrénées,65,2,02,039,Aspin-Aure,52,1,53
73,Midi-Pyrénées,65,1,27,040,Aspin-en-Lavedan,239,2,241
73,Midi-Pyrénées,65,2,05,041,Asque,119,4,123
73,Midi-Pyrénées,65,2,07,042,Asté,531,12,543
73,Midi-Pyrénées,65,2,04,043,Astugue,301,8,309
73,Midi-Pyrénées,65,3,17,044,Aubarède,247,2,249
73,Midi-Pyrénées,65,1,03,045,Aucun,259,8,267
73,Midi-Pyrénées,65,2,02,046,Aulon,78,4,82
73,Midi-Pyrénées,65,3,21,047,Aureilhan,7801,261,8062
73,Midi-Pyrénées,65,3,33,048,Aurensan,744,21,765
73,Midi-Pyrénées,65,3,14,049,Auriébat,291,11,302
73,Midi-Pyrénées,65,2,06,050,Avajan,77,1,78
73,Midi-Pyrénées,65,2,19,051,Aventignan,179,8,187
73,Midi-Pyrénées,65,3,16,052,Averan,67,1,68
73,Midi-Pyrénées,65,2,15,053,Aveux,53,2,55
73,Midi-Pyrénées,65,2,05,054,Avezac-Prat-Lahitte,577,9,586
73,Midi-Pyrénées,65,1,01,055,Ayros-Arbouix,308,6,314
73,Midi-Pyrénées,65,1,01,056,Ayzac-Ost,401,14,415
73,Midi-Pyrénées,65,3,16,057,Azereix,946,28,974
73,Midi-Pyrénées,65,2,26,058,Azet,163,2,165
73,Midi-Pyrénées,65,2,04,059,Bagnères-de-Bigorre,8003,675,8678
73,Midi-Pyrénées,65,2,04,060,Banios,54,5,59
73,Midi-Pyrénées,65,3,18,061,Barbachen,51,3,54
73,Midi-Pyrénées,65,3,22,062,Barbazan-Debat,3432,98,3530
73,Midi-Pyrénées,65,3,23,063,Barbazan-Dessus,133,4,137
73,Midi-Pyrénées,65,1,13,481,Barèges,231,7,238
73,Midi-Pyrénées,65,2,06,064,Bareilles,63,2,65
73,Midi-Pyrénées,65,1,20,065,Barlest,247,24,271
73,Midi-Pyrénées,65,2,02,066,Barrancoueu,31,0,31
73,Midi-Pyrénées,65,3,16,067,Barry,134,3,137
73,Midi-Pyrénées,65,3,08,068,Barthe,16,1,17
73,Midi-Pyrénées,65,2,05,069,La Barthe-de-Neste,1162,33,1195
73,Midi-Pyrénées,65,1,27,070,Bartrès,472,7,479
73,Midi-Pyrénées,65,2,05,071,Batsère,46,1,47
73,Midi-Pyrénées,65,3,33,072,Bazet,1528,22,1550
73,Midi-Pyrénées,65,3,18,073,Bazillac,345,7,352
73,Midi-Pyrénées,65,3,08,074,Bazordan,127,1,128
73,Midi-Pyrénées,65,2,02,075,Bazus-Aure,132,6,138
73,Midi-Pyrénées,65,2,05,076,Bazus-Neste,42,3,45
73,Midi-Pyrénées,65,1,01,077,Beaucens,432,16,448
73,Midi-Pyrénées,65,2,07,078,Beaudéan,392,10,402
73,Midi-Pyrénées,65,3,23,079,Bégole,178,3,181
73,Midi-Pyrénées,65,3,16,080,Bénac,509,13,522
73,Midi-Pyrénées,65,2,11,081,Benqué,65,1,66
73,Midi-Pyrénées,65,1,12,082,Berbérust-Lias,52,0,52
73,Midi-Pyrénées,65,3,22,083,Bernac-Debat,634,13,647
73,Midi-Pyrénées,65,3,22,084,Bernac-Dessus,315,14,329
73,Midi-Pyrénées,65,3,24,085,Bernadets-Debat,105,2,107
73,Midi-Pyrénées,65,3,23,086,Bernadets-Dessus,139,3,142
73,Midi-Pyrénées,65,2,15,087,Bertren,208,0,208
73,Midi-Pyrénées,65,3,08,088,Betbèze,45,1,46
73,Midi-Pyrénées,65,1,13,089,Betpouey,108,1,109
73,Midi-Pyrénées,65,3,08,090,Betpouy,71,6,77
73,Midi-Pyrénées,65,2,04,091,Bettes,72,3,75
73,Midi-Pyrénées,65,2,02,092,Beyrède-Jumet,212,3,215
73,Midi-Pyrénées,65,2,19,093,Bize,212,5,217
73,Midi-Pyrénées,65,2,19,094,Bizous,109,3,112
73,Midi-Pyrénées,65,3,24,095,Bonnefont,353,6,359
73,Midi-Pyrénées,65,2,11,096,Bonnemazon,74,0,74
73,Midi-Pyrénées,65,3,10,097,Bonrepos,180,3,183
73,Midi-Pyrénées,65,1,01,098,Boô-Silhen,276,6,282
73,Midi-Pyrénées,65,2,06,099,Bordères-Louron,152,6,158
73,Midi-Pyrénées,65,3,33,100,Bordères-sur-l'Échez,4076,186,4262
73,Midi-Pyrénées,65,3,23,101,Bordes,660,26,686
73,Midi-Pyrénées,65,3,18,102,Bouilh-Devant,18,1,19
73,Midi-Pyrénées,65,3,17,103,Bouilh-Péreuilh,98,4,102
73,Midi-Pyrénées,65,3,17,104,Boulin,289,9,298
73,Midi-Pyrénées,65,2,11,105,Bourg-de-Bigorre,215,3,218
73,Midi-Pyrénées,65,2,26,106,Bourisp,146,5,151
73,Midi-Pyrénées,65,1,12,107,Bourréac,89,3,92
73,Midi-Pyrénées,65,3,21,108,Bours,748,21,769
73,Midi-Pyrénées,65,2,15,109,Bramevaque,34,0,34
73,Midi-Pyrénées,65,3,24,110,Bugard,86,2,88
73,Midi-Pyrénées,65,2,05,111,Bulan,67,1,68
73,Midi-Pyrénées,65,1,03,112,Bun,132,1,133
73,Midi-Pyrénées,65,3,23,113,Burg,264,6,270
73,Midi-Pyrénées,65,3,18,114,Buzon,79,0,79
73,Midi-Pyrénées,65,3,17,115,Cabanac,241,6,247
73,Midi-Pyrénées,65,2,02,116,Cadéac,240,9,249
73,Midi-Pyrénées,65,2,26,117,Cadeilhan-Trachère,44,5,49
73,Midi-Pyrénées,65,3,23,118,Caharet,27,1,28
73,Midi-Pyrénées,65,3,25,119,Caixon,412,28,440
73,Midi-Pyrénées,65,3,23,120,Calavanté,242,5,247
73,Midi-Pyrénées,65,3,25,121,Camalès,398,11,409
73,Midi-Pyrénées,65,2,02,122,Camous,25,1,26
73,Midi-Pyrénées,65,2,07,123,Campan,1465,60,1525
73,Midi-Pyrénées,65,2,26,124,Camparan,58,1,59
73,Midi-Pyrénées,65,2,11,125,Campistrous,304,19,323
73,Midi-Pyrénées,65,3,08,126,Campuzan,152,5,157
73,Midi-Pyrénées,65,2,19,482,Cantaous,439,70,509
73,Midi-Pyrénées,65,2,11,127,Capvern,1278,34,1312
73,Midi-Pyrénées,65,3,10,128,Castelbajac,112,4,116
73,Midi-Pyrénées,65,3,08,129,Castelnau-Magnoac,774,17,791
73,Midi-Pyrénées,65,3,09,130,Castelnau-Rivière-Basse,698,9,707
73,Midi-Pyrénées,65,3,17,131,Castelvieilh,215,4,219
73,Midi-Pyrénées,65,3,23,132,Castéra-Lanusse,33,1,34
73,Midi-Pyrénées,65,3,17,133,Castéra-Lou,189,3,192
73,Midi-Pyrénées,65,3,08,134,Casterets,16,1,17
73,Midi-Pyrénées,65,2,11,135,Castillon,88,2,90
73,Midi-Pyrénées,65,3,08,136,Caubous,38,1,39
73,Midi-Pyrénées,65,3,14,137,Caussade-Rivière,85,4,89
73,Midi-Pyrénées,65,1,01,138,Cauterets,1112,51,1163
73,Midi-Pyrénées,65,2,15,139,Cazarilh,39,1,40
73,Midi-Pyrénées,65,2,06,140,Cazaux-Debat,20,1,21
73,Midi-Pyrénées,65,2,06,141,Cazaux-Fréchet-Anéran-Camors,48,0,48
73,Midi-Pyrénées,65,3,17,142,Chelle-Debat,203,6,209
73,Midi-Pyrénées,65,2,11,143,Chelle-Spou,97,3,100
73,Midi-Pyrénées,65,1,12,144,Cheust,85,2,87
73,Midi-Pyrénées,65,1,13,145,Chèze,44,1,45
73,Midi-Pyrénées,65,3,21,146,Chis,291,2,293
73,Midi-Pyrénées,65,2,04,147,Cieutat,574,13,587
73,Midi-Pyrénées,65,3,08,148,Cizos,113,3,116
73,Midi-Pyrénées,65,3,23,149,Clarac,164,10,174
73,Midi-Pyrénées,65,2,11,150,Clarens,448,9,457
73,Midi-Pyrénées,65,3,17,151,Collongues,142,1,143
73,Midi-Pyrénées,65,3,17,153,Coussan,120,5,125
73,Midi-Pyrénées,65,2,15,154,Créchets,37,3,40
73,Midi-Pyrénées,65,3,08,155,Devèze,58,2,60
73,Midi-Pyrénées,65,3,17,156,Dours,227,3,230
73,Midi-Pyrénées,65,2,26,157,Ens,26,0,26
73,Midi-Pyrénées,65,2,15,158,Esbareich,80,0,80
73,Midi-Pyrénées,65,2,05,159,Escala,389,9,398
73,Midi-Pyrénées,65,3,25,160,Escaunets,105,5,110
73,Midi-Pyrénées,65,3,18,161,Escondeaux,243,10,253
73,Midi-Pyrénées,65,2,11,162,Esconnets,26,1,27
73,Midi-Pyrénées,65,2,11,163,Escots,28,0,28
73,Midi-Pyrénées,65,1,12,164,Escoubès-Pouts,102,3,105
73,Midi-Pyrénées,65,2,05,165,Esparros,172,5,177
73,Midi-Pyrénées,65,2,05,166,Espèche,52,0,52
73,Midi-Pyrénées,65,2,11,167,Espieilh,33,1,34
73,Midi-Pyrénées,65,1,13,168,Esquièze-Sère,395,15,410
73,Midi-Pyrénées,65,1,03,169,Estaing,74,4,78
73,Midi-Pyrénées,65,3,24,170,Estampures,81,5,86
73,Midi-Pyrénées,65,2,06,171,Estarvielle,32,1,33
73,Midi-Pyrénées,65,2,26,172,Estensan,38,0,38
73,Midi-Pyrénées,65,1,13,173,Esterre,204,8,212
73,Midi-Pyrénées,65,3,14,174,Estirac,105,0,105
73,Midi-Pyrénées,65,2,15,175,Ferrère,52,1,53
73,Midi-Pyrénées,65,1,03,176,Ferrières,114,3,117
73,Midi-Pyrénées,65,3,24,177,Fontrailles,153,11,164
73,Midi-Pyrénées,65,3,24,178,Fréchède,35,0,35
73,Midi-Pyrénées,65,2,11,179,Fréchendets,33,0,33
73,Midi-Pyrénées,65,2,02,180,Fréchet-Aure,13,0,13
73,Midi-Pyrénées,65,3,23,181,Fréchou-Fréchet,122,7,129
73,Midi-Pyrénées,65,1,03,182,Gaillagos,105,5,110
73,Midi-Pyrénées,65,3,10,183,Galan,744,11,755
73,Midi-Pyrénées,65,3,10,184,Galez,134,6,140
73,Midi-Pyrénées,65,3,16,185,Gardères,411,8,419
73,Midi-Pyrénées,65,2,15,186,Gaudent,47,0,47
73,Midi-Pyrénées,65,3,08,187,Gaussan,111,3,114
73,Midi-Pyrénées,65,1,13,188,Gavarnie,147,2,149
73,Midi-Pyrénées,65,3,33,189,Gayan,266,3,269
73,Midi-Pyrénées,65,2,05,190,Gazave,71,3,74
73,Midi-Pyrénées,65,1,12,191,Gazost,139,1,140
73,Midi-Pyrénées,65,1,13,192,Gèdre,263,3,266
73,Midi-Pyrénées,65,2,15,193,Gembrie,68,2,70
73,Midi-Pyrénées,65,2,19,194,Générest,94,2,96
73,Midi-Pyrénées,65,2,06,195,Génos,154,1,155
73,Midi-Pyrénées,65,3,18,196,Gensac,87,6,93
73,Midi-Pyrénées,65,1,12,197,Ger,170,5,175
73,Midi-Pyrénées,65,2,07,198,Gerde,1155,27,1182
73,Midi-Pyrénées,65,2,06,199,Germ,51,0,51
73,Midi-Pyrénées,65,1,12,200,Germs-sur-l'Oussouet,128,4,132
73,Midi-Pyrénées,65,1,12,201,Geu,161,6,167
73,Midi-Pyrénées,65,1,01,202,Gez,284,11,295
73,Midi-Pyrénées,65,1,12,203,Gez-ez-Angles,20,1,21
73,Midi-Pyrénées,65,3,17,204,Gonez,30,0,30
73,Midi-Pyrénées,65,2,02,205,Gouaux,68,4,72
73,Midi-Pyrénées,65,3,23,206,Goudon,224,10,234
73,Midi-Pyrénées,65,2,11,207,Gourgue,44,0,44
73,Midi-Pyrénées,65,2,26,208,Grailhen,16,2,18
73,Midi-Pyrénées,65,2,02,209,Grézian,92,2,94
73,Midi-Pyrénées,65,1,13,210,Grust,49,0,49
73,Midi-Pyrénées,65,2,26,211,Guchan,145,11,156
73,Midi-Pyrénées,65,2,02,212,Guchen,354,15,369
73,Midi-Pyrénées,65,3,08,213,Guizerix,130,4,134
73,Midi-Pyrénées,65,3,08,214,Hachan,43,0,43
73,Midi-Pyrénées,65,3,09,215,Hagedet,46,0,46
73,Midi-Pyrénées,65,2,04,216,Hauban,86,3,89
73,Midi-Pyrénées,65,2,19,217,Hautaget,43,2,45
73,Midi-Pyrénées,65,2,05,218,Hèches,622,11,633
73,Midi-Pyrénées,65,3,09,219,Hères,110,1,111
73,Midi-Pyrénées,65,3,16,220,Hibarette,229,4,233
73,Midi-Pyrénées,65,3,34,221,Hiis,217,6,223
73,Midi-Pyrénées,65,3,23,222,Hitte,143,0,143
73,Midi-Pyrénées,65,3,34,223,Horgues,1082,52,1134
73,Midi-Pyrénées,65,3,10,224,Houeydets,227,3,230
73,Midi-Pyrénées,65,3,17,225,Hourc,108,3,111
73,Midi-Pyrénées,65,3,33,226,Ibos,2746,180,2926
73,Midi-Pyrénées,65,2,02,228,Ilhet,131,2,133
73,Midi-Pyrénées,65,2,15,229,Ilheu,39,1,40
73,Midi-Pyrénées,65,2,15,230,Izaourt,235,7,242
73,Midi-Pyrénées,65,2,05,231,Izaux,183,12,195
73,Midi-Pyrénées,65,3,17,232,Jacque,61,1,62
73,Midi-Pyrénées,65,1,12,233,Jarret,312,9,321
73,Midi-Pyrénées,65,2,02,234,Jézeau,119,8,127
73,Midi-Pyrénées,65,3,16,235,Juillan,3868,99,3967
73,Midi-Pyrénées,65,1,12,236,Julos,322,5,327
73,Midi-Pyrénées,65,1,12,237,Juncalas,181,6,187
73,Midi-Pyrénées,65,2,04,238,Labassère,265,5,270
73,Midi-Pyrénées,65,2,05,239,Labastide,160,5,165
73,Midi-Pyrénées,65,3,14,240,Labatut-Rivière,341,18,359
73,Midi-Pyrénées,65,2,05,241,Laborde,96,4,100
73,Midi-Pyrénées,65,3,18,242,Lacassagne,198,6,204
73,Midi-Pyrénées,65,3,14,243,Lafitole,465,13,478
73,Midi-Pyrénées,65,3,33,244,Lagarde,498,9,507
73,Midi-Pyrénées,65,2,11,245,Lagrange,218,8,226
73,Midi-Pyrénées,65,3,14,248,Lahitte-Toupière,246,16,262
73,Midi-Pyrénées,65,3,08,249,Lalanne,76,0,76
73,Midi-Pyrénées,65,3,24,250,Lalanne-Trie,128,0,128
73,Midi-Pyrénées,65,3,34,251,Laloubère,1875,105,1980
73,Midi-Pyrénées,65,3,16,252,Lamarque-Pontacq,760,9,769
73,Midi-Pyrénées,65,3,24,253,Lamarque-Rustaing,57,1,58
73,Midi-Pyrénées,65,3,18,254,Laméac,124,1,125
73,Midi-Pyrénées,65,3,23,256,Lanespède,155,5,160
73,Midi-Pyrénées,65,3,16,257,Lanne,582,8,590
73,Midi-Pyrénées,65,2,11,258,Lannemezan,5716,195,5911
73,Midi-Pyrénées,65,3,17,259,Lansac,151,4,155
73,Midi-Pyrénées,65,2,02,255,Lançon,31,1,32
73,Midi-Pyrénées,65,3,24,260,Lapeyre,84,1,85
73,Midi-Pyrénées,65,3,08,261,Laran,40,1,41
73,Midi-Pyrénées,65,3,14,262,Larreule,416,16,432
73,Midi-Pyrénées,65,3,08,263,Larroque,89,6,95
73,Midi-Pyrénées,65,3,09,264,Lascazères,295,31,326
73,Midi-Pyrénées,65,3,17,265,Laslades,341,12,353
73,Midi-Pyrénées,65,3,08,266,Lassales,24,1,25
73,Midi-Pyrénées,65,1,01,267,Lau-Balagnas,491,13,504
73,Midi-Pyrénées,65,3,16,268,Layrisse,170,7,177
73,Midi-Pyrénées,65,3,18,269,Lescurry,172,3,175
73,Midi-Pyrénées,65,3,23,270,Lespouey,193,6,199
73,Midi-Pyrénées,65,1,12,271,Lézignan,373,6,379
73,Midi-Pyrénées,65,3,23,272,Lhez,78,3,81
73,Midi-Pyrénées,65,3,18,273,Liac,181,5,186
73,Midi-Pyrénées,65,3,10,274,Libaros,149,7,156
73,Midi-Pyrénées,65,2,04,275,Lies,76,3,79
73,Midi-Pyrénées,65,3,17,276,Lizos,99,0,99
73,Midi-Pyrénées,65,2,19,277,Lombrès,81,4,85
73,Midi-Pyrénées,65,2,05,278,Lomné,41,1,42
73,Midi-Pyrénées,65,2,05,279,Lortet,193,7,200
73,Midi-Pyrénées,65,1,20,280,Loubajac,393,3,396
73,Midi-Pyrénées,65,3,16,281,Loucrup,211,6,217
73,Midi-Pyrénées,65,2,06,282,Loudenvielle,308,8,316
73,Midi-Pyrénées,65,2,06,283,Loudervielle,55,0,55
73,Midi-Pyrénées,65,3,16,284,Louey,982,22,1004
73,Midi-Pyrénées,65,3,17,285,Louit,167,1,168
73,Midi-Pyrénées,65,1,98,286,Lourdes,15410,387,15797
73,Midi-Pyrénées,65,2,15,287,Loures-Barousse,729,14,743
73,Midi-Pyrénées,65,3,24,288,Lubret-Saint-Luc,71,2,73
73,Midi-Pyrénées,65,3,24,289,Luby-Betmont,108,2,110
73,Midi-Pyrénées,65,3,23,290,Luc,162,0,162
73,Midi-Pyrénées,65,1,12,291,Lugagnan,165,9,174
73,Midi-Pyrénées,65,3,16,292,Luquet,342,5,347
73,Midi-Pyrénées,65,3,24,293,Lustar,106,1,107
73,Midi-Pyrénées,65,2,11,294,Lutilhous,209,6,215
73,Midi-Pyrénées,65,1,13,295,Luz-Saint-Sauveur,1032,32,1064
73,Midi-Pyrénées,65,3,09,296,Madiran,458,16,474
73,Midi-Pyrénées,65,3,18,297,Mansan,46,0,46
73,Midi-Pyrénées,65,3,17,298,Marquerie,68,1,69
73,Midi-Pyrénées,65,3,25,299,Marsac,233,2,235
73,Midi-Pyrénées,65,2,04,300,Marsas,62,0,62
73,Midi-Pyrénées,65,3,17,301,Marseillan,192,4,196
73,Midi-Pyrénées,65,3,23,303,Mascaras,371,9,380
73,Midi-Pyrénées,65,3,14,304,Maubourguet,2478,38,2516
73,Midi-Pyrénées,65,2,15,305,Mauléon-Barousse,115,6,121
73,Midi-Pyrénées,65,2,11,306,Mauvezin,226,3,229
73,Midi-Pyrénées,65,2,19,307,Mazères-de-Neste,313,16,329
73,Midi-Pyrénées,65,3,24,308,Mazerolles,121,7,128
73,Midi-Pyrénées,65,2,05,309,Mazouau,14,0,14
73,Midi-Pyrénées,65,2,04,310,Mérilheu,245,4,249
73,Midi-Pyrénées,65,3,18,311,Mingot,88,6,94
73,Midi-Pyrénées,65,2,11,312,Molère,37,1,38
73,Midi-Pyrénées,65,3,34,313,Momères,642,15,657
73,Midi-Pyrénées,65,3,18,314,Monfaucon,223,2,225
73,Midi-Pyrénées,65,3,08,315,Monléon-Magnoac,431,254,685
73,Midi-Pyrénées,65,3,08,316,Monlong,99,3,102
73,Midi-Pyrénées,65,2,06,317,Mont,33,0,33
73,Midi-Pyrénées,65,3,10,318,Montastruc,264,7,271
73,Midi-Pyrénées,65,2,19,319,Montégut,122,4,126
73,Midi-Pyrénées,65,2,04,320,Montgaillard,735,43,778
73,Midi-Pyrénées,65,3,22,321,Montignac,110,3,113
73,Midi-Pyrénées,65,2,05,322,Montoussé,225,9,234
73,Midi-Pyrénées,65,2,19,323,Montsérié,46,2,48
73,Midi-Pyrénées,65,3,23,324,Moulédous,171,3,174
73,Midi-Pyrénées,65,3,18,325,Moumoulous,48,2,50
73,Midi-Pyrénées,65,3,17,326,Mun,106,0,106
73,Midi-Pyrénées,65,2,19,327,Nestier,168,8,176
73,Midi-Pyrénées,65,2,04,328,Neuilh,108,7,115
73,Midi-Pyrénées,65,2,19,329,Nistos,223,2,225
73,Midi-Pyrénées,65,3,25,330,Nouilhan,190,2,192
73,Midi-Pyrénées,65,3,34,331,Odos,3236,142,3378
73,Midi-Pyrénées,65,3,17,332,Oléac-Debat,95,6,101
73,Midi-Pyrénées,65,3,23,333,Oléac-Dessus,94,0,94
73,Midi-Pyrénées,65,1,27,334,Omex,243,6,249
73,Midi-Pyrénées,65,2,04,335,Ordizan,449,17,466
73,Midi-Pyrénées,65,3,08,336,Organ,35,0,35
73,Midi-Pyrénées,65,3,23,337,Orieux,109,4,113
73,Midi-Pyrénées,65,2,04,338,Orignac,228,7,235
73,Midi-Pyrénées,65,3,16,339,Orincles,309,6,315
73,Midi-Pyrénées,65,3,21,340,Orleix,1729,36,1765
73,Midi-Pyrénées,65,3,33,341,Oroix,120,3,123
73,Midi-Pyrénées,65,3,24,342,Osmets,83,4,87
73,Midi-Pyrénées,65,1,27,343,Ossen,192,4,196
73,Midi-Pyrénées,65,3,16,344,Ossun,2275,60,2335
73,Midi-Pyrénées,65,1,12,345,Ossun-ez-Angles,35,0,35
73,Midi-Pyrénées,65,3,23,346,Oueilloux,142,4,146
73,Midi-Pyrénées,65,2,15,347,Ourde,30,2,32
73,Midi-Pyrénées,65,1,12,348,Ourdis-Cotdoussan,48,2,50
73,Midi-Pyrénées,65,1,12,349,Ourdon,9,0,9
73,Midi-Pyrénées,65,3,33,350,Oursbelille,1205,26,1231
73,Midi-Pyrénées,65,1,12,351,Ousté,45,2,47
73,Midi-Pyrénées,65,1,01,352,Ouzous,194,10,204
73,Midi-Pyrénées,65,3,23,353,Ozon,275,6,281
73,Midi-Pyrénées,65,2,02,354,Pailhac,76,3,79
73,Midi-Pyrénées,65,1,12,355,Paréac,67,1,68
73,Midi-Pyrénées,65,2,11,356,Péré,58,3,61
73,Midi-Pyrénées,65,3,23,357,Peyraube,127,1,128
73,Midi-Pyrénées,65,3,08,358,Peyret-Saint-André,57,1,58
73,Midi-Pyrénées,65,3,17,359,Peyriguère,24,0,24
73,Midi-Pyrénées,65,1,20,360,Peyrouse,278,4,282
73,Midi-Pyrénées,65,3,18,361,Peyrun,78,0,78
73,Midi-Pyrénées,65,1,01,362,Pierrefitte-Nestalas,1290,31,1321
73,Midi-Pyrénées,65,2,11,363,Pinas,454,9,463
73,Midi-Pyrénées,65,3,33,364,Pintac,35,1,36
73,Midi-Pyrénées,65,1,27,366,Poueyferré,800,39,839
73,Midi-Pyrénées,65,3,23,367,Poumarous,121,3,124
73,Midi-Pyrénées,65,3,08,368,Pouy,36,2,38
73,Midi-Pyrénées,65,3,17,369,Pouyastruc,633,19,652
73,Midi-Pyrénées,65,2,04,370,Pouzac,1104,21,1125
73,Midi-Pyrénées,65,1,01,371,Préchac,216,5,221
73,Midi-Pyrénées,65,3,25,372,Pujo,611,28,639
73,Midi-Pyrénées,65,3,08,373,Puntous,209,7,216
73,Midi-Pyrénées,65,3,24,374,Puydarrieux,225,9,234
73,Midi-Pyrénées,65,3,18,375,Rabastens-de-Bigorre,1415,23,1438
73,Midi-Pyrénées,65,3,10,376,Recurt,181,6,187
73,Midi-Pyrénées,65,2,11,377,Réjaumont,168,4,172
73,Midi-Pyrénées,65,3,23,378,Ricaud,73,2,75
73,Midi-Pyrénées,65,2,06,379,Ris,9,0,9
73,Midi-Pyrénées,65,3,17,380,Sabalos,141,6,147
73,Midi-Pyrénées,65,3,10,381,Sabarros,33,2,35
73,Midi-Pyrénées,65,2,15,382,Sacoué,73,2,75
73,Midi-Pyrénées,65,3,24,383,Sadournin,180,4,184
73,Midi-Pyrénées,65,2,26,384,Sailhan,136,5,141
73,Midi-Pyrénées,65,2,05,385,Saint-Arroman,101,4,105
73,Midi-Pyrénées,65,1,12,386,Saint-Créac,91,1,92
73,Midi-Pyrénées,65,3,09,387,Saint-Lanne,132,6,138
73,Midi-Pyrénées,65,2,26,388,Saint-Lary-Soulan,1007,36,1043
73,Midi-Pyrénées,65,2,19,389,Saint-Laurent-de-Neste,899,33,932
73,Midi-Pyrénées,65,3,25,390,Saint-Lézer,408,16,424
73,Midi-Pyrénées,65,3,34,392,Saint-Martin,367,8,375
73,Midi-Pyrénées,65,1,01,393,Saint-Pastous,107,3,110
73,Midi-Pyrénées,65,2,19,394,Saint-Paul,266,9,275
73,Midi-Pyrénées,65,1,20,395,Saint-Pé-de-Bigorre,1265,23,1288
73,Midi-Pyrénées,65,1,01,396,Saint-Savin,374,14,388
73,Midi-Pyrénées,65,3,18,397,Saint-Sever-de-Rustan,153,5,158
73,Midi-Pyrénées,65,2,15,391,Sainte-Marie,34,0,34
73,Midi-Pyrénées,65,2,15,398,Saléchan,213,6,219
73,Midi-Pyrénées,65,1,13,399,Saligos,82,1,83
73,Midi-Pyrénées,65,1,01,400,Salles,194,2,196
73,Midi-Pyrénées,65,3,22,401,Salles-Adour,437,12,449
73,Midi-Pyrénées,65,2,15,402,Samuran,18,0,18
73,Midi-Pyrénées,65,3,25,403,Sanous,84,4,88
73,Midi-Pyrénées,65,3,08,404,Sariac-Magnoac,155,6,161
73,Midi-Pyrénées,65,2,11,405,Sarlabous,76,0,76
73,Midi-Pyrénées,65,3,33,406,Sarniguet,251,2,253
73,Midi-Pyrénées,65,2,15,407,Sarp,108,2,110
73,Midi-Pyrénées,65,2,02,408,Sarrancolin,627,19,646
73,Midi-Pyrénées,65,3,18,409,Sarriac-Bigorre,290,3,293
73,Midi-Pyrénées,65,3,22,410,Sarrouilles,576,16,592
73,Midi-Pyrénées,65,1,13,411,Sassis,90,0,90
73,Midi-Pyrénées,65,3,14,412,Sauveterre,175,9,184
73,Midi-Pyrénées,65,1,13,413,Sazos,108,1,109
73,Midi-Pyrénées,65,3,18,414,Ségalas,89,2,91
73,Midi-Pyrénées,65,1,27,415,Ségus,252,4,256
73,Midi-Pyrénées,65,2,19,416,Seich,68,1,69
73,Midi-Pyrénées,65,3,22,417,Séméac,4950,173,5123
73,Midi-Pyrénées,65,3,18,418,Sénac,246,6,252
73,Midi-Pyrénées,65,3,10,419,Sentous,83,5,88
73,Midi-Pyrénées,65,1,01,420,Sère-en-Lavedan,76,0,76
73,Midi-Pyrénées,65,1,12,421,Sère-Lanso,56,2,58
73,Midi-Pyrénées,65,3,24,423,Sère-Rustaing,132,2,134
73,Midi-Pyrénées,65,3,16,422,Séron,275,5,280
73,Midi-Pyrénées,65,1,13,424,Sers,87,1,88
73,Midi-Pyrénées,65,3,25,425,Siarrouy,425,15,440
73,Midi-Pyrénées,65,3,23,426,Sinzos,139,4,143
73,Midi-Pyrénées,65,2,15,427,Siradan,293,10,303
73,Midi-Pyrénées,65,1,03,428,Sireix,69,0,69
73,Midi-Pyrénées,65,3,14,429,Sombrun,211,3,214
73,Midi-Pyrénées,65,3,17,430,Soréac,37,1,38
73,Midi-Pyrénées,65,2,15,431,Sost,101,0,101
73,Midi-Pyrénées,65,3,09,432,Soublecause,177,7,184
73,Midi-Pyrénées,65,3,34,433,Soues,2998,73,3071
73,Midi-Pyrénées,65,1,01,435,Soulom,254,9,263
73,Midi-Pyrénées,65,3,17,436,Souyeaux,283,5,288
73,Midi-Pyrénées,65,2,11,437,Tajan,135,5,140
73,Midi-Pyrénées,65,3,25,438,Talazac,74,3,77
73,Midi-Pyrénées,65,3,33,439,Tarasteix,276,6,282
73,Midi-Pyrénées,65,3,99,440,Tarbes,44173,1943,46116
73,Midi-Pyrénées,65,2,15,441,Thèbe,76,3,79
73,Midi-Pyrénées,65,3,08,442,Thermes-Magnoac,186,4,190
73,Midi-Pyrénées,65,3,17,443,Thuy,14,0,14
73,Midi-Pyrénées,65,2,19,444,Tibiran-Jaunac,253,6,259
73,Midi-Pyrénées,65,2,11,445,Tilhouse,213,8,221
73,Midi-Pyrénées,65,3,18,446,Tostat,440,14,454
73,Midi-Pyrénées,65,3,23,447,Tournay,1273,27,1300
73,Midi-Pyrénées,65,3,24,448,Tournous-Darré,83,2,85
73,Midi-Pyrénées,65,3,10,449,Tournous-Devant,112,9,121
73,Midi-Pyrénées,65,2,26,450,Tramezaïgues,32,1,33
73,Midi-Pyrénées,65,2,04,451,Trébons,672,18,690
73,Midi-Pyrénées,65,3,24,452,Trie-sur-Baïse,1084,22,1106
73,Midi-Pyrénées,65,2,15,453,Troubat,56,1,57
73,Midi-Pyrénées,65,3,18,454,Trouley-Labarthe,88,1,89
73,Midi-Pyrénées,65,2,19,455,Tuzaguet,455,14,469
73,Midi-Pyrénées,65,2,11,456,Uglas,271,7,278
73,Midi-Pyrénées,65,3,18,457,Ugnouas,76,1,77
73,Midi-Pyrénées,65,1,01,458,Uz,34,0,34
73,Midi-Pyrénées,65,2,04,459,Uzer,106,2,108
73,Midi-Pyrénées,65,3,25,460,Vic-en-Bigorre,5116,302,5418
73,Midi-Pyrénées,65,3,24,461,Vidou,87,1,88
73,Midi-Pyrénées,65,3,14,462,Vidouze,255,3,258
73,Midi-Pyrénées,65,1,13,463,Viella,79,6,85
73,Midi-Pyrénées,65,3,22,464,Vielle-Adour,485,11,496
73,Midi-Pyrénées,65,2,26,465,Vielle-Aure,356,14,370
73,Midi-Pyrénées,65,2,06,466,Vielle-Louron,75,6,81
73,Midi-Pyrénées,65,1,01,467,Vier-Bordes,88,5,93
73,Midi-Pyrénées,65,3,08,468,Vieuzos,48,2,50
73,Midi-Pyrénées,65,1,13,469,Viey,29,0,29
73,Midi-Pyrénées,65,1,27,470,Viger,129,4,133
73,Midi-Pyrénées,65,2,26,471,Vignec,204,4,208
73,Midi-Pyrénées,65,3,09,472,Villefranque,85,3,88
73,Midi-Pyrénées,65,1,01,473,Villelongue,340,7,347
73,Midi-Pyrénées,65,3,24,474,Villembits,94,2,96
73,Midi-Pyrénées,65,3,08,475,Villemur,64,1,65
73,Midi-Pyrénées,65,3,25,476,Villenave-près-Béarn,60,1,61
73,Midi-Pyrénées,65,3,25,477,Villenave-près-Marsac,65,1,66
73,Midi-Pyrénées,65,1,13,478,Viscos,46,1,47
73,Midi-Pyrénées,65,3,16,479,Visker,329,13,342
73,Midi-Pyrénées,65,1,13,480,Vizos,35,0,35
91,Languedoc-Roussillon,66,1,03,001,L' Albère,78,1,79
91,Languedoc-Roussillon,66,2,27,002,Alénya,2912,39,2951
91,Languedoc-Roussillon,66,1,02,003,Amélie-les-Bains-Palalda,3688,63,3751
91,Languedoc-Roussillon,66,3,06,004,Les Angles,561,8,569
91,Languedoc-Roussillon,66,3,13,005,Angoustrine-Villeneuve-des-Escaldes,643,34,677
91,Languedoc-Roussillon,66,2,15,006,Ansignan,188,5,193
91,Languedoc-Roussillon,66,3,16,007,Arboussols,105,3,108
91,Languedoc-Roussillon,66,1,01,008,Argelès-sur-Mer,10015,167,10182
91,Languedoc-Roussillon,66,1,02,009,Arles-sur-Tech,2740,47,2787
91,Languedoc-Roussillon,66,3,07,010,Ayguatébia-Talau,45,3,48
91,Languedoc-Roussillon,66,2,28,011,Bages,3834,53,3887
91,Languedoc-Roussillon,66,2,30,012,Baho,2951,46,2997
91,Languedoc-Roussillon,66,3,18,013,Baillestavy,94,0,94
91,Languedoc-Roussillon,66,2,30,014,Baixas,2455,27,2482
91,Languedoc-Roussillon,66,1,03,015,Banyuls-dels-Aspres,1172,24,1196
91,Languedoc-Roussillon,66,1,19,016,Banyuls-sur-Mer,4680,87,4767
91,Languedoc-Roussillon,66,2,14,017,Le Barcarès,3987,45,4032
91,Languedoc-Roussillon,66,1,02,018,La Bastide,98,2,100
91,Languedoc-Roussillon,66,2,04,019,Bélesta,213,0,213
91,Languedoc-Roussillon,66,3,06,020,Bolquère,789,34,823
91,Languedoc-Roussillon,66,2,24,021,Bompas,7172,117,7289
91,Languedoc-Roussillon,66,3,18,022,Boule-d'Amont,54,3,57
91,Languedoc-Roussillon,66,3,18,023,Bouleternère,812,15,827
91,Languedoc-Roussillon,66,1,03,024,Le Boulou,5293,70,5363
91,Languedoc-Roussillon,66,3,13,025,Bourg-Madame,1244,96,1340
91,Languedoc-Roussillon,66,2,17,026,Brouilla,1014,6,1020
91,Languedoc-Roussillon,66,3,06,027,La Cabanasse,724,13,737
91,Languedoc-Roussillon,66,2,20,028,Cabestany,8630,167,8797
91,Languedoc-Roussillon,66,2,17,029,Caixas,120,1,121
91,Languedoc-Roussillon,66,2,30,030,Calce,228,10,238
91,Languedoc-Roussillon,66,1,03,032,Calmeilles,63,0,63
91,Languedoc-Roussillon,66,2,17,033,Camélas,440,8,448
91,Languedoc-Roussillon,66,3,10,034,Campôme,105,2,107
91,Languedoc-Roussillon,66,3,16,035,Campoussy,43,1,44
91,Languedoc-Roussillon,66,3,07,036,Canaveilles,48,2,50
91,Languedoc-Roussillon,66,2,31,037,Canet-en-Roussillon,12372,207,12579
91,Languedoc-Roussillon,66,2,29,038,Canohès,4849,111,4960
91,Languedoc-Roussillon,66,2,04,039,Caramany,142,1,143
91,Languedoc-Roussillon,66,3,18,040,Casefabre,35,1,36
91,Languedoc-Roussillon,66,2,12,041,Cases-de-Pène,728,6,734
91,Languedoc-Roussillon,66,2,04,042,Cassagnes,258,1,259
91,Languedoc-Roussillon,66,3,10,043,Casteil,124,2,126
91,Languedoc-Roussillon,66,2,17,044,Castelnou,365,8,373
91,Languedoc-Roussillon,66,3,10,045,Catllar,715,25,740
91,Languedoc-Roussillon,66,3,06,047,Caudiès-de-Conflent,13,1,14
91,Languedoc-Roussillon,66,2,15,046,Caudiès-de-Fenouillèdes,593,13,606
91,Languedoc-Roussillon,66,1,19,048,Cerbère,1573,10,1583
91,Languedoc-Roussillon,66,1,03,049,Céret,7674,215,7889
91,Languedoc-Roussillon,66,2,14,050,Claira,3508,59,3567
91,Languedoc-Roussillon,66,3,10,051,Clara,240,5,245
91,Languedoc-Roussillon,66,1,03,063,Les Cluses,246,2,248
91,Languedoc-Roussillon,66,3,10,052,Codalet,377,12,389
91,Languedoc-Roussillon,66,1,19,053,Collioure,2937,49,2986
91,Languedoc-Roussillon,66,3,10,054,Conat,52,3,55
91,Languedoc-Roussillon,66,2,05,055,Corbère,622,7,629
91,Languedoc-Roussillon,66,2,05,056,Corbère-les-Cabanes,1001,11,1012
91,Languedoc-Roussillon,66,3,10,057,Corneilla-de-Conflent,466,4,470
91,Languedoc-Roussillon,66,2,28,059,Corneilla-del-Vercol,1952,32,1984
91,Languedoc-Roussillon,66,2,05,058,Corneilla-la-Rivière,1764,23,1787
91,Languedoc-Roussillon,66,1,02,060,Corsavy,208,43,251
91,Languedoc-Roussillon,66,1,11,061,Coustouges,113,1,114
91,Languedoc-Roussillon,66,3,13,062,Dorres,178,11,189
91,Languedoc-Roussillon,66,3,13,064,Égat,456,18,474
91,Languedoc-Roussillon,66,2,28,065,Elne,7579,98,7677
91,Languedoc-Roussillon,66,3,13,066,Enveitg,667,14,681
91,Languedoc-Roussillon,66,3,13,067,Err,647,5,652
91,Languedoc-Roussillon,66,3,07,068,Escaro,88,1,89
91,Languedoc-Roussillon,66,3,18,070,Espira-de-Conflent,186,2,188
91,Languedoc-Roussillon,66,2,12,069,Espira-de-l'Agly,3012,158,3170
91,Languedoc-Roussillon,66,2,04,071,Estagel,1918,21,1939
91,Languedoc-Roussillon,66,3,13,072,Estavar,449,14,463
91,Languedoc-Roussillon,66,3,18,073,Estoher,155,2,157
91,Languedoc-Roussillon,66,3,10,074,Eus,402,17,419
91,Languedoc-Roussillon,66,3,13,075,Eyne,138,2,140
91,Languedoc-Roussillon,66,3,16,076,Felluns,58,3,61
91,Languedoc-Roussillon,66,2,15,077,Fenouillet,86,0,86
91,Languedoc-Roussillon,66,3,10,078,Fillols,151,2,153
91,Languedoc-Roussillon,66,3,18,079,Finestret,163,5,168
91,Languedoc-Roussillon,66,3,13,124,Font-Romeu-Odeillo-Via,1937,252,2189
91,Languedoc-Roussillon,66,3,06,080,Fontpédrouse,127,3,130
91,Languedoc-Roussillon,66,3,06,081,Fontrabiouse,111,3,114
91,Languedoc-Roussillon,66,3,06,082,Formiguères,442,20,462
91,Languedoc-Roussillon,66,2,15,083,Fosse,40,0,40
91,Languedoc-Roussillon,66,2,17,084,Fourques,1049,17,1066
91,Languedoc-Roussillon,66,3,10,085,Fuilla,369,6,375
91,Languedoc-Roussillon,66,3,18,086,Glorianes,20,0,20
91,Languedoc-Roussillon,66,3,18,088,Ille-sur-Têt,5278,82,5360
91,Languedoc-Roussillon,66,3,18,089,Joch,225,3,228
91,Languedoc-Roussillon,66,3,07,090,Jujols,51,3,54
91,Languedoc-Roussillon,66,1,11,091,Lamanère,56,2,58
91,Languedoc-Roussillon,66,2,04,092,Lansac,104,1,105
91,Languedoc-Roussillon,66,1,01,093,Laroque-des-Albères,1977,38,2015
91,Languedoc-Roussillon,66,2,27,094,Latour-Bas-Elne,2114,35,2149
91,Languedoc-Roussillon,66,3,13,095,Latour-de-Carol,416,33,449
91,Languedoc-Roussillon,66,2,04,096,Latour-de-France,1053,19,1072
91,Languedoc-Roussillon,66,2,15,097,Lesquerde,161,0,161
91,Languedoc-Roussillon,66,3,06,098,La Llagonne,260,5,265
91,Languedoc-Roussillon,66,2,17,099,Llauro,324,7,331
91,Languedoc-Roussillon,66,3,13,100,Llo,151,7,158
91,Languedoc-Roussillon,66,2,17,101,Llupia,1863,28,1891
91,Languedoc-Roussillon,66,3,07,102,Mantet,23,2,25
91,Languedoc-Roussillon,66,3,18,103,Marquixanes,536,6,542
91,Languedoc-Roussillon,66,3,10,104,Los Masos,665,26,691
91,Languedoc-Roussillon,66,3,06,105,Matemale,300,5,305
91,Languedoc-Roussillon,66,1,03,106,Maureillas-las-Illas,2638,38,2676
91,Languedoc-Roussillon,66,2,15,107,Maury,902,8,910
91,Languedoc-Roussillon,66,2,05,108,Millas,3877,74,3951
91,Languedoc-Roussillon,66,3,10,109,Molitg-les-Bains,216,11,227
91,Languedoc-Roussillon,66,3,06,117,Mont-Louis,288,5,293
91,Languedoc-Roussillon,66,3,18,111,Montalba-le-Château,145,5,150
91,Languedoc-Roussillon,66,1,03,112,Montauriol,215,3,218
91,Languedoc-Roussillon,66,1,02,113,Montbolo,189,0,189
91,Languedoc-Roussillon,66,2,28,114,Montescot,1628,23,1651
91,Languedoc-Roussillon,66,1,01,115,Montesquieu-des-Albères,1146,18,1164
91,Languedoc-Roussillon,66,1,02,116,Montferrer,202,4,206
91,Languedoc-Roussillon,66,2,04,118,Montner,312,6,318
91,Languedoc-Roussillon,66,3,10,119,Mosset,299,6,305
91,Languedoc-Roussillon,66,3,13,120,Nahuja,69,6,75
91,Languedoc-Roussillon,66,2,05,121,Néfiach,1039,38,1077
91,Languedoc-Roussillon,66,3,10,122,Nohèdes,72,2,74
91,Languedoc-Roussillon,66,3,07,123,Nyer,173,2,175
91,Languedoc-Roussillon,66,3,07,125,Olette,395,4,399
91,Languedoc-Roussillon,66,1,03,126,Oms,275,5,280
91,Languedoc-Roussillon,66,2,12,127,Opoul-Périllos,814,8,822
91,Languedoc-Roussillon,66,3,07,128,Oreilla,15,0,15
91,Languedoc-Roussillon,66,2,28,129,Ortaffa,1309,16,1325
91,Languedoc-Roussillon,66,3,13,130,Osséja,1493,137,1630
91,Languedoc-Roussillon,66,3,13,132,Palau-de-Cerdagne,475,15,490
91,Languedoc-Roussillon,66,1,01,133,Palau-del-Vidre,2668,43,2711
91,Languedoc-Roussillon,66,2,17,134,Passa,700,12,712
91,Languedoc-Roussillon,66,2,99,136,Perpignan,116676,2169,118845
91,Languedoc-Roussillon,66,1,03,137,Le Perthus,585,9,594
91,Languedoc-Roussillon,66,2,12,138,Peyrestortes,1355,14,1369
91,Languedoc-Roussillon,66,3,16,139,Pézilla-de-Conflent,55,2,57
91,Languedoc-Roussillon,66,2,05,140,Pézilla-la-Rivière,3114,56,3170
91,Languedoc-Roussillon,66,2,12,141,Pia,7316,161,7477
91,Languedoc-Roussillon,66,3,06,142,Planès,49,1,50
91,Languedoc-Roussillon,66,2,04,143,Planèzes,97,5,102
91,Languedoc-Roussillon,66,2,29,144,Pollestres,4108,63,4171
91,Languedoc-Roussillon,66,2,17,145,Ponteilla,2711,47,2758
91,Languedoc-Roussillon,66,1,19,148,Port-Vendres,4346,93,4439
91,Languedoc-Roussillon,66,3,13,146,Porta,139,1,140
91,Languedoc-Roussillon,66,3,13,147,Porté-Puymorens,127,10,137
91,Languedoc-Roussillon,66,3,10,149,Prades,6569,411,6980
91,Languedoc-Roussillon,66,1,11,150,Prats-de-Mollo-la-Preste,1148,23,1171
91,Languedoc-Roussillon,66,3,16,151,Prats-de-Sournia,72,1,73
91,Languedoc-Roussillon,66,2,15,152,Prugnanes,104,2,106
91,Languedoc-Roussillon,66,3,18,153,Prunet-et-Belpuig,57,4,61
91,Languedoc-Roussillon,66,3,06,154,Puyvalador,81,3,84
91,Languedoc-Roussillon,66,3,07,155,Py,103,1,104
91,Languedoc-Roussillon,66,3,16,156,Rabouillet,107,4,111
91,Languedoc-Roussillon,66,3,07,157,Railleu,15,0,15
91,Languedoc-Roussillon,66,2,04,158,Rasiguères,137,3,140
91,Languedoc-Roussillon,66,3,06,159,Réal,44,0,44
91,Languedoc-Roussillon,66,1,03,160,Reynès,1230,26,1256
91,Languedoc-Roussillon,66,3,10,161,Ria-Sirach,1178,19,1197
91,Languedoc-Roussillon,66,3,18,162,Rigarda,332,9,341
91,Languedoc-Roussillon,66,2,12,164,Rivesaltes,8429,209,8638
91,Languedoc-Roussillon,66,3,18,165,Rodès,605,13,618
91,Languedoc-Roussillon,66,3,07,166,Sahorre,362,2,364
91,Languedoc-Roussillon,66,3,13,167,Saillagouse,1017,18,1035
91,Languedoc-Roussillon,66,1,01,168,Saint-André,2851,45,2896
91,Languedoc-Roussillon,66,2,15,169,Saint-Arnac,121,2,123
91,Languedoc-Roussillon,66,2,27,171,Saint-Cyprien,10551,145,10696
91,Languedoc-Roussillon,66,2,30,172,Saint-Estève,11085,224,11309
91,Languedoc-Roussillon,66,2,05,173,Saint-Féliu-d'Amont,736,8,744
91,Languedoc-Roussillon,66,2,05,174,Saint-Féliu-d'Avall,2426,36,2462
91,Languedoc-Roussillon,66,1,01,175,Saint-Génis-des-Fontaines,2792,40,2832
91,Languedoc-Roussillon,66,2,14,176,Saint-Hippolyte,2385,26,2411
91,Languedoc-Roussillon,66,2,17,177,Saint-Jean-Lasseille,735,7,742
91,Languedoc-Roussillon,66,1,03,178,Saint-Jean-Pla-de-Corts,1992,47,2039
91,Languedoc-Roussillon,66,1,11,179,Saint-Laurent-de-Cerdans,1285,14,1299
91,Languedoc-Roussillon,66,2,14,180,Saint-Laurent-de-la-Salanque,8537,108,8645
91,Languedoc-Roussillon,66,1,02,183,Saint-Marsal,101,2,103
91,Languedoc-Roussillon,66,2,15,184,Saint-Martin,55,0,55
91,Languedoc-Roussillon,66,3,18,185,Saint-Michel-de-Llotes,299,3,302
91,Languedoc-Roussillon,66,2,31,186,Saint-Nazaire,2362,46,2408
91,Languedoc-Roussillon,66,2,15,187,Saint-Paul-de-Fenouillet,1937,23,1960
91,Languedoc-Roussillon,66,3,06,188,Saint-Pierre-dels-Forcats,243,7,250
91,Languedoc-Roussillon,66,2,17,170,Sainte-Colombe-de-la-Commanderie,119,2,121
91,Languedoc-Roussillon,66,3,13,181,Sainte-Léocadie,133,3,136
91,Languedoc-Roussillon,66,2,31,182,Sainte-Marie,4373,43,4416
91,Languedoc-Roussillon,66,2,27,189,Saleilles,4335,74,4409
91,Languedoc-Roussillon,66,2,12,190,Salses-le-Château,2920,119,3039
91,Languedoc-Roussillon,66,3,07,191,Sansa,21,0,21
91,Languedoc-Roussillon,66,3,06,192,Sauto,80,3,83
91,Languedoc-Roussillon,66,3,07,193,Serdinya,219,2,221
91,Languedoc-Roussillon,66,1,11,194,Serralongue,255,8,263
91,Languedoc-Roussillon,66,2,05,195,Le Soler,6737,99,6836
91,Languedoc-Roussillon,66,1,01,196,Sorède,2990,37,3027
91,Languedoc-Roussillon,66,3,07,197,Souanyas,37,0,37
91,Languedoc-Roussillon,66,3,16,198,Sournia,426,6,432
91,Languedoc-Roussillon,66,1,03,199,Taillet,80,0,80
91,Languedoc-Roussillon,66,3,16,201,Tarerach,59,0,59
91,Languedoc-Roussillon,66,3,13,202,Targassonne,200,5,205
91,Languedoc-Roussillon,66,1,02,203,Taulis,51,3,54
91,Languedoc-Roussillon,66,3,10,204,Taurinya,319,8,327
91,Languedoc-Roussillon,66,2,04,205,Tautavel,918,13,931
91,Languedoc-Roussillon,66,1,11,206,Le Tech,86,1,87
91,Languedoc-Roussillon,66,2,17,207,Terrats,633,12,645
91,Languedoc-Roussillon,66,2,28,208,Théza,1354,66,1420
91,Languedoc-Roussillon,66,3,07,209,Thuès-Entre-Valls,35,1,36
91,Languedoc-Roussillon,66,2,17,210,Thuir,7372,118,7490
91,Languedoc-Roussillon,66,2,17,211,Tordères,174,6,180
91,Languedoc-Roussillon,66,2,14,212,Torreilles,3110,43,3153
91,Languedoc-Roussillon,66,2,29,213,Toulouges,5976,104,6080
91,Languedoc-Roussillon,66,2,17,214,Tresserre,763,9,772
91,Languedoc-Roussillon,66,3,16,215,Trévillach,117,1,118
91,Languedoc-Roussillon,66,3,16,216,Trilla,58,0,58
91,Languedoc-Roussillon,66,2,17,217,Trouillas,1629,21,1650
91,Languedoc-Roussillon,66,3,13,218,Ur,335,11,346
91,Languedoc-Roussillon,66,3,10,219,Urbanya,42,0,42
91,Languedoc-Roussillon,66,3,13,220,Valcebollère,41,2,43
91,Languedoc-Roussillon,66,3,18,221,Valmanya,33,0,33
91,Languedoc-Roussillon,66,3,10,222,Vernet-les-Bains,1456,59,1515
91,Languedoc-Roussillon,66,3,10,223,Villefranche-de-Conflent,234,5,239
91,Languedoc-Roussillon,66,2,31,224,Villelongue-de-la-Salanque,2937,44,2981
91,Languedoc-Roussillon,66,1,01,225,Villelongue-dels-Monts,1355,75,1430
91,Languedoc-Roussillon,66,2,17,226,Villemolaque,1120,18,1138
91,Languedoc-Roussillon,66,2,28,227,Villeneuve-de-la-Raho,3723,92,3815
91,Languedoc-Roussillon,66,2,30,228,Villeneuve-la-Rivière,1317,10,1327
91,Languedoc-Roussillon,66,2,12,231,Vingrau,579,9,588
91,Languedoc-Roussillon,66,3,18,230,Vinça,1880,38,1918
91,Languedoc-Roussillon,66,2,15,232,Vira,35,0,35
91,Languedoc-Roussillon,66,1,03,233,Vivès,168,2,170
91,Languedoc-Roussillon,66,3,16,234,Le Vivier,88,2,90
42,Alsace,67,6,43,001,Achenheim,2216,39,2255
42,Alsace,67,4,06,002,Adamswiller,381,12,393
42,Alsace,67,5,32,003,Albé,476,8,484
42,Alsace,67,4,13,004,Allenwiller,507,8,515
42,Alsace,67,6,10,005,Alteckendorf,737,5,742
42,Alsace,67,4,21,006,Altenheim,218,3,221
42,Alsace,67,3,14,008,Altorf,1211,10,1221
42,Alsace,67,4,20,009,Altwiller,414,11,425
42,Alsace,67,5,01,010,Andlau,1838,70,1908
42,Alsace,67,5,12,011,Artolsheim,890,11,901
42,Alsace,67,7,26,012,Aschbach,667,10,677
42,Alsace,67,4,06,013,Asswiller,277,3,280
42,Alsace,67,2,03,014,Auenheim,848,8,856
42,Alsace,67,3,14,016,Avolsheim,752,11,763
42,Alsace,67,4,06,017,Baerendorf,302,6,308
42,Alsace,67,3,33,018,Balbronn,640,7,647
42,Alsace,67,5,12,019,Baldenheim,1099,16,1115
42,Alsace,67,3,23,020,Barembach,883,17,900
42,Alsace,67,5,01,021,Barr,6748,190,6938
42,Alsace,67,5,32,022,Bassemberg,270,6,276
42,Alsace,67,2,09,023,Batzendorf,906,16,922
42,Alsace,67,7,25,025,Beinheim,1900,40,1940
42,Alsace,67,3,23,026,Bellefosse,129,1,130
42,Alsace,67,3,23,027,Belmont,169,0,169
42,Alsace,67,5,02,028,Benfeld,5377,89,5466
42,Alsace,67,4,06,029,Berg,410,3,413
42,Alsace,67,3,33,030,Bergbieten,624,14,638
42,Alsace,67,5,16,031,Bernardswiller,1427,38,1465
42,Alsace,67,5,01,032,Bernardvillé,212,7,219
42,Alsace,67,6,05,033,Bernolsheim,578,4,582
42,Alsace,67,6,31,034,Berstett,2209,20,2229
42,Alsace,67,2,09,035,Berstheim,369,5,374
42,Alsace,67,7,26,339,Betschdorf,4001,53,4054
42,Alsace,67,4,06,036,Bettwiller,339,7,346
42,Alsace,67,7,35,037,Biblisheim,371,13,384
42,Alsace,67,6,05,038,Bietlenheim,277,1,278
42,Alsace,67,6,05,039,Bilwisheim,416,7,423
42,Alsace,67,5,12,040,Bindernheim,874,13,887
42,Alsace,67,4,13,041,Birkenwald,289,7,296
42,Alsace,67,6,44,043,Bischheim,17692,230,17922
42,Alsace,67,4,04,044,Bischholtz,275,5,280
42,Alsace,67,3,18,045,Bischoffsheim,3203,69,3272
42,Alsace,67,2,03,046,Bischwiller,12678,77,12755
42,Alsace,67,4,20,047,Bissert,144,3,147
42,Alsace,67,2,15,048,Bitschhoffen,469,6,475
42,Alsace,67,6,08,049,Blaesheim,1291,11,1302
42,Alsace,67,3,23,050,Blancherupt,33,0,33
42,Alsace,67,5,01,051,Blienschwiller,320,8,328
42,Alsace,67,3,18,052,Boersch,2401,61,2462
42,Alsace,67,5,12,053,Boesenbiesen,299,8,307
42,Alsace,67,5,07,054,Bolsenheim,444,4,448
42,Alsace,67,5,02,055,Boofzheim,1217,16,1233
42,Alsace,67,5,12,056,Bootzheim,597,7,604
42,Alsace,67,4,04,057,Bosselshausen,173,3,176
42,Alsace,67,6,10,058,Bossendorf,384,4,388
42,Alsace,67,3,19,059,Bourg-Bruche,447,7,454
42,Alsace,67,5,16,060,Bourgheim,588,7,595
42,Alsace,67,4,04,061,Bouxwiller,3932,92,4024
42,Alsace,67,5,32,062,Breitenau,291,4,295
42,Alsace,67,5,32,063,Breitenbach,692,19,711
42,Alsace,67,6,43,065,Breuschwickersheim,1226,10,1236
42,Alsace,67,3,23,066,La Broque,2807,112,2919
42,Alsace,67,6,05,067,Brumath,9912,120,10032
42,Alsace,67,7,25,069,Buhl,513,5,518
42,Alsace,67,4,06,070,Burbach,322,1,323
42,Alsace,67,4,06,071,Bust,448,7,455
42,Alsace,67,4,04,068,Buswiller,193,3,196
42,Alsace,67,4,20,072,Butten,668,11,679
42,Alsace,67,5,24,073,Châtenois,4067,86,4153
42,Alsace,67,7,34,074,Cleebourg,682,15,697
42,Alsace,67,7,34,075,Climbach,523,5,528
42,Alsace,67,3,19,076,Colroy-la-Roche,480,4,484
42,Alsace,67,3,33,077,Cosswiller,559,20,579
42,Alsace,67,4,13,078,Crastatt,198,2,200
42,Alsace,67,7,25,079,Croettwiller,167,3,170
42,Alsace,67,3,14,080,Dachstein,1543,20,1563
42,Alsace,67,3,33,081,Dahlenheim,707,11,718
42,Alsace,67,2,03,082,Dalhunden,975,7,982
42,Alsace,67,2,15,083,Dambach,767,13,780
42,Alsace,67,5,01,084,Dambach-la-Ville,1938,49,1987
42,Alsace,67,3,33,085,Dangolsheim,632,11,643
42,Alsace,67,5,07,086,Daubensand,374,8,382
42,Alsace,67,2,09,087,Dauendorf,1428,14,1442
42,Alsace,67,4,20,088,Dehlingen,382,8,390
42,Alsace,67,4,21,089,Dettwiller,2635,56,2691
42,Alsace,67,5,12,090,Diebolsheim,617,43,660
42,Alsace,67,4,20,091,Diedendorf,329,13,342
42,Alsace,67,5,32,092,Dieffenbach-au-Val,625,16,641
42,Alsace,67,7,35,093,Dieffenbach-lès-Woerth,344,5,349
42,Alsace,67,5,24,094,Dieffenthal,251,4,255
42,Alsace,67,4,06,095,Diemeringen,1627,31,1658
42,Alsace,67,4,13,096,Dimbsthal,312,7,319
42,Alsace,67,6,31,097,Dingsheim,1311,19,1330
42,Alsace,67,3,14,098,Dinsheim-sur-Bruche,1329,25,1354
42,Alsace,67,4,20,099,Domfessel,297,5,302
42,Alsace,67,6,05,100,Donnenheim,259,9,268
42,Alsace,67,3,14,101,Dorlisheim,2436,27,2463
42,Alsace,67,6,31,102,Dossenheim-Kochersberg,246,3,249
42,Alsace,67,4,04,103,Dossenheim-sur-Zinsel,1101,24,1125
42,Alsace,67,7,26,104,Drachenbronn-Birlenbach,955,9,964
42,Alsace,67,4,06,105,Drulingen,1448,30,1478
42,Alsace,67,2,03,106,Drusenheim,5009,42,5051
42,Alsace,67,6,10,107,Duntzenheim,608,4,612
42,Alsace,67,6,08,108,Duppigheim,1568,12,1580
42,Alsace,67,6,31,109,Durningen,632,12,644
42,Alsace,67,7,35,110,Durrenbach,1065,23,1088
42,Alsace,67,4,06,111,Durstel,401,8,409
42,Alsace,67,3,14,112,Duttlenheim,2902,24,2926
42,Alsace,67,7,25,113,Eberbach-Seltz,388,9,397
42,Alsace,67,5,24,115,Ebersheim,1997,40,2037
42,Alsace,67,5,24,116,Ebersmunster,454,41,495
42,Alsace,67,4,21,117,Eckartswiller,480,12,492
42,Alsace,67,6,43,118,Eckbolsheim,6458,63,6521
42,Alsace,67,6,05,119,Eckwersheim,1421,25,1446
42,Alsace,67,5,01,120,Eichhoffen,523,8,531
42,Alsace,67,5,12,121,Elsenheim,797,14,811
42,Alsace,67,2,15,123,Engwiller,474,22,496
42,Alsace,67,6,08,124,Entzheim,1781,22,1803
42,Alsace,67,5,01,125,Epfig,2140,62,2202
42,Alsace,67,4,17,126,Erckartswiller,261,3,264
42,Alsace,67,3,14,127,Ergersheim,1121,17,1138
42,Alsace,67,3,14,128,Ernolsheim-Bruche,1570,24,1594
42,Alsace,67,4,21,129,Ernolsheim-lès-Saverne,600,15,615
42,Alsace,67,5,07,130,Erstein,10301,158,10459
42,Alsace,67,6,08,131,Eschau,4819,47,4866
42,Alsace,67,7,35,132,Eschbach,925,17,942
42,Alsace,67,4,17,133,Eschbourg,479,4,483
42,Alsace,67,4,06,134,Eschwiller,165,3,168
42,Alsace,67,6,10,135,Ettendorf,824,20,844
42,Alsace,67,4,06,136,Eywiller,270,3,273
42,Alsace,67,6,08,137,Fegersheim,5243,63,5306
42,Alsace,67,6,31,138,Fessenheim-le-Bas,499,4,503
42,Alsace,67,3,33,139,Flexbourg,468,12,480
42,Alsace,67,2,03,140,Forstfeld,700,8,708
42,Alsace,67,7,35,141,Forstheim,543,13,556
42,Alsace,67,2,03,142,Fort-Louis,315,0,315
42,Alsace,67,5,32,143,Fouchy,627,11,638
42,Alsace,67,3,23,144,Fouday,350,4,354
42,Alsace,67,6,10,145,Friedolsheim,234,0,234
42,Alsace,67,5,02,146,Friesenheim,651,8,659
42,Alsace,67,7,35,147,Froeschwiller,529,7,536
42,Alsace,67,4,17,148,Frohmuhl,186,4,190
42,Alsace,67,4,21,149,Furchhausen,382,17,399
42,Alsace,67,6,31,150,Furdenheim,1161,7,1168
42,Alsace,67,6,05,151,Gambsheim,4523,42,4565
42,Alsace,67,6,08,152,Geispolsheim,7061,76,7137
42,Alsace,67,6,10,153,Geiswiller,204,2,206
42,Alsace,67,5,07,154,Gerstheim,3096,24,3120
42,Alsace,67,5,01,155,Gertwiller,898,17,915
42,Alsace,67,6,05,156,Geudertheim,2300,26,2326
42,Alsace,67,6,10,158,Gingsheim,318,9,327
42,Alsace,67,4,06,159,Goerlingen,249,6,255
42,Alsace,67,7,35,160,Goersdorf,1117,11,1128
42,Alsace,67,4,13,161,Gottenhouse,369,14,383
42,Alsace,67,4,21,162,Gottesheim,348,2,350
42,Alsace,67,6,31,163,Gougenheim,524,5,529
42,Alsace,67,5,16,164,Goxwiller,801,18,819
42,Alsace,67,3,23,165,Grandfontaine,389,7,396
42,Alsace,67,6,10,166,Grassendorf,178,7,185
42,Alsace,67,3,18,167,Grendelbruch,1240,50,1290
42,Alsace,67,3,14,168,Gresswiller,1484,30,1514
42,Alsace,67,6,05,169,Gries,2748,28,2776
42,Alsace,67,3,18,172,Griesheim-près-Molsheim,1955,48,2003
42,Alsace,67,6,31,173,Griesheim-sur-Souffel,1135,26,1161
42,Alsace,67,2,15,174,Gumbrechtshoffen,1219,18,1237
42,Alsace,67,2,15,176,Gundershoffen,3454,43,3497
42,Alsace,67,4,06,178,Gungwiller,283,3,286
42,Alsace,67,7,35,177,Gunstett,687,14,701
42,Alsace,67,4,13,179,Haegen,637,14,651
42,Alsace,67,2,09,180,Haguenau,35144,601,35745
42,Alsace,67,6,31,181,Handschuheim,301,2,303
42,Alsace,67,6,43,182,Hangenbieten,1481,14,1495
42,Alsace,67,4,20,183,Harskirchen,882,17,899
42,Alsace,67,7,26,184,Hatten,1975,30,2005
42,Alsace,67,4,21,185,Hattmatt,644,8,652
42,Alsace,67,7,35,186,Hegeney,384,0,384
42,Alsace,67,5,12,187,Heidolsheim,469,4,473
42,Alsace,67,3,14,188,Heiligenberg,634,11,645
42,Alsace,67,5,01,189,Heiligenstein,994,20,1014
42,Alsace,67,4,13,190,Hengwiller,176,1,177
42,Alsace,67,4,20,191,Herbitzheim,1913,35,1948
42,Alsace,67,5,02,192,Herbsheim,810,6,816
42,Alsace,67,2,03,194,Herrlisheim,4629,57,4686
42,Alsace,67,5,12,195,Hessenheim,555,8,563
42,Alsace,67,5,12,196,Hilsenheim,2515,132,2647
42,Alsace,67,5,07,197,Hindisheim,1397,27,1424
42,Alsace,67,4,17,198,Hinsbourg,118,3,121
42,Alsace,67,4,20,199,Hinsingen,84,1,85
42,Alsace,67,5,07,200,Hipsheim,776,37,813
42,Alsace,67,4,06,201,Hirschland,325,13,338
42,Alsace,67,6,10,202,Hochfelden,3195,28,3223
42,Alsace,67,2,09,203,Hochstett,324,4,328
42,Alsace,67,6,44,204,Hoenheim,10474,115,10589
42,Alsace,67,6,05,205,Hoerdt,4435,56,4491
42,Alsace,67,7,26,206,Hoffen,1193,20,1213
42,Alsace,67,6,10,207,Hohatzenheim,208,6,214
42,Alsace,67,4,13,208,Hohengoeft,527,7,534
42,Alsace,67,6,10,209,Hohfrankenheim,257,4,261
42,Alsace,67,5,01,210,Le Hohwald,492,9,501
42,Alsace,67,6,08,212,Holtzheim,3038,21,3059
42,Alsace,67,7,26,213,Hunspach,668,15,683
42,Alsace,67,6,31,214,Hurtigheim,509,4,513
42,Alsace,67,2,09,215,Huttendorf,409,6,415
42,Alsace,67,5,02,216,Huttenheim,2461,41,2502
42,Alsace,67,5,07,217,Ichtratzheim,307,2,309
42,Alsace,67,6,42,218,Illkirch-Graffenstaden,26743,660,27403
42,Alsace,67,6,10,220,Ingenheim,374,5,379
42,Alsace,67,7,26,221,Ingolsheim,288,3,291
42,Alsace,67,4,04,222,Ingwiller,4110,73,4183
42,Alsace,67,5,16,223,Innenheim,1090,12,1102
42,Alsace,67,6,10,225,Issenhausen,107,2,109
42,Alsace,67,6,43,226,Ittenheim,2108,32,2140
42,Alsace,67,5,01,227,Itterswiller,276,3,279
42,Alsace,67,4,13,229,Jetterswiller,178,6,184
42,Alsace,67,2,09,230,Kaltenhouse,2179,7,2186
42,Alsace,67,2,03,231,Kauffenheim,222,1,223
42,Alsace,67,7,26,232,Keffenach,212,6,218
42,Alsace,67,5,02,233,Kertzfeld,1321,9,1330
42,Alsace,67,4,20,234,Keskastel,1551,33,1584
42,Alsace,67,7,25,235,Kesseldorf,429,4,433
42,Alsace,67,6,31,236,Kienheim,576,13,589
42,Alsace,67,6,05,237,Kilstett,2369,13,2382
42,Alsace,67,2,15,238,Kindwiller,570,15,585
42,Alsace,67,5,24,239,Kintzheim,1525,30,1555
42,Alsace,67,3,33,240,Kirchheim,584,4,588
42,Alsace,67,4,06,241,Kirrberg,177,1,178
42,Alsace,67,4,04,242,Kirrwiller,512,10,522
42,Alsace,67,4,13,244,Kleingoeft,137,5,142
42,Alsace,67,4,13,245,Knoersheim,199,6,205
42,Alsace,67,5,02,246,Kogenheim,1095,14,1109
42,Alsace,67,6,08,247,Kolbsheim,822,6,828
42,Alsace,67,5,16,248,Krautergersheim,1630,16,1646
42,Alsace,67,6,05,249,Krautwiller,192,2,194
42,Alsace,67,6,05,250,Kriegsheim,747,11,758
42,Alsace,67,6,05,252,Kurtzenhouse,973,5,978
42,Alsace,67,6,31,253,Kuttolsheim,651,13,664
42,Alsace,67,7,26,254,Kutzenhausen,874,27,901
42,Alsace,67,5,32,255,Lalaye,440,7,447
42,Alsace,67,6,43,256,Lampertheim,2992,69,3061
42,Alsace,67,7,35,257,Lampertsloch,698,11,709
42,Alsace,67,4,13,258,Landersheim,194,5,199
42,Alsace,67,7,35,259,Langensoultzbach,961,21,982
42,Alsace,67,7,35,260,Laubach,301,3,304
42,Alsace,67,7,11,261,Lauterbourg,2241,49,2290
42,Alsace,67,7,34,263,Lembach,1734,38,1772
42,Alsace,67,2,03,264,Leutenheim,847,8,855
42,Alsace,67,4,17,265,Lichtenberg,564,5,569
42,Alsace,67,5,07,266,Limersheim,621,10,631
42,Alsace,67,6,42,267,Lingolsheim,16802,180,16982
42,Alsace,67,6,08,268,Lipsheim,2500,23,2523
42,Alsace,67,4,21,269,Littenheim,289,3,292
42,Alsace,67,6,10,270,Lixhausen,325,6,331
42,Alsace,67,7,26,271,Lobsann,600,6,606
42,Alsace,67,4,13,272,Lochwiller,405,12,417
42,Alsace,67,4,17,273,Lohr,506,5,511
42,Alsace,67,4,20,274,Lorentzen,200,4,204
42,Alsace,67,4,21,275,Lupstein,789,10,799
42,Alsace,67,3,14,276,Lutzelhouse,1819,32,1851
42,Alsace,67,5,12,277,Mackenheim,705,14,719
42,Alsace,67,4,06,278,Mackwiller,602,9,611
42,Alsace,67,4,21,279,Maennolsheim,196,3,199
42,Alsace,67,5,32,280,Maisonsgoutte,838,14,852
42,Alsace,67,5,12,281,Marckolsheim,4265,53,4318
42,Alsace,67,3,33,282,Marlenheim,3509,48,3557
42,Alsace,67,4,13,283,Marmoutier,2700,62,2762
42,Alsace,67,5,02,285,Matzenheim,1491,147,1638
42,Alsace,67,5,16,286,Meistratzheim,1379,19,1398
42,Alsace,67,6,10,287,Melsheim,586,4,590
42,Alsace,67,7,26,288,Memmelshoffen,321,5,326
42,Alsace,67,4,04,289,Menchhoffen,517,8,525
42,Alsace,67,7,26,290,Merkwiller-Pechelbronn,905,18,923
42,Alsace,67,2,15,291,Mertzwiller,3511,51,3562
42,Alsace,67,2,15,292,Mietesheim,635,13,648
42,Alsace,67,6,10,293,Minversheim,633,3,636
42,Alsace,67,5,01,295,Mittelbergheim,667,15,682
42,Alsace,67,6,43,296,Mittelhausbergen,1726,30,1756
42,Alsace,67,6,10,297,Mittelhausen,547,7,554
42,Alsace,67,6,05,298,Mittelschaeffolsheim,507,7,514
42,Alsace,67,3,18,299,Mollkirch,948,21,969
42,Alsace,67,3,14,300,Molsheim,9344,189,9533
42,Alsace,67,6,05,301,Mommenheim,1806,36,1842
42,Alsace,67,4,21,302,Monswiller,2145,25,2170
42,Alsace,67,7,35,303,Morsbronn-les-Bains,614,11,625
42,Alsace,67,2,09,304,Morschwiller,563,10,573
42,Alsace,67,7,25,305,Mothern,2039,30,2069
42,Alsace,67,3,14,306,Muhlbach-sur-Bruche,644,67,711
42,Alsace,67,4,04,307,Mulhausen,435,6,441
42,Alsace,67,7,25,308,Munchhausen,735,9,744
42,Alsace,67,6,43,309,Mundolsheim,5089,79,5168
42,Alsace,67,5,12,310,Mussig,1156,46,1202
42,Alsace,67,5,12,311,Muttersholtz,1904,39,1943
42,Alsace,67,6,10,312,Mutzenhouse,429,5,434
42,Alsace,67,3,14,313,Mutzig,5844,73,5917
42,Alsace,67,3,23,314,Natzwiller,611,12,623
42,Alsace,67,7,11,315,Neewiller-près-Lauterbourg,653,25,678
42,Alsace,67,5,32,317,Neubois,668,10,678
42,Alsace,67,6,31,228,Neugartheim-Ittlenheim,728,8,736
42,Alsace,67,2,03,319,Neuhaeusel,352,3,355
42,Alsace,67,5,32,320,Neuve-Église,621,17,638
42,Alsace,67,3,23,321,Neuviller-la-Roche,408,11,419
42,Alsace,67,4,04,322,Neuwiller-lès-Saverne,1158,21,1179
42,Alsace,67,2,15,324,Niederbronn-les-Bains,4402,73,4475
42,Alsace,67,3,14,325,Niederhaslach,1431,20,1451
42,Alsace,67,6,43,326,Niederhausbergen,1344,26,1370
42,Alsace,67,7,11,327,Niederlauterbach,937,16,953
42,Alsace,67,4,04,328,Niedermodern,782,13,795
42,Alsace,67,5,16,329,Niedernai,1245,23,1268
42,Alsace,67,7,25,330,Niederroedern,880,20,900
42,Alsace,67,2,09,331,Niederschaeffolsheim,1246,24,1270
42,Alsace,67,4,04,333,Niedersoultzbach,254,5,259
42,Alsace,67,7,34,334,Niedersteinbach,145,3,148
42,Alsace,67,3,33,335,Nordheim,796,11,807
42,Alsace,67,5,07,336,Nordhouse,1617,18,1635
42,Alsace,67,5,01,337,Nothalten,459,8,467
42,Alsace,67,5,07,338,Obenheim,1390,17,1407
42,Alsace,67,2,15,340,Oberbronn,1559,24,1583
42,Alsace,67,7,35,341,Oberdorf-Spachbach,346,6,352
42,Alsace,67,3,14,342,Oberhaslach,1771,29,1800
42,Alsace,67,6,43,343,Oberhausbergen,5036,65,5101
42,Alsace,67,7,34,344,Oberhoffen-lès-Wissembourg,314,15,329
42,Alsace,67,2,03,345,Oberhoffen-sur-Moder,3189,38,3227
42,Alsace,67,7,25,346,Oberlauterbach,524,6,530
42,Alsace,67,4,04,347,Obermodern-Zutzendorf,1606,12,1618
42,Alsace,67,5,16,348,Obernai,10883,484,11367
42,Alsace,67,7,26,349,Oberroedern,510,7,517
42,Alsace,67,6,43,350,Oberschaeffolsheim,2128,29,2157
42,Alsace,67,4,04,352,Obersoultzbach,397,6,403
42,Alsace,67,7,34,353,Obersteinbach,225,3,228
42,Alsace,67,3,33,354,Odratzheim,460,9,469
42,Alsace,67,4,20,355,Oermingen,1230,17,1247
42,Alsace,67,2,03,356,Offendorf,2139,15,2154
42,Alsace,67,2,15,358,Offwiller,823,11,834
42,Alsace,67,2,09,359,Ohlungen,1351,11,1362
42,Alsace,67,5,12,360,Ohnenheim,855,21,876
42,Alsace,67,6,05,361,Olwisheim,506,12,518
42,Alsace,67,5,24,362,Orschwiller,579,14,593
42,Alsace,67,6,31,363,Osthoffen,822,5,827
42,Alsace,67,5,07,364,Osthouse,958,14,972
42,Alsace,67,6,42,365,Ostwald,10804,102,10906
42,Alsace,67,4,21,366,Ottersthal,725,21,746
42,Alsace,67,4,13,367,Otterswiller,1353,42,1395
42,Alsace,67,3,18,368,Ottrott,1649,34,1683
42,Alsace,67,4,06,369,Ottwiller,220,4,224
42,Alsace,67,4,17,370,Petersbach,689,7,696
42,Alsace,67,4,17,371,La Petite-Pierre,602,15,617
42,Alsace,67,4,04,372,Pfaffenhoffen,2753,44,2797
42,Alsace,67,4,17,373,Pfalzweyer,303,9,312
42,Alsace,67,6,31,374,Pfettisheim,798,12,810
42,Alsace,67,6,31,375,Pfulgriesheim,1283,29,1312
42,Alsace,67,3,19,377,Plaine,965,32,997
42,Alsace,67,6,08,378,Plobsheim,3839,42,3881
42,Alsace,67,7,35,379,Preuschdorf,960,10,970
42,Alsace,67,4,21,380,Printzheim,213,0,213
42,Alsace,67,4,17,381,Puberg,342,7,349
42,Alsace,67,6,31,382,Quatzenheim,799,11,810
42,Alsace,67,4,13,383,Rangen,176,3,179
42,Alsace,67,3,19,384,Ranrupt,349,8,357
42,Alsace,67,4,20,385,Ratzwiller,252,3,255
42,Alsace,67,4,06,386,Rauwiller,216,3,219
42,Alsace,67,5,01,387,Reichsfeld,306,4,310
42,Alsace,67,2,15,388,Reichshoffen,5541,114,5655
42,Alsace,67,6,43,389,Reichstett,4466,44,4510
42,Alsace,67,4,13,391,Reinhardsmunster,466,5,471
42,Alsace,67,4,17,392,Reipertswiller,953,5,958
42,Alsace,67,7,26,394,Retschwiller,255,9,264
42,Alsace,67,4,13,395,Reutenbourg,361,5,366
42,Alsace,67,4,06,396,Rexingen,191,5,196
42,Alsace,67,5,02,397,Rhinau,2653,23,2676
42,Alsace,67,5,12,398,Richtolsheim,350,3,353
42,Alsace,67,7,34,400,Riedseltz,1124,23,1147
42,Alsace,67,4,20,401,Rimsdorf,267,6,273
42,Alsace,67,6,10,402,Ringeldorf,80,2,82
42,Alsace,67,6,10,403,Ringendorf,421,7,428
42,Alsace,67,7,26,404,Rittershoffen,912,16,928
42,Alsace,67,2,03,405,Roeschwoog,2128,29,2157
42,Alsace,67,6,31,406,Rohr,279,7,286
42,Alsace,67,2,03,407,Rohrwiller,1608,8,1616
42,Alsace,67,3,33,408,Romanswiller,1353,25,1378
42,Alsace,67,2,03,409,Roppenheim,932,16,948
42,Alsace,67,3,18,410,Rosenwiller,680,17,697
42,Alsace,67,3,18,411,Rosheim,4730,66,4796
42,Alsace,67,5,02,412,Rossfeld,801,12,813
42,Alsace,67,4,17,413,Rosteig,567,10,577
42,Alsace,67,3,23,414,Rothau,1584,22,1606
42,Alsace,67,2,15,415,Rothbach,494,12,506
42,Alsace,67,7,34,416,Rott,474,5,479
42,Alsace,67,6,05,417,Rottelsheim,330,2,332
42,Alsace,67,2,03,418,Rountzenheim,1026,6,1032
42,Alsace,67,3,23,420,Russ,1229,22,1251
42,Alsace,67,3,19,421,Saales,910,13,923
42,Alsace,67,5,12,422,Saasenheim,591,18,609
42,Alsace,67,6,10,423,Saessolsheim,498,8,506
42,Alsace,67,3,19,424,Saint-Blaise-la-Roche,223,1,224
42,Alsace,67,4,21,425,Saint-Jean-Saverne,599,22,621
42,Alsace,67,5,32,426,Saint-Martin,348,12,360
42,Alsace,67,5,32,427,Saint-Maurice,381,15,396
42,Alsace,67,3,18,428,Saint-Nabor,463,19,482
42,Alsace,67,5,01,429,Saint-Pierre,592,9,601
42,Alsace,67,5,32,430,Saint-Pierre-Bois,723,18,741
42,Alsace,67,4,13,431,Salenthal,213,4,217
42,Alsace,67,7,11,432,Salmbach,598,10,608
42,Alsace,67,5,02,433,Sand,1156,11,1167
42,Alsace,67,4,20,434,Sarre-Union,3169,86,3255
42,Alsace,67,4,20,435,Sarrewerden,936,25,961
42,Alsace,67,3,19,436,Saulxures,533,7,540
42,Alsace,67,4,21,437,Saverne,11989,272,12261
42,Alsace,67,5,07,438,Schaeffersheim,819,7,826
42,Alsace,67,7,25,440,Schaffhouse-près-Seltz,543,11,554
42,Alsace,67,6,10,439,Schaffhouse-sur-Zorn,393,14,407
42,Alsace,67,4,04,441,Schalkendorf,308,2,310
42,Alsace,67,3,33,442,Scharrachbergheim-Irmstett,1119,58,1177
42,Alsace,67,7,11,443,Scheibenhard,853,16,869
42,Alsace,67,6,10,444,Scherlenheim,121,1,122
42,Alsace,67,5,24,445,Scherwiller,3056,43,3099
42,Alsace,67,4,04,446,Schillersdorf,441,11,452
42,Alsace,67,6,22,447,Schiltigheim,31133,251,31384
42,Alsace,67,3,23,448,Schirmeck,2464,66,2530
42,Alsace,67,2,03,449,Schirrhein,2160,29,2189
42,Alsace,67,2,03,450,Schirrhoffen,698,6,704
42,Alsace,67,7,34,451,Schleithal,1450,36,1486
42,Alsace,67,6,31,452,Schnersheim,1248,16,1264
42,Alsace,67,5,12,453,Schoenau,540,12,552
42,Alsace,67,4,17,454,Schoenbourg,453,9,462
42,Alsace,67,7,26,455,Schoenenbourg,670,14,684
42,Alsace,67,4,20,456,Schopperten,404,6,410
42,Alsace,67,2,09,458,Schweighouse-sur-Moder,4815,80,4895
42,Alsace,67,4,13,459,Schwenheim,670,9,679
42,Alsace,67,6,10,460,Schwindratzheim,1604,21,1625
42,Alsace,67,5,12,461,Schwobsheim,274,1,275
42,Alsace,67,7,34,351,Seebach,1780,43,1823
42,Alsace,67,5,24,462,Sélestat,19313,359,19672
42,Alsace,67,7,25,463,Seltz,3217,23,3240
42,Alsace,67,5,02,464,Sermersheim,798,9,807
42,Alsace,67,2,03,465,Sessenheim,2054,7,2061
42,Alsace,67,7,25,466,Siegen,517,14,531
42,Alsace,67,4,06,467,Siewiller,413,8,421
42,Alsace,67,4,20,468,Siltzheim,628,7,635
42,Alsace,67,4,13,469,Singrist,347,6,353
42,Alsace,67,3,23,470,Solbach,108,2,110
42,Alsace,67,6,43,471,Souffelweyersheim,7180,72,7252
42,Alsace,67,2,03,472,Soufflenheim,4804,51,4855
42,Alsace,67,3,14,473,Soultz-les-Bains,870,24,894
42,Alsace,67,7,26,474,Soultz-sous-Forêts,2876,54,2930
42,Alsace,67,4,17,475,Sparsbach,253,4,257
42,Alsace,67,2,03,476,Stattmatten,670,2,672
42,Alsace,67,5,32,477,Steige,566,4,570
42,Alsace,67,4,21,478,Steinbourg,1988,21,2009
42,Alsace,67,7,34,479,Steinseltz,620,15,635
42,Alsace,67,3,14,480,Still,1673,26,1699
42,Alsace,67,5,01,481,Stotzheim,1038,28,1066
42,Alsace,67,8,99,482,Strasbourg,272116,4078,276194
42,Alsace,67,4,17,483,Struth,229,4,233
42,Alsace,67,7,26,484,Stundwiller,471,8,479
42,Alsace,67,6,31,485,Stutzheim-Offenheim,1484,27,1511
42,Alsace,67,5,12,486,Sundhouse,1467,18,1485
42,Alsace,67,7,26,487,Surbourg,1639,32,1671
42,Alsace,67,4,06,488,Thal-Drulingen,173,1,174
42,Alsace,67,4,13,489,Thal-Marmoutier,734,12,746
42,Alsace,67,5,32,490,Thanvillé,581,16,597
42,Alsace,67,4,17,491,Tieffenbach,279,4,283
42,Alsace,67,3,33,492,Traenheim,667,12,679
42,Alsace,67,5,32,493,Triembach-au-Val,462,6,468
42,Alsace,67,7,25,494,Trimbach,502,7,509
42,Alsace,67,6,31,495,Truchtersheim,2863,46,2909
42,Alsace,67,2,15,496,Uberach,1174,29,1203
42,Alsace,67,2,09,497,Uhlwiller,705,9,714
42,Alsace,67,2,15,498,Uhrwiller,689,12,701
42,Alsace,67,5,32,499,Urbeis,305,17,322
42,Alsace,67,3,14,500,Urmatt,1447,18,1465
42,Alsace,67,5,07,501,Uttenheim,576,6,582
42,Alsace,67,2,15,502,Uttenhoffen,171,6,177
42,Alsace,67,4,04,503,Uttwiller,171,3,174
42,Alsace,67,5,16,504,Valff,1342,19,1361
42,Alsace,67,5,24,505,La Vancelle,397,20,417
42,Alsace,67,6,05,506,Vendenheim,5617,75,5692
42,Alsace,67,5,32,507,Villé,1796,39,1835
42,Alsace,67,4,20,508,Voellerdingen,435,5,440
42,Alsace,67,4,06,509,Volksberg,353,5,358
42,Alsace,67,2,09,510,Wahlenheim,392,5,397
42,Alsace,67,7,35,511,Walbourg,785,307,1092
42,Alsace,67,2,15,512,La Walck,1162,14,1176
42,Alsace,67,3,23,513,Waldersbach,138,2,140
42,Alsace,67,4,06,514,Waldhambach,661,10,671
42,Alsace,67,4,21,515,Waldolwisheim,539,11,550
42,Alsace,67,6,10,516,Waltenheim-sur-Zorn,730,3,733
42,Alsace,67,3,33,517,Wangen,711,19,730
42,Alsace,67,3,33,122,Wangenbourg-Engenthal,1383,18,1401
42,Alsace,67,6,05,519,La Wantzenau,5973,86,6059
42,Alsace,67,3,33,520,Wasselonne,5545,50,5595
42,Alsace,67,4,04,521,Weinbourg,439,12,451
42,Alsace,67,4,06,522,Weislingen,565,13,578
42,Alsace,67,2,09,523,Weitbruch,2660,44,2704
42,Alsace,67,4,17,524,Weiterswiller,573,19,592
42,Alsace,67,3,33,525,Westhoffen,1615,27,1642
42,Alsace,67,5,07,526,Westhouse,1410,23,1433
42,Alsace,67,4,13,527,Westhouse-Marmoutier,253,4,257
42,Alsace,67,4,06,528,Weyer,595,10,605
42,Alsace,67,6,05,529,Weyersheim,3266,47,3313
42,Alsace,67,6,10,530,Wickersheim-Wilshausen,435,12,447
42,Alsace,67,3,23,531,Wildersbach,319,8,327
42,Alsace,67,6,31,532,Willgottheim,1095,5,1100
42,Alsace,67,6,10,534,Wilwisheim,676,11,687
42,Alsace,67,4,17,535,Wimmenau,1140,19,1159
42,Alsace,67,2,15,536,Windstein,165,3,168
42,Alsace,67,7,34,537,Wingen,453,10,463
42,Alsace,67,4,17,538,Wingen-sur-Moder,1586,33,1619
42,Alsace,67,6,10,539,Wingersheim,1159,10,1169
42,Alsace,67,2,09,540,Wintershouse,809,7,816
42,Alsace,67,7,25,541,Wintzenbach,591,6,597
42,Alsace,67,6,31,542,Wintzenheim-Kochersberg,306,6,312
42,Alsace,67,3,23,543,Wisches,2184,35,2219
42,Alsace,67,7,34,544,Wissembourg,7880,253,8133
42,Alsace,67,5,02,545,Witternheim,519,10,529
42,Alsace,67,2,09,546,Wittersheim,603,10,613
42,Alsace,67,5,12,547,Wittisheim,2024,31,2055
42,Alsace,67,6,31,548,Wiwersheim,746,9,755
42,Alsace,67,7,35,550,Woerth,1824,26,1850
42,Alsace,67,6,43,551,Wolfisheim,3958,50,4008
42,Alsace,67,4,20,552,Wolfskirchen,350,12,362
42,Alsace,67,4,21,553,Wolschheim,312,4,316
42,Alsace,67,3,14,554,Wolxheim,870,21,891
42,Alsace,67,4,13,555,Zehnacker,253,6,259
42,Alsace,67,4,13,556,Zeinheim,190,1,191
42,Alsace,67,5,16,557,Zellwiller,727,11,738
42,Alsace,67,2,15,558,Zinswiller,814,11,825
42,Alsace,67,4,17,559,Zittersheim,264,1,265
42,Alsace,67,6,10,560,Zoebersdorf,184,7,191
42,Alsace,68,2,19,001,Algolsheim,1102,13,1115
42,Alsace,68,1,05,002,Altenach,389,5,394
42,Alsace,68,1,01,004,Altkirch,5709,157,5866
42,Alsace,68,5,12,005,Ammerschwihr,1914,65,1979
42,Alsace,68,1,05,006,Ammerzwiller,334,12,346
42,Alsace,68,2,02,007,Andolsheim,2218,79,2297
42,Alsace,68,2,19,008,Appenwihr,530,9,539
42,Alsace,68,2,02,009,Artzenheim,803,9,812
42,Alsace,68,1,01,010,Aspach,1168,29,1197
42,Alsace,68,6,03,011,Aspach-le-Bas,1358,22,1380
42,Alsace,68,6,25,012,Aspach-le-Haut,1448,37,1485
42,Alsace,68,4,11,013,Attenschwiller,882,19,901
42,Alsace,68,5,23,014,Aubure,413,16,429
42,Alsace,68,4,31,015,Baldersheim,2506,59,2565
42,Alsace,68,2,19,016,Balgau,878,10,888
42,Alsace,68,1,01,017,Ballersdorf,838,23,861
42,Alsace,68,1,05,018,Balschwiller,831,15,846
42,Alsace,68,2,02,019,Baltzenheim,584,8,592
42,Alsace,68,4,31,020,Bantzenheim,1652,20,1672
42,Alsace,68,4,13,021,Bartenheim,3531,56,3587
42,Alsace,68,4,31,022,Battenheim,1298,29,1327
42,Alsace,68,5,12,023,Beblenheim,965,7,972
42,Alsace,68,1,05,024,Bellemagny,193,6,199
42,Alsace,68,1,07,025,Bendorf,230,2,232
42,Alsace,68,5,12,026,Bennwihr,1323,25,1348
42,Alsace,68,1,01,027,Berentzwiller,321,5,326
42,Alsace,68,5,20,028,Bergheim,1883,32,1915
42,Alsace,68,3,08,029,Bergholtz,1068,14,1082
42,Alsace,68,3,08,030,Bergholtzzell,443,5,448
42,Alsace,68,6,03,031,Bernwiller,633,20,653
42,Alsace,68,3,24,032,Berrwiller,1120,26,1146
42,Alsace,68,1,10,033,Bettendorf,472,8,480
42,Alsace,68,1,07,034,Bettlach,331,4,335
42,Alsace,68,1,07,035,Biederthal,351,3,354
42,Alsace,68,2,19,036,Biesheim,2348,34,2382
42,Alsace,68,3,06,037,Biltzheim,369,6,375
42,Alsace,68,2,02,038,Bischwihr,958,23,981
42,Alsace,68,1,10,039,Bisel,571,10,581
42,Alsace,68,6,25,040,Bitschwiller-lès-Thann,2119,53,2172
42,Alsace,68,3,06,041,Blodelsheim,1643,24,1667
42,Alsace,68,4,11,042,Blotzheim,3913,103,4016
42,Alsace,68,3,24,043,Bollwiller,3560,53,3613
42,Alsace,68,5,14,044,Le Bonhomme,854,22,876
42,Alsace,68,6,25,045,Bourbach-le-Bas,623,9,632
42,Alsace,68,6,15,046,Bourbach-le-Haut,420,6,426
42,Alsace,68,1,07,049,Bouxwiller,457,19,476
42,Alsace,68,1,05,050,Bréchaumont,401,8,409
42,Alsace,68,2,18,051,Breitenbach-Haut-Rhin,864,20,884
42,Alsace,68,1,05,052,Bretten,173,2,175
42,Alsace,68,4,13,054,Brinckheim,341,6,347
42,Alsace,68,4,17,055,Bruebach,1031,27,1058
42,Alsace,68,4,17,056,Brunstatt,6164,146,6310
42,Alsace,68,1,05,057,Buethwiller,281,7,288
42,Alsace,68,3,08,058,Buhl,3265,47,3312
42,Alsace,68,6,03,059,Burnhaupt-le-Bas,1610,23,1633
42,Alsace,68,6,03,060,Burnhaupt-le-Haut,1597,45,1642
42,Alsace,68,4,11,061,Buschwiller,946,19,965
42,Alsace,68,1,01,062,Carspach,1842,75,1917
42,Alsace,68,6,03,063,Cernay,11181,253,11434
42,Alsace,68,4,31,064,Chalampé,912,19,931
42,Alsace,68,1,05,065,Chavannes-sur-l'Étang,550,11,561
42,Alsace,68,2,98,066,Colmar,66871,1139,68010
42,Alsace,68,1,07,067,Courtavon,342,8,350
42,Alsace,68,1,05,068,Dannemarie,2324,45,2369
42,Alsace,68,2,19,069,Dessenheim,1218,15,1233
42,Alsace,68,4,17,070,Didenheim,1693,31,1724
42,Alsace,68,1,05,071,Diefmatten,263,4,267
42,Alsace,68,4,13,072,Dietwiller,1348,26,1374
42,Alsace,68,6,15,073,Dolleren,426,9,435
42,Alsace,68,1,07,074,Durlinsdorf,467,13,480
42,Alsace,68,1,07,075,Durmenach,919,13,932
42,Alsace,68,2,02,076,Durrenentzen,916,10,926
42,Alsace,68,1,01,077,Eglingen,343,3,346
42,Alsace,68,2,26,078,Eguisheim,1597,40,1637
42,Alsace,68,1,05,079,Elbach,268,4,272
42,Alsace,68,1,01,080,Emlingen,254,5,259
42,Alsace,68,3,06,082,Ensisheim,7123,97,7220
42,Alsace,68,2,18,083,Eschbach-au-Val,387,5,392
42,Alsace,68,4,09,084,Eschentzwiller,1476,43,1519
42,Alsace,68,1,05,085,Eteimbes,320,4,324
42,Alsace,68,1,05,086,Falkwiller,197,1,198
42,Alsace,68,1,10,087,Feldbach,453,13,466
42,Alsace,68,3,24,088,Feldkirch,949,16,965
42,Alsace,68,6,22,089,Fellering,1712,32,1744
42,Alsace,68,1,07,090,Ferrette,936,22,958
42,Alsace,68,3,06,091,Fessenheim,2273,45,2318
42,Alsace,68,1,07,092,Fislis,421,7,428
42,Alsace,68,4,17,093,Flaxlanden,1475,29,1504
42,Alsace,68,4,11,094,Folgensbourg,770,19,789
42,Alsace,68,2,02,095,Fortschwihr,1209,42,1251
42,Alsace,68,1,01,096,Franken,338,4,342
42,Alsace,68,5,14,097,Fréland,1408,22,1430
42,Alsace,68,1,10,098,Friesen,573,11,584
42,Alsace,68,1,01,099,Froeningen,600,10,610
42,Alsace,68,1,10,100,Fulleren,336,3,339
42,Alsace,68,4,17,101,Galfingue,793,10,803
42,Alsace,68,6,22,102,Geishouse,483,8,491
42,Alsace,68,4,13,103,Geispitzen,432,15,447
42,Alsace,68,2,19,104,Geiswasser,334,7,341
42,Alsace,68,1,05,105,Gildwiller,278,7,285
42,Alsace,68,6,22,106,Goldbach-Altenbach,295,15,310
42,Alsace,68,1,05,107,Gommersdorf,365,9,374
42,Alsace,68,1,10,108,Grentzingen,546,18,564
42,Alsace,68,2,18,109,Griesbach-au-Val,753,15,768
42,Alsace,68,2,02,110,Grussenheim,833,17,850
42,Alsace,68,3,21,111,Gueberschwihr,835,25,860
42,Alsace,68,3,08,112,Guebwiller,11575,341,11916
42,Alsace,68,5,20,113,Guémar,1362,20,1382
42,Alsace,68,1,05,114,Guevenatten,132,7,139
42,Alsace,68,6,25,115,Guewenheim,1222,19,1241
42,Alsace,68,3,21,116,Gundolsheim,719,19,738
42,Alsace,68,2,18,117,Gunsbach,922,21,943
42,Alsace,68,4,09,118,Habsheim,4785,65,4850
42,Alsace,68,1,05,119,Hagenbach,710,16,726
42,Alsace,68,4,11,120,Hagenthal-le-Bas,1064,20,1084
42,Alsace,68,4,11,121,Hagenthal-le-Haut,593,11,604
42,Alsace,68,3,24,122,Hartmannswiller,658,11,669
42,Alsace,68,3,21,123,Hattstatt,850,24,874
42,Alsace,68,1,01,124,Hausgauen,441,16,457
42,Alsace,68,1,05,125,Hecken,446,8,454
42,Alsace,68,4,11,126,Hégenheim,3085,76,3161
42,Alsace,68,1,01,127,Heidwiller,624,17,641
42,Alsace,68,1,10,128,Heimersdorf,656,14,670
42,Alsace,68,4,17,129,Heimsbrunn,1443,25,1468
42,Alsace,68,2,19,130,Heiteren,896,15,911
42,Alsace,68,1,01,131,Heiwiller,188,5,193
42,Alsace,68,4,13,132,Helfrantzkirch,812,19,831
42,Alsace,68,1,10,133,Henflingen,193,3,196
42,Alsace,68,2,26,134,Herrlisheim-près-Colmar,1723,35,1758
42,Alsace,68,4,11,135,Hésingue,2404,35,2439
42,Alsace,68,2,19,136,Hettenschlag,333,4,337
42,Alsace,68,1,10,137,Hindlingen,619,6,625
42,Alsace,68,1,10,138,Hirsingue,2163,27,2190
42,Alsace,68,1,10,139,Hirtzbach,1278,19,1297
42,Alsace,68,3,06,140,Hirtzfelden,1113,9,1122
42,Alsace,68,1,01,141,Hochstatt,2135,54,2189
42,Alsace,68,2,18,142,Hohrod,344,9,353
42,Alsace,68,2,02,143,Holtzwihr,1320,35,1355
42,Alsace,68,4,31,144,Hombourg,1053,9,1062
42,Alsace,68,2,02,145,Horbourg-Wihr,4998,137,5135
42,Alsace,68,2,02,146,Houssen,1678,37,1715
42,Alsace,68,5,20,147,Hunawihr,612,21,633
42,Alsace,68,1,01,148,Hundsbach,296,1,297
42,Alsace,68,4,11,149,Huningue,6503,104,6607
42,Alsace,68,2,26,150,Husseren-les-Châteaux,526,4,530
42,Alsace,68,6,22,151,Husseren-Wesserling,1001,23,1024
42,Alsace,68,1,01,152,Illfurth,2340,49,2389
42,Alsace,68,5,20,153,Illhaeusern,742,9,751
42,Alsace,68,4,31,154,Illzach,14568,325,14893
42,Alsace,68,5,12,155,Ingersheim,4634,89,4723
42,Alsace,68,3,24,156,Issenheim,3402,47,3449
42,Alsace,68,2,02,157,Jebsheim,1117,9,1126
42,Alsace,68,1,01,158,Jettingen,512,4,516
42,Alsace,68,3,24,159,Jungholtz,912,15,927
42,Alsace,68,4,13,160,Kappelen,515,7,522
42,Alsace,68,5,12,161,Katzenthal,553,10,563
42,Alsace,68,5,12,162,Kaysersberg,2726,51,2777
42,Alsace,68,4,13,163,Kembs,4361,86,4447
42,Alsace,68,5,12,164,Kientzheim,777,19,796
42,Alsace,68,1,07,165,Kiffis,269,5,274
42,Alsace,68,4,27,166,Kingersheim,13060,237,13297
42,Alsace,68,6,15,167,Kirchberg,818,19,837
42,Alsace,68,4,11,168,Knoeringue,337,10,347
42,Alsace,68,1,07,169,Koestlach,514,1,515
42,Alsace,68,4,13,170,Koetzingue,545,5,550
42,Alsace,68,6,22,171,Kruth,1016,19,1035
42,Alsace,68,2,02,172,Kunheim,1767,28,1795
42,Alsace,68,5,14,173,Labaroche,2229,82,2311
42,Alsace,68,4,13,174,Landser,1564,33,1597
42,Alsace,68,5,14,175,Lapoutroie,2030,77,2107
42,Alsace,68,1,10,176,Largitzen,288,4,292
42,Alsace,68,3,08,177,Lautenbach,1570,30,1600
42,Alsace,68,3,08,178,Lautenbachzell,1001,20,1021
42,Alsace,68,6,15,179,Lauw,982,26,1008
42,Alsace,68,6,25,180,Leimbach,831,22,853
42,Alsace,68,1,07,181,Levoncourt,253,3,256
42,Alsace,68,4,11,182,Leymen,1109,35,1144
42,Alsace,68,4,11,183,Liebenswiller,196,2,198
42,Alsace,68,1,07,184,Liebsdorf,338,5,343
42,Alsace,68,5,23,185,Lièpvre,1746,21,1767
42,Alsace,68,1,07,186,Ligsdorf,344,6,350
42,Alsace,68,1,07,187,Linsdorf,311,8,319
42,Alsace,68,3,08,188,Linthal,623,18,641
42,Alsace,68,2,19,189,Logelheim,830,22,852
42,Alsace,68,1,07,190,Lucelle,41,0,41
42,Alsace,68,1,01,191,Luemschwiller,703,5,708
42,Alsace,68,2,18,193,Luttenbach-près-Munster,793,19,812
42,Alsace,68,1,07,194,Lutter,298,6,304
42,Alsace,68,4,27,195,Lutterbach,6008,141,6149
42,Alsace,68,1,05,196,Magny,301,2,303
42,Alsace,68,4,13,197,Magstatt-le-Bas,460,5,465
42,Alsace,68,4,13,198,Magstatt-le-Haut,276,2,278
42,Alsace,68,6,22,199,Malmerspach,520,6,526
42,Alsace,68,1,05,200,Manspach,541,9,550
42,Alsace,68,6,15,201,Masevaux,3255,42,3297
42,Alsace,68,1,10,202,Mertzen,209,6,215
42,Alsace,68,3,24,203,Merxheim,1292,23,1315
42,Alsace,68,2,18,204,Metzeral,1099,20,1119
42,Alsace,68,3,06,205,Meyenheim,1227,9,1236
42,Alsace,68,6,25,206,Michelbach,337,4,341
42,Alsace,68,4,11,207,Michelbach-le-Bas,707,23,730
42,Alsace,68,4,11,208,Michelbach-le-Haut,484,10,494
42,Alsace,68,5,12,209,Mittelwihr,780,25,805
42,Alsace,68,2,18,210,Mittlach,314,5,319
42,Alsace,68,6,22,211,Mitzach,426,7,433
42,Alsace,68,1,07,212,Moernach,545,9,554
42,Alsace,68,6,22,213,Mollau,425,5,430
42,Alsace,68,1,05,214,Montreux-Jeune,328,4,332
42,Alsace,68,1,05,215,Montreux-Vieux,859,12,871
42,Alsace,68,6,22,217,Moosch,1789,27,1816
42,Alsace,68,1,07,216,Mooslargue,422,2,424
42,Alsace,68,4,17,218,Morschwiller-le-Bas,3229,73,3302
42,Alsace,68,6,15,219,Mortzwiller,317,9,326
42,Alsace,68,1,07,221,Muespach,885,11,896
42,Alsace,68,1,07,222,Muespach-le-Haut,993,20,1013
42,Alsace,68,2,18,223,Muhlbach-sur-Munster,770,15,785
42,Alsace,68,4,99,224,Mulhouse,111860,1617,113477
42,Alsace,68,3,06,225,Munchhouse,1599,19,1618
42,Alsace,68,2,18,226,Munster,4939,94,5033
42,Alsace,68,2,02,227,Muntzenheim,1085,29,1114
42,Alsace,68,3,06,228,Munwiller,480,14,494
42,Alsace,68,3,08,229,Murbach,137,1,138
42,Alsace,68,2,19,230,Nambsheim,574,11,585
42,Alsace,68,2,19,231,Neuf-Brisach,2083,27,2110
42,Alsace,68,4,11,232,Neuwiller,524,15,539
42,Alsace,68,6,15,233,Niederbruck,448,10,458
42,Alsace,68,3,06,234,Niederentzen,368,8,376
42,Alsace,68,3,06,235,Niederhergheim,973,12,985
42,Alsace,68,5,12,237,Niedermorschwihr,563,24,587
42,Alsace,68,4,31,238,Niffer,926,9,935
42,Alsace,68,6,15,239,Oberbruck,441,9,450
42,Alsace,68,1,10,240,Oberdorf,563,11,574
42,Alsace,68,3,06,241,Oberentzen,535,8,543
42,Alsace,68,3,06,242,Oberhergheim,1182,15,1197
42,Alsace,68,1,07,243,Oberlarg,151,3,154
42,Alsace,68,2,26,244,Obermorschwihr,381,24,405
42,Alsace,68,1,01,245,Obermorschwiller,440,15,455
42,Alsace,68,2,19,246,Obersaasheim,1030,12,1042
42,Alsace,68,6,22,247,Oderen,1321,21,1342
42,Alsace,68,1,07,248,Oltingue,732,13,745
42,Alsace,68,5,14,249,Orbey,3604,99,3703
42,Alsace,68,3,08,250,Orschwihr,993,31,1024
42,Alsace,68,3,21,251,Osenbach,883,28,911
42,Alsace,68,5,20,252,Ostheim,1596,22,1618
42,Alsace,68,4,31,253,Ottmarsheim,1890,24,1914
42,Alsace,68,4,31,254,Petit-Landau,709,12,721
42,Alsace,68,3,21,255,Pfaffenheim,1333,29,1362
42,Alsace,68,4,27,256,Pfastatt,8471,143,8614
42,Alsace,68,1,10,257,Pfetterhouse,1043,23,1066
42,Alsace,68,3,06,258,Pulversheim,2829,22,2851
42,Alsace,68,1,07,259,Raedersdorf,502,9,511
42,Alsace,68,3,24,260,Raedersheim,1135,20,1155
42,Alsace,68,6,25,261,Rammersmatt,222,5,227
42,Alsace,68,6,22,262,Ranspach,848,12,860
42,Alsace,68,4,11,263,Ranspach-le-Bas,657,11,668
42,Alsace,68,4,11,264,Ranspach-le-Haut,566,9,575
42,Alsace,68,4,13,265,Rantzwiller,795,17,812
42,Alsace,68,3,06,266,Réguisheim,1730,23,1753
42,Alsace,68,4,27,267,Reiningue,1720,19,1739
42,Alsace,68,1,05,268,Retzwiller,645,13,658
42,Alsace,68,5,20,269,Ribeauvillé,4857,187,5044
42,Alsace,68,4,27,270,Richwiller,3382,53,3435
42,Alsace,68,4,09,271,Riedisheim,12236,314,12550
42,Alsace,68,2,02,272,Riedwihr,374,8,382
42,Alsace,68,1,10,273,Riespach,708,40,748
42,Alsace,68,3,08,274,Rimbach-près-Guebwiller,243,1,244
42,Alsace,68,6,15,275,Rimbach-près-Masevaux,499,9,508
42,Alsace,68,3,08,276,Rimbachzell,225,2,227
42,Alsace,68,5,12,277,Riquewihr,1263,39,1302
42,Alsace,68,4,09,278,Rixheim,13068,266,13334
42,Alsace,68,6,25,279,Roderen,876,16,892
42,Alsace,68,5,20,280,Rodern,328,7,335
42,Alsace,68,3,06,281,Roggenhouse,486,5,491
42,Alsace,68,1,05,282,Romagny,197,1,198
42,Alsace,68,5,23,283,Rombach-le-Franc,897,8,905
42,Alsace,68,1,07,284,Roppentzwiller,756,4,760
42,Alsace,68,5,20,285,Rorschwihr,392,12,404
42,Alsace,68,4,11,286,Rosenau,2011,31,2042
42,Alsace,68,3,21,287,Rouffach,4636,272,4908
42,Alsace,68,1,10,288,Ruederbach,339,13,352
42,Alsace,68,4,31,289,Ruelisheim,2426,59,2485
42,Alsace,68,3,06,291,Rumersheim-le-Haut,1090,13,1103
42,Alsace,68,3,06,290,Rustenhart,801,8,809
42,Alsace,68,6,22,292,Saint-Amarin,2456,38,2494
42,Alsace,68,1,01,081,Saint-Bernard,464,4,468
42,Alsace,68,1,05,293,Saint-Cosme,85,3,88
42,Alsace,68,5,20,296,Saint-Hippolyte,1051,16,1067
42,Alsace,68,4,11,297,Saint-Louis,19930,375,20305
42,Alsace,68,1,10,299,Saint-Ulrich,309,8,317
42,Alsace,68,5,23,294,Sainte-Croix-aux-Mines,2066,30,2096
42,Alsace,68,2,28,295,Sainte-Croix-en-Plaine,2606,41,2647
42,Alsace,68,5,23,298,Sainte-Marie-aux-Mines,5536,143,5679
42,Alsace,68,4,31,300,Sausheim,5262,84,5346
42,Alsace,68,4,13,301,Schlierbach,1158,36,1194
42,Alsace,68,6,03,302,Schweighouse-Thann,720,18,738
42,Alsace,68,1,01,303,Schwoben,263,10,273
42,Alsace,68,6,15,304,Sentheim,1565,17,1582
42,Alsace,68,1,10,305,Seppois-le-Bas,1121,14,1135
42,Alsace,68,1,10,306,Seppois-le-Haut,522,9,531
42,Alsace,68,6,15,307,Sewen,533,4,537
42,Alsace,68,6,15,308,Sickert,325,4,329
42,Alsace,68,4,13,309,Sierentz,2686,32,2718
42,Alsace,68,5,12,310,Sigolsheim,1199,36,1235
42,Alsace,68,2,18,311,Sondernach,652,13,665
42,Alsace,68,1,07,312,Sondersdorf,347,15,362
42,Alsace,68,6,15,313,Soppe-le-Bas,714,8,722
42,Alsace,68,6,15,314,Soppe-le-Haut,567,18,585
42,Alsace,68,3,24,315,Soultz-Haut-Rhin,7273,119,7392
42,Alsace,68,2,18,316,Soultzbach-les-Bains,656,8,664
42,Alsace,68,2,18,317,Soultzeren,1179,22,1201
42,Alsace,68,3,21,318,Soultzmatt,2261,46,2307
42,Alsace,68,1,01,319,Spechbach-le-Bas,748,22,770
42,Alsace,68,1,01,320,Spechbach-le-Haut,636,16,652
42,Alsace,68,6,03,321,Staffelfelden,3606,48,3654
42,Alsace,68,6,03,322,Steinbach,1288,36,1324
42,Alsace,68,4,13,323,Steinbrunn-le-Bas,643,19,662
42,Alsace,68,4,13,324,Steinbrunn-le-Haut,604,9,613
42,Alsace,68,1,10,325,Steinsoultz,757,12,769
42,Alsace,68,1,05,326,Sternenberg,163,3,166
42,Alsace,68,4,13,327,Stetten,297,6,303
42,Alsace,68,6,22,328,Storckensohn,258,2,260
42,Alsace,68,2,18,329,Stosswihr,1407,35,1442
42,Alsace,68,1,10,330,Strueth,324,8,332
42,Alsace,68,2,02,331,Sundhoffen,1942,56,1998
42,Alsace,68,1,01,332,Tagolsheim,675,13,688
42,Alsace,68,1,01,333,Tagsdorf,326,8,334
42,Alsace,68,6,25,334,Thann,7964,165,8129
42,Alsace,68,5,20,335,Thannenkirch,488,11,499
42,Alsace,68,1,05,336,Traubach-le-Bas,490,8,498
42,Alsace,68,1,05,337,Traubach-le-Haut,534,14,548
42,Alsace,68,2,26,338,Turckheim,3719,84,3803
42,Alsace,68,1,10,340,Ueberstrass,349,6,355
42,Alsace,68,4,13,341,Uffheim,873,18,891
42,Alsace,68,6,03,342,Uffholtz,1570,29,1599
42,Alsace,68,3,24,343,Ungersheim,2000,23,2023
42,Alsace,68,6,22,344,Urbès,474,12,486
42,Alsace,68,2,02,345,Urschenheim,674,16,690
42,Alsace,68,1,05,192,Valdieu-Lutran,373,8,381
42,Alsace,68,1,07,347,Vieux-Ferrette,576,19,595
42,Alsace,68,6,25,348,Vieux-Thann,2858,61,2919
42,Alsace,68,4,11,349,Village-Neuf,3591,64,3655
42,Alsace,68,2,26,350,Voegtlinshoffen,546,19,565
42,Alsace,68,2,19,351,Vogelgrun,609,9,618
42,Alsace,68,2,19,352,Volgelsheim,2467,39,2506
42,Alsace,68,4,13,353,Wahlbach,424,8,432
42,Alsace,68,2,26,354,Walbach,898,30,928
42,Alsace,68,1,10,355,Waldighofen,1441,16,1457
42,Alsace,68,1,01,356,Walheim,894,20,914
42,Alsace,68,4,13,357,Waltenheim,559,14,573
42,Alsace,68,2,18,358,Wasserbourg,480,14,494
42,Alsace,68,6,03,359,Wattwiller,1727,39,1766
42,Alsace,68,2,19,360,Weckolsheim,610,7,617
42,Alsace,68,6,15,361,Wegscheid,333,3,336
42,Alsace,68,4,11,362,Wentzwiller,714,9,723
42,Alsace,68,1,07,363,Werentzhouse,583,16,599
42,Alsace,68,3,21,364,Westhalten,922,13,935
42,Alsace,68,2,26,365,Wettolsheim,1697,60,1757
42,Alsace,68,2,02,366,Wickerschwihr,764,17,781
42,Alsace,68,2,02,367,Widensolen,1244,11,1255
42,Alsace,68,2,18,368,Wihr-au-Val,1210,36,1246
42,Alsace,68,6,22,370,Wildenstein,195,1,196
42,Alsace,68,1,01,371,Willer,335,5,340
42,Alsace,68,6,25,372,Willer-sur-Thur,1908,30,1938
42,Alsace,68,1,07,373,Winkel,359,6,365
42,Alsace,68,2,26,374,Wintzenheim,7636,364,8000
42,Alsace,68,6,03,375,Wittelsheim,10406,166,10572
42,Alsace,68,4,27,376,Wittenheim,14317,196,14513
42,Alsace,68,1,01,377,Wittersdorf,831,17,848
42,Alsace,68,1,05,378,Wolfersdorf,393,0,393
42,Alsace,68,2,19,379,Wolfgantzen,1045,15,1060
42,Alsace,68,1,07,380,Wolschwiller,475,15,490
42,Alsace,68,3,24,381,Wuenheim,817,35,852
42,Alsace,68,4,13,382,Zaessingue,311,5,316
42,Alsace,68,5,12,383,Zellenberg,390,15,405
42,Alsace,68,4,17,384,Zillisheim,2605,78,2683
42,Alsace,68,2,26,385,Zimmerbach,865,24,889
42,Alsace,68,4,09,386,Zimmersheim,1051,29,1080
82,Rhône-Alpes,69,2,29,001,Affoux,323,10,333
82,Rhône-Alpes,69,2,23,002,Aigueperse,247,4,251
82,Rhône-Alpes,69,1,25,003,Albigny-sur-Saône,2748,38,2786
82,Rhône-Alpes,69,2,02,004,Alix,672,8,680
82,Rhône-Alpes,69,2,02,005,Ambérieux,557,9,566
82,Rhône-Alpes,69,2,01,006,Amplepuis,5085,133,5218
82,Rhône-Alpes,69,1,07,007,Ampuis,2613,63,2676
82,Rhône-Alpes,69,2,29,008,Ancy,555,7,562
82,Rhône-Alpes,69,2,02,009,Anse,5281,155,5436
82,Rhône-Alpes,69,1,03,010,L' Arbresle,6037,157,6194
82,Rhône-Alpes,69,2,04,012,Les Ardillats,546,12,558
82,Rhône-Alpes,69,2,53,013,Arnas,3240,69,3309
82,Rhône-Alpes,69,1,28,014,Aveize,1088,32,1120
82,Rhône-Alpes,69,2,04,015,Avenas,133,4,137
82,Rhône-Alpes,69,2,23,016,Azolette,118,2,120
82,Rhône-Alpes,69,2,06,017,Bagnols,717,18,735
82,Rhône-Alpes,69,2,04,018,Beaujeu,2006,27,2033
82,Rhône-Alpes,69,2,05,019,Belleville,7465,175,7640
82,Rhône-Alpes,69,2,02,020,Belmont-d'Azergues,647,12,659
82,Rhône-Alpes,69,1,03,021,Bessenay,2205,65,2270
82,Rhône-Alpes,69,1,03,022,Bibost,476,8,484
82,Rhône-Alpes,69,2,53,023,Blacé,1360,29,1389
82,Rhône-Alpes,69,2,06,024,Le Bois-d'Oingt,2096,56,2152
82,Rhône-Alpes,69,2,30,025,Bourg-de-Thizy,2615,74,2689
82,Rhône-Alpes,69,2,06,026,Le Breuil,444,5,449
82,Rhône-Alpes,69,1,26,027,Brignais,11371,177,11548
82,Rhône-Alpes,69,1,31,028,Brindas,5434,147,5581
82,Rhône-Alpes,69,1,35,029,Bron,39094,573,39667
82,Rhône-Alpes,69,1,27,030,Brullioles,744,14,758
82,Rhône-Alpes,69,1,27,031,Brussieu,1082,60,1142
82,Rhône-Alpes,69,1,03,032,Bully,2040,36,2076
82,Rhône-Alpes,69,1,25,033,Cailloux-sur-Fontaines,2391,49,2440
82,Rhône-Alpes,69,1,43,034,Caluire-et-Cuire,40869,567,41436
82,Rhône-Alpes,69,2,23,035,Cenves,396,11,407
82,Rhône-Alpes,69,2,05,036,Cercié,1070,19,1089
82,Rhône-Alpes,69,2,09,037,Chambost-Allières,775,21,796
82,Rhône-Alpes,69,1,27,038,Chambost-Longessaigne,829,22,851
82,Rhône-Alpes,69,2,06,039,Chamelet,685,16,701
82,Rhône-Alpes,69,1,52,040,Champagne-au-Mont-d'Or,4951,71,5022
82,Rhône-Alpes,69,2,30,041,La Chapelle-de-Mardore,207,4,211
82,Rhône-Alpes,69,1,28,042,La Chapelle-sur-Coise,513,17,530
82,Rhône-Alpes,69,1,38,270,Chaponnay,3580,56,3636
82,Rhône-Alpes,69,1,26,043,Chaponost,8026,231,8257
82,Rhône-Alpes,69,1,31,044,Charbonnières-les-Bains,4728,142,4870
82,Rhône-Alpes,69,2,05,045,Charentay,1086,69,1155
82,Rhône-Alpes,69,1,48,046,Charly,4310,129,4439
82,Rhône-Alpes,69,2,02,047,Charnay,1079,19,1098
82,Rhône-Alpes,69,1,08,048,Chassagny,1222,19,1241
82,Rhône-Alpes,69,1,10,049,Chasselay,2703,41,2744
82,Rhône-Alpes,69,1,44,271,Chassieu,9492,130,9622
82,Rhône-Alpes,69,2,06,050,Châtillon,2119,59,2178
82,Rhône-Alpes,69,1,24,051,Chaussan,957,42,999
82,Rhône-Alpes,69,2,02,052,Chazay-d'Azergues,3916,105,4021
82,Rhône-Alpes,69,2,04,053,Chénas,489,10,499
82,Rhône-Alpes,69,2,09,054,Chénelette,329,11,340
82,Rhône-Alpes,69,1,10,055,Les Chères,1266,13,1279
82,Rhône-Alpes,69,2,06,056,Chessy,1558,40,1598
82,Rhône-Alpes,69,1,03,057,Chevinay,537,20,557
82,Rhône-Alpes,69,2,04,058,Chiroubles,358,15,373
82,Rhône-Alpes,69,1,10,059,Civrieux-d'Azergues,1419,17,1436
82,Rhône-Alpes,69,2,09,060,Claveisolles,622,97,719
82,Rhône-Alpes,69,2,53,061,Cogny,1029,27,1056
82,Rhône-Alpes,69,1,28,062,Coise,714,24,738
82,Rhône-Alpes,69,1,10,063,Collonges-au-Mont-d'Or,3824,98,3922
82,Rhône-Alpes,69,1,37,299,Colombier-Saugnieu,2334,26,2360
82,Rhône-Alpes,69,1,38,272,Communay,3922,44,3966
82,Rhône-Alpes,69,1,07,064,Condrieu,3762,74,3836
82,Rhône-Alpes,69,1,49,273,Corbas,9418,97,9515
82,Rhône-Alpes,69,2,05,065,Corcelles-en-Beaujolais,710,10,720
82,Rhône-Alpes,69,2,30,066,Cours-la-Ville,3899,96,3995
82,Rhône-Alpes,69,1,31,067,Courzieu,1162,20,1182
82,Rhône-Alpes,69,1,25,068,Couzon-au-Mont-d'Or,2559,35,2594
82,Rhône-Alpes,69,1,31,069,Craponne,8815,174,8989
82,Rhône-Alpes,69,2,01,070,Cublize,1235,22,1257
82,Rhône-Alpes,69,1,25,071,Curis-au-Mont-d'Or,1025,35,1060
82,Rhône-Alpes,69,1,52,072,Dardilly,8314,556,8870
82,Rhône-Alpes,69,2,29,073,Dareizé,447,14,461
82,Rhône-Alpes,69,1,44,275,Décines-Charpieu,24780,333,25113
82,Rhône-Alpes,69,2,53,074,Denicé,1275,38,1313
82,Rhône-Alpes,69,2,29,075,Dième,167,2,169
82,Rhône-Alpes,69,1,03,076,Dommartin,2702,82,2784
82,Rhône-Alpes,69,2,05,077,Dracé,961,14,975
82,Rhône-Alpes,69,1,28,078,Duerne,762,17,779
82,Rhône-Alpes,69,1,08,080,Échalas,1456,14,1470
82,Rhône-Alpes,69,1,52,081,Écully,17953,322,18275
82,Rhône-Alpes,69,2,04,082,Émeringes,227,6,233
82,Rhône-Alpes,69,1,03,083,Éveux,1011,11,1022
82,Rhône-Alpes,69,1,49,276,Feyzin,9254,69,9323
82,Rhône-Alpes,69,2,04,084,Fleurie,1239,32,1271
82,Rhône-Alpes,69,1,25,085,Fleurieu-sur-Saône,1304,38,1342
82,Rhône-Alpes,69,1,03,086,Fleurieux-sur-l'Arbresle,2169,41,2210
82,Rhône-Alpes,69,1,25,087,Fontaines-Saint-Martin,2794,60,2854
82,Rhône-Alpes,69,1,25,088,Fontaines-sur-Saône,6299,120,6419
82,Rhône-Alpes,69,1,51,089,Francheville,12174,271,12445
82,Rhône-Alpes,69,2,06,090,Frontenas,776,27,803
82,Rhône-Alpes,69,1,44,277,Genas,11667,146,11813
82,Rhône-Alpes,69,1,25,278,Genay,4872,102,4974
82,Rhône-Alpes,69,1,08,091,Givors,19477,119,19596
82,Rhône-Alpes,69,2,53,092,Gleizé,7725,286,8011
82,Rhône-Alpes,69,2,09,093,Grandris,1232,21,1253
82,Rhône-Alpes,69,1,31,094,Grézieu-la-Varenne,4830,110,4940
82,Rhône-Alpes,69,1,28,095,Grézieu-le-Marché,749,28,777
82,Rhône-Alpes,69,1,08,096,Grigny,8602,118,8720
82,Rhône-Alpes,69,1,07,097,Les Haies,725,19,744
82,Rhône-Alpes,69,1,27,098,Les Halles,455,7,462
82,Rhône-Alpes,69,1,27,099,Haute-Rivoire,1298,28,1326
82,Rhône-Alpes,69,1,48,100,Irigny,8250,189,8439
82,Rhône-Alpes,69,2,06,101,Jarnioux,553,20,573
82,Rhône-Alpes,69,1,37,279,Jonage,5789,69,5858
82,Rhône-Alpes,69,1,37,280,Jons,1286,21,1307
82,Rhône-Alpes,69,2,29,102,Joux,665,9,674
82,Rhône-Alpes,69,2,04,103,Juliénas,809,42,851
82,Rhône-Alpes,69,2,04,104,Jullié,417,9,426
82,Rhône-Alpes,69,2,53,105,Lacenas,875,35,910
82,Rhône-Alpes,69,2,02,106,Lachassagne,884,20,904
82,Rhône-Alpes,69,2,09,107,Lamure-sur-Azergues,1061,105,1166
82,Rhône-Alpes,69,2,05,108,Lancié,742,16,758
82,Rhône-Alpes,69,2,04,109,Lantignié,745,19,764
82,Rhône-Alpes,69,1,28,110,Larajasse,1698,50,1748
82,Rhône-Alpes,69,2,06,111,Légny,545,12,557
82,Rhône-Alpes,69,1,03,112,Lentilly,5235,94,5329
82,Rhône-Alpes,69,2,06,113,Létra,871,28,899
82,Rhône-Alpes,69,2,02,114,Liergues,1758,42,1800
82,Rhône-Alpes,69,2,53,115,Limas,4372,111,4483
82,Rhône-Alpes,69,1,10,116,Limonest,3010,156,3166
82,Rhône-Alpes,69,1,10,117,Lissieu,3161,43,3204
82,Rhône-Alpes,69,1,07,118,Loire-sur-Rhône,2348,28,2376
82,Rhône-Alpes,69,1,07,119,Longes,844,11,855
82,Rhône-Alpes,69,1,27,120,Longessaigne,597,19,616
82,Rhône-Alpes,69,2,02,121,Lozanne,2296,36,2332
82,Rhône-Alpes,69,2,02,122,Lucenay,1638,25,1663
82,Rhône-Alpes,69,1,13,381,Lyon 1er Arrondissement,28110,904,29014
82,Rhône-Alpes,69,1,11,382,Lyon 2e  Arrondissement,29726,615,30341
82,Rhône-Alpes,69,1,99,383,Lyon 3e  Arrondissement,92366,1230,93596
82,Rhône-Alpes,69,1,14,384,Lyon 4e  Arrondissement,35007,551,35558
82,Rhône-Alpes,69,1,16,385,Lyon 5e  Arrondissement,46754,1223,47977
82,Rhône-Alpes,69,1,99,386,Lyon 6e  Arrondissement,48988,939,49927
82,Rhône-Alpes,69,1,99,387,Lyon 7e  Arrondissement,69766,952,70718
82,Rhône-Alpes,69,1,99,388,Lyon 8e  Arrondissement,76343,1034,77377
82,Rhône-Alpes,69,1,15,389,Lyon 9e  Arrondissement,47886,787,48673
82,Rhône-Alpes,69,2,04,124,Marchampt,448,8,456
82,Rhône-Alpes,69,1,10,125,Marcilly-d'Azergues,882,19,901
82,Rhône-Alpes,69,2,02,126,Marcy,651,18,669
82,Rhône-Alpes,69,1,31,127,Marcy-l'Étoile,3302,73,3375
82,Rhône-Alpes,69,2,30,128,Mardore,508,17,525
82,Rhône-Alpes,69,1,38,281,Marennes,1628,19,1647
82,Rhône-Alpes,69,2,30,129,Marnand,616,12,628
82,Rhône-Alpes,69,2,01,130,Meaux-la-Montagne,205,1,206
82,Rhône-Alpes,69,1,31,131,Messimy,3219,51,3270
82,Rhône-Alpes,69,1,28,132,Meys,679,27,706
82,Rhône-Alpes,69,1,37,282,Meyzieu,29463,373,29836
82,Rhône-Alpes,69,1,08,133,Millery,3500,80,3580
82,Rhône-Alpes,69,1,38,283,Mions,11431,120,11551
82,Rhône-Alpes,69,2,06,134,Moiré,203,8,211
82,Rhône-Alpes,69,2,23,135,Monsols,980,19,999
82,Rhône-Alpes,69,1,08,136,Montagny,2496,50,2546
82,Rhône-Alpes,69,1,25,284,Montanay,2705,92,2797
82,Rhône-Alpes,69,2,53,137,Montmelas-Saint-Sorlin,352,10,362
82,Rhône-Alpes,69,1,27,138,Montromant,409,9,418
82,Rhône-Alpes,69,1,27,139,Montrottier,1378,74,1452
82,Rhône-Alpes,69,2,02,140,Morancé,2029,30,2059
82,Rhône-Alpes,69,1,24,141,Mornant,5363,185,5548
82,Rhône-Alpes,69,1,50,142,La Mulatière,6511,98,6609
82,Rhône-Alpes,69,1,25,143,Neuville-sur-Saône,7382,87,7469
82,Rhône-Alpes,69,1,03,144,Nuelles,621,11,632
82,Rhône-Alpes,69,2,05,145,Odenas,784,27,811
82,Rhône-Alpes,69,2,06,146,Oingt,595,19,614
82,Rhône-Alpes,69,2,29,147,Les Olmes,748,27,775
82,Rhône-Alpes,69,1,24,148,Orliénas,2178,29,2207
82,Rhône-Alpes,69,1,40,149,Oullins,25652,389,26041
82,Rhône-Alpes,69,2,23,150,Ouroux,337,29,366
82,Rhône-Alpes,69,2,53,151,Le Perréon,1394,37,1431
82,Rhône-Alpes,69,1,48,152,Pierre-Bénite,9935,78,10013
82,Rhône-Alpes,69,1,25,153,Poleymieux-au-Mont-d'Or,1212,34,1246
82,Rhône-Alpes,69,1,31,154,Pollionnay,1892,44,1936
82,Rhône-Alpes,69,1,28,155,Pomeys,971,84,1055
82,Rhône-Alpes,69,2,02,156,Pommiers,2209,76,2285
82,Rhône-Alpes,69,2,30,158,Pont-Trambouze,503,8,511
82,Rhône-Alpes,69,2,29,157,Pontcharra-sur-Turdine,2447,52,2499
82,Rhône-Alpes,69,2,02,159,Pouilly-le-Monial,864,29,893
82,Rhône-Alpes,69,2,09,160,Poule-les-Écharmeaux,1009,24,1033
82,Rhône-Alpes,69,2,23,161,Propières,465,65,530
82,Rhône-Alpes,69,1,37,285,Pusignan,3506,52,3558
82,Rhône-Alpes,69,2,04,162,Quincié-en-Beaujolais,1176,32,1208
82,Rhône-Alpes,69,1,25,163,Quincieux,2931,55,2986
82,Rhône-Alpes,69,2,09,164,Ranchal,321,6,327
82,Rhône-Alpes,69,2,04,165,Régnié-Durette,976,40,1016
82,Rhône-Alpes,69,1,39,286,Rillieux-la-Pape,29578,441,30019
82,Rhône-Alpes,69,1,24,166,Riverie,279,4,283
82,Rhône-Alpes,69,2,53,167,Rivolet,543,18,561
82,Rhône-Alpes,69,1,25,168,Rochetaillée-sur-Saône,1376,19,1395
82,Rhône-Alpes,69,2,01,169,Ronno,599,21,620
82,Rhône-Alpes,69,1,24,170,Rontalon,1117,26,1143
82,Rhône-Alpes,69,1,03,171,Sain-Bel,2228,35,2263
82,Rhône-Alpes,69,1,08,179,Saint-Andéol-le-Château,1555,23,1578
82,Rhône-Alpes,69,1,24,180,Saint-André-la-Côte,280,4,284
82,Rhône-Alpes,69,2,29,181,Saint-Appolinaire,156,3,159
82,Rhône-Alpes,69,1,37,287,Saint-Bonnet-de-Mure,6217,89,6306
82,Rhône-Alpes,69,2,23,182,Saint-Bonnet-des-Bruyères,371,11,382
82,Rhône-Alpes,69,2,09,183,Saint-Bonnet-le-Troncy,310,6,316
82,Rhône-Alpes,69,2,23,185,Saint-Christophe,232,9,241
82,Rhône-Alpes,69,2,23,186,Saint-Clément-de-Vers,220,5,225
82,Rhône-Alpes,69,1,27,187,Saint-Clément-les-Places,657,12,669
82,Rhône-Alpes,69,2,29,188,Saint-Clément-sur-Valsonne,704,17,721
82,Rhône-Alpes,69,1,10,191,Saint-Cyr-au-Mont-d'Or,5443,129,5572
82,Rhône-Alpes,69,2,53,192,Saint-Cyr-le-Chatoux,124,4,128
82,Rhône-Alpes,69,1,07,193,Saint-Cyr-sur-le-Rhône,1171,45,1216
82,Rhône-Alpes,69,1,10,194,Saint-Didier-au-Mont-d'Or,6436,201,6637
82,Rhône-Alpes,69,1,24,195,Saint-Didier-sous-Riverie,1178,30,1208
82,Rhône-Alpes,69,2,04,196,Saint-Didier-sur-Beaujeu,583,5,588
82,Rhône-Alpes,69,2,05,197,Saint-Étienne-des-Oullières,1799,32,1831
82,Rhône-Alpes,69,2,05,198,Saint-Étienne-la-Varenne,677,19,696
82,Rhône-Alpes,69,1,49,199,Saint-Fons,17063,101,17164
82,Rhône-Alpes,69,2,29,200,Saint-Forgeux,1356,48,1404
82,Rhône-Alpes,69,1,27,203,Saint-Genis-l'Argentière,993,27,1020
82,Rhône-Alpes,69,1,26,204,Saint-Genis-Laval,20147,653,20800
82,Rhône-Alpes,69,1,31,205,Saint-Genis-les-Ollières,4655,97,4752
82,Rhône-Alpes,69,2,05,206,Saint-Georges-de-Reneins,4165,81,4246
82,Rhône-Alpes,69,1,25,207,Saint-Germain-au-Mont-d'Or,2669,45,2714
82,Rhône-Alpes,69,1,03,208,Saint-Germain-sur-l'Arbresle,1329,31,1360
82,Rhône-Alpes,69,2,23,209,Saint-Igny-de-Vers,604,6,610
82,Rhône-Alpes,69,2,23,210,Saint-Jacques-des-Arrêts,112,2,114
82,Rhône-Alpes,69,2,05,211,Saint-Jean-d'Ardières,2975,92,3067
82,Rhône-Alpes,69,1,08,213,Saint-Jean-de-Touslas,769,17,786
82,Rhône-Alpes,69,2,02,212,Saint-Jean-des-Vignes,395,9,404
82,Rhône-Alpes,69,2,30,214,Saint-Jean-la-Bussière,1006,37,1043
82,Rhône-Alpes,69,2,53,215,Saint-Julien,825,20,845
82,Rhône-Alpes,69,1,03,216,Saint-Julien-sur-Bibost,529,8,537
82,Rhône-Alpes,69,2,01,217,Saint-Just-d'Avray,729,56,785
82,Rhône-Alpes,69,2,05,218,Saint-Lager,947,17,964
82,Rhône-Alpes,69,1,24,219,Saint-Laurent-d'Agny,2020,67,2087
82,Rhône-Alpes,69,2,06,222,Saint-Laurent-d'Oingt,812,33,845
82,Rhône-Alpes,69,1,27,220,Saint-Laurent-de-Chamousset,1841,99,1940
82,Rhône-Alpes,69,1,37,288,Saint-Laurent-de-Mure,4985,64,5049
82,Rhône-Alpes,69,1,31,221,Saint-Laurent-de-Vaux,251,8,259
82,Rhône-Alpes,69,2,29,223,Saint-Loup,975,23,998
82,Rhône-Alpes,69,2,23,224,Saint-Mamert,63,3,66
82,Rhône-Alpes,69,2,29,225,Saint-Marcel-l'Éclairé,537,11,548
82,Rhône-Alpes,69,1,28,227,Saint-Martin-en-Haut,3880,133,4013
82,Rhône-Alpes,69,1,24,228,Saint-Maurice-sur-Dargoire,2145,62,2207
82,Rhône-Alpes,69,2,09,229,Saint-Nizier-d'Azergues,682,28,710
82,Rhône-Alpes,69,1,38,289,Saint-Pierre-de-Chandieu,4478,72,4550
82,Rhône-Alpes,69,1,03,231,Saint-Pierre-la-Palud,2290,62,2352
82,Rhône-Alpes,69,1,45,290,Saint-Priest,41460,360,41820
82,Rhône-Alpes,69,1,25,233,Saint-Romain-au-Mont-d'Or,1054,71,1125
82,Rhône-Alpes,69,2,29,234,Saint-Romain-de-Popey,1402,81,1483
82,Rhône-Alpes,69,1,07,235,Saint-Romain-en-Gal,1663,90,1753
82,Rhône-Alpes,69,1,08,236,Saint-Romain-en-Gier,491,3,494
82,Rhône-Alpes,69,1,24,237,Saint-Sorlin,680,31,711
82,Rhône-Alpes,69,1,38,291,Saint-Symphorien-d'Ozon,5204,53,5257
82,Rhône-Alpes,69,1,28,238,Saint-Symphorien-sur-Coise,3448,73,3521
82,Rhône-Alpes,69,2,06,239,Saint-Vérand,1100,23,1123
82,Rhône-Alpes,69,2,01,240,Saint-Vincent-de-Reins,673,10,683
82,Rhône-Alpes,69,1,24,184,Sainte-Catherine,919,27,946
82,Rhône-Alpes,69,1,07,189,Sainte-Colombe,1935,40,1975
82,Rhône-Alpes,69,1,31,190,Sainte-Consorce,1854,67,1921
82,Rhône-Alpes,69,1,27,201,Sainte-Foy-l'Argentière,1235,31,1266
82,Rhône-Alpes,69,1,50,202,Sainte-Foy-lès-Lyon,22179,446,22625
82,Rhône-Alpes,69,2,06,230,Sainte-Paule,291,11,302
82,Rhône-Alpes,69,2,53,172,Salles-Arbuissonnas-en-Beaujolais,761,24,785
82,Rhône-Alpes,69,1,03,173,Sarcey,868,22,890
82,Rhône-Alpes,69,1,39,292,Sathonay-Camp,4226,50,4276
82,Rhône-Alpes,69,1,39,293,Sathonay-Village,1891,38,1929
82,Rhône-Alpes,69,2,29,174,Les Sauvages,624,14,638
82,Rhône-Alpes,69,1,03,175,Savigny,1919,50,1969
82,Rhône-Alpes,69,1,38,294,Sérézin-du-Rhône,2471,63,2534
82,Rhône-Alpes,69,1,38,295,Simandres,1586,13,1599
82,Rhône-Alpes,69,1,49,296,Solaize,2732,29,2761
82,Rhône-Alpes,69,1,24,176,Soucieu-en-Jarrest,3641,72,3713
82,Rhône-Alpes,69,1,03,177,Sourcieux-les-Mines,1903,53,1956
82,Rhône-Alpes,69,1,27,178,Souzy,651,18,669
82,Rhône-Alpes,69,1,24,241,Taluyers,2015,36,2051
82,Rhône-Alpes,69,2,05,242,Taponas,856,16,872
82,Rhône-Alpes,69,2,29,243,Tarare,10289,198,10487
82,Rhône-Alpes,69,1,51,244,Tassin-la-Demi-Lune,18579,364,18943
82,Rhône-Alpes,69,2,06,245,Ternand,724,12,736
82,Rhône-Alpes,69,1,38,297,Ternay,5125,67,5192
82,Rhône-Alpes,69,2,06,246,Theizé,1049,75,1124
82,Rhône-Alpes,69,2,09,247,Thel,304,3,307
82,Rhône-Alpes,69,2,30,248,Thizy,2402,97,2499
82,Rhône-Alpes,69,1,31,249,Thurins,2800,49,2849
82,Rhône-Alpes,69,1,03,250,La Tour-de-Salvagny,3486,87,3573
82,Rhône-Alpes,69,1,38,298,Toussieu,2371,29,2400
82,Rhône-Alpes,69,2,23,251,Trades,110,3,113
82,Rhône-Alpes,69,1,07,252,Trèves,688,18,706
82,Rhône-Alpes,69,1,07,253,Tupin-et-Semons,621,12,633
82,Rhône-Alpes,69,2,29,254,Valsonne,828,23,851
82,Rhône-Alpes,69,1,31,255,Vaugneray,4740,113,4853
82,Rhône-Alpes,69,1,46,256,Vaulx-en-Velin,40373,502,40875
82,Rhône-Alpes,69,2,53,257,Vaux-en-Beaujolais,1003,21,1024
82,Rhône-Alpes,69,2,04,258,Vauxrenard,320,12,332
82,Rhône-Alpes,69,1,97,259,Vénissieux,57629,549,58178
82,Rhône-Alpes,69,1,48,260,Vernaison,4379,49,4428
82,Rhône-Alpes,69,2,04,261,Vernay,120,4,124
82,Rhône-Alpes,69,2,06,265,Ville-sur-Jarnioux,765,14,779
82,Rhône-Alpes,69,1,27,263,Villechenève,760,16,776
82,Rhône-Alpes,69,2,32,264,Villefranche-sur-Saône,34159,475,34634
82,Rhône-Alpes,69,1,98,266,Villeurbanne,141106,1446,142552
82,Rhône-Alpes,69,2,04,267,Villié-Morgon,1839,90,1929
82,Rhône-Alpes,69,1,26,268,Vourles,3040,75,3115
82,Rhône-Alpes,69,1,31,269,Yzeron,1011,27,1038
43,Franche-Comté,70,1,23,001,Abelcourt,320,10,330
43,Franche-Comté,70,2,05,002,Aboncourt-Gesincourt,253,4,257
43,Franche-Comté,70,2,06,003,Achey,71,2,73
43,Franche-Comté,70,1,93,004,Adelans-et-le-Val-de-Bithaine,313,11,324
43,Franche-Comté,70,1,27,005,Aillevans,142,2,144
43,Franche-Comté,70,1,22,006,Aillevillers-et-Lyaumont,1665,79,1744
43,Franche-Comté,70,1,32,007,Ailloncourt,288,5,293
43,Franche-Comté,70,1,22,008,Ainvelle,166,5,171
43,Franche-Comté,70,2,12,009,Aisey-et-Richecourt,109,3,112
43,Franche-Comté,70,1,25,010,Alaincourt,96,1,97
43,Franche-Comté,70,1,07,011,Amage,342,10,352
43,Franche-Comté,70,2,01,012,Amance,684,21,705
43,Franche-Comté,70,1,25,013,Ambiévillers,83,4,87
43,Franche-Comté,70,1,31,014,Amblans-et-Velotte,364,1,365
43,Franche-Comté,70,2,20,015,Amoncourt,316,11,327
43,Franche-Comté,70,1,07,016,Amont-et-Effreney,181,1,182
43,Franche-Comté,70,2,01,017,Anchenoncourt-et-Chazel,240,3,243
43,Franche-Comté,70,2,09,018,Ancier,465,14,479
43,Franche-Comté,70,2,29,019,Andelarre,122,3,125
43,Franche-Comté,70,2,29,020,Andelarrot,227,9,236
43,Franche-Comté,70,1,13,021,Andornay,197,6,203
43,Franche-Comté,70,2,09,022,Angirey,130,5,135
43,Franche-Comté,70,1,25,023,Anjeux,165,9,174
43,Franche-Comté,70,2,09,024,Apremont,420,9,429
43,Franche-Comté,70,2,05,025,Arbecey,240,7,247
43,Franche-Comté,70,2,09,026,Arc-lès-Gray,2649,64,2713
43,Franche-Comté,70,2,04,027,Argillières,71,1,72
43,Franche-Comté,70,2,24,028,Aroz,153,2,155
43,Franche-Comté,70,1,13,029,Arpenans,221,4,225
43,Franche-Comté,70,2,19,030,Arsans,40,1,41
43,Franche-Comté,70,1,27,031,Athesans-Étroitefontaine,617,4,621
43,Franche-Comté,70,2,02,032,Attricourt,36,1,37
43,Franche-Comté,70,2,05,035,Augicourt,180,4,184
43,Franche-Comté,70,2,21,036,Aulx-lès-Cromary,148,1,149
43,Franche-Comté,70,2,06,037,Autet,297,29,326
43,Franche-Comté,70,2,17,038,Authoison,280,7,287
43,Franche-Comté,70,2,10,039,Autoreille,282,3,285
43,Franche-Comté,70,1,27,042,Autrey-le-Vay,58,5,63
43,Franche-Comté,70,2,18,040,Autrey-lès-Cerre,241,1,242
43,Franche-Comté,70,2,02,041,Autrey-lès-Gray,455,5,460
43,Franche-Comté,70,2,02,043,Auvet-et-la-Chapelotte,261,3,264
43,Franche-Comté,70,2,20,044,Auxon,421,17,438
43,Franche-Comté,70,2,15,045,Avrigney-Virey,386,9,395
43,Franche-Comté,70,1,13,046,Les Aynans,296,4,300
43,Franche-Comté,70,2,24,047,Baignes,93,2,95
43,Franche-Comté,70,2,19,048,Bard-lès-Pesmes,124,6,130
43,Franche-Comté,70,2,12,049,Barges,110,4,114
43,Franche-Comté,70,2,17,050,La Barre,102,2,104
43,Franche-Comté,70,2,12,051,La Basse-Vaivre,44,0,44
43,Franche-Comté,70,1,25,052,Bassigney,121,0,121
43,Franche-Comté,70,2,08,053,Les Bâties,82,1,83
43,Franche-Comté,70,2,09,054,Battrans,230,6,236
43,Franche-Comté,70,1,32,055,Baudoncourt,544,11,555
43,Franche-Comté,70,2,01,056,Baulay,326,3,329
43,Franche-Comté,70,2,15,057,Bay,121,0,121
43,Franche-Comté,70,2,08,058,Beaujeu-Saint-Vallier-Pierrejux-et-Quitteur,1016,15,1031
43,Franche-Comté,70,2,17,059,Beaumotte-Aubertans,487,11,498
43,Franche-Comté,70,2,15,060,Beaumotte-lès-Pin,263,1,264
43,Franche-Comté,70,1,16,061,Belfahy,72,0,72
43,Franche-Comté,70,1,16,062,Belmont,110,5,115
43,Franche-Comté,70,1,16,063,Belonchamp,232,3,235
43,Franche-Comté,70,1,11,064,Belverne,118,3,121
43,Franche-Comté,70,2,17,065,Besnans,77,0,77
43,Franche-Comté,70,2,12,066,Betaucourt,151,3,154
43,Franche-Comté,70,1,23,067,Betoncourt-lès-Brotte,77,2,79
43,Franche-Comté,70,1,25,069,Betoncourt-Saint-Pancras,47,0,47
43,Franche-Comté,70,2,28,070,Betoncourt-sur-Mance,43,1,44
43,Franche-Comté,70,1,07,071,Beulotte-Saint-Laurent,67,0,67
43,Franche-Comté,70,1,27,072,Beveuge,93,2,95
43,Franche-Comté,70,2,12,074,Blondefontaine,240,5,245
43,Franche-Comté,70,2,15,075,Bonboillon,151,3,154
43,Franche-Comté,70,2,10,076,Bonnevent-Velloreille,343,2,345
43,Franche-Comté,70,2,18,077,Borey,223,3,226
43,Franche-Comté,70,2,05,078,Bougey,84,1,85
43,Franche-Comté,70,2,20,079,Bougnon,493,24,517
43,Franche-Comté,70,2,02,080,Bouhans-et-Feurg,266,6,272
43,Franche-Comté,70,1,31,081,Bouhans-lès-Lure,287,2,289
43,Franche-Comté,70,2,17,082,Bouhans-lès-Montbozon,104,2,106
43,Franche-Comté,70,1,25,083,Bouligney,437,10,447
43,Franche-Comté,70,2,21,084,Boulot,565,4,569
43,Franche-Comté,70,2,21,085,Boult,522,8,530
43,Franche-Comté,70,2,12,086,Bourbévelle,77,1,78
43,Franche-Comté,70,1,25,087,Bourguignon-lès-Conflans,123,0,123
43,Franche-Comté,70,2,24,088,Bourguignon-lès-la-Charité,147,1,148
43,Franche-Comté,70,2,28,089,Bourguignon-lès-Morey,49,4,53
43,Franche-Comté,70,2,24,090,Boursières,86,1,87
43,Franche-Comté,70,2,12,091,Bousseraucourt,55,3,58
43,Franche-Comté,70,2,19,092,Bresilley,166,1,167
43,Franche-Comté,70,1,32,093,Breuches,756,56,812
43,Franche-Comté,70,1,32,094,Breuchotte,310,9,319
43,Franche-Comté,70,2,20,095,Breurey-lès-Faverney,554,14,568
43,Franche-Comté,70,1,30,096,Brevilliers,649,17,666
43,Franche-Comté,70,1,22,097,Briaucourt,242,8,250
43,Franche-Comté,70,1,32,098,Brotte-lès-Luxeuil,218,1,219
43,Franche-Comté,70,2,06,099,Brotte-lès-Ray,59,0,59
43,Franche-Comté,70,2,19,101,Broye-Aubigney-Montseugny,450,12,462
43,Franche-Comté,70,2,02,100,Broye-les-Loups-et-Verfontaine,102,5,107
43,Franche-Comté,70,2,15,102,Brussey,255,3,258
43,Franche-Comté,70,1,07,103,La Bruyère,203,2,205
43,Franche-Comté,70,2,10,104,Bucey-lès-Gy,653,16,669
43,Franche-Comté,70,2,24,105,Bucey-lès-Traves,99,4,103
43,Franche-Comté,70,2,01,106,Buffignécourt,116,2,118
43,Franche-Comté,70,2,21,107,Bussières,278,4,282
43,Franche-Comté,70,2,21,109,Buthiers,311,10,321
43,Franche-Comté,70,2,18,111,Calmoutier,228,2,230
43,Franche-Comté,70,2,12,112,Cemboing,208,1,209
43,Franche-Comté,70,2,17,113,Cenans,139,1,140
43,Franche-Comté,70,2,12,114,Cendrecourt,230,8,238
43,Franche-Comté,70,2,18,115,Cerre-lès-Noroy,199,7,206
43,Franche-Comté,70,1,30,116,Chagey,675,6,681
43,Franche-Comté,70,1,30,117,Châlonvillars,1260,53,1313
43,Franche-Comté,70,2,21,118,Chambornay-lès-Bellevaux,155,1,156
43,Franche-Comté,70,2,15,119,Chambornay-lès-Pin,356,10,366
43,Franche-Comté,70,1,03,120,Champagney,3665,59,3724
43,Franche-Comté,70,1,11,121,Champey,842,15,857
43,Franche-Comté,70,2,04,122,Champlitte,1862,34,1896
43,Franche-Comté,70,2,09,124,Champtonnay,89,0,89
43,Franche-Comté,70,2,09,125,Champvans,210,4,214
43,Franche-Comté,70,2,19,126,Chancey,151,5,156
43,Franche-Comté,70,2,24,127,Chantes,113,3,116
43,Franche-Comté,70,1,32,128,La Chapelle-lès-Luxeuil,425,11,436
43,Franche-Comté,70,2,10,129,La Chapelle-Saint-Quillain,137,2,139
43,Franche-Comté,70,2,15,130,Charcenne,349,11,360
43,Franche-Comté,70,2,02,132,Chargey-lès-Gray,683,68,751
43,Franche-Comté,70,2,05,133,Chargey-lès-Port,245,6,251
43,Franche-Comté,70,2,29,134,Chariez,217,3,220
43,Franche-Comté,70,2,28,135,Charmes-Saint-Valbert,49,3,52
43,Franche-Comté,70,2,29,136,Charmoille,434,18,452
43,Franche-Comté,70,2,17,137,Chassey-lès-Montbozon,227,11,238
43,Franche-Comté,70,2,24,138,Chassey-lès-Scey,100,2,102
43,Franche-Comté,70,1,23,140,Châteney,54,1,55
43,Franche-Comté,70,1,23,141,Châtenois,131,6,137
43,Franche-Comté,70,2,19,142,Chaumercenne,150,2,152
43,Franche-Comté,70,2,28,143,Chauvirey-le-Châtel,118,1,119
43,Franche-Comté,70,2,28,144,Chauvirey-le-Vieil,32,2,34
43,Franche-Comté,70,2,21,145,Chaux-la-Lotière,346,6,352
43,Franche-Comté,70,2,20,146,Chaux-lès-Port,140,3,143
43,Franche-Comté,70,1,11,147,Chavanne,233,2,235
43,Franche-Comté,70,2,24,148,Chemilly,81,2,83
43,Franche-Comté,70,1,11,149,Chenebier,688,22,710
43,Franche-Comté,70,2,15,150,Chenevrey-et-Morogne,256,8,264
43,Franche-Comté,70,2,19,151,Chevigney,29,4,33
43,Franche-Comté,70,2,10,152,Choye,355,55,410
43,Franche-Comté,70,2,28,153,Cintrey,117,1,118
43,Franche-Comté,70,2,21,154,Cirey,330,4,334
43,Franche-Comté,70,1,32,155,Citers,833,20,853
43,Franche-Comté,70,2,10,156,Citey,89,0,89
43,Franche-Comté,70,1,03,157,Clairegoutte,426,17,443
43,Franche-Comté,70,2,24,158,Clans,125,3,128
43,Franche-Comté,70,2,17,159,Cognières,108,4,112
43,Franche-Comté,70,1,11,160,Coisevaux,318,7,325
43,Franche-Comté,70,2,18,162,Colombe-lès-Vesoul,497,20,517
43,Franche-Comté,70,2,26,163,Colombier,389,13,402
43,Franche-Comté,70,2,18,164,Colombotte,54,0,54
43,Franche-Comté,70,2,05,165,Combeaufontaine,547,43,590
43,Franche-Comté,70,2,26,166,Comberjon,174,9,183
43,Franche-Comté,70,2,20,167,Conflandey,410,8,418
43,Franche-Comté,70,1,22,168,Conflans-sur-Lanterne,653,7,660
43,Franche-Comté,70,2,06,169,Confracourt,214,3,217
43,Franche-Comté,70,2,01,170,Contréglise,98,4,102
43,Franche-Comté,70,1,22,171,Corbenay,1327,28,1355
43,Franche-Comté,70,1,32,172,La Corbière,104,2,106
43,Franche-Comté,70,2,21,174,Cordonnet,121,1,122
43,Franche-Comté,70,2,05,175,Cornot,151,6,157
43,Franche-Comté,70,1,07,176,Corravillers,197,8,205
43,Franche-Comté,70,2,12,177,Corre,595,15,610
43,Franche-Comté,70,1,31,178,La Côte,520,6,526
43,Franche-Comté,70,2,26,179,Coulevon,191,7,198
43,Franche-Comté,70,1,27,180,Courchaton,446,8,454
43,Franche-Comté,70,2,15,181,Courcuire,129,0,129
43,Franche-Comté,70,1,11,182,Courmont,102,3,105
43,Franche-Comté,70,2,04,183,Courtesoult-et-Gatey,61,1,62
43,Franche-Comté,70,1,11,184,Couthenans,782,31,813
43,Franche-Comté,70,2,09,185,Cresancey,182,9,191
43,Franche-Comté,70,1,23,186,La Creuse,73,5,78
43,Franche-Comté,70,1,27,187,Crevans-et-la-Chapelle-lès-Granges,284,5,289
43,Franche-Comté,70,1,23,188,Creveney,53,3,56
43,Franche-Comté,70,2,21,189,Cromary,229,5,234
43,Franche-Comté,70,1,25,190,Cubry-lès-Faverney,115,5,120
43,Franche-Comté,70,2,15,192,Cugney,174,12,186
43,Franche-Comté,70,2,15,193,Cult,213,5,218
43,Franche-Comté,70,1,25,194,Cuve,158,2,160
43,Franche-Comté,70,1,32,195,Dambenoît-lès-Colombe,265,4,269
43,Franche-Comté,70,1,25,196,Dampierre-lès-Conflans,257,5,262
43,Franche-Comté,70,2,17,197,Dampierre-sur-Linotte,722,26,748
43,Franche-Comté,70,2,06,198,Dampierre-sur-Salon,1269,21,1290
43,Franche-Comté,70,2,18,199,Dampvalley-lès-Colombe,113,4,117
43,Franche-Comté,70,1,25,200,Dampvalley-Saint-Pancras,47,0,47
43,Franche-Comté,70,2,06,201,Delain,198,4,202
43,Franche-Comté,70,2,12,202,Demangevelle,344,14,358
43,Franche-Comté,70,2,18,203,La Demie,98,0,98
43,Franche-Comté,70,2,06,204,Denèvre,176,2,178
43,Franche-Comté,70,1,03,205,Échavanne,199,10,209
43,Franche-Comté,70,1,30,206,Échenans-sous-Mont-Vaudois,502,11,513
43,Franche-Comté,70,2,29,207,Échenoz-la-Méline,3038,83,3121
43,Franche-Comté,70,2,17,208,Échenoz-le-Sec,316,11,327
43,Franche-Comté,70,1,16,210,Écromagny,175,3,178
43,Franche-Comté,70,2,02,211,Écuelle,87,4,91
43,Franche-Comté,70,1,32,213,Éhuns,260,9,269
43,Franche-Comté,70,2,20,214,Équevilley,125,9,134
43,Franche-Comté,70,1,03,215,Errevet,241,11,252
43,Franche-Comté,70,1,32,216,Esboz-Brest,481,17,498
43,Franche-Comté,70,1,07,217,Esmoulières,98,0,98
43,Franche-Comté,70,2,09,218,Esmoulins,158,2,160
43,Franche-Comté,70,2,18,219,Esprels,689,16,705
43,Franche-Comté,70,2,02,220,Essertenne-et-Cecey,394,8,402
43,Franche-Comté,70,1,11,221,Étobon,294,4,298
43,Franche-Comté,70,2,10,222,Étrelles-et-la-Montbleuse,79,1,80
43,Franche-Comté,70,2,15,224,Étuz,665,15,680
43,Franche-Comté,70,2,02,225,Fahy-lès-Autrey,118,9,127
43,Franche-Comté,70,1,27,226,Fallon,325,7,332
43,Franche-Comté,70,1,07,227,Faucogney-et-la-Mer,597,19,616
43,Franche-Comté,70,2,01,228,Faverney,1044,24,1068
43,Franche-Comté,70,1,27,229,Faymont,256,10,266
43,Franche-Comté,70,2,06,230,Fédry,111,3,114
43,Franche-Comté,70,2,06,231,Ferrières-lès-Ray,47,2,49
43,Franche-Comté,70,2,24,232,Ferrières-lès-Scey,160,4,164
43,Franche-Comté,70,1,07,233,Les Fessey,128,3,131
43,Franche-Comté,70,2,17,234,Filain,225,11,236
43,Franche-Comté,70,2,20,235,Flagy,149,5,154
43,Franche-Comté,70,2,20,236,Fleurey-lès-Faverney,395,3,398
43,Franche-Comté,70,2,06,237,Fleurey-lès-Lavoncourt,116,3,119
43,Franche-Comté,70,1,22,238,Fleurey-lès-Saint-Loup,161,7,168
43,Franche-Comté,70,2,21,239,Fondremand,181,1,182
43,Franche-Comté,70,1,22,240,Fontaine-lès-Luxeuil,1473,47,1520
43,Franche-Comté,70,1,25,242,Fontenois-la-Ville,150,3,153
43,Franche-Comté,70,2,17,243,Fontenois-lès-Montbozon,301,5,306
43,Franche-Comté,70,2,05,244,Fouchécourt,115,4,119
43,Franche-Comté,70,1,22,245,Fougerolles,3841,187,4028
43,Franche-Comté,70,2,04,247,Fouvent-Saint-Andoche,241,5,246
43,Franche-Comté,70,1,03,248,Frahier-et-Chatebier,1158,28,1186
43,Franche-Comté,70,2,04,252,Framont,194,2,196
43,Franche-Comté,70,1,22,249,Francalmont,123,3,126
43,Franche-Comté,70,1,31,250,Franchevelle,389,1,390
43,Franche-Comté,70,2,06,251,Francourt,98,2,100
43,Franche-Comté,70,2,10,253,Frasne-le-Château,274,48,322
43,Franche-Comté,70,1,03,254,Frédéric-Fontaine,263,1,264
43,Franche-Comté,70,2,08,255,Fresne-Saint-Mamès,474,17,491
43,Franche-Comté,70,1,16,256,Fresse,723,18,741
43,Franche-Comté,70,2,08,257,Fretigney-et-Velloreille,667,6,673
43,Franche-Comté,70,1,32,258,Froideconche,1991,75,2066
43,Franche-Comté,70,1,31,259,Froideterre,365,17,382
43,Franche-Comté,70,1,13,260,Frotey-lès-Lure,622,24,646
43,Franche-Comté,70,2,26,261,Frotey-lès-Vesoul,1330,44,1374
43,Franche-Comté,70,1,31,262,Genevreuille,172,2,174
43,Franche-Comté,70,1,23,263,Genevrey,227,7,234
43,Franche-Comté,70,1,27,264,Georfans,62,0,62
43,Franche-Comté,70,2,09,265,Germigney,181,2,183
43,Franche-Comté,70,2,05,267,Gevigney-et-Mercey,476,6,482
43,Franche-Comté,70,2,10,268,Gézier-et-Fontenelay,183,2,185
43,Franche-Comté,70,1,25,269,Girefontaine,45,1,46
43,Franche-Comté,70,1,27,271,Gouhenans,438,10,448
43,Franche-Comté,70,2,05,272,Gourgeon,247,4,251
43,Franche-Comté,70,1,27,273,Grammont,77,0,77
43,Franche-Comté,70,2,19,443,La Grande-Résie,89,5,94
43,Franche-Comté,70,2,06,274,Grandecourt,32,2,34
43,Franche-Comté,70,2,24,275,Grandvelle-et-le-Perrenot,348,5,353
43,Franche-Comté,70,1,27,276,Granges-la-Ville,235,0,235
43,Franche-Comté,70,1,27,277,Granges-le-Bourg,356,10,366
43,Franche-Comté,70,2,20,278,Grattery,192,8,200
43,Franche-Comté,70,2,09,279,Gray,6088,392,6480
43,Franche-Comté,70,2,09,280,Gray-la-Ville,982,38,1020
43,Franche-Comté,70,2,08,281,Greucourt,89,3,92
43,Franche-Comté,70,2,10,282,Gy,1039,33,1072
43,Franche-Comté,70,1,16,283,Haut-du-Them-Château-Lambert,490,11,501
43,Franche-Comté,70,1,22,284,Hautevelle,258,6,264
43,Franche-Comté,70,1,94,285,Héricourt,10547,250,10797
43,Franche-Comté,70,2,15,286,Hugier,126,5,131
43,Franche-Comté,70,1,25,287,Hurecourt,61,0,61
43,Franche-Comté,70,2,21,288,Hyet,96,4,100
43,Franche-Comté,70,2,09,289,Igny,185,3,188
43,Franche-Comté,70,1,25,290,Jasney,229,3,232
43,Franche-Comté,70,2,12,291,Jonvelle,145,5,150
43,Franche-Comté,70,2,12,292,Jussey,1782,52,1834
43,Franche-Comté,70,2,05,293,Lambrey,79,3,82
43,Franche-Comté,70,1,32,294,Lantenot,337,10,347
43,Franche-Comté,70,1,16,295,La Lanterne-et-les-Armonts,175,5,180
43,Franche-Comté,70,2,17,296,Larians-et-Munans,216,2,218
43,Franche-Comté,70,2,04,297,Larret,53,1,54
43,Franche-Comté,70,2,28,298,Lavigney,121,4,125
43,Franche-Comté,70,2,06,299,Lavoncourt,329,7,336
43,Franche-Comté,70,2,24,301,Lieffrans,54,0,54
43,Franche-Comté,70,2,19,302,Lieucourt,76,1,77
43,Franche-Comté,70,2,18,303,Liévans,132,3,135
43,Franche-Comté,70,1,32,304,Linexert,134,6,140
43,Franche-Comté,70,2,02,305,Loeuilley,122,0,122
43,Franche-Comté,70,1,11,306,Lomont,380,11,391
43,Franche-Comté,70,1,27,307,Longevelle,114,4,118
43,Franche-Comté,70,1,07,308,La Longine,253,8,261
43,Franche-Comté,70,2,17,309,Loulans-Verchamp,470,7,477
43,Franche-Comté,70,1,95,310,Lure,8264,304,8568
43,Franche-Comté,70,1,14,311,Luxeuil-les-Bains,7482,411,7893
43,Franche-Comté,70,1,30,312,Luze,731,11,742
43,Franche-Comté,70,1,13,313,Lyoffans,383,5,388
43,Franche-Comté,70,1,32,314,Magnivray,165,3,168
43,Franche-Comté,70,1,22,315,Magnoncourt,438,18,456
43,Franche-Comté,70,2,17,316,Le Magnoray,104,1,105
43,Franche-Comté,70,1,27,317,Les Magny,133,3,136
43,Franche-Comté,70,1,13,318,Magny-Danigon,445,6,451
43,Franche-Comté,70,1,13,319,Magny-Jobert,97,2,99
43,Franche-Comté,70,2,12,320,Magny-lès-Jussey,101,5,106
43,Franche-Comté,70,1,13,321,Magny-Vernois,1245,21,1266
43,Franche-Comté,70,1,23,322,Mailleroncourt-Charette,304,8,312
43,Franche-Comté,70,1,25,323,Mailleroncourt-Saint-Pancras,214,5,219
43,Franche-Comté,70,2,24,324,Mailley-et-Chazelot,579,34,613
43,Franche-Comté,70,2,21,325,Maizières,295,72,367
43,Franche-Comté,70,2,21,326,La Malachère,268,1,269
43,Franche-Comté,70,2,19,327,Malans,129,7,136
43,Franche-Comté,70,1,31,328,Malbouhans,384,10,394
43,Franche-Comté,70,2,28,329,Malvillers,75,1,76
43,Franche-Comté,70,1,30,330,Mandrevillars,213,8,221
43,Franche-Comté,70,2,02,331,Mantoche,494,18,512
43,Franche-Comté,70,1,27,332,Marast,43,1,44
43,Franche-Comté,70,2,15,334,Marnay,1415,25,1440
43,Franche-Comté,70,2,17,335,Maussans,78,0,78
43,Franche-Comté,70,1,27,336,Mélecey,173,7,180
43,Franche-Comté,70,2,05,337,Melin,64,0,64
43,Franche-Comté,70,1,25,338,Melincourt,255,13,268
43,Franche-Comté,70,1,16,339,Mélisey,1721,42,1763
43,Franche-Comté,70,2,06,340,Membrey,233,46,279
43,Franche-Comté,70,2,01,341,Menoux,281,11,292
43,Franche-Comté,70,2,08,342,Mercey-sur-Saône,141,0,141
43,Franche-Comté,70,2,20,343,Mersuay,265,2,267
43,Franche-Comté,70,1,23,344,Meurcourt,315,12,327
43,Franche-Comté,70,1,16,345,Miellin,84,2,86
43,Franche-Comté,70,1,27,347,Mignavillers,326,7,333
43,Franche-Comté,70,1,13,348,Moffans-et-Vacheresse,607,11,618
43,Franche-Comté,70,1,27,349,Moimay,226,4,230
43,Franche-Comté,70,2,28,350,Molay,65,0,65
43,Franche-Comté,70,1,13,351,Mollans,250,2,252
43,Franche-Comté,70,2,29,367,Mont-le-Vernois,150,2,152
43,Franche-Comté,70,2,06,369,Mont-Saint-Léger,68,1,69
43,Franche-Comté,70,1,07,352,La Montagne,38,2,40
43,Franche-Comté,70,2,19,353,Montagney,478,10,488
43,Franche-Comté,70,2,21,355,Montarlot-lès-Rioz,272,4,276
43,Franche-Comté,70,2,10,356,Montboillon,263,3,266
43,Franche-Comté,70,2,17,357,Montbozon,511,70,581
43,Franche-Comté,70,2,26,358,Montcey,219,7,226
43,Franche-Comté,70,2,12,359,Montcourt,73,0,73
43,Franche-Comté,70,1,25,360,Montdoré,73,2,75
43,Franche-Comté,70,1,16,361,Montessaux,158,8,166
43,Franche-Comté,70,2,28,362,Montigny-lès-Cherlieu,172,0,172
43,Franche-Comté,70,2,29,363,Montigny-lès-Vesoul,640,23,663
43,Franche-Comté,70,2,18,364,Montjustin-et-Velotte,134,7,141
43,Franche-Comté,70,2,06,368,Montot,121,1,122
43,Franche-Comté,70,2,02,371,Montureux-et-Prantigny,236,8,244
43,Franche-Comté,70,2,01,372,Montureux-lès-Baulay,174,1,175
43,Franche-Comté,70,2,19,374,Motey-Besuche,113,1,114
43,Franche-Comté,70,2,08,375,Motey-sur-Saône,26,0,26
43,Franche-Comté,70,2,02,376,Nantilly,518,13,531
43,Franche-Comté,70,2,26,378,Navenne,1773,79,1852
43,Franche-Comté,70,1,23,380,Neurey-en-Vaux,162,7,169
43,Franche-Comté,70,2,18,381,Neurey-lès-la-Demie,341,3,344
43,Franche-Comté,70,2,21,383,Neuvelle-lès-Cromary,283,6,289
43,Franche-Comté,70,2,24,384,Neuvelle-lès-la-Charité,228,3,231
43,Franche-Comté,70,1,31,385,La Neuvelle-lès-Lure,332,7,339
43,Franche-Comté,70,2,05,386,La Neuvelle-lès-Scey,191,7,198
43,Franche-Comté,70,2,24,387,Noidans-le-Ferroux,607,16,623
43,Franche-Comté,70,2,29,388,Noidans-lès-Vesoul,2092,61,2153
43,Franche-Comté,70,2,09,389,Noiron,76,0,76
43,Franche-Comté,70,2,18,390,Noroy-le-Bourg,486,14,500
43,Franche-Comté,70,2,05,392,Oigney,50,1,51
43,Franche-Comté,70,2,10,393,Oiselay-et-Grachaux,395,13,408
43,Franche-Comté,70,2,09,394,Onay,74,2,76
43,Franche-Comté,70,1,27,395,Oppenans,51,1,52
43,Franche-Comté,70,1,27,396,Oricourt,33,2,35
43,Franche-Comté,70,2,17,397,Ormenans,64,0,64
43,Franche-Comté,70,1,32,398,Ormoiche,72,0,72
43,Franche-Comté,70,2,12,399,Ormoy,228,1,229
43,Franche-Comté,70,2,28,400,Ouge,120,2,122
43,Franche-Comté,70,2,24,401,Ovanches,114,1,115
43,Franche-Comté,70,2,02,402,Oyrières,427,4,431
43,Franche-Comté,70,1,13,403,Palante,174,5,179
43,Franche-Comté,70,2,12,404,Passavant-la-Rochère,703,24,727
43,Franche-Comté,70,2,21,405,Pennesières,167,4,171
43,Franche-Comté,70,2,04,406,Percey-le-Grand,93,4,97
43,Franche-Comté,70,2,21,407,Perrouse,216,3,219
43,Franche-Comté,70,2,19,408,Pesmes,1109,30,1139
43,Franche-Comté,70,2,04,409,Pierrecourt,129,4,133
43,Franche-Comté,70,2,15,410,Pin,709,7,716
43,Franche-Comté,70,1,25,411,La Pisseure,42,1,43
43,Franche-Comté,70,1,25,412,Plainemont,57,2,59
43,Franche-Comté,70,1,03,413,Plancher-Bas,1864,30,1894
43,Franche-Comté,70,1,03,414,Plancher-les-Mines,1092,12,1104
43,Franche-Comté,70,2,01,415,Polaincourt-et-Clairefontaine,776,11,787
43,Franche-Comté,70,1,31,416,Pomoy,179,5,184
43,Franche-Comté,70,2,08,418,Le Pont-de-Planches,225,4,229
43,Franche-Comté,70,1,25,419,Pont-du-Bois,122,2,124
43,Franche-Comté,70,1,27,420,Pont-sur-l'Ognon,59,3,62
43,Franche-Comté,70,2,24,417,Pontcey,259,11,270
43,Franche-Comté,70,2,20,421,Port-sur-Saône,2969,81,3050
43,Franche-Comté,70,2,02,422,Poyans,134,1,135
43,Franche-Comté,70,2,28,423,Preigney,133,3,136
43,Franche-Comté,70,1,07,425,La Proiselière-et-Langle,170,6,176
43,Franche-Comté,70,2,20,426,Provenchère,276,10,286
43,Franche-Comté,70,2,05,427,Purgerot,368,9,377
43,Franche-Comté,70,2,29,428,Pusey,1474,31,1505
43,Franche-Comté,70,2,29,429,Pusy-et-Épenoux,534,7,541
43,Franche-Comté,70,2,28,430,La Quarte,81,0,81
43,Franche-Comté,70,2,21,431,Quenoche,175,2,177
43,Franche-Comté,70,1,31,432,Quers,354,7,361
43,Franche-Comté,70,2,26,433,Quincey,1215,50,1265
43,Franche-Comté,70,1,07,435,Raddon-et-Chapendu,900,25,925
43,Franche-Comté,70,2,12,436,Raincourt,135,3,138
43,Franche-Comté,70,2,12,437,Ranzevelle,15,0,15
43,Franche-Comté,70,2,06,438,Ray-sur-Saône,216,4,220
43,Franche-Comté,70,2,24,439,Raze,314,9,323
43,Franche-Comté,70,2,06,440,Recologne,40,1,41
43,Franche-Comté,70,2,21,441,Recologne-lès-Rioz,210,3,213
43,Franche-Comté,70,2,06,442,Renaucourt,108,1,109
43,Franche-Comté,70,2,19,444,La Résie-Saint-Martin,151,2,153
43,Franche-Comté,70,1,32,445,Rignovelle,96,4,100
43,Franche-Comté,70,2,02,446,Rigny,613,16,629
43,Franche-Comté,70,2,21,447,Rioz,1784,94,1878
43,Franche-Comté,70,2,06,448,Roche-et-Raucourt,148,3,151
43,Franche-Comté,70,2,28,373,La Roche-Morey,288,6,294
43,Franche-Comté,70,2,17,449,Roche-sur-Linotte-et-Sorans-les-Cordiers,71,0,71
43,Franche-Comté,70,2,28,450,La Rochelle,42,3,45
43,Franche-Comté,70,1,03,451,Ronchamp,2891,34,2925
43,Franche-Comté,70,2,24,452,Rosey,248,7,255
43,Franche-Comté,70,1,07,453,La Rosière,99,5,104
43,Franche-Comté,70,2,28,454,Rosières-sur-Mance,82,2,84
43,Franche-Comté,70,1,13,455,Roye,1261,33,1294
43,Franche-Comté,70,2,17,456,Ruhans,142,1,143
43,Franche-Comté,70,2,24,457,Rupt-sur-Saône,121,6,127
43,Franche-Comté,70,1,16,459,Saint-Barthélemy,1154,24,1178
43,Franche-Comté,70,1,07,460,Saint-Bresson,426,6,432
43,Franche-Comté,70,2,09,461,Saint-Broing,133,3,136
43,Franche-Comté,70,1,27,462,Saint-Ferjeux,74,1,75
43,Franche-Comté,70,2,08,463,Saint-Gand,137,1,138
43,Franche-Comté,70,1,31,464,Saint-Germain,1308,38,1346
43,Franche-Comté,70,2,09,466,Saint-Loup-Nantouard,114,2,116
43,Franche-Comté,70,1,22,467,Saint-Loup-sur-Semouse,3673,123,3796
43,Franche-Comté,70,2,28,468,Saint-Marcel,115,3,118
43,Franche-Comté,70,2,01,472,Saint-Remy,650,10,660
43,Franche-Comté,70,1,32,473,Saint-Sauveur,2149,56,2205
43,Franche-Comté,70,1,27,474,Saint-Sulpice,126,1,127
43,Franche-Comté,70,1,14,475,Saint-Valbert,218,11,229
43,Franche-Comté,70,1,07,469,Sainte-Marie-en-Chanois,200,5,205
43,Franche-Comté,70,1,32,470,Sainte-Marie-en-Chaux,166,6,172
43,Franche-Comté,70,2,08,471,Sainte-Reine,35,0,35
43,Franche-Comté,70,2,01,476,Saponcourt,60,1,61
43,Franche-Comté,70,1,11,477,Saulnot,751,16,767
43,Franche-Comté,70,1,23,478,Saulx,847,21,868
43,Franche-Comté,70,2,09,479,Sauvigney-lès-Gray,109,0,109
43,Franche-Comté,70,2,19,480,Sauvigney-lès-Pesmes,173,2,175
43,Franche-Comté,70,2,06,481,Savoyeux,216,4,220
43,Franche-Comté,70,2,24,482,Scey-sur-Saône-et-Saint-Albin,1655,37,1692
43,Franche-Comté,70,2,20,483,Scye,114,3,117
43,Franche-Comté,70,1,27,484,Secenans,151,2,153
43,Franche-Comté,70,1,25,485,Selles,247,13,260
43,Franche-Comté,70,2,05,486,Semmadon,129,4,133
43,Franche-Comté,70,1,27,487,Senargent-Mignafans,289,10,299
43,Franche-Comté,70,2,01,488,Senoncourt,216,10,226
43,Franche-Comté,70,1,16,489,Servance,885,25,910
43,Franche-Comté,70,1,23,490,Servigney,101,1,102
43,Franche-Comté,70,2,08,491,Seveux,446,6,452
43,Franche-Comté,70,2,08,492,Soing-Cubry-Charentenay,442,12,454
43,Franche-Comté,70,2,21,493,Sorans-lès-Breurey,401,3,404
43,Franche-Comté,70,2,15,494,Sornay,303,5,308
43,Franche-Comté,70,2,12,496,Tartécourt,41,0,41
43,Franche-Comté,70,1,11,497,Tavey,407,6,413
43,Franche-Comté,70,1,16,498,Ternuay-Melay-et-Saint-Hilaire,525,14,539
43,Franche-Comté,70,2,06,499,Theuley,92,2,94
43,Franche-Comté,70,2,17,500,Thieffrans,169,4,173
43,Franche-Comté,70,2,17,501,Thiénans,82,4,86
43,Franche-Comté,70,2,06,502,Tincey-et-Pontrebeau,80,2,82
43,Franche-Comté,70,2,21,503,Traitiéfontaine,144,3,147
43,Franche-Comté,70,2,24,504,Traves,355,7,362
43,Franche-Comté,70,2,09,505,Le Tremblois,179,3,182
43,Franche-Comté,70,1,11,506,Trémoins,345,6,351
43,Franche-Comté,70,2,21,507,Trésilley,202,2,204
43,Franche-Comté,70,2,15,509,Tromarey,105,7,112
43,Franche-Comté,70,2,19,510,Vadans,128,4,132
43,Franche-Comté,70,2,06,511,Vaite,219,5,224
43,Franche-Comté,70,1,22,512,La Vaivre,218,3,221
43,Franche-Comté,70,2,29,513,Vaivre-et-Montoille,2324,92,2416
43,Franche-Comté,70,1,13,515,Le Val-de-Gouhenans,62,2,64
43,Franche-Comté,70,2,20,518,Le Val-Saint-Éloi,115,3,118
43,Franche-Comté,70,2,19,514,Valay,664,8,672
43,Franche-Comté,70,2,18,516,Vallerois-le-Bois,261,6,267
43,Franche-Comté,70,2,18,517,Vallerois-Lorioz,346,13,359
43,Franche-Comté,70,2,21,519,Vandelans,110,4,114
43,Franche-Comté,70,2,06,520,Vanne,99,2,101
43,Franche-Comté,70,2,10,521,Vantoux-et-Longevelle,152,7,159
43,Franche-Comté,70,2,26,522,Varogne,141,2,143
43,Franche-Comté,70,2,02,523,Vars,203,4,207
43,Franche-Comté,70,2,20,524,Vauchoux,127,3,130
43,Franche-Comté,70,2,06,525,Vauconcourt-Nervezain,222,3,225
43,Franche-Comté,70,1,25,526,Vauvillers,690,18,708
43,Franche-Comté,70,2,10,527,Vaux-le-Moncelot,76,1,77
43,Franche-Comté,70,2,09,528,Velesmes-Échevanne,487,20,507
43,Franche-Comté,70,2,09,529,Velet,425,17,442
43,Franche-Comté,70,2,24,536,Velle-le-Châtel,137,1,138
43,Franche-Comté,70,1,27,530,Vellechevreux-et-Courbenans,159,3,162
43,Franche-Comté,70,2,10,531,Velleclaire,82,2,84
43,Franche-Comté,70,2,17,532,Vellefaux,469,16,485
43,Franche-Comté,70,2,10,533,Vellefrey-et-Vellefrange,98,1,99
43,Franche-Comté,70,2,26,534,Vellefrie,127,1,128
43,Franche-Comté,70,2,24,535,Velleguindry-et-Levrecey,159,2,161
43,Franche-Comté,70,1,23,537,Velleminfroy,275,2,277
43,Franche-Comté,70,2,10,538,Vellemoz,93,2,95
43,Franche-Comté,70,2,08,539,Vellexon-Queutrey-et-Vaudey,504,6,510
43,Franche-Comté,70,2,10,540,Velloreille-lès-Choye,77,0,77
43,Franche-Comté,70,1,23,541,Velorcey,199,2,201
43,Franche-Comté,70,2,19,542,Venère,167,3,170
43,Franche-Comté,70,2,01,545,Venisey,132,5,137
43,Franche-Comté,70,2,06,546,Vereux,247,30,277
43,Franche-Comté,70,1,27,544,La Vergenne,105,3,108
43,Franche-Comté,70,1,11,547,Verlans,140,2,142
43,Franche-Comté,70,2,28,548,Vernois-sur-Mance,175,3,178
43,Franche-Comté,70,2,08,549,La Vernotte,71,3,74
43,Franche-Comté,70,2,96,550,Vesoul,16271,909,17180
43,Franche-Comté,70,2,08,551,Vezet,189,3,192
43,Franche-Comté,70,1,27,552,Villafans,198,6,204
43,Franche-Comté,70,1,27,553,Villargent,106,1,107
43,Franche-Comté,70,2,12,554,Villars-le-Pautel,151,5,156
43,Franche-Comté,70,1,23,555,La Villedieu-en-Fontenette,179,6,185
43,Franche-Comté,70,2,10,557,Villefrancon,137,3,140
43,Franche-Comté,70,2,26,558,La Villeneuve-Bellenoye-et-la-Maize,127,6,133
43,Franche-Comté,70,2,26,559,Villeparois,203,3,206
43,Franche-Comté,70,2,21,560,Villers-Bouton,164,2,166
43,Franche-Comté,70,2,10,366,Villers-Chemin-et-Mont-lès-Étrelles,124,3,127
43,Franche-Comté,70,1,27,562,Villers-la-Ville,161,1,162
43,Franche-Comté,70,2,18,563,Villers-le-Sec,534,19,553
43,Franche-Comté,70,1,23,564,Villers-lès-Luxeuil,353,5,358
43,Franche-Comté,70,2,17,565,Villers-Pater,41,2,43
43,Franche-Comté,70,2,20,566,Villers-sur-Port,205,4,209
43,Franche-Comté,70,1,11,567,Villers-sur-Saulnot,157,1,158
43,Franche-Comté,70,2,06,568,Villers-Vaudey,60,0,60
43,Franche-Comté,70,1,27,561,Villersexel,1448,119,1567
43,Franche-Comté,70,2,26,569,Vilory,88,2,90
43,Franche-Comté,70,1,32,571,Visoncourt,32,0,32
43,Franche-Comté,70,2,28,572,Vitrey-sur-Mance,271,3,274
43,Franche-Comté,70,1,07,573,La Voivre,136,5,141
43,Franche-Comté,70,2,06,574,Volon,70,0,70
43,Franche-Comté,70,2,21,575,Voray-sur-l'Ognon,839,20,859
43,Franche-Comté,70,2,12,576,Vougécourt,148,3,151
43,Franche-Comté,70,1,13,577,Vouhenans,405,14,419
43,Franche-Comté,70,2,15,578,Vregille,174,6,180
43,Franche-Comté,70,2,24,580,Vy-le-Ferroux,173,4,177
43,Franche-Comté,70,2,17,583,Vy-lès-Filain,75,1,76
43,Franche-Comté,70,1,13,581,Vy-lès-Lure,638,21,659
43,Franche-Comté,70,2,24,582,Vy-lès-Rupt,101,2,103
43,Franche-Comté,70,1,11,579,Vyans-le-Val,431,14,445
26,Bourgogne,71,4,16,001,L' Abergement-de-Cuisery,707,14,721
26,Bourgogne,71,2,43,002,L' Abergement-Sainte-Colombe,1075,34,1109
26,Bourgogne,71,2,51,003,Allerey-sur-Saône,752,17,769
26,Bourgogne,71,2,45,004,Allériot,944,24,968
26,Bourgogne,71,2,05,005,Aluze,238,5,243
26,Bourgogne,71,3,11,006,Amanzé,199,20,219
26,Bourgogne,71,5,41,007,Ameugny,134,10,144
26,Bourgogne,71,3,10,008,Anglure-sous-Dun,165,0,165
26,Bourgogne,71,1,24,009,Anost,685,19,704
26,Bourgogne,71,1,52,010,Antully,811,18,829
26,Bourgogne,71,3,28,011,Anzy-le-Duc,442,78,520
26,Bourgogne,71,3,28,012,Artaix,401,5,406
26,Bourgogne,71,4,39,013,Authumes,227,6,233
26,Bourgogne,71,1,95,014,Autun,14887,1302,16189
26,Bourgogne,71,1,52,015,Auxy,988,25,1013
26,Bourgogne,71,5,25,016,Azé,1020,30,1050
26,Bourgogne,71,3,21,017,Ballore,80,6,86
26,Bourgogne,71,4,34,018,Bantanges,566,12,578
26,Bourgogne,71,2,19,019,Barizey,133,2,135
26,Bourgogne,71,1,24,020,Barnay,101,2,103
26,Bourgogne,71,3,09,021,Baron,276,9,285
26,Bourgogne,71,3,11,022,Baudemont,685,17,702
26,Bourgogne,71,2,43,023,Baudrières,867,14,881
26,Bourgogne,71,3,28,024,Baugy,496,12,508
26,Bourgogne,71,3,40,025,Beaubery,357,13,370
26,Bourgogne,71,2,47,026,Beaumont-sur-Grosne,316,6,322
26,Bourgogne,71,4,02,027,Beaurepaire-en-Bresse,605,14,619
26,Bourgogne,71,4,39,028,Beauvernois,90,3,93
26,Bourgogne,71,4,39,029,Bellevesvre,277,7,284
26,Bourgogne,71,5,12,030,Bergesserin,236,14,250
26,Bourgogne,71,5,26,032,Berzé-la-Ville,520,9,529
26,Bourgogne,71,5,12,031,Berzé-le-Châtel,64,2,66
26,Bourgogne,71,2,45,033,Bey,772,16,788
26,Bourgogne,71,2,04,034,Bissey-sous-Cruchaud,364,14,378
26,Bourgogne,71,5,25,035,Bissy-la-Mâconnaise,197,4,201
26,Bourgogne,71,5,41,036,Bissy-sous-Uxelles,69,0,69
26,Bourgogne,71,2,04,037,Bissy-sur-Fley,98,4,102
26,Bourgogne,71,1,32,038,Les Bizots,431,16,447
26,Bourgogne,71,5,12,039,Blanot,163,0,163
26,Bourgogne,71,1,32,040,Blanzy,6729,263,6992
26,Bourgogne,71,3,11,041,Bois-Sainte-Marie,197,1,198
26,Bourgogne,71,5,41,042,Bonnay,297,10,307
26,Bourgogne,71,2,51,043,Les Bordes,98,2,100
26,Bourgogne,71,4,42,044,Bosjean,310,7,317
26,Bourgogne,71,4,42,045,Bouhans,156,8,164
26,Bourgogne,71,1,30,046,La Boulaye,116,5,121
26,Bourgogne,71,3,03,047,Bourbon-Lancy,5338,113,5451
26,Bourgogne,71,3,28,048,Bourg-le-Comte,210,9,219
26,Bourgogne,71,5,50,050,Bourgvilain,332,8,340
26,Bourgogne,71,2,05,051,Bouzeron,152,2,154
26,Bourgogne,71,2,47,052,Boyer,677,17,694
26,Bourgogne,71,2,51,054,Bragny-sur-Saône,587,8,595
26,Bourgogne,71,5,29,055,Brandon,290,2,292
26,Bourgogne,71,4,23,056,Branges,2343,39,2382
26,Bourgogne,71,5,12,057,Bray,119,8,127
26,Bourgogne,71,2,47,058,Bresse-sur-Grosne,203,4,207
26,Bourgogne,71,1,14,059,Le Breuil,3564,106,3670
26,Bourgogne,71,3,46,060,Briant,222,6,228
26,Bourgogne,71,4,16,061,Brienne,421,11,432
26,Bourgogne,71,1,30,062,Brion,343,20,363
26,Bourgogne,71,1,30,063,Broye,839,16,855
26,Bourgogne,71,4,23,064,Bruailles,927,24,951
26,Bourgogne,71,5,12,065,Buffières,265,7,272
26,Bourgogne,71,5,25,066,Burgy,104,1,105
26,Bourgogne,71,5,41,067,Burnand,115,8,123
26,Bourgogne,71,5,41,068,Burzy,64,6,70
26,Bourgogne,71,5,27,069,Bussières,581,20,601
26,Bourgogne,71,2,04,070,Buxy,2183,115,2298
26,Bourgogne,71,1,24,509,La Celle-en-Morvan,446,16,462
26,Bourgogne,71,3,28,071,Céron,287,3,290
26,Bourgogne,71,2,04,072,Cersot,119,2,121
26,Bourgogne,71,2,05,073,Chagny,5498,157,5655
26,Bourgogne,71,5,08,074,Chaintré,528,25,553
26,Bourgogne,71,3,03,075,Chalmoux,716,9,725
26,Bourgogne,71,2,98,076,Chalon-sur-Saône,46017,1708,47725
26,Bourgogne,71,3,28,077,Chambilly,532,6,538
26,Bourgogne,71,2,05,078,Chamilly,121,4,125
26,Bourgogne,71,4,15,079,Champagnat,503,4,507
26,Bourgogne,71,2,47,080,Champagny-sous-Uxelles,77,1,78
26,Bourgogne,71,2,53,081,Champforgeuil,2248,62,2310
26,Bourgogne,71,3,09,082,Champlecy,237,9,246
26,Bourgogne,71,5,08,084,Chânes,527,28,555
26,Bourgogne,71,1,18,085,Change,233,10,243
26,Bourgogne,71,3,09,086,Changy,440,15,455
26,Bourgogne,71,5,41,087,Chapaize,140,4,144
26,Bourgogne,71,3,20,088,La Chapelle-au-Mans,268,7,275
26,Bourgogne,71,2,47,089,La Chapelle-de-Bragny,239,6,245
26,Bourgogne,71,5,08,090,La Chapelle-de-Guinchay,3583,79,3662
26,Bourgogne,71,5,29,091,La Chapelle-du-Mont-de-France,168,3,171
26,Bourgogne,71,4,23,092,La Chapelle-Naude,514,19,533
26,Bourgogne,71,4,39,093,La Chapelle-Saint-Sauveur,703,23,726
26,Bourgogne,71,5,49,094,La Chapelle-sous-Brancion,123,7,130
26,Bourgogne,71,3,11,095,La Chapelle-sous-Dun,417,13,430
26,Bourgogne,71,1,30,096,La Chapelle-sous-Uchon,189,10,199
26,Bourgogne,71,4,34,097,La Chapelle-Thècle,484,16,500
26,Bourgogne,71,1,30,098,Charbonnat,234,4,238
26,Bourgogne,71,5,26,099,Charbonnières,338,17,355
26,Bourgogne,71,5,25,100,Chardonnay,175,9,184
26,Bourgogne,71,4,39,101,Charette-Varennes,374,8,382
26,Bourgogne,71,2,07,102,La Charmée,677,27,704
26,Bourgogne,71,1,32,103,Charmoy,262,8,270
26,Bourgogne,71,2,51,104,Charnay-lès-Chalon,178,6,184
26,Bourgogne,71,5,55,105,Charnay-lès-Mâcon,6832,360,7192
26,Bourgogne,71,3,09,106,Charolles,2837,288,3125
26,Bourgogne,71,2,19,107,Charrecey,300,8,308
26,Bourgogne,71,5,08,108,Chasselas,161,1,162
26,Bourgogne,71,2,05,109,Chassey-le-Camp,319,4,323
26,Bourgogne,71,3,10,110,Chassigny-sous-Dun,591,20,611
26,Bourgogne,71,3,20,111,Chassy,353,12,365
26,Bourgogne,71,5,12,112,Château,233,12,245
26,Bourgogne,71,3,10,113,Châteauneuf,103,1,104
26,Bourgogne,71,2,19,115,Châtel-Moron,78,2,80
26,Bourgogne,71,3,11,116,Châtenay,162,8,170
26,Bourgogne,71,2,07,117,Châtenoy-en-Bresse,928,18,946
26,Bourgogne,71,2,57,118,Châtenoy-le-Royal,5987,184,6171
26,Bourgogne,71,2,05,119,Chaudenay,978,30,1008
26,Bourgogne,71,3,10,120,Chauffailles,3962,97,4059
26,Bourgogne,71,4,39,121,La Chaux,298,14,312
26,Bourgogne,71,1,13,122,Cheilly-lès-Maranges,497,10,507
26,Bourgogne,71,3,28,123,Chenay-le-Châtel,395,11,406
26,Bourgogne,71,2,04,124,Chenôves,220,6,226
26,Bourgogne,71,5,12,125,Chérizet,32,0,32
26,Bourgogne,71,5,26,126,Chevagny-les-Chevrières,618,30,648
26,Bourgogne,71,3,21,127,Chevagny-sur-Guye,74,4,78
26,Bourgogne,71,3,40,128,Chiddes,72,0,72
26,Bourgogne,71,1,24,129,Chissey-en-Morvan,304,9,313
26,Bourgogne,71,5,41,130,Chissey-lès-Mâcon,246,6,252
26,Bourgogne,71,2,51,131,Ciel,702,19,721
26,Bourgogne,71,3,48,132,Ciry-le-Noble,2403,63,2466
26,Bourgogne,71,3,11,133,La Clayette,1897,75,1972
26,Bourgogne,71,5,50,134,Clermain,222,4,226
26,Bourgogne,71,5,25,135,Clessé,828,21,849
26,Bourgogne,71,3,20,136,Clessy,264,13,277
26,Bourgogne,71,5,12,137,Cluny,4604,298,4902
26,Bourgogne,71,2,51,138,Clux,105,0,105
26,Bourgogne,71,3,21,139,Collonge-en-Charollais,123,0,123
26,Bourgogne,71,1,18,140,Collonge-la-Madeleine,62,1,63
26,Bourgogne,71,3,11,141,Colombier-en-Brionnais,293,5,298
26,Bourgogne,71,1,44,142,La Comelle,185,3,188
26,Bourgogne,71,4,15,143,Condal,415,7,422
26,Bourgogne,71,1,24,144,Cordesse,196,5,201
26,Bourgogne,71,5,41,145,Cormatin,533,8,541
26,Bourgogne,71,5,12,146,Cortambert,206,8,214
26,Bourgogne,71,5,41,147,Cortevaix,264,1,265
26,Bourgogne,71,3,10,148,Coublanc,886,27,913
26,Bourgogne,71,1,13,149,Couches,1502,28,1530
26,Bourgogne,71,5,08,150,Crêches-sur-Saône,2830,105,2935
26,Bourgogne,71,1,18,151,Créot,79,2,81
26,Bourgogne,71,1,22,152,Cressy-sur-Somme,232,5,237
26,Bourgogne,71,1,96,153,Le Creusot,23207,480,23687
26,Bourgogne,71,2,53,154,Crissey,2368,82,2450
26,Bourgogne,71,3,03,155,Cronat,575,12,587
26,Bourgogne,71,5,25,156,Cruzille,229,69,298
26,Bourgogne,71,4,15,157,Cuiseaux,1765,40,1805
26,Bourgogne,71,4,16,158,Cuisery,1629,46,1675
26,Bourgogne,71,2,04,159,Culles-les-Roches,183,7,190
26,Bourgogne,71,3,11,160,Curbigny,310,15,325
26,Bourgogne,71,3,20,161,Curdin,318,7,325
26,Bourgogne,71,1,52,162,Curgy,1113,42,1155
26,Bourgogne,71,5,12,163,Curtil-sous-Buffières,75,1,76
26,Bourgogne,71,5,41,164,Curtil-sous-Burnand,125,2,127
26,Bourgogne,71,1,24,165,Cussy-en-Morvan,460,11,471
26,Bourgogne,71,1,22,166,Cuzy,139,6,145
26,Bourgogne,71,2,45,167,Damerey,557,9,566
26,Bourgogne,71,4,39,168,Dampierre-en-Bresse,160,0,160
26,Bourgogne,71,5,27,169,Davayé,688,81,769
26,Bourgogne,71,2,05,170,Demigny,1740,40,1780
26,Bourgogne,71,2,05,171,Dennevy,324,5,329
26,Bourgogne,71,1,30,172,Dettey,97,3,100
26,Bourgogne,71,4,42,173,Devrouze,277,7,284
26,Bourgogne,71,1,13,174,Dezize-lès-Maranges,199,7,206
26,Bourgogne,71,4,42,175,Diconne,299,2,301
26,Bourgogne,71,3,17,176,Digoin,8596,321,8917
26,Bourgogne,71,4,15,177,Dommartin-lès-Cuiseaux,769,13,782
26,Bourgogne,71,5,29,178,Dompierre-les-Ormes,886,19,905
26,Bourgogne,71,3,48,179,Dompierre-sous-Sanvignes,71,1,72
26,Bourgogne,71,5,12,180,Donzy-le-National,182,9,191
26,Bourgogne,71,5,12,181,Donzy-le-Pertuis,165,2,167
26,Bourgogne,71,2,19,182,Dracy-le-Fort,1324,68,1392
26,Bourgogne,71,1,13,183,Dracy-lès-Couches,171,10,181
26,Bourgogne,71,1,01,184,Dracy-Saint-Loup,566,16,582
26,Bourgogne,71,3,11,185,Dyo,335,11,346
26,Bourgogne,71,2,51,186,Écuelles,207,2,209
26,Bourgogne,71,2,33,187,Écuisses,1688,41,1729
26,Bourgogne,71,1,18,188,Épertully,59,0,59
26,Bourgogne,71,2,07,189,Épervans,1616,35,1651
26,Bourgogne,71,1,18,190,Épinac,2374,60,2434
26,Bourgogne,71,1,13,191,Essertenne,421,23,444
26,Bourgogne,71,1,44,192,Étang-sur-Arroux,1947,123,2070
26,Bourgogne,71,2,47,193,Étrigny,446,16,462
26,Bourgogne,71,2,53,194,Farges-lès-Chalon,718,29,747
26,Bourgogne,71,5,49,195,Farges-lès-Mâcon,179,7,186
26,Bourgogne,71,4,02,196,Le Fay,607,9,616
26,Bourgogne,71,4,15,198,Flacey-en-Bresse,363,6,369
26,Bourgogne,71,5,12,199,Flagy,177,5,182
26,Bourgogne,71,5,25,591,Fleurville,463,13,476
26,Bourgogne,71,3,46,200,Fleury-la-Montagne,620,13,633
26,Bourgogne,71,2,04,201,Fley,244,1,245
26,Bourgogne,71,2,05,202,Fontaines,2002,350,2352
26,Bourgogne,71,3,09,203,Fontenay,42,1,43
26,Bourgogne,71,2,53,204,Fragnes,1008,41,1049
26,Bourgogne,71,4,42,205,Frangy-en-Bresse,615,12,627
26,Bourgogne,71,4,35,206,La Frette,207,3,210
26,Bourgogne,71,4,39,207,Fretterans,291,7,298
26,Bourgogne,71,4,39,208,Frontenard,231,7,238
26,Bourgogne,71,4,15,209,Frontenaud,732,20,752
26,Bourgogne,71,5,27,210,Fuissé,347,7,354
26,Bourgogne,71,3,48,212,Génelard,1441,56,1497
26,Bourgogne,71,4,16,213,La Genête,543,12,555
26,Bourgogne,71,2,36,214,Genouilly,416,15,431
26,Bourgogne,71,2,51,215,Gergy,2514,63,2577
26,Bourgogne,71,2,04,216,Germagny,170,1,171
26,Bourgogne,71,5,50,217,Germolles-sur-Grosne,138,5,143
26,Bourgogne,71,3,11,218,Gibles,643,23,666
26,Bourgogne,71,2,47,219,Gigny-sur-Saône,520,17,537
26,Bourgogne,71,3,03,220,Gilly-sur-Loire,480,14,494
26,Bourgogne,71,2,19,221,Givry,3719,178,3897
26,Bourgogne,71,2,36,222,Gourdon,882,36,918
26,Bourgogne,71,1,44,223,La Grande-Verrière,535,13,548
26,Bourgogne,71,3,37,224,Grandvaux,83,3,86
26,Bourgogne,71,2,19,225,Granges,512,10,522
26,Bourgogne,71,5,25,226,Grevilly,35,1,36
26,Bourgogne,71,1,22,227,Grury,552,8,560
26,Bourgogne,71,2,45,228,Guerfand,162,0,162
26,Bourgogne,71,3,17,229,Les Guerreaux,259,6,265
26,Bourgogne,71,3,20,230,Gueugnon,7791,307,8098
26,Bourgogne,71,3,21,231,La Guiche,635,15,650
26,Bourgogne,71,3,38,232,Hautefond,212,11,223
26,Bourgogne,71,3,38,233,L' Hôpital-le-Mercier,308,5,313
26,Bourgogne,71,4,16,234,Huilly-sur-Seille,293,1,294
26,Bourgogne,71,5,26,235,Hurigny,1834,97,1931
26,Bourgogne,71,5,26,236,Igé,873,27,900
26,Bourgogne,71,1,24,237,Igornay,502,7,509
26,Bourgogne,71,3,46,238,Iguerande,1015,37,1052
26,Bourgogne,71,1,22,239,Issy-l'Évêque,856,25,881
26,Bourgogne,71,5,12,240,Jalogny,316,6,322
26,Bourgogne,71,2,19,241,Jambles,486,17,503
26,Bourgogne,71,3,21,242,Joncy,519,11,530
26,Bourgogne,71,4,15,243,Joudes,412,10,422
26,Bourgogne,71,4,16,244,Jouvençon,420,9,429
26,Bourgogne,71,2,47,245,Jugy,301,3,304
26,Bourgogne,71,4,35,246,Juif,252,3,255
26,Bourgogne,71,2,04,247,Jully-lès-Buxy,347,9,356
26,Bourgogne,71,5,49,248,Lacrost,608,16,624
26,Bourgogne,71,2,47,249,Laives,999,32,1031
26,Bourgogne,71,5,26,250,Laizé,1017,35,1052
26,Bourgogne,71,1,30,251,Laizy,641,19,660
26,Bourgogne,71,2,47,252,Lalheue,360,12,372
26,Bourgogne,71,2,07,253,Lans,880,31,911
26,Bourgogne,71,4,39,254,Lays-sur-le-Doubs,124,1,125
26,Bourgogne,71,3,03,255,Lesme,182,6,188
26,Bourgogne,71,2,43,256,Lessard-en-Bresse,506,6,512
26,Bourgogne,71,2,05,257,Lessard-le-National,624,26,650
26,Bourgogne,71,5,08,258,Leynes,483,29,512
26,Bourgogne,71,3,46,259,Ligny-en-Brionnais,348,19,367
26,Bourgogne,71,4,16,261,Loisy,573,10,583
26,Bourgogne,71,2,51,262,Longepierre,175,2,177
26,Bourgogne,71,4,23,263,Louhans,6435,409,6844
26,Bourgogne,71,5,12,264,Lournand,349,10,359
26,Bourgogne,71,2,53,265,La Loyère,493,13,506
26,Bourgogne,71,1,24,266,Lucenay-l'Évêque,392,7,399
26,Bourgogne,71,5,25,267,Lugny,914,86,1000
26,Bourgogne,71,3,09,268,Lugny-lès-Charolles,335,11,346
26,Bourgogne,71,2,07,269,Lux,1676,48,1724
26,Bourgogne,71,5,99,270,Mâcon,34298,1145,35443
26,Bourgogne,71,3,46,271,Mailly,169,10,179
26,Bourgogne,71,5,41,272,Malay,253,7,260
26,Bourgogne,71,3,03,273,Maltat,279,12,291
26,Bourgogne,71,2,47,274,Mancey,388,10,398
26,Bourgogne,71,3,28,275,Marcigny,1898,47,1945
26,Bourgogne,71,3,09,276,Marcilly-la-Gueurce,129,4,133
26,Bourgogne,71,2,04,277,Marcilly-lès-Buxy,606,15,621
26,Bourgogne,71,2,36,278,Marigny,136,3,139
26,Bourgogne,71,3,21,279,Marizy,462,17,479
26,Bourgogne,71,1,22,280,Marly-sous-Issy,101,3,104
26,Bourgogne,71,3,48,281,Marly-sur-Arroux,340,16,356
26,Bourgogne,71,1,32,282,Marmagne,1252,38,1290
26,Bourgogne,71,2,07,283,Marnay,477,6,483
26,Bourgogne,71,5,49,284,Martailly-lès-Brancion,113,3,116
26,Bourgogne,71,3,37,285,Martigny-le-Comte,427,8,435
26,Bourgogne,71,2,36,286,Mary,219,3,222
26,Bourgogne,71,5,12,287,Massilly,372,14,386
26,Bourgogne,71,5,12,288,Massy,56,1,57
26,Bourgogne,71,5,29,289,Matour,1081,13,1094
26,Bourgogne,71,5,12,290,Mazille,407,46,453
26,Bourgogne,71,3,28,291,Melay,872,22,894
26,Bourgogne,71,2,19,292,Mellecey,1221,51,1272
26,Bourgogne,71,4,34,293,Ménetreuil,353,4,357
26,Bourgogne,71,2,19,294,Mercurey,1322,181,1503
26,Bourgogne,71,4,42,295,Mervans,1353,16,1369
26,Bourgogne,71,2,04,296,Messey-sur-Grosne,741,26,767
26,Bourgogne,71,1,30,297,Mesvres,820,18,838
26,Bourgogne,71,5,26,299,Milly-Lamartine,308,24,332
26,Bourgogne,71,4,15,300,Le Miroir,553,13,566
26,Bourgogne,71,3,03,301,Mont,190,2,192
26,Bourgogne,71,2,51,315,Mont-lès-Seurre,153,0,153
26,Bourgogne,71,2,36,320,Mont-Saint-Vincent,325,11,336
26,Bourgogne,71,2,04,302,Montagny-lès-Buxy,220,8,228
26,Bourgogne,71,4,23,303,Montagny-près-Louhans,452,9,461
26,Bourgogne,71,5,29,304,Montagny-sur-Grosne,89,2,91
26,Bourgogne,71,5,25,305,Montbellet,771,22,793
26,Bourgogne,71,2,97,306,Montceau-les-Mines,19692,515,20207
26,Bourgogne,71,3,28,307,Montceaux-l'Étoile,260,17,277
26,Bourgogne,71,2,47,308,Montceaux-Ragny,37,11,48
26,Bourgogne,71,1,32,309,Montcenis,2200,63,2263
26,Bourgogne,71,2,33,310,Montchanin,5490,101,5591
26,Bourgogne,71,4,02,311,Montcony,278,5,283
26,Bourgogne,71,2,45,312,Montcoy,277,2,279
26,Bourgogne,71,1,01,313,Monthelon,393,13,406
26,Bourgogne,71,4,39,314,Montjay,192,6,198
26,Bourgogne,71,5,29,316,Montmelard,315,9,324
26,Bourgogne,71,1,22,317,Montmort,188,2,190
26,Bourgogne,71,4,34,318,Montpont-en-Bresse,1052,23,1075
26,Bourgogne,71,4,35,319,Montret,724,8,732
26,Bourgogne,71,2,19,321,Morey,188,3,191
26,Bourgogne,71,1,18,322,Morlet,55,3,58
26,Bourgogne,71,3,40,323,Mornay,126,5,131
26,Bourgogne,71,2,04,324,Moroges,575,23,598
26,Bourgogne,71,3,17,325,La Motte-Saint-Jean,1207,46,1253
26,Bourgogne,71,4,39,326,Mouthier-en-Bresse,401,7,408
26,Bourgogne,71,3,10,327,Mussy-sous-Dun,374,10,384
26,Bourgogne,71,2,47,328,Nanton,580,13,593
26,Bourgogne,71,2,51,329,Navilly,417,4,421
26,Bourgogne,71,3,20,330,Neuvy-Grandchamp,801,29,830
26,Bourgogne,71,3,38,331,Nochize,98,1,99
26,Bourgogne,71,4,16,332,Ormes,504,9,513
26,Bourgogne,71,2,07,333,Oslon,1290,32,1322
26,Bourgogne,71,3,37,334,Oudry,380,8,388
26,Bourgogne,71,3,11,335,Ouroux-sous-le-Bois-Sainte-Marie,69,2,71
26,Bourgogne,71,2,43,336,Ouroux-sur-Saône,2889,53,2942
26,Bourgogne,71,3,46,337,Oyé,293,11,304
26,Bourgogne,71,5,49,338,Ozenay,214,7,221
26,Bourgogne,71,3,09,339,Ozolles,436,17,453
26,Bourgogne,71,3,37,340,Palinges,1498,40,1538
26,Bourgogne,71,2,51,341,Palleau,188,2,190
26,Bourgogne,71,3,38,342,Paray-le-Monial,9123,464,9587
26,Bourgogne,71,1,13,343,Paris-l'Hôpital,208,13,221
26,Bourgogne,71,5,41,344,Passy,68,0,68
26,Bourgogne,71,5,25,345,Péronne,512,16,528
26,Bourgogne,71,3,48,346,Perrecy-les-Forges,1721,38,1759
26,Bourgogne,71,1,13,347,Perreuil,467,7,474
26,Bourgogne,71,3,03,348,Perrigny-sur-Loire,151,1,152
26,Bourgogne,71,1,24,349,La Petite-Verrière,52,0,52
26,Bourgogne,71,4,39,351,Pierre-de-Bresse,1967,59,2026
26,Bourgogne,71,5,50,350,Pierreclos,928,23,951
26,Bourgogne,71,4,42,352,Le Planois,98,0,98
26,Bourgogne,71,5,49,353,Plottes,589,15,604
26,Bourgogne,71,3,38,354,Poisson,581,22,603
26,Bourgogne,71,2,51,355,Pontoux,228,5,233
26,Bourgogne,71,3,21,356,Pouilloux,982,25,1007
26,Bourgogne,71,4,39,357,Pourlans,206,3,209
26,Bourgogne,71,3,40,358,Pressy-sous-Dondin,97,2,99
26,Bourgogne,71,5,49,359,Préty,553,32,585
26,Bourgogne,71,5,27,360,Prissé,1738,52,1790
26,Bourgogne,71,3,09,361,Prizy,65,1,66
26,Bourgogne,71,5,08,362,Pruzilly,240,8,248
26,Bourgogne,71,2,36,363,Le Puley,97,5,102
26,Bourgogne,71,4,39,364,La Racineuse,152,2,154
26,Bourgogne,71,4,16,365,Rancy,546,8,554
26,Bourgogne,71,5,49,366,Ratenelle,367,9,376
26,Bourgogne,71,4,23,367,Ratte,385,6,391
26,Bourgogne,71,1,24,368,Reclesne,306,13,319
26,Bourgogne,71,2,05,369,Remigny,435,10,445
26,Bourgogne,71,3,20,370,Rigny-sur-Arroux,610,13,623
26,Bourgogne,71,5,26,371,La Roche-Vineuse,1415,64,1479
26,Bourgogne,71,5,08,372,Romanèche-Thorins,1798,54,1852
26,Bourgogne,71,5,49,373,Romenay,1610,34,1644
26,Bourgogne,71,2,19,374,Rosey,161,3,164
26,Bourgogne,71,3,21,375,Le Rousset,253,7,260
26,Bourgogne,71,1,24,376,Roussillon-en-Morvan,283,4,287
26,Bourgogne,71,5,49,377,Royer,120,7,127
26,Bourgogne,71,2,05,378,Rully,1586,34,1620
26,Bourgogne,71,4,02,379,Sagy,1201,16,1217
26,Bourgogne,71,4,02,380,Saillenard,702,4,706
26,Bourgogne,71,5,41,381,Sailly,79,0,79
26,Bourgogne,71,3,17,382,Saint-Agnan,688,16,704
26,Bourgogne,71,5,25,383,Saint-Albain,520,18,538
26,Bourgogne,71,2,47,384,Saint-Ambreuil,534,17,551
26,Bourgogne,71,5,08,385,Saint-Amour-Bellevue,542,8,550
26,Bourgogne,71,4,35,386,Saint-André-en-Bresse,101,1,102
26,Bourgogne,71,5,12,387,Saint-André-le-Désert,264,9,273
26,Bourgogne,71,3,37,388,Saint-Aubin-en-Charollais,431,13,444
26,Bourgogne,71,3,03,389,Saint-Aubin-sur-Loire,306,6,312
26,Bourgogne,71,1,32,390,Saint-Berain-sous-Sanvignes,1030,41,1071
26,Bourgogne,71,2,19,391,Saint-Bérain-sur-Dheune,566,10,576
26,Bourgogne,71,2,04,392,Saint-Boil,461,13,474
26,Bourgogne,71,3,46,393,Saint-Bonnet-de-Cray,419,9,428
26,Bourgogne,71,3,40,394,Saint-Bonnet-de-Joux,811,31,842
26,Bourgogne,71,3,37,395,Saint-Bonnet-de-Vieille-Vigne,193,4,197
26,Bourgogne,71,4,39,396,Saint-Bonnet-en-Bresse,462,18,480
26,Bourgogne,71,2,43,398,Saint-Christophe-en-Bresse,947,13,960
26,Bourgogne,71,3,46,399,Saint-Christophe-en-Brionnais,485,23,508
26,Bourgogne,71,2,36,400,Saint-Clément-sur-Guye,126,10,136
26,Bourgogne,71,2,47,402,Saint-Cyr,686,15,701
26,Bourgogne,71,2,19,403,Saint-Denis-de-Vaux,260,7,267
26,Bourgogne,71,2,19,404,Saint-Désert,898,35,933
26,Bourgogne,71,2,45,405,Saint-Didier-en-Bresse,164,6,170
26,Bourgogne,71,3,46,406,Saint-Didier-en-Brionnais,146,1,147
26,Bourgogne,71,1,44,407,Saint-Didier-sur-Arroux,247,8,255
26,Bourgogne,71,3,10,408,Saint-Edmond,365,5,370
26,Bourgogne,71,1,13,409,Saint-Émiland,315,5,320
26,Bourgogne,71,4,35,410,Saint-Étienne-en-Bresse,822,21,843
26,Bourgogne,71,1,30,411,Saint-Eugène,174,6,180
26,Bourgogne,71,2,33,412,Saint-Eusèbe,1091,32,1123
26,Bourgogne,71,1,14,413,Saint-Firmin,776,30,806
26,Bourgogne,71,1,01,414,Saint-Forgeot,512,18,530
26,Bourgogne,71,5,25,416,Saint-Gengoux-de-Scissé,590,10,600
26,Bourgogne,71,5,41,417,Saint-Gengoux-le-National,1053,37,1090
26,Bourgogne,71,4,42,419,Saint-Germain-du-Bois,1912,62,1974
26,Bourgogne,71,2,43,420,Saint-Germain-du-Plain,2119,51,2170
26,Bourgogne,71,3,11,421,Saint-Germain-en-Brionnais,179,5,184
26,Bourgogne,71,2,04,422,Saint-Germain-lès-Buxy,266,6,272
26,Bourgogne,71,2,51,423,Saint-Gervais-en-Vallière,386,6,392
26,Bourgogne,71,1,18,424,Saint-Gervais-sur-Couches,202,3,205
26,Bourgogne,71,2,05,425,Saint-Gilles,318,5,323
26,Bourgogne,71,5,41,427,Saint-Huruge,66,0,66
26,Bourgogne,71,3,10,428,Saint-Igny-de-Roche,671,15,686
26,Bourgogne,71,1,13,431,Saint-Jean-de-Trézy,304,9,313
26,Bourgogne,71,2,19,430,Saint-Jean-de-Vaux,386,13,399
26,Bourgogne,71,3,09,433,Saint-Julien-de-Civry,508,19,527
26,Bourgogne,71,3,46,434,Saint-Julien-de-Jonzy,277,13,290
26,Bourgogne,71,2,33,435,Saint-Julien-sur-Dheune,238,1,239
26,Bourgogne,71,2,33,436,Saint-Laurent-d'Andenay,1065,28,1093
26,Bourgogne,71,3,11,437,Saint-Laurent-en-Brionnais,370,25,395
26,Bourgogne,71,1,18,438,Saint-Léger-du-Bois,542,15,557
26,Bourgogne,71,3,38,439,Saint-Léger-lès-Paray,590,20,610
26,Bourgogne,71,1,44,440,Saint-Léger-sous-Beuvray,483,8,491
26,Bourgogne,71,5,50,441,Saint-Léger-sous-la-Bussière,272,9,281
26,Bourgogne,71,2,05,442,Saint-Léger-sur-Dheune,1523,39,1562
26,Bourgogne,71,2,07,444,Saint-Loup-de-Varennes,1124,31,1155
26,Bourgogne,71,2,51,443,Saint-Loup-Géanges,1497,31,1528
26,Bourgogne,71,2,07,445,Saint-Marcel,5816,248,6064
26,Bourgogne,71,3,21,446,Saint-Marcelin-de-Cray,165,1,166
26,Bourgogne,71,2,19,447,Saint-Mard-de-Vaux,281,18,299
26,Bourgogne,71,5,26,448,Saint-Martin-Belle-Roche,1300,31,1331
26,Bourgogne,71,2,04,449,Saint-Martin-d'Auxy,87,4,91
26,Bourgogne,71,1,13,450,Saint-Martin-de-Commune,115,0,115
26,Bourgogne,71,3,10,451,Saint-Martin-de-Lixy,92,2,94
26,Bourgogne,71,3,21,452,Saint-Martin-de-Salencey,92,1,93
26,Bourgogne,71,3,28,453,Saint-Martin-du-Lac,262,12,274
26,Bourgogne,71,4,02,454,Saint-Martin-du-Mont,183,6,189
26,Bourgogne,71,2,04,455,Saint-Martin-du-Tartre,167,5,172
26,Bourgogne,71,2,45,456,Saint-Martin-en-Bresse,1839,54,1893
26,Bourgogne,71,2,51,457,Saint-Martin-en-Gâtinois,118,4,122
26,Bourgogne,71,3,21,458,Saint-Martin-la-Patrouille,51,1,52
26,Bourgogne,71,2,19,459,Saint-Martin-sous-Montaigu,338,19,357
26,Bourgogne,71,5,25,460,Saint-Maurice-de-Satonnay,417,10,427
26,Bourgogne,71,2,04,461,Saint-Maurice-des-Champs,60,4,64
26,Bourgogne,71,2,45,462,Saint-Maurice-en-Rivière,553,10,563
26,Bourgogne,71,3,10,463,Saint-Maurice-lès-Châteauneuf,571,16,587
26,Bourgogne,71,1,13,464,Saint-Maurice-lès-Couches,185,1,186
26,Bourgogne,71,2,36,465,Saint-Micaud,244,7,251
26,Bourgogne,71,1,30,466,Saint-Nizier-sur-Arroux,117,2,119
26,Bourgogne,71,1,13,468,Saint-Pierre-de-Varennes,829,32,861
26,Bourgogne,71,5,50,469,Saint-Pierre-le-Vieux,339,14,353
26,Bourgogne,71,5,50,470,Saint-Point,335,14,349
26,Bourgogne,71,2,04,471,Saint-Privé,85,0,85
26,Bourgogne,71,1,44,472,Saint-Prix,218,9,227
26,Bourgogne,71,3,11,473,Saint-Racho,176,5,181
26,Bourgogne,71,2,07,475,Saint-Rémy,5880,224,6104
26,Bourgogne,71,2,36,477,Saint-Romain-sous-Gourdon,503,24,527
26,Bourgogne,71,3,48,478,Saint-Romain-sous-Versigny,119,7,126
26,Bourgogne,71,1,14,479,Saint-Sernin-du-Bois,1789,38,1827
26,Bourgogne,71,1,13,480,Saint-Sernin-du-Plain,621,16,637
26,Bourgogne,71,5,08,481,Saint-Symphorien-d'Ancelles,997,23,1020
26,Bourgogne,71,1,32,482,Saint-Symphorien-de-Marmagne,860,20,880
26,Bourgogne,71,3,11,483,Saint-Symphorien-des-Bois,410,17,427
26,Bourgogne,71,4,23,484,Saint-Usuge,1148,17,1165
26,Bourgogne,71,2,04,485,Saint-Vallerin,264,11,275
26,Bourgogne,71,2,56,486,Saint-Vallier,9042,276,9318
26,Bourgogne,71,5,08,487,Saint-Vérand,183,7,190
26,Bourgogne,71,3,37,490,Saint-Vincent-Bragny,955,40,995
26,Bourgogne,71,5,12,488,Saint-Vincent-des-Prés,116,8,124
26,Bourgogne,71,4,35,489,Saint-Vincent-en-Bresse,480,16,496
26,Bourgogne,71,3,38,491,Saint-Yan,1118,35,1153
26,Bourgogne,71,5,41,492,Saint-Ythaire,124,9,133
26,Bourgogne,71,5,12,397,Sainte-Cécile,278,11,289
26,Bourgogne,71,4,34,401,Sainte-Croix,560,9,569
26,Bourgogne,71,3,46,415,Sainte-Foy,133,6,139
26,Bourgogne,71,2,04,426,Sainte-Hélène,433,13,446
26,Bourgogne,71,1,22,474,Sainte-Radegonde,175,1,176
26,Bourgogne,71,1,18,493,Saisy,316,11,327
26,Bourgogne,71,5,25,494,La Salle,510,17,527
26,Bourgogne,71,5,12,495,Salornay-sur-Guye,818,25,843
26,Bourgogne,71,1,13,496,Sampigny-lès-Maranges,155,8,163
26,Bourgogne,71,5,26,497,Sancé,1865,86,1951
26,Bourgogne,71,2,04,498,Santilly,139,0,139
26,Bourgogne,71,3,48,499,Sanvignes-les-Mines,4374,95,4469
26,Bourgogne,71,3,46,500,Sarry,122,8,130
26,Bourgogne,71,2,04,501,Sassangy,159,6,165
26,Bourgogne,71,2,53,502,Sassenay,1513,50,1563
26,Bourgogne,71,2,04,503,Saules,125,5,130
26,Bourgogne,71,2,51,504,Saunières,83,2,85
26,Bourgogne,71,2,04,505,Savianges,70,4,74
26,Bourgogne,71,4,02,506,Savigny-en-Revermont,1133,37,1170
26,Bourgogne,71,5,41,507,Savigny-sur-Grosne,173,9,182
26,Bourgogne,71,4,35,508,Savigny-sur-Seille,420,4,424
26,Bourgogne,71,3,46,510,Semur-en-Brionnais,622,25,647
26,Bourgogne,71,2,47,512,Sennecey-le-Grand,3023,61,3084
26,Bourgogne,71,5,26,513,Senozan,1107,28,1135
26,Bourgogne,71,4,42,514,Sens-sur-Seille,333,6,339
26,Bourgogne,71,2,04,515,Sercy,98,4,102
26,Bourgogne,71,4,42,516,Serley,550,3,553
26,Bourgogne,71,2,51,517,Sermesse,209,4,213
26,Bourgogne,71,5,50,518,Serrières,293,13,306
26,Bourgogne,71,4,42,519,Serrigny-en-Bresse,178,2,180
26,Bourgogne,71,2,07,520,Sevrey,1450,34,1484
26,Bourgogne,71,5,41,521,Sigy-le-Châtel,98,0,98
26,Bourgogne,71,4,16,522,Simandre,1566,23,1589
26,Bourgogne,71,4,35,523,Simard,1104,10,1114
26,Bourgogne,71,3,40,524,Sivignon,178,11,189
26,Bourgogne,71,5,26,525,Sologny,514,25,539
26,Bourgogne,71,5,27,526,Solutré-Pouilly,377,16,393
26,Bourgogne,71,1,24,527,Sommant,200,5,205
26,Bourgogne,71,4,23,528,Sornay,1919,56,1975
26,Bourgogne,71,3,40,529,Suin,287,11,298
26,Bourgogne,71,1,18,530,Sully,569,16,585
26,Bourgogne,71,1,30,531,La Tagnière,256,8,264
26,Bourgogne,71,5,41,532,Taizé,177,5,182
26,Bourgogne,71,3,10,533,Tancon,586,13,599
26,Bourgogne,71,4,42,534,Le Tartre,119,3,122
26,Bourgogne,71,1,01,535,Tavernay,520,8,528
26,Bourgogne,71,1,44,537,Thil-sur-Arroux,145,2,147
26,Bourgogne,71,4,42,538,Thurey,393,4,397
26,Bourgogne,71,1,18,539,Tintry,86,2,88
26,Bourgogne,71,1,32,540,Torcy,3065,66,3131
26,Bourgogne,71,4,39,541,Torpes,391,10,401
26,Bourgogne,71,3,48,542,Toulon-sur-Arroux,1595,37,1632
26,Bourgogne,71,5,49,543,Tournus,5951,353,6304
26,Bourgogne,71,2,51,544,Toutenant,187,3,190
26,Bourgogne,71,5,50,545,Tramayes,963,37,1000
26,Bourgogne,71,5,29,546,Trambly,399,9,408
26,Bourgogne,71,5,29,547,Trivy,284,3,287
26,Bourgogne,71,2,43,548,Tronchy,226,0,226
26,Bourgogne,71,5,49,549,La Truchère,215,3,218
26,Bourgogne,71,5,49,550,Uchizy,777,23,800
26,Bourgogne,71,1,30,551,Uchon,97,4,101
26,Bourgogne,71,3,20,552,Uxeau,522,18,540
26,Bourgogne,71,3,11,553,Vareilles,220,5,225
26,Bourgogne,71,3,46,554,Varenne-l'Arconce,128,5,133
26,Bourgogne,71,3,17,557,Varenne-Saint-Germain,670,24,694
26,Bourgogne,71,2,07,555,Varennes-le-Grand,2325,28,2353
26,Bourgogne,71,5,27,556,Varennes-lès-Mâcon,541,22,563
26,Bourgogne,71,4,15,558,Varennes-Saint-Sauveur,1188,21,1209
26,Bourgogne,71,3,11,559,Varennes-sous-Dun,612,26,638
26,Bourgogne,71,3,11,561,Vauban,238,13,251
26,Bourgogne,71,3,09,562,Vaudebarrier,235,39,274
26,Bourgogne,71,2,36,563,Vaux-en-Pré,106,1,107
26,Bourgogne,71,3,09,564,Vendenesse-lès-Charolles,788,14,802
26,Bourgogne,71,3,20,565,Vendenesse-sur-Arroux,606,11,617
26,Bourgogne,71,2,51,566,Verdun-sur-le-Doubs,1137,15,1152
26,Bourgogne,71,5,27,567,Vergisson,241,11,252
26,Bourgogne,71,4,35,568,Vérissey,51,1,52
26,Bourgogne,71,2,51,570,Verjux,495,12,507
26,Bourgogne,71,3,40,571,Verosvres,442,134,576
26,Bourgogne,71,2,47,572,Vers,187,8,195
26,Bourgogne,71,3,38,573,Versaugues,202,7,209
26,Bourgogne,71,5,26,574,Verzé,706,23,729
26,Bourgogne,71,5,49,576,Le Villars,253,8,261
26,Bourgogne,71,2,45,577,Villegaudin,179,0,179
26,Bourgogne,71,2,51,578,La Villeneuve,220,6,226
26,Bourgogne,71,2,04,579,Villeneuve-en-Montagne,142,5,147
26,Bourgogne,71,4,23,580,Vincelles,411,5,416
26,Bourgogne,71,3,28,581,Vindecy,264,7,271
26,Bourgogne,71,5,12,582,La Vineuse,293,8,301
26,Bourgogne,71,5,27,583,Vinzelles,739,33,772
26,Bourgogne,71,5,25,584,Viré,1093,51,1144
26,Bourgogne,71,2,53,585,Virey-le-Grand,1298,75,1373
26,Bourgogne,71,3,09,586,Viry,246,10,256
26,Bourgogne,71,3,38,588,Vitry-en-Charollais,1099,27,1126
26,Bourgogne,71,5,12,587,Vitry-lès-Cluny,64,1,65
26,Bourgogne,71,3,03,589,Vitry-sur-Loire,446,6,452
26,Bourgogne,71,3,38,590,Volesvres,604,26,630
52,Pays de la Loire,72,3,34,001,Aigné,1515,26,1541
52,Pays de la Loire,72,2,11,002,Aillières-Beauvoir,222,9,231
52,Pays de la Loire,72,3,40,003,Allonnes,11122,136,11258
52,Pays de la Loire,72,1,15,004,Amné,476,11,487
52,Pays de la Loire,72,2,29,005,Ancinnes,896,33,929
52,Pays de la Loire,72,2,24,007,Ardenay-sur-Mérize,453,3,456
52,Pays de la Loire,72,3,36,008,Arnage,5131,247,5378
52,Pays de la Loire,72,1,17,009,Arthezé,364,6,370
52,Pays de la Loire,72,2,29,006,Arçonnay,1914,166,2080
52,Pays de la Loire,72,1,27,010,Asnières-sur-Vègre,427,13,440
52,Pays de la Loire,72,2,12,011,Assé-le-Boisne,884,17,901
52,Pays de la Loire,72,2,02,012,Assé-le-Riboul,483,4,487
52,Pays de la Loire,72,1,23,013,Aubigné-Racan,2075,34,2109
52,Pays de la Loire,72,2,11,015,Les Aulneaux,102,1,103
52,Pays de la Loire,72,1,27,016,Auvers-le-Hamon,1521,41,1562
52,Pays de la Loire,72,1,15,017,Auvers-sous-Montfaucon,236,1,237
52,Pays de la Loire,72,2,22,018,Avesnes-en-Saosnois,105,2,107
52,Pays de la Loire,72,1,05,019,Avessé,367,2,369
52,Pays de la Loire,72,2,10,020,Avezé,765,22,787
52,Pays de la Loire,72,1,27,021,Avoise,533,9,542
52,Pays de la Loire,72,1,17,022,Le Bailleul,1170,16,1186
52,Pays de la Loire,72,3,01,023,Ballon,1286,20,1306
52,Pays de la Loire,72,3,34,024,La Bazoge,3617,81,3698
52,Pays de la Loire,72,1,14,025,Bazouges-sur-le-Loir,1186,54,1240
52,Pays de la Loire,72,3,01,026,Beaufay,1342,20,1362
52,Pays de la Loire,72,1,07,028,Beaumont-Pied-de-Boeuf,496,15,511
52,Pays de la Loire,72,1,06,027,Beaumont-sur-Dême,337,8,345
52,Pays de la Loire,72,2,02,029,Beaumont-sur-Sarthe,2116,23,2139
52,Pays de la Loire,72,2,32,031,Beillé,512,3,515
52,Pays de la Loire,72,2,33,032,Berfay,374,5,379
52,Pays de la Loire,72,2,08,033,Bernay-en-Champagne,460,43,503
52,Pays de la Loire,72,2,29,034,Bérus,420,16,436
52,Pays de la Loire,72,2,28,035,Bessé-sur-Braye,2403,50,2453
52,Pays de la Loire,72,2,29,036,Béthon,318,6,324
52,Pays de la Loire,72,2,11,037,Blèves,100,3,103
52,Pays de la Loire,72,2,32,038,Boëssé-le-Sec,642,6,648
52,Pays de la Loire,72,2,03,039,Bonnétable,4087,45,4132
52,Pays de la Loire,72,2,32,040,La Bosse,123,3,126
52,Pays de la Loire,72,2,32,041,Bouër,270,2,272
52,Pays de la Loire,72,2,04,042,Bouloire,2011,73,2084
52,Pays de la Loire,72,2,29,043,Bourg-le-Roi,321,8,329
52,Pays de la Loire,72,1,17,044,Bousse,433,8,441
52,Pays de la Loire,72,1,15,045,Brains-sur-Gée,654,9,663
52,Pays de la Loire,72,2,24,046,Le Breil-sur-Mérize,1424,25,1449
52,Pays de la Loire,72,3,09,047,Brette-les-Pins,2043,111,2154
52,Pays de la Loire,72,2,03,048,Briosne-lès-Sables,496,4,500
52,Pays de la Loire,72,1,16,049,La Bruère-sur-Loir,264,54,318
52,Pays de la Loire,72,1,05,050,Brûlon,1484,34,1518
52,Pays de la Loire,72,1,26,051,Cérans-Foulletourte,3156,48,3204
52,Pays de la Loire,72,1,06,052,Chahaignes,790,25,815
52,Pays de la Loire,72,3,37,053,Challes,1161,22,1183
52,Pays de la Loire,72,2,24,054,Champagné,3628,84,3712
52,Pays de la Loire,72,2,29,056,Champfleur,1405,32,1437
52,Pays de la Loire,72,2,25,057,Champrond,101,4,105
52,Pays de la Loire,72,3,37,058,Changé,5901,207,6108
52,Pays de la Loire,72,1,05,059,Chantenay-Villedieu,881,13,894
52,Pays de la Loire,72,1,16,060,La Chapelle-aux-Choux,278,9,287
52,Pays de la Loire,72,1,14,061,La Chapelle-d'Aligné,1459,22,1481
52,Pays de la Loire,72,2,10,062,La Chapelle-du-Bois,882,21,903
52,Pays de la Loire,72,1,06,063,La Chapelle-Gaugain,321,6,327
52,Pays de la Loire,72,2,28,064,La Chapelle-Huon,529,21,550
52,Pays de la Loire,72,3,34,065,La Chapelle-Saint-Aubin,2162,75,2237
52,Pays de la Loire,72,2,08,066,La Chapelle-Saint-Fray,391,7,398
52,Pays de la Loire,72,2,32,067,La Chapelle-Saint-Rémy,884,13,897
52,Pays de la Loire,72,1,06,068,La Chartre-sur-le-Loir,1460,30,1490
52,Pays de la Loire,72,2,11,069,Chassé,180,4,184
52,Pays de la Loire,72,1,15,070,Chassillé,234,4,238
52,Pays de la Loire,72,1,07,071,Château-du-Loir,4711,217,4928
52,Pays de la Loire,72,1,26,072,Château-l'Hermitage,235,2,237
52,Pays de la Loire,72,3,40,073,Chaufour-Notre-Dame,1078,17,1095
52,Pays de la Loire,72,1,15,074,Chemiré-en-Charnie,201,1,202
52,Pays de la Loire,72,1,31,075,Chemiré-le-Gaudin,934,15,949
52,Pays de la Loire,72,2,11,076,Chenay,184,3,187
52,Pays de la Loire,72,1,16,077,Chenu,441,44,485
52,Pays de la Loire,72,2,02,078,Chérancé,380,6,386
52,Pays de la Loire,72,2,29,079,Chérisay,274,3,277
52,Pays de la Loire,72,2,10,080,Cherré,1657,59,1716
52,Pays de la Loire,72,2,10,081,Cherreau,813,33,846
52,Pays de la Loire,72,2,29,082,Le Chevain,642,18,660
52,Pays de la Loire,72,1,05,083,Chevillé,394,7,401
52,Pays de la Loire,72,1,14,084,Clermont-Créans,1186,9,1195
52,Pays de la Loire,72,2,28,085,Cogners,197,6,203
52,Pays de la Loire,72,2,18,086,Commerveil,132,2,134
52,Pays de la Loire,72,2,28,087,Conflans-sur-Anille,580,4,584
52,Pays de la Loire,72,2,22,088,Congé-sur-Orne,310,7,317
52,Pays de la Loire,72,2,08,089,Conlie,1820,28,1848
52,Pays de la Loire,72,2,24,090,Connerré,2934,28,2962
52,Pays de la Loire,72,2,18,091,Contilly,152,3,155
52,Pays de la Loire,72,2,10,093,Cormes,861,37,898
52,Pays de la Loire,72,2,04,094,Coudrecieux,602,15,617
52,Pays de la Loire,72,3,38,095,Coulaines,7434,184,7618
52,Pays de la Loire,72,1,15,096,Coulans-sur-Gée,1454,92,1546
52,Pays de la Loire,72,2,02,097,Coulombiers,420,6,426
52,Pays de la Loire,72,1,23,098,Coulongé,583,6,589
52,Pays de la Loire,72,3,01,099,Courceboeufs,584,2,586
52,Pays de la Loire,72,1,17,100,Courcelles-la-Forêt,427,9,436
52,Pays de la Loire,72,3,01,101,Courcemont,666,12,678
52,Pays de la Loire,72,2,03,102,Courcival,81,2,83
52,Pays de la Loire,72,1,13,103,Courdemanche,637,6,643
52,Pays de la Loire,72,2,22,104,Courgains,594,9,603
52,Pays de la Loire,72,2,25,105,Courgenard,459,10,469
52,Pays de la Loire,72,1,27,106,Courtillers,850,12,862
52,Pays de la Loire,72,1,15,107,Crannes-en-Champagne,361,6,367
52,Pays de la Loire,72,1,14,108,Cré,807,10,817
52,Pays de la Loire,72,2,30,109,Crissé,538,7,545
52,Pays de la Loire,72,1,14,110,Crosmières,922,26,948
52,Pays de la Loire,72,2,08,111,Cures,543,14,557
52,Pays de la Loire,72,2,22,112,Dangeul,517,7,524
52,Pays de la Loire,72,2,08,113,Degré,719,15,734
52,Pays de la Loire,72,2,10,114,Dehault,279,5,284
52,Pays de la Loire,72,1,07,115,Dissay-sous-Courcillon,992,11,1003
52,Pays de la Loire,72,2,22,116,Dissé-sous-Ballon,130,1,131
52,Pays de la Loire,72,1,16,117,Dissé-sous-le-Lude,573,11,584
52,Pays de la Loire,72,2,33,118,Dollon,1411,18,1429
52,Pays de la Loire,72,2,08,119,Domfront-en-Champagne,972,24,996
52,Pays de la Loire,72,2,02,120,Doucelles,232,3,235
52,Pays de la Loire,72,2,12,121,Douillet,306,7,313
52,Pays de la Loire,72,2,32,122,Duneau,980,17,997
52,Pays de la Loire,72,1,17,123,Dureil,67,0,67
52,Pays de la Loire,72,3,09,124,Écommoy,4644,61,4705
52,Pays de la Loire,72,2,28,125,Écorpain,328,10,338
52,Pays de la Loire,72,1,15,126,Épineu-le-Chevreuil,284,7,291
52,Pays de la Loire,72,1,31,127,Étival-lès-le-Mans,2081,27,2108
52,Pays de la Loire,72,2,28,128,Évaillé,380,7,387
52,Pays de la Loire,72,2,24,129,Fatines,739,12,751
52,Pays de la Loire,72,3,40,130,Fay,600,6,606
52,Pays de la Loire,72,1,31,131,Fercé-sur-Sarthe,628,4,632
52,Pays de la Loire,72,2,10,132,La Ferté-Bernard,9279,345,9624
52,Pays de la Loire,72,1,31,133,Fillé,1522,25,1547
52,Pays de la Loire,72,1,14,154,La Flèche,15359,1052,16411
52,Pays de la Loire,72,1,07,134,Flée,570,10,580
52,Pays de la Loire,72,1,26,135,La Fontaine-Saint-Martin,572,3,575
52,Pays de la Loire,72,1,05,136,Fontenay-sur-Vègre,324,4,328
52,Pays de la Loire,72,2,12,138,Fresnay-sur-Sarthe,2214,33,2247
52,Pays de la Loire,72,2,11,137,La Fresnaye-sur-Chédouet,927,21,948
52,Pays de la Loire,72,2,29,139,Fyé,1023,61,1084
52,Pays de la Loire,72,2,29,141,Gesnes-le-Gandelin,970,21,991
52,Pays de la Loire,72,1,13,143,Le Grand-Lucé,2054,23,2077
52,Pays de la Loire,72,2,29,142,Grandchamp,167,4,171
52,Pays de la Loire,72,2,25,144,Gréez-sur-Roc,398,4,402
52,Pays de la Loire,72,2,30,145,Le Grez,392,18,410
52,Pays de la Loire,72,1,31,146,Guécélard,2674,42,2716
52,Pays de la Loire,72,3,01,147,La Guierche,1110,16,1126
52,Pays de la Loire,72,2,03,148,Jauzé,95,3,98
52,Pays de la Loire,72,1,15,149,Joué-en-Charnie,611,9,620
52,Pays de la Loire,72,3,01,150,Joué-l'Abbé,1214,15,1229
52,Pays de la Loire,72,1,27,151,Juigné-sur-Sarthe,1183,34,1217
52,Pays de la Loire,72,2,02,152,Juillé,456,8,464
52,Pays de la Loire,72,1,07,153,Jupilles,579,18,597
52,Pays de la Loire,72,3,09,155,Laigné-en-Belin,2222,54,2276
52,Pays de la Loire,72,2,25,156,Lamnay,887,21,908
52,Pays de la Loire,72,2,08,157,Lavardin,772,15,787
52,Pays de la Loire,72,2,33,158,Lavaré,835,4,839
52,Pays de la Loire,72,1,06,159,Lavenay,362,8,370
52,Pays de la Loire,72,1,23,160,Lavernat,631,10,641
52,Pays de la Loire,72,1,06,161,Lhomme,965,12,977
52,Pays de la Loire,72,2,11,162,Lignières-la-Carelle,377,9,386
52,Pays de la Loire,72,1,17,163,Ligron,466,8,474
52,Pays de la Loire,72,2,29,164,Livet-en-Saosnois,76,0,76
52,Pays de la Loire,72,2,24,165,Lombron,1962,22,1984
52,Pays de la Loire,72,1,15,166,Longnes,365,4,369
52,Pays de la Loire,72,1,27,167,Louailles,759,5,764
52,Pays de la Loire,72,1,15,168,Loué,2113,38,2151
52,Pays de la Loire,72,1,31,169,Louplande,1522,20,1542
52,Pays de la Loire,72,2,18,170,Louvigny,177,5,182
52,Pays de la Loire,72,2,11,171,Louzes,104,2,106
52,Pays de la Loire,72,2,32,172,Le Luart,1311,32,1343
52,Pays de la Loire,72,2,22,174,Lucé-sous-Ballon,106,2,108
52,Pays de la Loire,72,1,07,173,Luceau,1228,27,1255
52,Pays de la Loire,72,1,16,175,Luché-Pringé,1647,24,1671
52,Pays de la Loire,72,1,16,176,Le Lude,4061,80,4141
52,Pays de la Loire,72,1,05,177,Maigné,344,8,352
52,Pays de la Loire,72,2,04,178,Maisoncelles,198,7,205
52,Pays de la Loire,72,1,17,179,Malicorne-sur-Sarthe,1952,29,1981
52,Pays de la Loire,72,2,18,180,Mamers,5617,220,5837
52,Pays de la Loire,72,3,99,181,Le Mans,143547,4192,147739
52,Pays de la Loire,72,1,26,182,Mansigné,1567,24,1591
52,Pays de la Loire,72,1,05,184,Mareil-en-Champagne,326,17,343
52,Pays de la Loire,72,1,14,185,Mareil-sur-Loir,606,9,615
52,Pays de la Loire,72,2,02,186,Maresché,900,15,915
52,Pays de la Loire,72,3,09,187,Marigné-Laillé,1536,82,1618
52,Pays de la Loire,72,2,22,189,Marolles-les-Braults,2172,63,2235
52,Pays de la Loire,72,2,28,190,Marolles-lès-Saint-Calais,277,15,292
52,Pays de la Loire,72,2,18,188,Marollette,131,9,140
52,Pays de la Loire,72,1,06,183,Marçon,1024,25,1049
52,Pays de la Loire,72,1,23,191,Mayet,3185,48,3233
52,Pays de la Loire,72,2,18,192,Les Mées,95,2,97
52,Pays de la Loire,72,2,25,193,Melleray,492,9,501
52,Pays de la Loire,72,2,22,194,Meurcé,306,12,318
52,Pays de la Loire,72,1,17,195,Mézeray,1739,31,1770
52,Pays de la Loire,72,2,08,197,Mézières-sous-Lavardin,613,9,622
52,Pays de la Loire,72,2,22,196,Mézières-sur-Ponthouin,672,3,675
52,Pays de la Loire,72,3,34,198,La Milesse,2446,56,2502
52,Pays de la Loire,72,2,12,199,Moitron-sur-Sarthe,220,7,227
52,Pays de la Loire,72,3,09,200,Moncé-en-Belin,3326,52,3378
52,Pays de la Loire,72,2,22,201,Moncé-en-Saosnois,269,4,273
52,Pays de la Loire,72,2,22,202,Monhoudou,199,4,203
52,Pays de la Loire,72,2,30,211,Mont-Saint-Jean,649,18,667
52,Pays de la Loire,72,1,07,203,Montabon,776,21,797
52,Pays de la Loire,72,2,28,204,Montaillé,558,7,565
52,Pays de la Loire,72,3,01,205,Montbizot,1630,25,1655
52,Pays de la Loire,72,2,24,241,Montfort-le-Gesnois,3092,49,3141
52,Pays de la Loire,72,2,11,207,Montigny,43,3,46
52,Pays de la Loire,72,2,25,208,Montmirail,412,4,416
52,Pays de la Loire,72,2,12,209,Montreuil-le-Chétif,311,2,313
52,Pays de la Loire,72,1,13,210,Montreuil-le-Henri,251,10,261
52,Pays de la Loire,72,2,29,212,Moulins-le-Carbonnel,727,27,754
52,Pays de la Loire,72,3,09,213,Mulsanne,4499,66,4565
52,Pays de la Loire,72,2,22,214,Nauvay,19,2,21
52,Pays de la Loire,72,2,11,215,Neufchâtel-en-Saosnois,950,13,963
52,Pays de la Loire,72,2,08,216,Neuvillalais,569,8,577
52,Pays de la Loire,72,3,38,217,Neuville-sur-Sarthe,2319,53,2372
52,Pays de la Loire,72,2,30,218,Neuvillette-en-Charnie,291,5,296
52,Pays de la Loire,72,2,08,219,Neuvy-en-Champagne,376,5,381
52,Pays de la Loire,72,2,03,220,Nogent-le-Bernard,877,62,939
52,Pays de la Loire,72,1,07,221,Nogent-sur-Loir,392,6,398
52,Pays de la Loire,72,1,27,232,Notre-Dame-du-Pé,555,2,557
52,Pays de la Loire,72,2,22,222,Nouans,267,3,270
52,Pays de la Loire,72,1,17,223,Noyen-sur-Sarthe,2575,36,2611
52,Pays de la Loire,72,2,24,224,Nuillé-le-Jalais,441,5,446
52,Pays de la Loire,72,2,29,225,Oisseau-le-Petit,694,14,708
52,Pays de la Loire,72,1,26,226,Oizé,1067,11,1078
52,Pays de la Loire,72,2,18,227,Panon,34,1,35
52,Pays de la Loire,72,1,27,228,Parcé-sur-Sarthe,2051,38,2089
52,Pays de la Loire,72,2,30,229,Parennes,547,3,550
52,Pays de la Loire,72,3,37,231,Parigné-l'Évêque,4698,71,4769
52,Pays de la Loire,72,1,31,230,Parigné-le-Pôlin,1050,95,1145
52,Pays de la Loire,72,2,22,233,Peray,54,0,54
52,Pays de la Loire,72,2,30,234,Pezé-le-Robert,362,5,367
52,Pays de la Loire,72,2,02,235,Piacé,361,11,372
52,Pays de la Loire,72,1,27,236,Pincé,197,9,206
52,Pays de la Loire,72,1,05,237,Pirmil,456,7,463
52,Pays de la Loire,72,2,18,238,Pizieux,89,1,90
52,Pays de la Loire,72,1,05,239,Poillé-sur-Vègre,656,16,672
52,Pays de la Loire,72,1,06,240,Poncé-sur-le-Loir,387,12,399
52,Pays de la Loire,72,1,26,243,Pontvallain,1549,16,1565
52,Pays de la Loire,72,1,27,244,Précigné,2896,57,2953
52,Pays de la Loire,72,2,10,245,Préval,635,14,649
52,Pays de la Loire,72,2,32,246,Prévelles,202,3,205
52,Pays de la Loire,72,1,13,248,Pruillé-l'Éguillé,722,10,732
52,Pays de la Loire,72,3,40,247,Pruillé-le-Chétif,1262,26,1288
52,Pays de la Loire,72,2,08,249,La Quinte,818,6,824
52,Pays de la Loire,72,2,28,250,Rahay,195,12,207
52,Pays de la Loire,72,2,22,251,René,363,1,364
52,Pays de la Loire,72,1,26,252,Requeil,1145,16,1161
52,Pays de la Loire,72,1,31,253,Roézé-sur-Sarthe,2646,43,2689
52,Pays de la Loire,72,2,29,254,Rouessé-Fontaine,238,3,241
52,Pays de la Loire,72,2,30,255,Rouessé-Vassé,793,17,810
52,Pays de la Loire,72,2,30,256,Rouez,791,12,803
52,Pays de la Loire,72,3,40,257,Rouillon,2159,171,2330
52,Pays de la Loire,72,2,11,258,Roullée,257,1,258
52,Pays de la Loire,72,2,03,259,Rouperroux-le-Coquet,327,10,337
52,Pays de la Loire,72,3,35,260,Ruaudin,3310,61,3371
52,Pays de la Loire,72,2,08,261,Ruillé-en-Champagne,326,8,334
52,Pays de la Loire,72,1,06,262,Ruillé-sur-Loir,1198,87,1285
52,Pays de la Loire,72,1,27,264,Sablé-sur-Sarthe,12347,529,12876
52,Pays de la Loire,72,2,22,265,Saint-Aignan,246,7,253
52,Pays de la Loire,72,2,12,266,Saint-Aubin-de-Locquenay,694,9,703
52,Pays de la Loire,72,2,10,267,Saint-Aubin-des-Coudrais,958,23,981
52,Pays de la Loire,72,3,09,268,Saint-Biez-en-Belin,698,14,712
52,Pays de la Loire,72,2,28,269,Saint-Calais,3621,212,3833
52,Pays de la Loire,72,2,18,270,Saint-Calez-en-Saosnois,173,3,176
52,Pays de la Loire,72,2,24,271,Saint-Célerin,697,11,708
52,Pays de la Loire,72,2,02,273,Saint-Christophe-du-Jambet,195,6,201
52,Pays de la Loire,72,1,05,274,Saint-Christophe-en-Champagne,196,5,201
52,Pays de la Loire,72,2,24,275,Saint-Corneille,1028,16,1044
52,Pays de la Loire,72,2,18,276,Saint-Cosme-en-Vairais,1986,40,2026
52,Pays de la Loire,72,1,15,278,Saint-Denis-d'Orques,888,13,901
52,Pays de la Loire,72,2,32,277,Saint-Denis-des-Coudrais,117,1,118
52,Pays de la Loire,72,1,13,279,Saint-Georges-de-la-Couée,181,7,188
52,Pays de la Loire,72,3,40,280,Saint-Georges-du-Bois,1786,33,1819
52,Pays de la Loire,72,2,03,281,Saint-Georges-du-Rosay,412,3,415
52,Pays de la Loire,72,2,12,282,Saint-Georges-le-Gaultier,564,14,578
52,Pays de la Loire,72,1,16,283,Saint-Germain-d'Arcé,376,1,377
52,Pays de la Loire,72,2,02,284,Saint-Germain-sur-Sarthe,515,11,526
52,Pays de la Loire,72,2,28,286,Saint-Gervais-de-Vic,382,12,394
52,Pays de la Loire,72,3,09,287,Saint-Gervais-en-Belin,1916,76,1992
52,Pays de la Loire,72,2,32,288,Saint-Hilaire-le-Lierru,139,2,141
52,Pays de la Loire,72,3,01,290,Saint-Jean-d'Assé,1405,23,1428
52,Pays de la Loire,72,1,26,291,Saint-Jean-de-la-Motte,939,20,959
52,Pays de la Loire,72,2,25,292,Saint-Jean-des-Échelles,256,5,261
52,Pays de la Loire,72,1,17,293,Saint-Jean-du-Bois,625,8,633
52,Pays de la Loire,72,2,12,294,Saint-Léonard-des-Bois,530,4,534
52,Pays de la Loire,72,2,18,295,Saint-Longis,515,16,531
52,Pays de la Loire,72,2,25,296,Saint-Maixent,765,9,774
52,Pays de la Loire,72,2,02,297,Saint-Marceau,469,11,480
52,Pays de la Loire,72,3,09,299,Saint-Mars-d'Outillé,2215,22,2237
52,Pays de la Loire,72,2,04,298,Saint-Mars-de-Locquenay,537,3,540
52,Pays de la Loire,72,2,24,300,Saint-Mars-la-Brière,2419,40,2459
52,Pays de la Loire,72,3,01,301,Saint-Mars-sous-Ballon,856,8,864
52,Pays de la Loire,72,2,10,302,Saint-Martin-des-Monts,174,5,179
52,Pays de la Loire,72,2,04,303,Saint-Michel-de-Chavaignes,780,10,790
52,Pays de la Loire,72,2,12,305,Saint-Ouen-de-Mimbré,864,15,879
52,Pays de la Loire,72,3,09,306,Saint-Ouen-en-Belin,1299,10,1309
52,Pays de la Loire,72,1,05,307,Saint-Ouen-en-Champagne,184,4,188
52,Pays de la Loire,72,2,29,308,Saint-Paterne,1591,251,1842
52,Pays de la Loire,72,2,12,309,Saint-Paul-le-Gaultier,284,8,292
52,Pays de la Loire,72,3,38,310,Saint-Pavace,1853,72,1925
52,Pays de la Loire,72,1,07,311,Saint-Pierre-de-Chevillé,358,6,364
52,Pays de la Loire,72,1,05,312,Saint-Pierre-des-Bois,204,2,206
52,Pays de la Loire,72,2,18,313,Saint-Pierre-des-Ormes,224,7,231
52,Pays de la Loire,72,1,13,314,Saint-Pierre-du-Lorouër,375,6,381
52,Pays de la Loire,72,2,30,315,Saint-Rémy-de-Sillé,760,28,788
52,Pays de la Loire,72,2,18,316,Saint-Rémy-des-Monts,685,17,702
52,Pays de la Loire,72,2,18,317,Saint-Rémy-du-Val,570,13,583
52,Pays de la Loire,72,2,11,318,Saint-Rigomer-des-Bois,409,13,422
52,Pays de la Loire,72,3,34,320,Saint-Saturnin,2306,72,2378
52,Pays de la Loire,72,2,08,321,Saint-Symphorien,556,12,568
52,Pays de la Loire,72,2,25,322,Saint-Ulphace,226,6,232
52,Pays de la Loire,72,2,12,323,Saint-Victeur,379,14,393
52,Pays de la Loire,72,2,18,324,Saint-Vincent-des-Prés,487,12,499
52,Pays de la Loire,72,1,13,325,Saint-Vincent-du-Lorouër,915,20,935
52,Pays de la Loire,72,2,28,272,Sainte-Cérotte,325,10,335
52,Pays de la Loire,72,3,01,289,Sainte-Jamme-sur-Sarthe,2065,20,2085
52,Pays de la Loire,72,2,28,304,Sainte-Osmane,192,3,195
52,Pays de la Loire,72,2,08,319,Sainte-Sabine-sur-Longève,645,13,658
52,Pays de la Loire,72,2,18,326,Saosnes,192,6,198
52,Pays de la Loire,72,1,23,327,Sarcé,283,9,292
52,Pays de la Loire,72,3,37,328,Sargé-lès-le-Mans,3605,85,3690
52,Pays de la Loire,72,3,37,329,Savigné-l'Évêque,4033,93,4126
52,Pays de la Loire,72,1,16,330,Savigné-sous-le-Lude,433,10,443
52,Pays de la Loire,72,2,32,331,Sceaux-sur-Huisne,585,13,598
52,Pays de la Loire,72,2,02,332,Ségrie,601,8,609
52,Pays de la Loire,72,2,33,333,Semur-en-Vallon,472,6,478
52,Pays de la Loire,72,2,30,334,Sillé-le-Guillaume,2359,99,2458
52,Pays de la Loire,72,2,24,335,Sillé-le-Philippe,1080,21,1101
52,Pays de la Loire,72,1,27,336,Solesmes,1359,62,1421
52,Pays de la Loire,72,2,12,337,Sougé-le-Ganelon,951,18,969
52,Pays de la Loire,72,3,01,338,Souillé,611,10,621
52,Pays de la Loire,72,1,31,339,Souligné-Flacé,730,12,742
52,Pays de la Loire,72,3,01,340,Souligné-sous-Ballon,1181,19,1200
52,Pays de la Loire,72,2,24,341,Soulitré,677,6,683
52,Pays de la Loire,72,2,10,342,Souvigné-sur-Même,178,8,186
52,Pays de la Loire,72,1,27,343,Souvigné-sur-Sarthe,613,12,625
52,Pays de la Loire,72,1,31,344,Spay,2687,44,2731
52,Pays de la Loire,72,2,24,345,Surfonds,314,11,325
52,Pays de la Loire,72,1,31,346,La Suze-sur-Sarthe,4028,73,4101
52,Pays de la Loire,72,1,05,347,Tassé,302,4,306
52,Pays de la Loire,72,1,15,348,Tassillé,138,1,139
52,Pays de la Loire,72,3,01,349,Teillé,525,13,538
52,Pays de la Loire,72,3,09,350,Teloché,3034,58,3092
52,Pays de la Loire,72,2,08,351,Tennie,1020,25,1045
52,Pays de la Loire,72,2,03,352,Terrehault,117,0,117
52,Pays de la Loire,72,2,10,353,Théligny,206,4,210
52,Pays de la Loire,72,2,22,354,Thoigné,165,2,167
52,Pays de la Loire,72,2,29,355,Thoiré-sous-Contensor,94,1,95
52,Pays de la Loire,72,1,07,356,Thoiré-sur-Dinan,427,10,437
52,Pays de la Loire,72,1,16,357,Thorée-les-Pins,661,21,682
52,Pays de la Loire,72,2,04,358,Thorigné-sur-Dué,1615,36,1651
52,Pays de la Loire,72,2,24,359,Torcé-en-Vallée,1192,7,1199
52,Pays de la Loire,72,3,34,360,Trangé,1424,26,1450
52,Pays de la Loire,72,2,04,361,Tresson,477,5,482
52,Pays de la Loire,72,2,02,362,Le Tronchet,135,3,138
52,Pays de la Loire,72,2,32,363,Tuffé,1574,15,1589
52,Pays de la Loire,72,1,23,364,Vaas,1621,90,1711
52,Pays de la Loire,72,2,33,366,Valennes,364,4,368
52,Pays de la Loire,72,1,15,367,Vallon-sur-Gée,810,8,818
52,Pays de la Loire,72,2,28,368,Vancé,351,7,358
52,Pays de la Loire,72,1,23,369,Verneil-le-Chétif,665,95,760
52,Pays de la Loire,72,2,02,370,Vernie,338,6,344
52,Pays de la Loire,72,2,18,372,Vezot,64,7,71
52,Pays de la Loire,72,2,33,373,Vibraye,2638,33,2671
52,Pays de la Loire,72,2,18,374,Villaines-la-Carelle,175,6,181
52,Pays de la Loire,72,2,10,375,Villaines-la-Gonais,501,11,512
52,Pays de la Loire,72,1,13,376,Villaines-sous-Lucé,700,16,716
52,Pays de la Loire,72,1,17,377,Villaines-sous-Malicorne,977,18,995
52,Pays de la Loire,72,1,27,378,Vion,1369,25,1394
52,Pays de la Loire,72,1,05,379,Viré-en-Champagne,235,5,240
52,Pays de la Loire,72,2,02,380,Vivoin,902,15,917
52,Pays de la Loire,72,1,31,381,Voivres-lès-le-Mans,1169,16,1185
52,Pays de la Loire,72,2,04,382,Volnay,778,14,792
52,Pays de la Loire,72,2,32,383,Vouvray-sur-Huisne,146,4,150
52,Pays de la Loire,72,1,07,384,Vouvray-sur-Loir,822,20,842
52,Pays de la Loire,72,3,37,386,Yvré-l'Évêque,4395,141,4536
52,Pays de la Loire,72,1,26,385,Yvré-le-Pôlin,1896,13,1909
82,Rhône-Alpes,73,2,21,001,Aiguebelette-le-Lac,228,9,237
82,Rhône-Alpes,73,3,01,002,Aiguebelle,1148,8,1156
82,Rhône-Alpes,73,1,20,003,Aigueblanche,3050,86,3136
82,Rhône-Alpes,73,2,13,004,Aillon-le-Jeune,446,11,457
82,Rhône-Alpes,73,2,13,005,Aillon-le-Vieux,171,3,174
82,Rhône-Alpes,73,1,02,006,Aime,3419,110,3529
82,Rhône-Alpes,73,3,01,007,Aiton,1764,17,1781
82,Rhône-Alpes,73,2,97,008,Aix-les-Bains,27095,687,27782
82,Rhône-Alpes,73,2,04,010,Albens,3146,65,3211
82,Rhône-Alpes,73,1,98,011,Albertville,18480,860,19340
82,Rhône-Alpes,73,3,25,012,Albiez-le-Jeune,105,2,107
82,Rhône-Alpes,73,3,25,013,Albiez-Montrond,373,13,386
82,Rhône-Alpes,73,1,05,014,Allondaz,216,4,220
82,Rhône-Alpes,73,1,08,015,Les Allues,1864,55,1919
82,Rhône-Alpes,73,2,18,017,Apremont,952,25,977
82,Rhône-Alpes,73,2,18,018,Arbin,763,10,773
82,Rhône-Alpes,73,3,01,019,Argentine,874,24,898
82,Rhône-Alpes,73,2,13,020,Arith,375,8,383
82,Rhône-Alpes,73,2,22,021,Arvillard,836,18,854
82,Rhône-Alpes,73,2,14,022,Attignat-Oncin,546,13,559
82,Rhône-Alpes,73,3,17,023,Aussois,683,22,705
82,Rhône-Alpes,73,1,20,024,Les Avanchers-Valmorel,760,21,781
82,Rhône-Alpes,73,2,24,025,Avressieux,459,9,468
82,Rhône-Alpes,73,3,17,026,Avrieux,386,19,405
82,Rhône-Alpes,73,2,21,027,Ayn,340,6,346
82,Rhône-Alpes,73,2,29,028,La Balme,230,4,234
82,Rhône-Alpes,73,2,33,029,Barberaz,4673,137,4810
82,Rhône-Alpes,73,2,34,030,Barby,3294,81,3375
82,Rhône-Alpes,73,2,34,031,Bassens,3762,135,3897
82,Rhône-Alpes,73,1,30,032,La Bâthie,2114,87,2201
82,Rhône-Alpes,73,2,14,033,La Bauche,314,7,321
82,Rhône-Alpes,73,1,06,034,Beaufort,2229,73,2302
82,Rhône-Alpes,73,2,13,036,Bellecombe-en-Bauges,632,16,648
82,Rhône-Alpes,73,1,02,038,Bellentre,935,27,962
82,Rhône-Alpes,73,2,21,039,Belmont-Tramonet,532,18,550
82,Rhône-Alpes,73,3,16,040,Bessans,341,11,352
82,Rhône-Alpes,73,2,12,041,Betton-Bettonet,278,2,280
82,Rhône-Alpes,73,2,29,042,Billième,249,2,251
82,Rhône-Alpes,73,2,04,043,La Biolle,2166,54,2220
82,Rhône-Alpes,73,1,20,045,Le Bois,327,17,344
82,Rhône-Alpes,73,1,20,046,Bonneval,112,1,113
82,Rhône-Alpes,73,3,16,047,Bonneval-sur-Arc,246,6,252
82,Rhône-Alpes,73,1,15,048,Bonvillard,336,9,345
82,Rhône-Alpes,73,3,01,049,Bonvillaret,108,1,109
82,Rhône-Alpes,73,2,19,050,Bourdeau,526,15,541
82,Rhône-Alpes,73,1,07,054,Bourg-Saint-Maurice,7749,381,8130
82,Rhône-Alpes,73,2,19,051,Le Bourget-du-Lac,4184,87,4271
82,Rhône-Alpes,73,2,22,052,Bourget-en-Huile,136,8,144
82,Rhône-Alpes,73,2,12,053,Bourgneuf,623,2,625
82,Rhône-Alpes,73,1,08,055,Bozel,2039,58,2097
82,Rhône-Alpes,73,3,16,056,Bramans,383,14,397
82,Rhône-Alpes,73,1,08,057,Brides-les-Bains,566,19,585
82,Rhône-Alpes,73,2,21,058,La Bridoire,1190,29,1219
82,Rhône-Alpes,73,2,32,059,Brison-Saint-Innocent,2129,61,2190
82,Rhône-Alpes,73,1,05,061,Césarches,384,3,387
82,Rhône-Alpes,73,2,04,062,Cessens,405,9,414
82,Rhône-Alpes,73,1,30,063,Cevins,669,11,680
82,Rhône-Alpes,73,2,33,064,Challes-les-Eaux,5077,245,5322
82,Rhône-Alpes,73,2,99,065,Chambéry,56835,1726,58561
82,Rhône-Alpes,73,3,11,067,La Chambre,1169,32,1201
82,Rhône-Alpes,73,2,12,068,Chamousset,537,11,548
82,Rhône-Alpes,73,2,12,069,Chamoux-sur-Gelon,831,19,850
82,Rhône-Alpes,73,2,12,072,Champ-Laurent,30,0,30
82,Rhône-Alpes,73,2,24,070,Champagneux,519,8,527
82,Rhône-Alpes,73,1,08,071,Champagny-en-Vanoise,674,26,700
82,Rhône-Alpes,73,2,23,073,Chanaz,506,8,514
82,Rhône-Alpes,73,3,11,074,La Chapelle,325,8,333
82,Rhône-Alpes,73,2,22,075,La Chapelle-Blanche,554,9,563
82,Rhône-Alpes,73,2,19,076,La Chapelle-du-Mont-du-Chat,251,3,254
82,Rhône-Alpes,73,2,29,078,La Chapelle-Saint-Martin,135,5,140
82,Rhône-Alpes,73,1,07,077,Les Chapelles,502,10,512
82,Rhône-Alpes,73,2,12,079,Châteauneuf,733,14,747
82,Rhône-Alpes,73,3,25,080,Le Châtel,192,9,201
82,Rhône-Alpes,73,2,13,081,Le Châtelard,627,44,671
82,Rhône-Alpes,73,2,18,082,La Chavanne,590,14,604
82,Rhône-Alpes,73,3,11,083,Les Chavannes-en-Maurienne,226,0,226
82,Rhône-Alpes,73,2,18,084,Chignin,785,16,801
82,Rhône-Alpes,73,2,23,085,Chindrieux,1210,31,1241
82,Rhône-Alpes,73,1,15,086,Cléry,401,6,407
82,Rhône-Alpes,73,2,37,087,Cognin,5840,157,5997
82,Rhône-Alpes,73,1,28,088,Cohennoz,169,2,171
82,Rhône-Alpes,73,2,12,089,Coise-Saint-Jean-Pied-Gauthier,1166,12,1178
82,Rhône-Alpes,73,2,13,090,La Compôte,224,6,230
82,Rhône-Alpes,73,2,23,091,Conjux,194,1,195
82,Rhône-Alpes,73,2,14,092,Corbel,134,4,138
82,Rhône-Alpes,73,1,02,093,La Côte-d'Aime,866,27,893
82,Rhône-Alpes,73,1,28,094,Crest-Voland,388,19,407
82,Rhône-Alpes,73,2,22,095,La Croix-de-la-Rochette,256,6,262
82,Rhône-Alpes,73,2,27,096,Cruet,1043,25,1068
82,Rhône-Alpes,73,2,34,097,Curienne,645,30,675
82,Rhône-Alpes,73,2,34,098,Les Déserts,787,12,799
82,Rhône-Alpes,73,2,22,099,Détrier,416,18,434
82,Rhône-Alpes,73,2,21,100,Domessin,1580,41,1621
82,Rhône-Alpes,73,2,13,101,Doucy-en-Bauges,88,4,92
82,Rhône-Alpes,73,2,35,103,Drumettaz-Clarafond,2338,71,2409
82,Rhône-Alpes,73,2,21,104,Dullin,390,13,403
82,Rhône-Alpes,73,2,14,105,Les Échelles,1230,29,1259
82,Rhône-Alpes,73,2,13,106,École,250,1,251
82,Rhône-Alpes,73,2,14,107,Entremont-le-Vieux,580,16,596
82,Rhône-Alpes,73,2,04,108,Épersy,306,21,327
82,Rhône-Alpes,73,3,01,109,Épierre,673,9,682
82,Rhône-Alpes,73,1,30,110,Esserts-Blay,723,16,739
82,Rhône-Alpes,73,2,22,111,Étable,346,18,364
82,Rhône-Alpes,73,1,20,112,Feissons-sur-Isère,561,13,574
82,Rhône-Alpes,73,1,08,113,Feissons-sur-Salins,198,2,200
82,Rhône-Alpes,73,1,28,114,Flumet,865,14,879
82,Rhône-Alpes,73,1,20,115,Fontaine-le-Puits,137,4,141
82,Rhône-Alpes,73,3,25,116,Fontcouverte-la-Toussuire,568,17,585
82,Rhône-Alpes,73,3,17,117,Fourneaux,808,14,822
82,Rhône-Alpes,73,2,18,118,Francin,852,19,871
82,Rhône-Alpes,73,3,17,119,Freney,121,1,122
82,Rhône-Alpes,73,2,27,120,Fréterive,444,8,452
82,Rhône-Alpes,73,1,15,121,Frontenex,1671,39,1710
82,Rhône-Alpes,73,2,24,122,Gerbaix,412,6,418
82,Rhône-Alpes,73,1,28,123,La Giettaz,449,12,461
82,Rhône-Alpes,73,1,30,124,Gilly-sur-Isère,2841,117,2958
82,Rhône-Alpes,73,1,02,126,Granier,378,2,380
82,Rhône-Alpes,73,2,24,127,Gresin,347,9,356
82,Rhône-Alpes,73,2,32,128,Grésy-sur-Aix,3690,82,3772
82,Rhône-Alpes,73,1,15,129,Grésy-sur-Isère,1259,29,1288
82,Rhône-Alpes,73,1,30,130,Grignon,1944,50,1994
82,Rhône-Alpes,73,1,20,131,Hautecour,302,9,311
82,Rhône-Alpes,73,1,06,132,Hauteluce,873,29,902
82,Rhône-Alpes,73,2,12,133,Hauteville,305,7,312
82,Rhône-Alpes,73,3,25,135,Hermillon,531,13,544
82,Rhône-Alpes,73,2,37,137,Jacob-Bellecombette,4244,80,4324
82,Rhône-Alpes,73,3,25,138,Jarrier,467,14,481
82,Rhône-Alpes,73,2,13,139,Jarsy,278,9,287
82,Rhône-Alpes,73,2,29,140,Jongieux,308,6,314
82,Rhône-Alpes,73,2,18,141,Laissaud,604,4,608
82,Rhône-Alpes,73,1,02,142,Landry,721,24,745
82,Rhône-Alpes,73,3,16,143,Lanslebourg-Mont-Cenis,609,23,632
82,Rhône-Alpes,73,3,16,144,Lanslevillard,452,17,469
82,Rhône-Alpes,73,1,20,187,La Léchère,1922,38,1960
82,Rhône-Alpes,73,2,21,145,Lépin-le-Lac,382,11,393
82,Rhône-Alpes,73,2,13,146,Lescheraines,737,15,752
82,Rhône-Alpes,73,2,29,147,Loisieux,179,6,185
82,Rhône-Alpes,73,2,29,149,Lucey,285,3,288
82,Rhône-Alpes,73,1,02,150,Mâcot-la-Plagne,1787,38,1825
82,Rhône-Alpes,73,2,18,151,Les Marches,2458,53,2511
82,Rhône-Alpes,73,2,24,152,Marcieux,174,4,178
82,Rhône-Alpes,73,1,28,153,Marthod,1376,34,1410
82,Rhône-Alpes,73,1,05,154,Mercury,2737,89,2826
82,Rhône-Alpes,73,2,35,155,Méry,1300,30,1330
82,Rhône-Alpes,73,2,29,156,Meyrieux-Trouet,286,6,292
82,Rhône-Alpes,73,3,17,157,Modane,3784,140,3924
82,Rhône-Alpes,73,2,04,158,Mognard,405,7,412
82,Rhône-Alpes,73,2,18,159,Les Mollettes,676,11,687
82,Rhône-Alpes,73,2,37,160,Montagnole,775,10,785
82,Rhône-Alpes,73,1,08,161,Montagny,611,10,621
82,Rhône-Alpes,73,1,15,162,Montailleur,598,20,618
82,Rhône-Alpes,73,3,11,163,Montaimont,155,1,156
82,Rhône-Alpes,73,2,32,164,Montcel,822,80,902
82,Rhône-Alpes,73,2,12,166,Montendry,52,0,52
82,Rhône-Alpes,73,3,11,167,Montgellafrey,65,3,68
82,Rhône-Alpes,73,3,01,168,Montgilbert,124,0,124
82,Rhône-Alpes,73,1,02,169,Montgirod,437,6,443
82,Rhône-Alpes,73,1,30,170,Monthion,450,17,467
82,Rhône-Alpes,73,2,18,171,Montmélian,4057,99,4156
82,Rhône-Alpes,73,3,25,173,Montricher-Albanne,694,26,720
82,Rhône-Alpes,73,3,01,175,Montsapey,73,0,73
82,Rhône-Alpes,73,1,07,176,Montvalezan,676,16,692
82,Rhône-Alpes,73,3,25,177,Montvernier,213,9,222
82,Rhône-Alpes,73,2,13,178,La Motte-en-Bauges,428,8,436
82,Rhône-Alpes,73,2,19,179,La Motte-Servolex,11420,577,11997
82,Rhône-Alpes,73,2,23,180,Motz,382,11,393
82,Rhône-Alpes,73,1,20,181,Moûtiers,3892,414,4306
82,Rhône-Alpes,73,2,35,182,Mouxy,1980,56,2036
82,Rhône-Alpes,73,2,18,183,Myans,1063,30,1093
82,Rhône-Alpes,73,2,21,184,Nances,428,9,437
82,Rhône-Alpes,73,1,28,186,Notre-Dame-de-Bellecombe,501,22,523
82,Rhône-Alpes,73,1,15,188,Notre-Dame-des-Millières,896,23,919
82,Rhône-Alpes,73,3,11,189,Notre-Dame-du-Cruet,190,4,194
82,Rhône-Alpes,73,1,20,190,Notre-Dame-du-Pré,278,15,293
82,Rhône-Alpes,73,2,24,191,Novalaise,1781,41,1822
82,Rhône-Alpes,73,2,13,192,Le Noyer,170,2,172
82,Rhône-Alpes,73,2,29,193,Ontex,85,0,85
82,Rhône-Alpes,73,3,26,194,Orelle,393,9,402
82,Rhône-Alpes,73,1,05,196,Pallud,648,16,664
82,Rhône-Alpes,73,1,02,197,Peisey-Nancroix,648,14,662
82,Rhône-Alpes,73,1,08,198,La Perrière,437,6,443
82,Rhône-Alpes,73,2,18,200,Planaise,501,13,514
82,Rhône-Alpes,73,1,08,201,Planay,430,4,434
82,Rhône-Alpes,73,1,15,202,Plancherine,395,8,403
82,Rhône-Alpes,73,2,21,204,Le Pont-de-Beauvoisin,1950,31,1981
82,Rhône-Alpes,73,3,25,203,Pontamafrey-Montpascal,343,15,358
82,Rhône-Alpes,73,2,22,205,Le Pontet,122,1,123
82,Rhône-Alpes,73,1,08,206,Pralognan-la-Vanoise,732,18,750
82,Rhône-Alpes,73,2,22,207,Presle,447,3,450
82,Rhône-Alpes,73,2,32,208,Pugny-Chatenod,874,41,915
82,Rhône-Alpes,73,2,34,210,Puygros,356,11,367
82,Rhône-Alpes,73,1,06,211,Queige,859,16,875
82,Rhône-Alpes,73,3,01,212,Randens,833,23,856
82,Rhône-Alpes,73,2,33,213,La Ravoire,7234,524,7758
82,Rhône-Alpes,73,2,24,214,Rochefort,206,4,210
82,Rhône-Alpes,73,2,22,215,La Rochette,3372,87,3459
82,Rhône-Alpes,73,1,30,216,Rognaix,429,12,441
82,Rhône-Alpes,73,2,22,217,Rotherens,289,3,292
82,Rhône-Alpes,73,2,23,218,Ruffieux,794,15,809
82,Rhône-Alpes,73,2,21,219,Saint-Alban-de-Montbel,584,15,599
82,Rhône-Alpes,73,3,01,220,Saint-Alban-des-Hurtières,301,18,319
82,Rhône-Alpes,73,3,11,221,Saint-Alban-des-Villards,81,0,81
82,Rhône-Alpes,73,2,34,222,Saint-Alban-Leysse,5626,206,5832
82,Rhône-Alpes,73,3,17,223,Saint-André,466,12,478
82,Rhône-Alpes,73,3,11,224,Saint-Avre,785,11,796
82,Rhône-Alpes,73,2,33,225,Saint-Baldoph,2948,74,3022
82,Rhône-Alpes,73,2,21,226,Saint-Béron,1492,39,1531
82,Rhône-Alpes,73,1,08,227,Saint-Bon-Tarentaise,1920,47,1967
82,Rhône-Alpes,73,2,37,228,Saint-Cassin,750,26,776
82,Rhône-Alpes,73,2,14,229,Saint-Christophe,497,7,504
82,Rhône-Alpes,73,3,11,230,Saint-Colomban-des-Villards,185,1,186
82,Rhône-Alpes,73,3,11,231,Saint-Étienne-de-Cuines,1195,52,1247
82,Rhône-Alpes,73,2,14,233,Saint-Franc,158,9,167
82,Rhône-Alpes,73,2,13,234,Saint-François-de-Sales,137,4,141
82,Rhône-Alpes,73,3,11,235,Saint-François-Longchamp,215,1,216
82,Rhône-Alpes,73,2,24,236,Saint-Genix-sur-Guiers,2172,42,2214
82,Rhône-Alpes,73,3,01,237,Saint-Georges-des-Hurtières,272,3,275
82,Rhône-Alpes,73,2,04,238,Saint-Germain-la-Chambotte,446,3,449
82,Rhône-Alpes,73,2,04,239,Saint-Girod,562,10,572
82,Rhône-Alpes,73,3,25,242,Saint-Jean-d'Arves,265,10,275
82,Rhône-Alpes,73,2,34,243,Saint-Jean-d'Arvey,1447,66,1513
82,Rhône-Alpes,73,1,20,244,Saint-Jean-de-Belleville,517,13,530
82,Rhône-Alpes,73,2,29,245,Saint-Jean-de-Chevelu,720,11,731
82,Rhône-Alpes,73,2,14,246,Saint-Jean-de-Couz,246,7,253
82,Rhône-Alpes,73,2,27,247,Saint-Jean-de-la-Porte,853,61,914
82,Rhône-Alpes,73,3,25,248,Saint-Jean-de-Maurienne,8507,465,8972
82,Rhône-Alpes,73,2,33,249,Saint-Jeoire-Prieuré,1007,24,1031
82,Rhône-Alpes,73,3,25,250,Saint-Julien-Mont-Denis,1605,67,1672
82,Rhône-Alpes,73,3,01,252,Saint-Léger,225,10,235
82,Rhône-Alpes,73,1,20,253,Saint-Marcel,700,11,711
82,Rhône-Alpes,73,3,26,256,Saint-Martin-d'Arc,352,17,369
82,Rhône-Alpes,73,1,20,257,Saint-Martin-de-Belleville,2653,63,2716
82,Rhône-Alpes,73,3,26,258,Saint-Martin-de-la-Porte,704,23,727
82,Rhône-Alpes,73,3,11,259,Saint-Martin-sur-la-Chambre,449,21,470
82,Rhône-Alpes,73,2,24,260,Saint-Maurice-de-Rotherens,182,1,183
82,Rhône-Alpes,73,3,26,261,Saint-Michel-de-Maurienne,2773,247,3020
82,Rhône-Alpes,73,1,28,262,Saint-Nicolas-la-Chapelle,409,44,453
82,Rhône-Alpes,73,2,32,263,Saint-Offenge-Dessous,578,13,591
82,Rhône-Alpes,73,2,32,264,Saint-Offenge-Dessus,263,6,269
82,Rhône-Alpes,73,2,04,265,Saint-Ours,525,9,534
82,Rhône-Alpes,73,1,20,266,Saint-Oyen,206,7,213
82,Rhône-Alpes,73,3,25,267,Saint-Pancrace,291,8,299
82,Rhône-Alpes,73,2,29,269,Saint-Paul,605,9,614
82,Rhône-Alpes,73,1,30,268,Saint-Paul-sur-Isère,514,91,605
82,Rhône-Alpes,73,2,27,270,Saint-Pierre-d'Albigny,3689,74,3763
82,Rhône-Alpes,73,2,29,271,Saint-Pierre-d'Alvey,272,3,275
82,Rhône-Alpes,73,2,14,274,Saint-Pierre-d'Entremont,423,20,443
82,Rhône-Alpes,73,3,01,272,Saint-Pierre-de-Belleville,159,4,163
82,Rhône-Alpes,73,2,23,273,Saint-Pierre-de-Curtille,434,11,445
82,Rhône-Alpes,73,2,14,275,Saint-Pierre-de-Genebroz,314,4,318
82,Rhône-Alpes,73,2,18,276,Saint-Pierre-de-Soucy,379,11,390
82,Rhône-Alpes,73,3,11,278,Saint-Rémy-de-Maurienne,1228,15,1243
82,Rhône-Alpes,73,3,25,280,Saint-Sorlin-d'Arves,356,4,360
82,Rhône-Alpes,73,2,37,281,Saint-Sulpice,708,18,726
82,Rhône-Alpes,73,2,14,282,Saint-Thibaud-de-Couz,892,19,911
82,Rhône-Alpes,73,1,15,283,Saint-Vital,670,17,687
82,Rhône-Alpes,73,1,07,232,Sainte-Foy-Tarentaise,805,17,822
82,Rhône-Alpes,73,2,18,240,Sainte-Hélène-du-Lac,660,18,678
82,Rhône-Alpes,73,1,15,241,Sainte-Hélène-sur-Isère,1106,29,1135
82,Rhône-Alpes,73,2,24,254,Sainte-Marie-d'Alvey,134,5,139
82,Rhône-Alpes,73,3,11,255,Sainte-Marie-de-Cuines,747,26,773
82,Rhône-Alpes,73,2,13,277,Sainte-Reine,151,1,152
82,Rhône-Alpes,73,1,20,284,Salins-les-Thermes,970,28,998
82,Rhône-Alpes,73,1,07,285,Séez,2295,71,2366
82,Rhône-Alpes,73,2,23,286,Serrières-en-Chautagne,1043,21,1064
82,Rhône-Alpes,73,3,16,287,Sollières-Sardières,194,3,197
82,Rhône-Alpes,73,2,09,288,Sonnaz,1350,41,1391
82,Rhône-Alpes,73,2,22,289,La Table,366,9,375
82,Rhône-Alpes,73,3,16,290,Termignon,428,10,438
82,Rhône-Alpes,73,1,05,292,Thénésol,223,11,234
82,Rhône-Alpes,73,2,34,293,Thoiry,429,11,440
82,Rhône-Alpes,73,2,27,294,La Thuile,279,12,291
82,Rhône-Alpes,73,1,07,296,Tignes,2160,34,2194
82,Rhône-Alpes,73,1,15,297,Tournon,554,19,573
82,Rhône-Alpes,73,1,30,298,Tours-en-Savoie,851,26,877
82,Rhône-Alpes,73,2,29,299,Traize,282,10,292
82,Rhône-Alpes,73,2,35,300,Tresserve,3136,158,3294
82,Rhône-Alpes,73,2,32,301,Trévignin,738,24,762
82,Rhône-Alpes,73,2,22,302,La Trinité,279,5,284
82,Rhône-Alpes,73,1,28,303,Ugine,7014,271,7285
82,Rhône-Alpes,73,1,07,304,Val-d'Isère,1640,43,1683
82,Rhône-Alpes,73,1,02,305,Valezan,176,10,186
82,Rhône-Alpes,73,3,26,306,Valloire,1299,43,1342
82,Rhône-Alpes,73,3,26,307,Valmeinier,459,38,497
82,Rhône-Alpes,73,1,05,308,Venthon,612,24,636
82,Rhône-Alpes,73,2,21,309,Verel-de-Montbel,283,12,295
82,Rhône-Alpes,73,2,34,310,Verel-Pragondran,429,11,440
82,Rhône-Alpes,73,2,22,311,Le Verneil,107,0,107
82,Rhône-Alpes,73,1,15,312,Verrens-Arvey,761,31,792
82,Rhône-Alpes,73,2,29,313,Verthemex,169,3,172
82,Rhône-Alpes,73,2,18,314,Villard-d'Héry,245,4,249
82,Rhône-Alpes,73,2,12,315,Villard-Léger,467,3,470
82,Rhône-Alpes,73,2,22,316,Villard-Sallet,227,6,233
82,Rhône-Alpes,73,1,06,317,Villard-sur-Doron,663,16,679
82,Rhône-Alpes,73,3,25,318,Villarembert,256,5,261
82,Rhône-Alpes,73,3,25,320,Villargondran,976,30,1006
82,Rhône-Alpes,73,1,20,321,Villarlurin,311,13,324
82,Rhône-Alpes,73,3,17,322,Villarodin-Bourget,481,22,503
82,Rhône-Alpes,73,1,07,323,Villaroger,409,7,416
82,Rhône-Alpes,73,2,18,324,Villaroux,222,11,233
82,Rhône-Alpes,73,2,37,326,Vimines,1675,68,1743
82,Rhône-Alpes,73,2,23,327,Vions,359,4,363
82,Rhône-Alpes,73,2,35,328,Viviers-du-Lac,1960,30,1990
82,Rhône-Alpes,73,2,35,329,Voglans,1652,43,1695
82,Rhône-Alpes,73,2,29,330,Yenne,2902,53,2955
82,Rhône-Alpes,74,4,01,001,Abondance,1344,137,1481
82,Rhône-Alpes,74,1,02,002,Alby-sur-Chéran,1983,36,2019
82,Rhône-Alpes,74,1,30,003,Alex,970,25,995
82,Rhône-Alpes,74,1,02,004,Allèves,356,4,360
82,Rhône-Alpes,74,4,34,005,Allinges,3766,146,3912
82,Rhône-Alpes,74,3,11,006,Allonzier-la-Caille,1465,22,1487
82,Rhône-Alpes,74,2,17,007,Amancy,1920,57,1977
82,Rhône-Alpes,74,3,05,008,Ambilly,5871,103,5974
82,Rhône-Alpes,74,3,11,009,Andilly,757,15,772
82,Rhône-Alpes,74,1,99,010,Annecy,50115,1855,51970
82,Rhône-Alpes,74,1,30,011,Annecy-le-Vieux,19770,870,20640
82,Rhône-Alpes,74,3,96,012,Annemasse,30468,624,31092
82,Rhône-Alpes,74,4,34,013,Anthy-sur-Léman,1933,116,2049
82,Rhône-Alpes,74,2,10,014,Arâches-la-Frasse,1807,78,1885
82,Rhône-Alpes,74,3,16,015,Arbusigny,942,10,952
82,Rhône-Alpes,74,3,21,016,Archamps,1703,30,1733
82,Rhône-Alpes,74,2,17,018,Arenthon,1423,47,1470
82,Rhône-Alpes,74,1,30,019,Argonay,2216,303,2519
82,Rhône-Alpes,74,4,27,020,Armoy,1117,36,1153
82,Rhône-Alpes,74,3,31,021,Arthaz-Pont-Notre-Dame,1264,30,1294
82,Rhône-Alpes,74,1,28,022,Aviernoz,772,17,789
82,Rhône-Alpes,74,2,08,024,Ayse,1970,52,2022
82,Rhône-Alpes,74,4,12,025,Ballaison,1282,38,1320
82,Rhône-Alpes,74,1,29,026,La Balme-de-Sillingy,4810,163,4973
82,Rhône-Alpes,74,1,26,027,La Balme-de-Thuy,367,7,374
82,Rhône-Alpes,74,3,24,029,Bassy,439,22,461
82,Rhône-Alpes,74,4,06,030,La Baume,251,9,260
82,Rhône-Alpes,74,3,21,031,Beaumont,2027,35,2062
82,Rhône-Alpes,74,4,27,032,Bellevaux,1327,28,1355
82,Rhône-Alpes,74,4,13,033,Bernex,1191,19,1210
82,Rhône-Alpes,74,4,06,034,Le Biot,448,7,455
82,Rhône-Alpes,74,1,18,035,Bloye,509,6,515
82,Rhône-Alpes,74,1,30,036,Bluffy,330,8,338
82,Rhône-Alpes,74,4,07,037,Boëge,1556,38,1594
82,Rhône-Alpes,74,4,07,038,Bogève,1060,26,1086
82,Rhône-Alpes,74,3,31,040,Bonne,2610,129,2739
82,Rhône-Alpes,74,4,01,041,Bonnevaux,272,13,285
82,Rhône-Alpes,74,2,08,042,Bonneville,11831,325,12156
82,Rhône-Alpes,74,4,12,043,Bons-en-Chablais,4688,91,4779
82,Rhône-Alpes,74,3,21,044,Bossey,680,15,695
82,Rhône-Alpes,74,1,26,045,Le Bouchet,240,3,243
82,Rhône-Alpes,74,1,18,046,Boussy,444,20,464
82,Rhône-Alpes,74,4,12,048,Brenthonne,844,20,864
82,Rhône-Alpes,74,2,08,049,Brizon,449,7,456
82,Rhône-Alpes,74,4,07,050,Burdignin,613,22,635
82,Rhône-Alpes,74,3,11,051,Cercier,564,12,576
82,Rhône-Alpes,74,3,11,052,Cernex,879,14,893
82,Rhône-Alpes,74,4,34,053,Cervens,1032,19,1051
82,Rhône-Alpes,74,1,02,054,Chainaz-les-Frasses,593,18,611
82,Rhône-Alpes,74,3,24,055,Challonges,444,15,459
82,Rhône-Alpes,74,2,09,056,Chamonix-Mont-Blanc,9042,317,9359
82,Rhône-Alpes,74,4,13,057,Champanges,855,27,882
82,Rhône-Alpes,74,1,02,061,Chapeiry,767,12,779
82,Rhône-Alpes,74,4,01,058,La Chapelle-d'Abondance,812,13,825
82,Rhône-Alpes,74,2,17,059,La Chapelle-Rambaud,215,4,219
82,Rhône-Alpes,74,1,33,060,La Chapelle-Saint-Maurice,118,1,119
82,Rhône-Alpes,74,1,30,062,Charvonnex,1005,16,1021
82,Rhône-Alpes,74,4,01,063,Châtel,1243,26,1269
82,Rhône-Alpes,74,2,10,064,Châtillon-sur-Cluses,1145,24,1169
82,Rhône-Alpes,74,3,15,065,Chaumont,398,15,413
82,Rhône-Alpes,74,3,15,066,Chavannaz,183,4,187
82,Rhône-Alpes,74,1,33,067,Chavanod,2197,175,2372
82,Rhône-Alpes,74,3,24,068,Chêne-en-Semine,375,6,381
82,Rhône-Alpes,74,3,21,069,Chênex,520,12,532
82,Rhône-Alpes,74,4,12,070,Chens-sur-Léman,1740,33,1773
82,Rhône-Alpes,74,3,15,071,Chessenaz,168,11,179
82,Rhône-Alpes,74,1,14,072,Chevaline,208,8,216
82,Rhône-Alpes,74,4,01,073,Chevenoz,549,16,565
82,Rhône-Alpes,74,3,21,074,Chevrier,385,7,392
82,Rhône-Alpes,74,3,15,075,Chilly,1089,29,1118
82,Rhône-Alpes,74,1,29,076,Choisy,1559,41,1600
82,Rhône-Alpes,74,3,15,077,Clarafond-Arcine,865,13,878
82,Rhône-Alpes,74,1,26,079,Les Clefs,593,16,609
82,Rhône-Alpes,74,3,24,078,Clermont,391,8,399
82,Rhône-Alpes,74,1,26,080,La Clusaz,1888,41,1929
82,Rhône-Alpes,74,2,10,081,Cluses,17972,451,18423
82,Rhône-Alpes,74,3,21,082,Collonges-sous-Salève,3568,117,3685
82,Rhône-Alpes,74,2,22,083,Combloux,2072,112,2184
82,Rhône-Alpes,74,1,14,084,Cons-Sainte-Colombe,334,7,341
82,Rhône-Alpes,74,3,15,086,Contamine-Sarzin,537,8,545
82,Rhône-Alpes,74,2,08,087,Contamine-sur-Arve,1572,129,1701
82,Rhône-Alpes,74,2,19,085,Les Contamines-Montjoie,1186,34,1220
82,Rhône-Alpes,74,3,11,088,Copponex,783,22,805
82,Rhône-Alpes,74,2,22,089,Cordon,991,28,1019
82,Rhône-Alpes,74,2,17,090,Cornier,1081,14,1095
82,Rhône-Alpes,74,2,25,091,La Côte-d'Arbroz,256,3,259
82,Rhône-Alpes,74,1,33,093,Cran-Gevrier,16398,397,16795
82,Rhône-Alpes,74,3,05,094,Cranves-Sales,5146,160,5306
82,Rhône-Alpes,74,1,18,095,Crempigny-Bonneguête,249,5,254
82,Rhône-Alpes,74,3,11,096,Cruseilles,3657,205,3862
82,Rhône-Alpes,74,1,02,097,Cusy,1706,23,1729
82,Rhône-Alpes,74,1,30,098,Cuvat,947,30,977
82,Rhône-Alpes,74,2,22,099,Demi-Quartier,1021,32,1053
82,Rhône-Alpes,74,3,24,100,Desingy,740,7,747
82,Rhône-Alpes,74,3,21,101,Dingy-en-Vuache,546,6,552
82,Rhône-Alpes,74,1,30,102,Dingy-Saint-Clair,1257,36,1293
82,Rhône-Alpes,74,2,22,103,Domancy,1789,79,1868
82,Rhône-Alpes,74,1,14,104,Doussard,3417,76,3493
82,Rhône-Alpes,74,4,12,105,Douvaine,4769,95,4864
82,Rhône-Alpes,74,4,34,106,Draillant,655,16,671
82,Rhône-Alpes,74,3,24,107,Droisy,132,0,132
82,Rhône-Alpes,74,1,33,108,Duingt,895,28,923
82,Rhône-Alpes,74,3,15,109,Éloise,874,12,886
82,Rhône-Alpes,74,2,08,110,Entremont,594,10,604
82,Rhône-Alpes,74,1,33,111,Entrevernes,202,8,210
82,Rhône-Alpes,74,1,29,112,Épagny,3816,80,3896
82,Rhône-Alpes,74,4,06,114,Essert-Romand,420,8,428
82,Rhône-Alpes,74,2,17,116,Etaux,1640,56,1696
82,Rhône-Alpes,74,1,18,117,Étercy,691,25,716
82,Rhône-Alpes,74,3,31,118,Étrembières,1827,27,1854
82,Rhône-Alpes,74,4,13,119,Évian-les-Bains,8137,229,8366
82,Rhône-Alpes,74,1,28,120,Évires,1280,25,1305
82,Rhône-Alpes,74,4,12,121,Excenevex,961,16,977
82,Rhône-Alpes,74,2,08,122,Faucigny,482,15,497
82,Rhône-Alpes,74,1,14,123,Faverges,6609,271,6880
82,Rhône-Alpes,74,3,21,124,Feigères,1418,26,1444
82,Rhône-Alpes,74,4,12,126,Fessy,765,29,794
82,Rhône-Alpes,74,4,13,127,Féternes,1294,30,1324
82,Rhône-Alpes,74,3,16,128,Fillinges,3037,83,3120
82,Rhône-Alpes,74,4,06,129,La Forclaz,216,1,217
82,Rhône-Alpes,74,3,24,130,Franclens,404,62,466
82,Rhône-Alpes,74,3,15,131,Frangy,1922,53,1975
82,Rhône-Alpes,74,3,31,133,Gaillard,11270,165,11435
82,Rhône-Alpes,74,2,25,134,Les Gets,1276,40,1316
82,Rhône-Alpes,74,1,14,135,Giez,614,12,626
82,Rhône-Alpes,74,1,26,136,Le Grand-Bornand,2203,49,2252
82,Rhône-Alpes,74,1,28,137,Groisy,2891,214,3105
82,Rhône-Alpes,74,1,02,138,Gruffy,1397,31,1428
82,Rhône-Alpes,74,4,07,139,Habère-Lullin,815,25,840
82,Rhône-Alpes,74,4,07,140,Habère-Poche,1192,37,1229
82,Rhône-Alpes,74,1,18,141,Hauteville-sur-Fier,802,19,821
82,Rhône-Alpes,74,1,02,142,Héry-sur-Alby,893,20,913
82,Rhône-Alpes,74,2,09,143,Les Houches,3098,66,3164
82,Rhône-Alpes,74,3,21,144,Jonzier-Épagny,642,12,654
82,Rhône-Alpes,74,3,05,145,Juvigny,643,19,662
82,Rhône-Alpes,74,4,13,146,Larringes,1215,25,1240
82,Rhône-Alpes,74,1,14,147,Lathuile,951,22,973
82,Rhône-Alpes,74,1,33,148,Leschaux,266,3,269
82,Rhône-Alpes,74,4,12,150,Loisin,1358,31,1389
82,Rhône-Alpes,74,1,18,151,Lornay,461,9,470
82,Rhône-Alpes,74,1,29,152,Lovagny,1106,32,1138
82,Rhône-Alpes,74,3,05,153,Lucinges,1497,44,1541
82,Rhône-Alpes,74,4,13,154,Lugrin,2217,46,2263
82,Rhône-Alpes,74,4,27,155,Lullin,771,20,791
82,Rhône-Alpes,74,4,12,156,Lully,651,14,665
82,Rhône-Alpes,74,4,27,157,Lyaud,1449,38,1487
82,Rhône-Alpes,74,3,05,158,Machilly,970,14,984
82,Rhône-Alpes,74,2,10,159,Magland,3024,63,3087
82,Rhône-Alpes,74,1,26,160,Manigod,912,21,933
82,Rhône-Alpes,74,2,08,162,Marcellaz,759,17,776
82,Rhône-Alpes,74,1,18,161,Marcellaz-Albanais,1716,47,1763
82,Rhône-Alpes,74,4,34,163,Margencel,1717,82,1799
82,Rhône-Alpes,74,2,08,164,Marignier,6137,177,6314
82,Rhône-Alpes,74,1,18,165,Marigny-Saint-Marcel,641,19,660
82,Rhône-Alpes,74,4,27,166,Marin,1508,47,1555
82,Rhône-Alpes,74,1,14,167,Marlens,822,13,835
82,Rhône-Alpes,74,3,15,168,Marlioz,644,16,660
82,Rhône-Alpes,74,2,32,169,Marnaz,5252,117,5369
82,Rhône-Alpes,74,1,18,170,Massingy,808,10,818
82,Rhône-Alpes,74,4,12,171,Massongy,1306,35,1341
82,Rhône-Alpes,74,4,13,172,Maxilly-sur-Léman,1245,32,1277
82,Rhône-Alpes,74,2,22,173,Megève,3868,172,4040
82,Rhône-Alpes,74,2,20,174,Mégevette,501,8,509
82,Rhône-Alpes,74,4,13,175,Meillerie,309,4,313
82,Rhône-Alpes,74,1,30,176,Menthon-Saint-Bernard,1863,76,1939
82,Rhône-Alpes,74,3,11,177,Menthonnex-en-Bornes,846,10,856
82,Rhône-Alpes,74,3,24,178,Menthonnex-sous-Clermont,628,18,646
82,Rhône-Alpes,74,1,29,179,Mésigny,687,13,700
82,Rhône-Alpes,74,4,12,180,Messery,2054,58,2112
82,Rhône-Alpes,74,1,29,181,Metz-Tessy,2551,91,2642
82,Rhône-Alpes,74,1,29,182,Meythet,8380,159,8539
82,Rhône-Alpes,74,2,25,183,Mieussy,2078,54,2132
82,Rhône-Alpes,74,3,15,184,Minzier,800,13,813
82,Rhône-Alpes,74,3,16,185,Monnetier-Mornex,2098,43,2141
82,Rhône-Alpes,74,2,08,189,Mont-Saxonnex,1518,66,1584
82,Rhône-Alpes,74,1,33,186,Montagny-les-Lanches,559,19,578
82,Rhône-Alpes,74,1,14,187,Montmin,319,3,322
82,Rhône-Alpes,74,4,06,188,Montriond,809,28,837
82,Rhône-Alpes,74,2,23,190,Morillon,542,13,555
82,Rhône-Alpes,74,4,06,191,Morzine,2933,95,3028
82,Rhône-Alpes,74,1,18,192,Moye,1019,29,1048
82,Rhône-Alpes,74,3,16,193,La Muraz,926,23,949
82,Rhône-Alpes,74,1,02,194,Mûres,680,23,703
82,Rhône-Alpes,74,3,15,195,Musièges,345,7,352
82,Rhône-Alpes,74,2,32,196,Nancy-sur-Cluses,451,4,455
82,Rhône-Alpes,74,3,16,197,Nangy,1207,28,1235
82,Rhône-Alpes,74,1,30,198,Nâves-Parmelan,863,38,901
82,Rhône-Alpes,74,4,12,199,Nernier,428,15,443
82,Rhône-Alpes,74,4,13,200,Neuvecelle,2558,79,2637
82,Rhône-Alpes,74,3,21,201,Neydens,1458,42,1500
82,Rhône-Alpes,74,1,29,202,Nonglard,481,7,488
82,Rhône-Alpes,74,4,13,203,Novel,51,2,53
82,Rhône-Alpes,74,1,28,204,Les Ollières,815,17,832
82,Rhône-Alpes,74,2,20,205,Onnion,1137,24,1161
82,Rhône-Alpes,74,4,34,206,Orcier,798,21,819
82,Rhône-Alpes,74,2,19,208,Passy,11295,421,11716
82,Rhône-Alpes,74,2,08,209,Peillonnex,1328,40,1368
82,Rhône-Alpes,74,4,34,210,Perrignier,1564,37,1601
82,Rhône-Alpes,74,3,16,211,Pers-Jussy,2519,55,2574
82,Rhône-Alpes,74,2,08,212,Le Petit-Bornand-les-Glières,1107,14,1121
82,Rhône-Alpes,74,1,29,213,Poisy,6279,318,6597
82,Rhône-Alpes,74,2,22,215,Praz-sur-Arly,1348,43,1391
82,Rhône-Alpes,74,3,21,216,Présilly,665,14,679
82,Rhône-Alpes,74,1,30,217,Pringy,3437,129,3566
82,Rhône-Alpes,74,4,13,218,Publier,6130,229,6359
82,Rhône-Alpes,74,1,33,219,Quintal,1129,38,1167
82,Rhône-Alpes,74,3,16,220,Reignier-Ésery,6365,182,6547
82,Rhône-Alpes,74,2,32,221,Le Reposoir,487,6,493
82,Rhône-Alpes,74,4,27,222,Reyvroz,466,7,473
82,Rhône-Alpes,74,2,25,223,La Rivière-Enverse,460,10,470
82,Rhône-Alpes,74,2,17,224,La Roche-sur-Foron,10061,354,10415
82,Rhône-Alpes,74,1,18,225,Rumilly,13380,396,13776
82,Rhône-Alpes,74,4,07,226,Saint-André-de-Boëge,570,13,583
82,Rhône-Alpes,74,3,11,228,Saint-Blaise,265,5,270
82,Rhône-Alpes,74,3,05,229,Saint-Cergues,3064,54,3118
82,Rhône-Alpes,74,1,18,231,Saint-Eusèbe,440,5,445
82,Rhône-Alpes,74,1,33,232,Saint-Eustache,473,13,486
82,Rhône-Alpes,74,1,02,233,Saint-Félix,2059,36,2095
82,Rhône-Alpes,74,1,14,234,Saint-Ferréol,859,19,878
82,Rhône-Alpes,74,3,24,235,Saint-Germain-sur-Rhône,384,9,393
82,Rhône-Alpes,74,2,19,236,Saint-Gervais-les-Bains,5681,138,5819
82,Rhône-Alpes,74,4,13,237,Saint-Gingolph,723,16,739
82,Rhône-Alpes,74,4,06,238,Saint-Jean-d'Aulps,1187,20,1207
82,Rhône-Alpes,74,1,26,239,Saint-Jean-de-Sixt,1296,31,1327
82,Rhône-Alpes,74,2,20,240,Saint-Jean-de-Tholome,869,16,885
82,Rhône-Alpes,74,2,20,241,Saint-Jeoire,3138,95,3233
82,Rhône-Alpes,74,1,33,242,Saint-Jorioz,5716,228,5944
82,Rhône-Alpes,74,3,21,243,Saint-Julien-en-Genevois,11362,252,11614
82,Rhône-Alpes,74,2,17,244,Saint-Laurent,772,15,787
82,Rhône-Alpes,74,1,30,245,Saint-Martin-Bellevue,2343,55,2398
82,Rhône-Alpes,74,4,13,249,Saint-Paul-en-Chablais,2110,40,2150
82,Rhône-Alpes,74,2,17,250,Saint-Pierre-en-Faucigny,5863,138,6001
82,Rhône-Alpes,74,2,10,252,Saint-Sigismond,660,16,676
82,Rhône-Alpes,74,2,17,253,Saint-Sixt,874,26,900
82,Rhône-Alpes,74,1,02,254,Saint-Sylvestre,597,17,614
82,Rhône-Alpes,74,1,18,255,Sales,1542,33,1575
82,Rhône-Alpes,74,2,22,256,Sallanches,15636,580,16216
82,Rhône-Alpes,74,1,29,257,Sallenôves,573,14,587
82,Rhône-Alpes,74,2,23,258,Samoëns,2323,61,2384
82,Rhône-Alpes,74,3,11,259,Le Sappey,375,10,385
82,Rhône-Alpes,74,3,21,260,Savigny,699,7,706
82,Rhône-Alpes,74,4,07,261,Saxel,376,6,382
82,Rhône-Alpes,74,3,16,262,Scientrier,1007,10,1017
82,Rhône-Alpes,74,4,34,263,Sciez,5163,118,5281
82,Rhône-Alpes,74,2,32,264,Scionzier,6936,116,7052
82,Rhône-Alpes,74,1,26,265,Serraval,584,68,652
82,Rhône-Alpes,74,2,09,266,Servoz,917,48,965
82,Rhône-Alpes,74,1,33,267,Sévrier,3845,181,4026
82,Rhône-Alpes,74,1,33,268,Seynod,17941,636,18577
82,Rhône-Alpes,74,3,24,269,Seyssel,2099,59,2158
82,Rhône-Alpes,74,1,14,270,Seythenex,591,17,608
82,Rhône-Alpes,74,4,06,271,Seytroux,385,6,391
82,Rhône-Alpes,74,1,29,272,Sillingy,3590,86,3676
82,Rhône-Alpes,74,2,23,273,Sixt-Fer-à-Cheval,789,12,801
82,Rhône-Alpes,74,1,30,275,Talloires,1626,47,1673
82,Rhône-Alpes,74,2,25,276,Taninges,3439,97,3536
82,Rhône-Alpes,74,4,13,279,Thollon-les-Mémises,695,13,708
82,Rhône-Alpes,74,1,26,280,Thônes,5832,295,6127
82,Rhône-Alpes,74,4,95,281,Thonon-les-Bains,32824,1297,34121
82,Rhône-Alpes,74,1,28,282,Thorens-Glières,3029,74,3103
82,Rhône-Alpes,74,1,18,283,Thusy,877,15,892
82,Rhône-Alpes,74,2,08,278,Thyez,5645,145,5790
82,Rhône-Alpes,74,2,20,284,La Tour,1213,15,1228
82,Rhône-Alpes,74,3,24,285,Usinens,359,10,369
82,Rhône-Alpes,74,4,01,286,Vacheresse,758,19,777
82,Rhône-Alpes,74,4,27,287,Vailly,724,24,748
82,Rhône-Alpes,74,1,18,274,Val-de-Fier,521,7,528
82,Rhône-Alpes,74,3,21,288,Valleiry,3056,41,3097
82,Rhône-Alpes,74,1,18,289,Vallières,1375,43,1418
82,Rhône-Alpes,74,2,09,290,Vallorcine,419,9,428
82,Rhône-Alpes,74,3,15,291,Vanzy,285,9,294
82,Rhône-Alpes,74,1,18,292,Vaulx,829,20,849
82,Rhône-Alpes,74,4,12,293,Veigy-Foncenex,3291,75,3366
82,Rhône-Alpes,74,2,23,294,Verchaix,650,12,662
82,Rhône-Alpes,74,4,06,295,La Vernaz,294,5,299
82,Rhône-Alpes,74,3,21,296,Vers,634,11,645
82,Rhône-Alpes,74,1,18,297,Versonnex,489,10,499
82,Rhône-Alpes,74,3,31,298,Vétraz-Monthoux,6352,299,6651
82,Rhône-Alpes,74,1,30,299,Veyrier-du-Lac,2136,82,2218
82,Rhône-Alpes,74,4,07,301,Villard,730,15,745
82,Rhône-Alpes,74,1,26,302,Les Villards-sur-Thônes,995,23,1018
82,Rhône-Alpes,74,1,28,303,Villaz,2519,61,2580
82,Rhône-Alpes,74,2,20,304,Ville-en-Sallaz,678,18,696
82,Rhône-Alpes,74,3,05,305,Ville-la-Grand,7407,167,7574
82,Rhône-Alpes,74,3,11,306,Villy-le-Bouveret,528,6,534
82,Rhône-Alpes,74,1,30,307,Villy-le-Pelloux,580,12,592
82,Rhône-Alpes,74,4,13,308,Vinzier,790,22,812
82,Rhône-Alpes,74,3,21,309,Viry,3467,97,3564
82,Rhône-Alpes,74,2,20,311,Viuz-en-Sallaz,3828,109,3937
82,Rhône-Alpes,74,1,02,310,Viuz-la-Chiésaz,1256,33,1289
82,Rhône-Alpes,74,2,08,312,Vougy,1419,31,1450
82,Rhône-Alpes,74,3,11,313,Vovray-en-Bornes,334,1,335
82,Rhône-Alpes,74,3,21,314,Vulbens,895,26,921
82,Rhône-Alpes,74,4,12,315,Yvoire,817,22,839
11,Île-de-France,75,1,15,101,Paris 1er Arrondissement,17440,144,17584
11,Île-de-France,75,1,16,102,Paris 2e  Arrondissement,21793,162,21955
11,Île-de-France,75,1,17,103,Paris 3e  Arrondissement,34824,307,35131
11,Île-de-France,75,1,18,104,Paris 4e  Arrondissement,27977,291,28268
11,Île-de-France,75,1,19,105,Paris 5e  Arrondissement,62143,711,62854
11,Île-de-France,75,1,20,106,Paris 6e  Arrondissement,44322,825,45147
11,Île-de-France,75,1,21,107,Paris 7e  Arrondissement,57082,813,57895
11,Île-de-France,75,1,22,108,Paris 8e  Arrondissement,38702,498,39200
11,Île-de-France,75,1,23,109,Paris 9e  Arrondissement,59157,683,59840
11,Île-de-France,75,1,24,110,Paris 10e  Arrondissement,94321,834,95155
11,Île-de-France,75,1,25,111,Paris 11e  Arrondissement,152672,1595,154267
11,Île-de-France,75,1,26,112,Paris 12e  Arrondissement,142673,1665,144338
11,Île-de-France,75,1,27,113,Paris 13e  Arrondissement,179500,2146,181646
11,Île-de-France,75,1,28,114,Paris 14e  Arrondissement,136464,1270,137734
11,Île-de-France,75,1,29,115,Paris 15e  Arrondissement,234091,2399,236490
11,Île-de-France,75,1,30,116,Paris 16e  Arrondissement,165074,2310,167384
11,Île-de-France,75,1,31,117,Paris 17e  Arrondissement,167070,1593,168663
11,Île-de-France,75,1,32,118,Paris 18e  Arrondissement,196000,1173,197173
11,Île-de-France,75,1,33,119,Paris 19e  Arrondissement,184909,1757,186666
11,Île-de-France,75,1,34,120,Paris 20e  Arrondissement,195083,1345,196428
23,Haute-Normandie,76,3,55,001,Allouville-Bellefosse,1098,27,1125
23,Haute-Normandie,76,2,20,002,Alvimare,500,4,504
23,Haute-Normandie,76,1,39,004,Ambrumesnil,529,14,543
23,Haute-Normandie,76,3,07,005,Amfreville-la-Mi-Voie,3063,34,3097
23,Haute-Normandie,76,3,15,006,Amfreville-les-Champs,143,2,145
23,Haute-Normandie,76,3,11,007,Anceaumeville,680,12,692
23,Haute-Normandie,76,1,14,008,Ancourt,717,7,724
23,Haute-Normandie,76,2,40,009,Ancourteville-sur-Héricourt,232,2,234
23,Haute-Normandie,76,3,54,010,Ancretiéville-Saint-Victor,348,7,355
23,Haute-Normandie,76,2,53,011,Ancretteville-sur-Mer,184,4,188
23,Haute-Normandie,76,2,24,012,Angerville-Bailleul,201,5,206
23,Haute-Normandie,76,2,12,014,Angerville-l'Orcher,1397,15,1412
23,Haute-Normandie,76,2,53,013,Angerville-la-Martel,862,19,881
23,Haute-Normandie,76,1,22,015,Angiens,600,15,615
23,Haute-Normandie,76,2,12,017,Anglesqueville-l'Esneval,526,8,534
23,Haute-Normandie,76,1,22,016,Anglesqueville-la-Bras-Long,122,2,124
23,Haute-Normandie,76,3,16,020,Anneville-Ambourville,1192,14,1206
23,Haute-Normandie,76,1,35,019,Anneville-sur-Scie,448,27,475
23,Haute-Normandie,76,2,24,021,Annouville-Vilmesnil,416,3,419
23,Haute-Normandie,76,3,10,022,Anquetierville,365,7,372
23,Haute-Normandie,76,2,40,023,Anvéville,249,6,255
23,Haute-Normandie,76,1,04,024,Ardouval,170,0,170
23,Haute-Normandie,76,1,01,025,Argueil,338,6,344
23,Haute-Normandie,76,1,39,026,Arques-la-Bataille,2537,58,2595
23,Haute-Normandie,76,1,18,027,Assigny,339,8,347
23,Haute-Normandie,76,1,02,028,Aubéguimont,190,2,192
23,Haute-Normandie,76,1,05,029,Aubermesnil-aux-Érables,213,5,218
23,Haute-Normandie,76,1,39,030,Aubermesnil-Beaumais,457,15,472
23,Haute-Normandie,76,2,33,031,Auberville-la-Campagne,619,8,627
23,Haute-Normandie,76,1,09,032,Auberville-la-Manuel,124,1,125
23,Haute-Normandie,76,2,24,033,Auberville-la-Renault,388,2,390
23,Haute-Normandie,76,1,52,034,Auffay,1796,34,1830
23,Haute-Normandie,76,1,02,035,Aumale,2417,99,2516
23,Haute-Normandie,76,1,03,036,Auppegard,693,9,702
23,Haute-Normandie,76,1,18,037,Auquemesnil,302,5,307
23,Haute-Normandie,76,3,11,038,Authieux-Ratiéville,420,5,425
23,Haute-Normandie,76,3,07,039,Les Authieux-sur-le-Port-Saint-Ouen,1218,29,1247
23,Haute-Normandie,76,1,22,040,Autigny,258,4,262
23,Haute-Normandie,76,3,55,041,Autretot,715,21,736
23,Haute-Normandie,76,1,38,042,Auvilliers,93,2,95
23,Haute-Normandie,76,3,55,043,Auzebosc,1012,257,1269
23,Haute-Normandie,76,2,20,044,Auzouville-Auberbosc,265,3,268
23,Haute-Normandie,76,3,54,045,Auzouville-l'Esneval,350,3,353
23,Haute-Normandie,76,3,13,046,Auzouville-sur-Ry,614,21,635
23,Haute-Normandie,76,1,03,047,Auzouville-sur-Saâne,153,4,157
23,Haute-Normandie,76,1,25,048,Avesnes-en-Bray,320,4,324
23,Haute-Normandie,76,1,18,049,Avesnes-en-Val,279,3,282
23,Haute-Normandie,76,1,03,050,Avremesnil,928,27,955
23,Haute-Normandie,76,1,03,051,Bacqueville-en-Caux,1795,28,1823
23,Haute-Normandie,76,1,34,052,Bailleul-Neuville,169,5,174
23,Haute-Normandie,76,1,34,053,Baillolet,136,3,139
23,Haute-Normandie,76,1,18,054,Bailly-en-Rivière,566,3,569
23,Haute-Normandie,76,3,55,055,Baons-le-Comte,337,6,343
23,Haute-Normandie,76,3,16,056,Bardouville,629,7,636
23,Haute-Normandie,76,3,41,057,Barentin,12321,234,12555
23,Haute-Normandie,76,1,19,058,Baromesnil,247,9,256
23,Haute-Normandie,76,1,05,059,Bazinval,338,4,342
23,Haute-Normandie,76,1,23,060,Beaubec-la-Rosière,460,11,471
23,Haute-Normandie,76,1,04,062,Beaumont-le-Hareng,211,5,216
23,Haute-Normandie,76,2,12,064,Beaurepaire,454,7,461
23,Haute-Normandie,76,1,23,065,Beaussault,385,7,392
23,Haute-Normandie,76,3,41,066,Beautot,113,5,118
23,Haute-Normandie,76,1,52,063,Beauval-en-Caux,429,12,441
23,Haute-Normandie,76,1,01,067,Beauvoir-en-Lyons,578,6,584
23,Haute-Normandie,76,2,24,068,Bec-de-Mortagne,678,14,692
23,Haute-Normandie,76,3,07,069,Belbeuf,2057,51,2108
23,Haute-Normandie,76,1,04,070,Bellencombre,654,10,664
23,Haute-Normandie,76,1,18,071,Bellengreville,474,5,479
23,Haute-Normandie,76,1,52,072,Belleville-en-Caux,556,4,560
23,Haute-Normandie,76,1,14,073,Belleville-sur-Mer,791,11,802
23,Haute-Normandie,76,1,23,074,La Bellière,57,2,59
23,Haute-Normandie,76,1,35,075,Belmesnil,506,6,512
23,Haute-Normandie,76,2,24,076,Bénarville,238,1,239
23,Haute-Normandie,76,3,15,077,Bénesville,167,0,167
23,Haute-Normandie,76,2,20,078,Bennetot,184,0,184
23,Haute-Normandie,76,2,12,079,Bénouville,117,2,119
23,Haute-Normandie,76,2,20,080,Bermonville,469,5,474
23,Haute-Normandie,76,1,14,081,Berneval-le-Grand,1207,32,1239
23,Haute-Normandie,76,2,06,082,Bernières,652,7,659
23,Haute-Normandie,76,1,09,083,Bertheauville,122,3,125
23,Haute-Normandie,76,1,09,084,Bertreville,97,1,98
23,Haute-Normandie,76,1,35,085,Bertreville-Saint-Ouen,333,11,344
23,Haute-Normandie,76,1,52,086,Bertrimont,259,4,263
23,Haute-Normandie,76,3,15,087,Berville,543,9,552
23,Haute-Normandie,76,3,16,088,Berville-sur-Seine,548,4,552
23,Haute-Normandie,76,3,41,089,Betteville,518,16,534
23,Haute-Normandie,76,2,06,090,Beuzeville-la-Grenier,1029,12,1041
23,Haute-Normandie,76,2,40,091,Beuzeville-la-Guérard,168,3,171
23,Haute-Normandie,76,2,06,092,Beuzevillette,712,4,716
23,Haute-Normandie,76,1,25,093,Bézancourt,301,10,311
23,Haute-Normandie,76,3,08,094,Bierville,271,7,278
23,Haute-Normandie,76,3,60,095,Bihorel,8438,196,8634
23,Haute-Normandie,76,1,52,096,Biville-la-Baignarde,592,6,598
23,Haute-Normandie,76,1,03,097,Biville-la-Rivière,106,5,111
23,Haute-Normandie,76,1,18,098,Biville-sur-Mer,660,13,673
23,Haute-Normandie,76,3,41,099,Blacqueville,595,10,605
23,Haute-Normandie,76,3,08,100,Blainville-Crevon,1129,32,1161
23,Haute-Normandie,76,1,05,101,Blangy-sur-Bresle,3071,39,3110
23,Haute-Normandie,76,1,50,104,Blosseville,308,12,320
23,Haute-Normandie,76,3,11,105,Le Bocasse,735,12,747
23,Haute-Normandie,76,3,13,106,Bois-d'Ennebourg,498,7,505
23,Haute-Normandie,76,3,08,107,Bois-Guilbert,248,4,252
23,Haute-Normandie,76,3,60,108,Bois-Guillaume,12953,373,13326
23,Haute-Normandie,76,3,08,109,Bois-Héroult,166,6,172
23,Haute-Normandie,76,3,55,110,Bois-Himont,423,11,434
23,Haute-Normandie,76,3,13,111,Bois-l'Évêque,485,10,495
23,Haute-Normandie,76,1,35,112,Le Bois-Robert,323,13,336
23,Haute-Normandie,76,3,08,113,Boissay,308,2,310
23,Haute-Normandie,76,2,06,114,Bolbec,11801,127,11928
23,Haute-Normandie,76,2,06,115,Bolleville,528,11,539
23,Haute-Normandie,76,3,07,103,Bonsecours,6768,137,6905
23,Haute-Normandie,76,3,07,116,Boos,3132,42,3174
23,Haute-Normandie,76,2,12,117,Bordeaux-Saint-Clair,599,11,610
23,Haute-Normandie,76,2,24,118,Bornambusc,268,2,270
23,Haute-Normandie,76,1,49,119,Bosc-Bérenger,186,0,186
23,Haute-Normandie,76,3,08,120,Bosc-Bordel,476,4,480
23,Haute-Normandie,76,3,08,121,Bosc-Édeline,312,2,314
23,Haute-Normandie,76,3,11,123,Bosc-Guérard-Saint-Adrien,836,19,855
23,Haute-Normandie,76,1,25,124,Bosc-Hyons,383,11,394
23,Haute-Normandie,76,1,04,125,Bosc-le-Hard,1455,20,1475
23,Haute-Normandie,76,1,49,126,Bosc-Mesnil,270,7,277
23,Haute-Normandie,76,3,08,127,Bosc-Roger-sur-Buchy,735,11,746
23,Haute-Normandie,76,1,09,128,Bosville,539,9,548
23,Haute-Normandie,76,3,15,129,Boudeville,191,6,197
23,Haute-Normandie,76,1,38,130,Bouelles,221,5,226
23,Haute-Normandie,76,3,26,131,La Bouille,797,13,810
23,Haute-Normandie,76,3,54,132,Bourdainville,426,3,429
23,Haute-Normandie,76,1,39,133,Le Bourg-Dun,461,12,473
23,Haute-Normandie,76,1,22,134,Bourville,296,7,303
23,Haute-Normandie,76,3,41,135,Bouville,904,16,920
23,Haute-Normandie,76,1,03,136,Brachy,727,7,734
23,Haute-Normandie,76,1,14,137,Bracquemont,911,17,928
23,Haute-Normandie,76,1,52,138,Bracquetuit,306,6,312
23,Haute-Normandie,76,1,49,139,Bradiancourt,197,0,197
23,Haute-Normandie,76,1,22,140,Brametot,166,4,170
23,Haute-Normandie,76,2,24,141,Bréauté,1273,16,1289
23,Haute-Normandie,76,1,25,142,Brémontier-Merval,494,86,580
23,Haute-Normandie,76,2,24,143,Bretteville-du-Grand-Caux,1275,20,1295
23,Haute-Normandie,76,3,15,144,Bretteville-Saint-Laurent,162,3,165
23,Haute-Normandie,76,1,18,145,Brunville,239,3,242
23,Haute-Normandie,76,3,08,146,Buchy,1423,83,1506
23,Haute-Normandie,76,1,38,147,Bully,873,14,887
23,Haute-Normandie,76,1,34,148,Bures-en-Bray,322,4,326
23,Haute-Normandie,76,3,41,149,Butot,287,6,293
23,Haute-Normandie,76,1,09,732,Butot-Vénesville,262,10,272
23,Haute-Normandie,76,1,50,151,Cailleville,258,5,263
23,Haute-Normandie,76,3,11,152,Cailly,726,10,736
23,Haute-Normandie,76,1,38,122,Callengeville,478,15,493
23,Haute-Normandie,76,1,52,153,Calleville-les-Deux-Églises,314,2,316
23,Haute-Normandie,76,1,05,154,Campneuseville,535,8,543
23,Haute-Normandie,76,1,19,155,Canehan,311,8,319
23,Haute-Normandie,76,1,09,156,Canouville,290,3,293
23,Haute-Normandie,76,3,36,157,Canteleu,14828,438,15266
23,Haute-Normandie,76,3,15,158,Canville-les-Deux-Églises,315,4,319
23,Haute-Normandie,76,1,09,159,Cany-Barville,3104,79,3183
23,Haute-Normandie,76,3,41,160,Carville-la-Folletière,344,1,345
23,Haute-Normandie,76,2,40,161,Carville-Pot-de-Fer,99,3,102
23,Haute-Normandie,76,1,35,162,Le Catelier,212,8,220
23,Haute-Normandie,76,3,08,163,Catenay,732,7,739
23,Haute-Normandie,76,3,10,164,Caudebec-en-Caux,2310,37,2347
23,Haute-Normandie,76,3,61,165,Caudebec-lès-Elbeuf,9603,117,9720
23,Haute-Normandie,76,1,02,166,Le Caule-Sainte-Beuve,420,8,428
23,Haute-Normandie,76,2,37,167,Cauville-sur-Mer,1377,27,1404
23,Haute-Normandie,76,1,35,168,Les Cent-Acres,38,4,42
23,Haute-Normandie,76,2,48,169,La Cerlangue,1229,97,1326
23,Haute-Normandie,76,1,35,170,La Chapelle-du-Bourgay,132,1,133
23,Haute-Normandie,76,1,01,171,La Chapelle-Saint-Ouen,92,3,95
23,Haute-Normandie,76,1,22,172,La Chapelle-sur-Dun,194,2,196
23,Haute-Normandie,76,1,35,173,La Chaussée,451,6,457
23,Haute-Normandie,76,3,54,174,Cideville,295,5,300
23,Haute-Normandie,76,1,34,175,Clais,214,4,218
23,Haute-Normandie,76,1,09,176,Clasville,260,8,268
23,Haute-Normandie,76,3,11,177,Claville-Motteville,253,3,256
23,Haute-Normandie,76,3,61,178,Cléon,5655,75,5730
23,Haute-Normandie,76,3,11,179,Clères,1313,19,1332
23,Haute-Normandie,76,2,40,180,Cleuville,155,2,157
23,Haute-Normandie,76,2,20,181,Cléville,160,5,165
23,Haute-Normandie,76,2,20,182,Cliponville,244,8,252
23,Haute-Normandie,76,2,53,183,Colleville,711,14,725
23,Haute-Normandie,76,1,39,184,Colmesnil-Manneville,122,10,132
23,Haute-Normandie,76,1,23,185,Compainville,137,3,140
23,Haute-Normandie,76,1,02,186,Conteville,486,6,492
23,Haute-Normandie,76,2,53,187,Contremoulins,198,10,208
23,Haute-Normandie,76,1,04,188,Cottévrard,380,3,383
23,Haute-Normandie,76,1,09,189,Crasville-la-Mallet,163,1,164
23,Haute-Normandie,76,1,22,190,Crasville-la-Rocquefort,222,4,226
23,Haute-Normandie,76,1,04,191,Cressy,250,1,251
23,Haute-Normandie,76,1,19,192,Criel-sur-Mer,2724,59,2783
23,Haute-Normandie,76,1,04,193,La Crique,359,2,361
23,Haute-Normandie,76,2,21,194,Criquebeuf-en-Caux,389,12,401
23,Haute-Normandie,76,2,12,196,Criquetot-l'Esneval,2270,92,2362
23,Haute-Normandie,76,2,53,195,Criquetot-le-Mauconduit,142,1,143
23,Haute-Normandie,76,1,35,197,Criquetot-sur-Longueville,171,3,174
23,Haute-Normandie,76,3,54,198,Criquetot-sur-Ouville,708,8,716
23,Haute-Normandie,76,1,02,199,Criquiers,657,6,663
23,Haute-Normandie,76,1,49,200,Critot,515,19,534
23,Haute-Normandie,76,1,01,201,Croisy-sur-Andelle,518,1,519
23,Haute-Normandie,76,3,41,203,Croix-Mare,675,6,681
23,Haute-Normandie,76,1,34,202,Croixdalle,207,6,213
23,Haute-Normandie,76,1,04,204,Cropus,230,4,234
23,Haute-Normandie,76,1,35,205,Crosville-sur-Scie,242,5,247
23,Haute-Normandie,76,2,12,206,Cuverville,331,6,337
23,Haute-Normandie,76,1,19,207,Cuverville-sur-Yères,223,6,229
23,Haute-Normandie,76,1,25,208,Cuy-Saint-Fiacre,641,7,648
23,Haute-Normandie,76,1,25,209,Dampierre-en-Bray,440,17,457
23,Haute-Normandie,76,1,18,210,Dampierre-Saint-Nicolas,519,7,526
23,Haute-Normandie,76,1,05,211,Dancourt,236,3,239
23,Haute-Normandie,76,3,13,212,Darnétal,9390,127,9517
23,Haute-Normandie,76,2,24,213,Daubeuf-Serville,376,9,385
23,Haute-Normandie,76,1,35,214,Dénestanville,200,6,206
23,Haute-Normandie,76,1,14,215,Derchigny,538,11,549
23,Haute-Normandie,76,3,65,216,Déville-lès-Rouen,10249,95,10344
23,Haute-Normandie,76,1,95,217,Dieppe,33590,1054,34644
23,Haute-Normandie,76,1,25,218,Doudeauville,95,2,97
23,Haute-Normandie,76,3,15,219,Doudeville,2580,55,2635
23,Haute-Normandie,76,1,18,220,Douvrend,495,2,497
23,Haute-Normandie,76,1,50,221,Drosay,213,8,221
23,Haute-Normandie,76,3,16,222,Duclair,4107,63,4170
23,Haute-Normandie,76,3,41,223,Écalles-Alix,484,10,494
23,Haute-Normandie,76,2,24,224,Écrainville,1021,16,1037
23,Haute-Normandie,76,3,55,225,Écretteville-lès-Baons,416,4,420
23,Haute-Normandie,76,2,53,226,Écretteville-sur-Mer,111,3,114
23,Haute-Normandie,76,3,54,227,Ectot-l'Auber,567,13,580
23,Haute-Normandie,76,3,54,228,Ectot-lès-Baons,408,5,413
23,Haute-Normandie,76,3,17,231,Elbeuf,17170,239,17409
23,Haute-Normandie,76,1,25,229,Elbeuf-en-Bray,394,10,404
23,Haute-Normandie,76,3,13,230,Elbeuf-sur-Andelle,385,5,390
23,Haute-Normandie,76,2,53,232,Életot,618,15,633
23,Haute-Normandie,76,1,02,233,Ellecourt,135,8,143
23,Haute-Normandie,76,3,41,234,Émanville,551,5,556
23,Haute-Normandie,76,1,18,235,Envermeu,2075,166,2241
23,Haute-Normandie,76,2,20,236,Envronville,321,11,332
23,Haute-Normandie,76,3,16,237,Épinay-sur-Duclair,504,2,506
23,Haute-Normandie,76,2,37,238,Épouville,2811,53,2864
23,Haute-Normandie,76,2,48,239,Épretot,737,10,747
23,Haute-Normandie,76,2,21,240,Épreville,996,21,1017
23,Haute-Normandie,76,1,22,241,Ermenouville,155,9,164
23,Haute-Normandie,76,1,25,242,Ernemont-la-Villette,194,4,198
23,Haute-Normandie,76,3,08,243,Ernemont-sur-Buchy,213,3,216
23,Haute-Normandie,76,1,38,244,Esclavelles,369,6,375
23,Haute-Normandie,76,3,11,245,Eslettes,1521,20,1541
23,Haute-Normandie,76,3,11,247,Esteville,526,1,527
23,Haute-Normandie,76,3,08,248,Estouteville-Écalles,472,4,476
23,Haute-Normandie,76,1,52,249,Étaimpuis,684,7,691
23,Haute-Normandie,76,2,48,250,Étainhus,1057,15,1072
23,Haute-Normandie,76,3,15,251,Étalleville,424,7,431
23,Haute-Normandie,76,1,19,252,Étalondes,1201,34,1235
23,Haute-Normandie,76,3,54,253,Étoutteville,625,8,633
23,Haute-Normandie,76,2,12,254,Étretat,1505,33,1538
23,Haute-Normandie,76,1,19,255,Eu,7419,217,7636
23,Haute-Normandie,76,1,05,257,Fallencourt,180,0,180
23,Haute-Normandie,76,2,20,258,Fauville-en-Caux,2136,65,2201
23,Haute-Normandie,76,2,21,259,Fécamp,19434,408,19842
23,Haute-Normandie,76,1,25,260,Ferrières-en-Bray,1668,28,1696
23,Haute-Normandie,76,1,23,261,La Ferté-Saint-Samson,436,6,442
23,Haute-Normandie,76,1,38,262,Fesques,120,2,122
23,Haute-Normandie,76,1,01,263,La Feuillie,1232,30,1262
23,Haute-Normandie,76,3,54,264,Flamanville,416,6,422
23,Haute-Normandie,76,1,38,265,Flamets-Frétils,166,7,173
23,Haute-Normandie,76,1,19,266,Flocques,695,7,702
23,Haute-Normandie,76,3,41,267,La Folletière,65,6,71
23,Haute-Normandie,76,2,12,268,Fongueusemare,188,2,190
23,Haute-Normandie,76,1,49,269,Fontaine-en-Bray,159,4,163
23,Haute-Normandie,76,2,37,270,Fontaine-la-Mallet,2705,93,2798
23,Haute-Normandie,76,3,11,271,Fontaine-le-Bourg,1435,19,1454
23,Haute-Normandie,76,1,22,272,Fontaine-le-Dun,942,43,985
23,Haute-Normandie,76,3,13,273,Fontaine-sous-Préaux,542,18,560
23,Haute-Normandie,76,1,52,274,La Fontelaye,33,0,33
23,Haute-Normandie,76,2,37,275,Fontenay,1040,21,1061
23,Haute-Normandie,76,1,23,276,Forges-les-Eaux,3527,242,3769
23,Haute-Normandie,76,1,23,277,Le Fossé,451,14,465
23,Haute-Normandie,76,1,05,278,Foucarmont,1025,23,1048
23,Haute-Normandie,76,2,20,279,Foucart,360,6,366
23,Haute-Normandie,76,3,07,475,Franqueville-Saint-Pierre,5567,205,5772
23,Haute-Normandie,76,1,34,280,Fréauville,133,3,136
23,Haute-Normandie,76,2,33,281,La Frénaye,1860,50,1910
23,Haute-Normandie,76,3,61,282,Freneuse,934,10,944
23,Haute-Normandie,76,1,38,283,Fresles,221,3,224
23,Haute-Normandie,76,1,52,284,Fresnay-le-Long,286,8,294
23,Haute-Normandie,76,3,07,285,Fresne-le-Plan,574,14,588
23,Haute-Normandie,76,1,34,286,Fresnoy-Folny,680,5,685
23,Haute-Normandie,76,3,41,287,Fresquiennes,1046,11,1057
23,Haute-Normandie,76,1,18,288,Freulleville,352,10,362
23,Haute-Normandie,76,3,41,289,Fréville,858,9,867
23,Haute-Normandie,76,3,11,290,Frichemesnil,408,7,415
23,Haute-Normandie,76,2,21,291,Froberville,1037,22,1059
23,Haute-Normandie,76,1,01,292,Fry,143,2,145
23,Haute-Normandie,76,3,15,293,Fultot,198,4,202
23,Haute-Normandie,76,1,22,294,La Gaillarde,433,10,443
23,Haute-Normandie,76,1,23,295,Gaillefontaine,1385,23,1408
23,Haute-Normandie,76,2,63,296,Gainneville,2624,30,2654
23,Haute-Normandie,76,1,25,297,Gancourt-Saint-Étienne,229,4,233
23,Haute-Normandie,76,2,21,298,Ganzeville,443,11,454
23,Haute-Normandie,76,2,53,299,Gerponville,356,7,363
23,Haute-Normandie,76,2,21,300,Gerville,411,8,419
23,Haute-Normandie,76,1,18,301,Glicourt,196,2,198
23,Haute-Normandie,76,2,24,302,Goderville,2881,31,2912
23,Haute-Normandie,76,2,48,303,Gommerville,706,16,722
23,Haute-Normandie,76,2,24,304,Gonfreville-Caillot,317,1,318
23,Haute-Normandie,76,2,63,305,Gonfreville-l'Orcher,9115,64,9179
23,Haute-Normandie,76,1,03,306,Gonnetot,148,1,149
23,Haute-Normandie,76,2,12,307,Gonneville-la-Mallet,1252,17,1269
23,Haute-Normandie,76,1,52,308,Gonneville-sur-Scie,435,9,444
23,Haute-Normandie,76,3,15,309,Gonzeville,108,3,111
23,Haute-Normandie,76,1,18,310,Gouchaupre,164,6,170
23,Haute-Normandie,76,3,41,311,Goupillières,422,5,427
23,Haute-Normandie,76,1,25,312,Gournay-en-Bray,6229,139,6368
23,Haute-Normandie,76,3,07,313,Gouy,816,16,832
23,Haute-Normandie,76,2,48,314,Graimbouville,573,10,583
23,Haute-Normandie,76,1,09,315,Grainville-la-Teinturière,1052,73,1125
23,Haute-Normandie,76,3,13,316,Grainville-sur-Ry,458,3,461
23,Haute-Normandie,76,2,24,317,Grainville-Ymauville,408,7,415
23,Haute-Normandie,76,2,33,318,Grand-Camp,685,23,708
23,Haute-Normandie,76,3,26,319,Grand-Couronne,9496,166,9662
23,Haute-Normandie,76,3,94,322,Le Grand-Quevilly,25826,258,26084
23,Haute-Normandie,76,1,34,320,Grandcourt,349,4,353
23,Haute-Normandie,76,1,04,321,Les Grandes-Ventes,1812,32,1844
23,Haute-Normandie,76,1,38,323,Graval,118,4,122
23,Haute-Normandie,76,1,14,324,Grèges,784,11,795
23,Haute-Normandie,76,3,54,325,Grémonville,388,13,401
23,Haute-Normandie,76,1,18,326,Greny,140,2,142
23,Haute-Normandie,76,1,03,327,Greuville,355,6,361
23,Haute-Normandie,76,1,04,328,Grigneuseville,317,0,317
23,Haute-Normandie,76,2,06,329,Gruchet-le-Valasse,2557,82,2639
23,Haute-Normandie,76,1,03,330,Gruchet-Saint-Siméon,700,17,717
23,Haute-Normandie,76,3,11,331,Grugny,918,10,928
23,Haute-Normandie,76,1,23,332,Grumesnil,502,15,517
23,Haute-Normandie,76,1,05,333,Guerville,448,5,453
23,Haute-Normandie,76,1,03,334,Gueures,503,7,510
23,Haute-Normandie,76,3,41,335,Gueutteville,76,1,77
23,Haute-Normandie,76,1,50,336,Gueutteville-les-Grès,347,8,355
23,Haute-Normandie,76,1,18,337,Guilmécourt,271,3,274
23,Haute-Normandie,76,1,01,338,La Hallotière,130,4,134
23,Haute-Normandie,76,2,40,339,Le Hanouard,226,5,231
23,Haute-Normandie,76,3,15,340,Harcanville,445,14,459
23,Haute-Normandie,76,2,63,341,Harfleur,8088,94,8182
23,Haute-Normandie,76,2,20,342,Hattenville,657,11,668
23,Haute-Normandie,76,1,23,343,Haucourt,250,5,255
23,Haute-Normandie,76,1,02,344,Haudricourt,452,10,462
23,Haute-Normandie,76,1,23,345,Haussez,278,6,284
23,Haute-Normandie,76,2,40,346,Hautot-l'Auvray,323,5,328
23,Haute-Normandie,76,2,20,347,Hautot-le-Vatois,286,7,293
23,Haute-Normandie,76,3,15,348,Hautot-Saint-Sulpice,581,23,604
23,Haute-Normandie,76,1,39,349,Hautot-sur-Mer,1986,68,2054
23,Haute-Normandie,76,3,26,350,Hautot-sur-Seine,358,6,364
23,Haute-Normandie,76,2,98,351,Le Havre,178769,2563,181332
23,Haute-Normandie,76,1,01,352,La Haye,269,3,272
23,Haute-Normandie,76,1,22,353,Héberville,115,2,117
23,Haute-Normandie,76,3,16,354,Hénouville,1250,31,1281
23,Haute-Normandie,76,2,40,355,Héricourt-en-Caux,942,24,966
23,Haute-Normandie,76,1,03,356,Hermanville,106,1,107
23,Haute-Normandie,76,2,12,357,Hermeville,366,2,368
23,Haute-Normandie,76,3,13,358,Le Héron,244,4,248
23,Haute-Normandie,76,3,08,359,Héronchelles,116,2,118
23,Haute-Normandie,76,1,35,360,Heugleville-sur-Scie,565,7,572
23,Haute-Normandie,76,2,12,361,Heuqueville,645,3,648
23,Haute-Normandie,76,3,10,362,Heurteauville,315,7,322
23,Haute-Normandie,76,1,05,363,Hodeng-au-Bosc,607,9,616
23,Haute-Normandie,76,1,01,364,Hodeng-Hodenger,254,9,263
23,Haute-Normandie,76,1,22,365,Houdetot,165,7,172
23,Haute-Normandie,76,3,66,366,Le Houlme,4073,43,4116
23,Haute-Normandie,76,3,66,367,Houppeville,2463,46,2509
23,Haute-Normandie,76,2,24,368,Houquetot,318,1,319
23,Haute-Normandie,76,3,11,369,La Houssaye-Béranger,538,4,542
23,Haute-Normandie,76,3,54,370,Hugleville-en-Caux,370,5,375
23,Haute-Normandie,76,1,18,371,Les Ifs,50,1,51
23,Haute-Normandie,76,1,02,372,Illois,315,7,322
23,Haute-Normandie,76,1,52,373,Imbleville,302,0,302
23,Haute-Normandie,76,1,19,374,Incheville,1378,19,1397
23,Haute-Normandie,76,1,50,375,Ingouville,265,8,273
23,Haute-Normandie,76,1,18,376,Intraville,243,4,247
23,Haute-Normandie,76,3,60,377,Isneauville,2463,42,2505
23,Haute-Normandie,76,3,16,378,Jumièges,1718,21,1739
23,Haute-Normandie,76,1,03,379,Lamberville,163,2,165
23,Haute-Normandie,76,1,03,380,Lammerville,320,8,328
23,Haute-Normandie,76,1,02,381,Landes-Vieilles-et-Neuves,130,5,135
23,Haute-Normandie,76,2,06,382,Lanquetot,1022,18,1040
23,Haute-Normandie,76,1,03,383,Lestanville,96,0,96
23,Haute-Normandie,76,2,33,384,Lillebonne,9342,201,9543
23,Haute-Normandie,76,3,41,385,Limésy,1401,121,1522
23,Haute-Normandie,76,2,53,386,Limpiville,350,8,358
23,Haute-Normandie,76,3,54,387,Lindebeuf,346,6,352
23,Haute-Normandie,76,2,06,388,Lintot,459,8,467
23,Haute-Normandie,76,1,35,389,Lintot-les-Bois,183,2,185
23,Haute-Normandie,76,2,21,390,Les Loges,1148,24,1172
23,Haute-Normandie,76,3,17,391,La Londe,2249,48,2297
23,Haute-Normandie,76,1,34,392,Londinières,1215,16,1231
23,Haute-Normandie,76,1,23,393,Longmesnil,57,1,58
23,Haute-Normandie,76,1,19,394,Longroy,662,10,672
23,Haute-Normandie,76,1,39,395,Longueil,552,12,564
23,Haute-Normandie,76,3,08,396,Longuerue,303,4,307
23,Haute-Normandie,76,1,35,397,Longueville-sur-Scie,1025,28,1053
23,Haute-Normandie,76,3,10,398,Louvetot,701,21,722
23,Haute-Normandie,76,1,38,399,Lucy,167,1,168
23,Haute-Normandie,76,1,03,400,Luneray,2118,54,2172
23,Haute-Normandie,76,3,10,401,La Mailleraye-sur-Seine,2004,22,2026
23,Haute-Normandie,76,3,66,402,Malaunay,5900,55,5955
23,Haute-Normandie,76,1,09,403,Malleville-les-Grès,157,6,163
23,Haute-Normandie,76,2,37,404,Manéglise,1152,21,1173
23,Haute-Normandie,76,1,35,405,Manéhouville,209,0,209
23,Haute-Normandie,76,2,21,406,Maniquerville,463,4,467
23,Haute-Normandie,76,1,50,407,Manneville-ès-Plains,261,13,274
23,Haute-Normandie,76,2,24,408,Manneville-la-Goupil,989,14,1003
23,Haute-Normandie,76,2,37,409,Mannevillette,836,11,847
23,Haute-Normandie,76,3,36,410,Maromme,11567,99,11666
23,Haute-Normandie,76,1,02,411,Marques,218,3,221
23,Haute-Normandie,76,3,13,412,Martainville-Épreville,702,13,715
23,Haute-Normandie,76,1,39,413,Martigny,484,9,493
23,Haute-Normandie,76,1,14,414,Martin-Église,1508,52,1560
23,Haute-Normandie,76,1,38,415,Massy,293,7,300
23,Haute-Normandie,76,1,49,416,Mathonville,235,2,237
23,Haute-Normandie,76,1,49,417,Maucomble,319,7,326
23,Haute-Normandie,76,3,10,418,Maulévrier-Sainte-Gertrude,914,15,929
23,Haute-Normandie,76,3,16,419,Mauny,185,2,187
23,Haute-Normandie,76,1,23,420,Mauquenchy,313,15,328
23,Haute-Normandie,76,2,33,421,Mélamare,766,16,782
23,Haute-Normandie,76,1,19,422,Melleville,281,5,286
23,Haute-Normandie,76,1,25,423,Ménerval,189,6,195
23,Haute-Normandie,76,1,38,424,Ménonval,191,5,196
23,Haute-Normandie,76,2,24,425,Mentheville,238,5,243
23,Haute-Normandie,76,1,01,426,Mésangueville,158,1,159
23,Haute-Normandie,76,1,38,427,Mesnières-en-Bray,914,271,1185
23,Haute-Normandie,76,1,50,428,Le Mesnil-Durdent,22,1,23
23,Haute-Normandie,76,3,07,429,Le Mesnil-Esnard,6773,371,7144
23,Haute-Normandie,76,1,04,430,Mesnil-Follemprise,128,3,131
23,Haute-Normandie,76,1,01,431,Le Mesnil-Lieubray,98,2,100
23,Haute-Normandie,76,1,23,432,Mesnil-Mauger,238,1,239
23,Haute-Normandie,76,3,41,433,Mesnil-Panneville,635,10,645
23,Haute-Normandie,76,3,07,434,Mesnil-Raoul,848,14,862
23,Haute-Normandie,76,1,19,435,Le Mesnil-Réaume,539,8,547
23,Haute-Normandie,76,3,16,436,Le Mesnil-sous-Jumièges,611,10,621
23,Haute-Normandie,76,1,18,437,Meulers,579,8,587
23,Haute-Normandie,76,1,19,438,Millebosc,275,4,279
23,Haute-Normandie,76,2,06,439,Mirville,317,1,318
23,Haute-Normandie,76,1,25,440,Molagnies,160,3,163
23,Haute-Normandie,76,1,05,441,Monchaux-Soreng,643,11,654
23,Haute-Normandie,76,1,19,442,Monchy-sur-Eu,543,7,550
23,Haute-Normandie,76,3,11,443,Mont-Cauvaire,616,8,624
23,Haute-Normandie,76,3,41,444,Mont-de-l'If,97,6,103
23,Haute-Normandie,76,3,65,451,Mont-Saint-Aignan,20001,502,20503
23,Haute-Normandie,76,1,49,445,Montérolier,519,11,530
23,Haute-Normandie,76,3,66,446,Montigny,1152,28,1180
23,Haute-Normandie,76,2,37,447,Montivilliers,16287,266,16553
23,Haute-Normandie,76,3,07,448,Montmain,1363,19,1382
23,Haute-Normandie,76,1,52,449,Montreuil-en-Caux,438,11,449
23,Haute-Normandie,76,1,25,450,Montroty,249,24,273
23,Haute-Normandie,76,3,11,452,Montville,4625,21,4646
23,Haute-Normandie,76,3,08,453,Morgny-la-Pommeraye,1034,9,1043
23,Haute-Normandie,76,1,02,606,Morienne,172,42,214
23,Haute-Normandie,76,1,38,454,Mortemer,108,1,109
23,Haute-Normandie,76,1,01,455,Morville-sur-Andelle,280,10,290
23,Haute-Normandie,76,3,54,456,Motteville,741,11,752
23,Haute-Normandie,76,3,26,457,Moulineaux,882,25,907
23,Haute-Normandie,76,1,35,458,Muchedent,124,3,127
23,Haute-Normandie,76,1,38,459,Nesle-Hodeng,304,5,309
23,Haute-Normandie,76,1,05,460,Nesle-Normandeuse,591,8,599
23,Haute-Normandie,76,1,25,463,Neuf-Marché,689,17,706
23,Haute-Normandie,76,1,49,461,Neufbosc,344,5,349
23,Haute-Normandie,76,1,38,462,Neufchâtel-en-Bray,4917,191,5108
23,Haute-Normandie,76,3,07,464,La Neuville-Chant-d'Oisel,1942,41,1983
23,Haute-Normandie,76,1,38,465,Neuville-Ferrières,599,7,606
23,Haute-Normandie,76,1,50,467,Néville,1102,14,1116
23,Haute-Normandie,76,2,06,468,Nointot,1284,35,1319
23,Haute-Normandie,76,1,01,469,Nolléval,411,6,417
23,Haute-Normandie,76,2,20,470,Normanville,577,14,591
23,Haute-Normandie,76,2,33,471,Norville,885,25,910
23,Haute-Normandie,76,1,18,472,Notre-Dame-d'Aliermont,636,11,647
23,Haute-Normandie,76,3,10,473,Notre-Dame-de-Bliquetuit,655,10,665
23,Haute-Normandie,76,3,66,474,Notre-Dame-de-Bondeville,7130,100,7230
23,Haute-Normandie,76,2,33,476,Notre-Dame-de-Gravenchon,8208,239,8447
23,Haute-Normandie,76,2,37,477,Notre-Dame-du-Bec,424,5,429
23,Haute-Normandie,76,1,35,478,Notre-Dame-du-Parc,160,1,161
23,Haute-Normandie,76,1,02,479,Nullemont,118,4,122
23,Haute-Normandie,76,1,09,480,Ocqueville,454,7,461
23,Haute-Normandie,76,2,37,481,Octeville-sur-Mer,5601,100,5701
23,Haute-Normandie,76,1,39,482,Offranville,3316,269,3585
23,Haute-Normandie,76,2,40,483,Oherville,191,8,199
23,Haute-Normandie,76,3,69,484,Oissel,11564,87,11651
23,Haute-Normandie,76,1,03,485,Omonville,269,56,325
23,Haute-Normandie,76,3,17,486,Orival,940,19,959
23,Haute-Normandie,76,1,34,487,Osmoy-Saint-Valery,329,5,334
23,Haute-Normandie,76,1,09,488,Ouainville,524,15,539
23,Haute-Normandie,76,2,48,489,Oudalle,360,7,367
23,Haute-Normandie,76,2,40,490,Ourville-en-Caux,1120,19,1139
23,Haute-Normandie,76,3,54,491,Ouville-l'Abbaye,620,17,637
23,Haute-Normandie,76,1,39,492,Ouville-la-Rivière,568,14,582
23,Haute-Normandie,76,1,09,493,Paluel,457,2,459
23,Haute-Normandie,76,2,06,494,Parc-d'Anxtot,578,6,584
23,Haute-Normandie,76,3,41,495,Pavilly,6113,172,6285
23,Haute-Normandie,76,1,18,496,Penly,325,4,329
23,Haute-Normandie,76,3,26,497,Petit-Couronne,9110,93,9203
23,Haute-Normandie,76,3,67,498,Le Petit-Quevilly,21860,328,22188
23,Haute-Normandie,76,2,33,499,Petiville,1050,26,1076
23,Haute-Normandie,76,1,05,500,Pierrecourt,472,6,478
23,Haute-Normandie,76,2,12,501,Pierrefiques,128,1,129
23,Haute-Normandie,76,3,08,502,Pierreval,445,4,449
23,Haute-Normandie,76,3,66,503,Pissy-Pôville,1288,24,1312
23,Haute-Normandie,76,1,50,504,Pleine-Sève,115,3,118
23,Haute-Normandie,76,1,23,505,Pommereux,104,4,108
23,Haute-Normandie,76,1,04,506,Pommeréval,376,4,380
23,Haute-Normandie,76,1,19,507,Ponts-et-Marais,841,9,850
23,Haute-Normandie,76,2,12,508,La Poterie-Cap-d'Antifer,383,5,388
23,Haute-Normandie,76,3,13,509,Préaux,1651,32,1683
23,Haute-Normandie,76,3,15,510,Prétot-Vicquemare,143,0,143
23,Haute-Normandie,76,1,34,511,Preuseville,137,2,139
23,Haute-Normandie,76,1,34,512,Puisenval,26,0,26
23,Haute-Normandie,76,3,16,513,Quevillon,608,12,620
23,Haute-Normandie,76,3,07,514,Quévreville-la-Poterie,921,16,937
23,Haute-Normandie,76,1,39,515,Quiberville,522,7,529
23,Haute-Normandie,76,1,38,516,Quièvrecourt,433,8,441
23,Haute-Normandie,76,3,11,517,Quincampoix,3193,74,3267
23,Haute-Normandie,76,2,06,518,Raffetot,475,13,488
23,Haute-Normandie,76,1,03,519,Rainfreville,87,1,88
23,Haute-Normandie,76,1,05,520,Réalcamp,661,4,665
23,Haute-Normandie,76,3,08,521,Rebets,140,3,143
23,Haute-Normandie,76,2,48,522,La Remuée,1337,27,1364
23,Haute-Normandie,76,1,05,523,Rétonval,193,3,196
23,Haute-Normandie,76,3,15,524,Reuville,122,4,126
23,Haute-Normandie,76,2,20,525,Ricarville,308,8,316
23,Haute-Normandie,76,1,18,526,Ricarville-du-Val,162,2,164
23,Haute-Normandie,76,1,02,527,Richemont,478,7,485
23,Haute-Normandie,76,1,05,528,Rieux,621,43,664
23,Haute-Normandie,76,2,53,529,Riville,304,3,307
23,Haute-Normandie,76,2,40,530,Robertot,186,2,188
23,Haute-Normandie,76,2,20,531,Rocquefort,321,3,324
23,Haute-Normandie,76,1,49,532,Rocquemont,797,7,804
23,Haute-Normandie,76,2,48,533,Rogerville,1253,10,1263
23,Haute-Normandie,76,2,37,534,Rolleville,1141,19,1160
23,Haute-Normandie,76,1,23,535,Roncherolles-en-Bray,446,9,455
23,Haute-Normandie,76,3,13,536,Roncherolles-sur-le-Vivier,1098,15,1113
23,Haute-Normandie,76,1,02,537,Ronchois,183,1,184
23,Haute-Normandie,76,1,04,538,Rosay,265,6,271
23,Haute-Normandie,76,3,99,540,Rouen,109425,2380,111805
23,Haute-Normandie,76,3,66,541,Roumare,1366,13,1379
23,Haute-Normandie,76,2,40,542,Routes,224,4,228
23,Haute-Normandie,76,2,06,543,Rouville,560,14,574
23,Haute-Normandie,76,1,23,544,Rouvray-Catillon,194,2,196
23,Haute-Normandie,76,1,39,545,Rouxmesnil-Bouteilles,1934,56,1990
23,Haute-Normandie,76,1,03,546,Royville,258,3,261
23,Haute-Normandie,76,3,11,547,La Rue-Saint-Pierre,629,2,631
23,Haute-Normandie,76,3,13,548,Ry,762,9,771
23,Haute-Normandie,76,1,03,549,Saâne-Saint-Just,142,2,144
23,Haute-Normandie,76,3,26,550,Sahurs,1315,24,1339
23,Haute-Normandie,76,2,48,551,Sainneville,818,15,833
23,Haute-Normandie,76,3,08,554,Saint-Aignan-sur-Ry,293,8,301
23,Haute-Normandie,76,3,11,555,Saint-André-sur-Cailly,860,13,873
23,Haute-Normandie,76,2,33,556,Saint-Antoine-la-Forêt,997,20,1017
23,Haute-Normandie,76,3,10,557,Saint-Arnoult,1319,37,1356
23,Haute-Normandie,76,3,07,558,Saint-Aubin-Celloville,967,16,983
23,Haute-Normandie,76,3,10,559,Saint-Aubin-de-Crétot,516,10,526
23,Haute-Normandie,76,3,13,560,Saint-Aubin-Épinay,942,12,954
23,Haute-Normandie,76,1,18,562,Saint-Aubin-le-Cauf,860,9,869
23,Haute-Normandie,76,3,17,561,Saint-Aubin-lès-Elbeuf,8107,111,8218
23,Haute-Normandie,76,2,48,563,Saint-Aubin-Routot,1264,22,1286
23,Haute-Normandie,76,1,22,564,Saint-Aubin-sur-Mer,265,5,270
23,Haute-Normandie,76,1,39,565,Saint-Aubin-sur-Scie,1177,93,1270
23,Haute-Normandie,76,3,55,568,Saint-Clair-sur-les-Monts,641,15,656
23,Haute-Normandie,76,1,35,570,Saint-Crespin,281,7,288
23,Haute-Normandie,76,1,39,572,Saint-Denis-d'Aclon,175,2,177
23,Haute-Normandie,76,3,13,573,Saint-Denis-le-Thiboult,503,13,516
23,Haute-Normandie,76,1,52,574,Saint-Denis-sur-Scie,447,8,455
23,Haute-Normandie,76,3,93,575,Saint-Étienne-du-Rouvray,28068,472,28540
23,Haute-Normandie,76,2,06,576,Saint-Eustache-la-Forêt,1084,16,1100
23,Haute-Normandie,76,3,11,580,Saint-Georges-sur-Fontaine,852,19,871
23,Haute-Normandie,76,1,35,582,Saint-Germain-d'Étables,267,11,278
23,Haute-Normandie,76,3,08,581,Saint-Germain-des-Essourts,374,5,379
23,Haute-Normandie,76,3,11,583,Saint-Germain-sous-Cailly,285,3,288
23,Haute-Normandie,76,1,38,584,Saint-Germain-sur-Eaulne,214,2,216
23,Haute-Normandie,76,3,10,585,Saint-Gilles-de-Crétot,357,5,362
23,Haute-Normandie,76,2,48,586,Saint-Gilles-de-la-Neuville,639,7,646
23,Haute-Normandie,76,1,04,588,Saint-Hellier,426,7,433
23,Haute-Normandie,76,1,35,589,Saint-Honoré,167,5,172
23,Haute-Normandie,76,1,18,590,Saint-Jacques-d'Aliermont,368,1,369
23,Haute-Normandie,76,3,13,591,Saint-Jacques-sur-Darnétal,2588,70,2658
23,Haute-Normandie,76,2,33,592,Saint-Jean-de-Folleville,831,13,844
23,Haute-Normandie,76,2,06,593,Saint-Jean-de-la-Neuville,556,9,565
23,Haute-Normandie,76,3,66,594,Saint-Jean-du-Cardonnay,1349,17,1366
23,Haute-Normandie,76,2,12,595,Saint-Jouin-Bruneval,1811,25,1836
23,Haute-Normandie,76,2,48,596,Saint-Laurent-de-Brèvedent,1433,29,1462
23,Haute-Normandie,76,3,15,597,Saint-Laurent-en-Caux,810,13,823
23,Haute-Normandie,76,1,05,598,Saint-Léger-aux-Bois,488,15,503
23,Haute-Normandie,76,3,13,599,Saint-Léger-du-Bourg-Denis,3335,45,3380
23,Haute-Normandie,76,2,21,600,Saint-Léonard,1828,27,1855
23,Haute-Normandie,76,1,52,602,Saint-Maclou-de-Folleville,549,1,550
23,Haute-Normandie,76,2,24,603,Saint-Maclou-la-Brière,495,7,502
23,Haute-Normandie,76,1,03,604,Saint-Mards,179,2,181
23,Haute-Normandie,76,1,05,612,Saint-Martin-au-Bosc,172,4,176
23,Haute-Normandie,76,3,54,611,Saint-Martin-aux-Arbres,290,14,304
23,Haute-Normandie,76,1,09,613,Saint-Martin-aux-Buneaux,664,12,676
23,Haute-Normandie,76,3,16,614,Saint-Martin-de-Boscherville,1438,44,1482
23,Haute-Normandie,76,2,12,615,Saint-Martin-du-Bec,595,36,631
23,Haute-Normandie,76,2,37,616,Saint-Martin-du-Manoir,1515,32,1547
23,Haute-Normandie,76,3,13,617,Saint-Martin-du-Vivier,1769,50,1819
23,Haute-Normandie,76,1,18,618,Saint-Martin-en-Campagne,1311,27,1338
23,Haute-Normandie,76,1,38,620,Saint-Martin-l'Hortier,244,10,254
23,Haute-Normandie,76,1,19,619,Saint-Martin-le-Gaillard,318,12,330
23,Haute-Normandie,76,1,49,621,Saint-Martin-Osmonville,1109,9,1118
23,Haute-Normandie,76,2,33,622,Saint-Maurice-d'Ételan,319,11,330
23,Haute-Normandie,76,1,23,623,Saint-Michel-d'Halescourt,105,4,109
23,Haute-Normandie,76,1,18,624,Saint-Nicolas-d'Aliermont,3699,101,3800
23,Haute-Normandie,76,3,10,625,Saint-Nicolas-de-Bliquetuit,550,13,563
23,Haute-Normandie,76,3,10,626,Saint-Nicolas-de-la-Haie,393,10,403
23,Haute-Normandie,76,2,33,627,Saint-Nicolas-de-la-Taille,1339,28,1367
23,Haute-Normandie,76,3,41,628,Saint-Ouen-du-Breuil,757,9,766
23,Haute-Normandie,76,1,03,629,Saint-Ouen-le-Mauger,194,2,196
23,Haute-Normandie,76,1,18,630,Saint-Ouen-sous-Bailly,218,0,218
23,Haute-Normandie,76,3,16,631,Saint-Paër,1198,13,1211
23,Haute-Normandie,76,1,52,632,Saint-Pierre-Bénouville,322,10,332
23,Haute-Normandie,76,3,26,634,Saint-Pierre-de-Manneville,724,12,736
23,Haute-Normandie,76,3,16,636,Saint-Pierre-de-Varengeville,2245,44,2289
23,Haute-Normandie,76,1,34,635,Saint-Pierre-des-Jonquières,120,1,121
23,Haute-Normandie,76,2,53,637,Saint-Pierre-en-Port,842,11,853
23,Haute-Normandie,76,1,19,638,Saint-Pierre-en-Val,1116,27,1143
23,Haute-Normandie,76,2,20,639,Saint-Pierre-Lavis,165,2,167
23,Haute-Normandie,76,1,22,641,Saint-Pierre-le-Vieux,220,3,223
23,Haute-Normandie,76,1,22,642,Saint-Pierre-le-Viger,275,9,284
23,Haute-Normandie,76,3,61,640,Saint-Pierre-lès-Elbeuf,8382,93,8475
23,Haute-Normandie,76,1,18,643,Saint-Quentin-au-Bosc,98,1,99
23,Haute-Normandie,76,1,19,644,Saint-Rémy-Boscrocourt,761,20,781
23,Haute-Normandie,76,1,05,645,Saint-Riquier-en-Rivière,162,0,162
23,Haute-Normandie,76,1,50,646,Saint-Riquier-ès-Plains,592,17,609
23,Haute-Normandie,76,2,48,647,Saint-Romain-de-Colbosc,3818,64,3882
23,Haute-Normandie,76,1,49,648,Saint-Saëns,2505,31,2536
23,Haute-Normandie,76,1,38,649,Saint-Saire,595,7,602
23,Haute-Normandie,76,2,24,650,Saint-Sauveur-d'Émalleville,1190,6,1196
23,Haute-Normandie,76,1,50,651,Saint-Sylvain,180,10,190
23,Haute-Normandie,76,1,18,652,Saint-Vaast-d'Équiqueville,612,8,620
23,Haute-Normandie,76,2,40,653,Saint-Vaast-Dieppedalle,338,4,342
23,Haute-Normandie,76,1,52,654,Saint-Vaast-du-Val,413,6,419
23,Haute-Normandie,76,1,50,655,Saint-Valery-en-Caux,4470,191,4661
23,Haute-Normandie,76,1,52,656,Saint-Victor-l'Abbaye,618,7,625
23,Haute-Normandie,76,2,48,657,Saint-Vigor-d'Ymonville,980,9,989
23,Haute-Normandie,76,2,48,658,Saint-Vincent-Cramesnil,602,6,608
23,Haute-Normandie,76,3,10,659,Saint-Wandrille-Rançon,1181,17,1198
23,Haute-Normandie,76,2,56,552,Sainte-Adresse,7651,286,7937
23,Haute-Normandie,76,1,34,553,Sainte-Agathe-d'Aliermont,312,2,314
23,Haute-Normandie,76,3,41,566,Sainte-Austreberthe,586,7,593
23,Haute-Normandie,76,1,38,567,Sainte-Beuve-en-Rivière,191,5,196
23,Haute-Normandie,76,1,50,569,Sainte-Colombe,202,3,205
23,Haute-Normandie,76,3,08,571,Sainte-Croix-sur-Buchy,677,15,692
23,Haute-Normandie,76,1,35,577,Sainte-Foy,507,8,515
23,Haute-Normandie,76,1,49,578,Sainte-Geneviève,281,3,284
23,Haute-Normandie,76,2,53,587,Sainte-Hélène-Bondeville,735,19,754
23,Haute-Normandie,76,3,16,608,Sainte-Marguerite-sur-Duclair,1724,24,1748
23,Haute-Normandie,76,2,20,607,Sainte-Marguerite-sur-Fauville,242,6,248
23,Haute-Normandie,76,1,39,605,Sainte-Marguerite-sur-Mer,503,9,512
23,Haute-Normandie,76,2,12,609,Sainte-Marie-au-Bosc,305,3,308
23,Haute-Normandie,76,3,55,610,Sainte-Marie-des-Champs,1518,28,1546
23,Haute-Normandie,76,2,48,660,Sandouville,766,13,779
23,Haute-Normandie,76,1,03,662,Sassetot-le-Malgardé,93,0,93
23,Haute-Normandie,76,2,53,663,Sassetot-le-Mauconduit,947,15,962
23,Haute-Normandie,76,1,09,664,Sasseville,297,13,310
23,Haute-Normandie,76,1,18,665,Sauchay,406,11,417
23,Haute-Normandie,76,1,23,666,Saumont-la-Poterie,390,8,398
23,Haute-Normandie,76,1,39,667,Sauqueville,356,16,372
23,Haute-Normandie,76,3,54,668,Saussay,322,6,328
23,Haute-Normandie,76,2,24,669,Sausseuzemare-en-Caux,406,7,413
23,Haute-Normandie,76,2,21,670,Senneville-sur-Fécamp,775,17,792
23,Haute-Normandie,76,1,19,671,Sept-Meules,161,0,161
23,Haute-Normandie,76,1,23,672,Serqueux,1056,26,1082
23,Haute-Normandie,76,3,13,673,Servaville-Salmonville,1059,17,1076
23,Haute-Normandie,76,1,04,674,Sévis,320,10,330
23,Haute-Normandie,76,3,11,675,Sierville,938,9,947
23,Haute-Normandie,76,1,01,676,Sigy-en-Bray,656,4,660
23,Haute-Normandie,76,1,34,677,Smermesnil,388,80,468
23,Haute-Normandie,76,1,49,678,Sommery,746,17,763
23,Haute-Normandie,76,2,40,679,Sommesnil,86,1,87
23,Haute-Normandie,76,2,53,680,Sorquainville,163,3,166
23,Haute-Normandie,76,3,92,681,Sotteville-lès-Rouen,30042,628,30670
23,Haute-Normandie,76,3,61,682,Sotteville-sous-le-Val,741,33,774
23,Haute-Normandie,76,1,22,683,Sotteville-sur-Mer,361,8,369
23,Haute-Normandie,76,2,48,684,Tancarville,1291,15,1306
23,Haute-Normandie,76,2,53,685,Thérouldeville,558,4,562
23,Haute-Normandie,76,2,53,686,Theuville-aux-Maillots,460,9,469
23,Haute-Normandie,76,2,53,688,Thiergeville,349,9,358
23,Haute-Normandie,76,2,53,689,Thiétreville,346,47,393
23,Haute-Normandie,76,1,03,690,Thil-Manneville,538,8,546
23,Haute-Normandie,76,1,23,691,Le Thil-Riberpré,217,5,222
23,Haute-Normandie,76,2,40,692,Thiouville,286,7,293
23,Haute-Normandie,76,2,12,693,Le Tilleul,679,11,690
23,Haute-Normandie,76,1,03,694,Tocqueville-en-Caux,121,6,127
23,Haute-Normandie,76,2,24,695,Tocqueville-les-Murs,291,4,295
23,Haute-Normandie,76,1,19,696,Tocqueville-sur-Eu,199,2,201
23,Haute-Normandie,76,1,35,697,Torcy-le-Grand,708,24,732
23,Haute-Normandie,76,1,35,698,Torcy-le-Petit,474,3,477
23,Haute-Normandie,76,3,15,699,Le Torp-Mesnil,303,6,309
23,Haute-Normandie,76,1,52,700,Tôtes,1330,11,1341
23,Haute-Normandie,76,3,10,701,Touffreville-la-Cable,386,11,397
23,Haute-Normandie,76,3,55,702,Touffreville-la-Corbeline,773,18,791
23,Haute-Normandie,76,1,19,703,Touffreville-sur-Eu,206,2,208
23,Haute-Normandie,76,1,18,704,Tourville-la-Chapelle,512,9,521
23,Haute-Normandie,76,3,61,705,Tourville-la-Rivière,2326,33,2359
23,Haute-Normandie,76,2,21,706,Tourville-les-Ifs,532,16,548
23,Haute-Normandie,76,1,39,707,Tourville-sur-Arques,1189,22,1211
23,Haute-Normandie,76,2,53,708,Toussaint,737,14,751
23,Haute-Normandie,76,3,16,709,Le Trait,5172,73,5245
23,Haute-Normandie,76,2,20,710,Trémauville,97,1,98
23,Haute-Normandie,76,1,19,711,Le Tréport,5576,98,5674
23,Haute-Normandie,76,2,33,712,La Trinité-du-Mont,745,16,761
23,Haute-Normandie,76,2,33,713,Triquerville,388,14,402
23,Haute-Normandie,76,2,48,714,Les Trois-Pierres,714,16,730
23,Haute-Normandie,76,2,06,715,Trouville,600,12,612
23,Haute-Normandie,76,2,12,716,Turretot,1459,26,1485
23,Haute-Normandie,76,3,26,717,Val-de-la-Haye,732,12,744
23,Haute-Normandie,76,1,52,018,Val-de-Saâne,1373,22,1395
23,Haute-Normandie,76,3,55,718,Valliquerville,1257,40,1297
23,Haute-Normandie,76,2,53,719,Valmont,1003,17,1020
23,Haute-Normandie,76,1,39,720,Varengeville-sur-Mer,1040,42,1082
23,Haute-Normandie,76,1,52,721,Varneville-Bretteville,296,5,301
23,Haute-Normandie,76,1,52,723,Vassonville,392,2,394
23,Haute-Normandie,76,1,38,724,Vatierville,107,2,109
23,Haute-Normandie,76,2,24,725,Vattetot-sous-Beaumont,549,7,556
23,Haute-Normandie,76,2,21,726,Vattetot-sur-Mer,311,5,316
23,Haute-Normandie,76,3,10,727,Vatteville-la-Rue,1044,9,1053
23,Haute-Normandie,76,3,66,728,La Vaupalière,988,13,1001
23,Haute-Normandie,76,3,55,729,Veauville-lès-Baons,662,13,675
23,Haute-Normandie,76,2,40,730,Veauville-lès-Quelles,104,3,107
23,Haute-Normandie,76,1,03,731,Vénestanville,168,2,170
23,Haute-Normandie,76,1,49,733,Ventes-Saint-Rémy,234,5,239
23,Haute-Normandie,76,2,12,734,Vergetot,419,5,424
23,Haute-Normandie,76,1,50,735,Veules-les-Roses,572,15,587
23,Haute-Normandie,76,1,09,736,Veulettes-sur-Mer,321,9,330
23,Haute-Normandie,76,3,54,737,Vibeuf,653,17,670
23,Haute-Normandie,76,3,08,738,Vieux-Manoir,684,11,695
23,Haute-Normandie,76,1,02,739,Vieux-Rouen-sur-Bresle,670,8,678
23,Haute-Normandie,76,3,13,740,La Vieux-Rue,455,4,459
23,Haute-Normandie,76,2,12,741,Villainville,289,7,296
23,Haute-Normandie,76,3,10,742,Villequier,758,21,779
23,Haute-Normandie,76,3,41,743,Villers-Écalles,1804,29,1833
23,Haute-Normandie,76,1,05,744,Villers-sous-Foucarmont,200,6,206
23,Haute-Normandie,76,1,19,745,Villy-sur-Yères,187,4,191
23,Haute-Normandie,76,2,53,746,Vinnemerville,208,5,213
23,Haute-Normandie,76,2,24,747,Virville,313,6,319
23,Haute-Normandie,76,1,09,748,Vittefleur,631,12,643
23,Haute-Normandie,76,1,34,749,Wanchy-Capval,341,6,347
23,Haute-Normandie,76,3,16,750,Yainville,1114,17,1131
23,Haute-Normandie,76,2,20,751,Yébleron,1376,15,1391
23,Haute-Normandie,76,3,54,752,Yerville,2281,29,2310
23,Haute-Normandie,76,3,07,753,Ymare,1123,21,1144
23,Haute-Normandie,76,2,21,754,Yport,976,14,990
23,Haute-Normandie,76,2,53,755,Ypreville-Biville,504,10,514
23,Haute-Normandie,76,3,11,756,Yquebeuf,241,4,245
23,Haute-Normandie,76,3,15,757,Yvecrique,644,12,656
23,Haute-Normandie,76,3,55,758,Yvetot,11596,471,12067
23,Haute-Normandie,76,3,16,759,Yville-sur-Seine,438,4,442
11,Île-de-France,77,4,03,001,Achères-la-Forêt,1242,22,1264
11,Île-de-France,77,3,11,002,Amillis,770,7,777
11,Île-de-France,77,4,03,003,Amponville,380,3,383
11,Île-de-France,77,2,22,004,Andrezel,310,7,317
11,Île-de-France,77,5,06,005,Annet-sur-Marne,3255,55,3310
11,Île-de-France,77,2,32,006,Arbonne-la-Forêt,1004,14,1018
11,Île-de-France,77,2,22,007,Argentières,374,1,375
11,Île-de-France,77,1,15,008,Armentières-en-Brie,1367,12,1379
11,Île-de-France,77,4,04,009,Arville,141,2,143
11,Île-de-France,77,2,22,010,Aubepierre-Ozouer-le-Repos,899,7,906
11,Île-de-France,77,4,04,011,Aufferville,543,15,558
11,Île-de-France,77,3,29,012,Augers-en-Brie,310,4,314
11,Île-de-France,77,1,07,013,Aulnoy,390,29,419
11,Île-de-France,77,4,13,014,Avon,14158,297,14455
11,Île-de-France,77,3,01,015,Baby,67,3,70
11,Île-de-France,77,4,24,016,Bagneaux-sur-Loing,1645,13,1658
11,Île-de-France,77,5,43,018,Bailly-Romainvilliers,5765,26,5791
11,Île-de-France,77,3,01,019,Balloy,333,8,341
11,Île-de-France,77,3,23,020,Bannost-Villegagnon,609,6,615
11,Île-de-France,77,3,20,021,Barbey,180,3,183
11,Île-de-France,77,2,32,022,Barbizon,1505,42,1547
11,Île-de-France,77,1,17,023,Barcy,225,5,230
11,Île-de-France,77,1,12,024,Bassevelle,351,8,359
11,Île-de-France,77,3,01,025,Bazoches-lès-Bray,801,13,814
11,Île-de-France,77,3,29,026,Beauchery-Saint-Martin,397,7,404
11,Île-de-France,77,4,04,027,Beaumont-du-Gâtinais,1174,15,1189
11,Île-de-France,77,1,07,028,Beautheil,703,8,711
11,Île-de-France,77,2,22,029,Beauvoir,199,1,200
11,Île-de-France,77,3,26,030,Bellot,804,6,810
11,Île-de-France,77,3,27,031,Bernay-Vilbert,826,24,850
11,Île-de-France,77,3,29,032,Beton-Bazoches,762,16,778
11,Île-de-France,77,3,23,033,Bezalles,223,0,223
11,Île-de-France,77,2,05,034,Blandy,772,14,786
11,Île-de-France,77,4,16,035,Blennes,553,11,564
11,Île-de-France,77,4,13,037,Bois-le-Roi,5493,191,5684
11,Île-de-France,77,3,23,036,Boisdon,86,3,89
11,Île-de-France,77,2,42,038,Boissettes,434,8,442
11,Île-de-France,77,2,42,039,Boissise-la-Bertrand,963,24,987
11,Île-de-France,77,2,32,040,Boissise-le-Roi,3616,54,3670
11,Île-de-France,77,4,03,041,Boissy-aux-Cailles,323,8,331
11,Île-de-France,77,1,07,042,Boissy-le-Châtel,3069,57,3126
11,Île-de-France,77,3,26,043,Boitron,385,5,390
11,Île-de-France,77,2,22,044,Bombon,1000,16,1016
11,Île-de-France,77,4,04,045,Bougligny,710,10,720
11,Île-de-France,77,4,03,046,Boulancourt,353,8,361
11,Île-de-France,77,1,08,047,Bouleurs,1443,27,1470
11,Île-de-France,77,4,24,048,Bourron-Marlotte,2821,111,2932
11,Île-de-France,77,1,08,049,Boutigny,847,21,868
11,Île-de-France,77,4,04,050,Bransles,520,8,528
11,Île-de-France,77,3,01,051,Bray-sur-Seine,2271,37,2308
11,Île-de-France,77,2,22,052,Bréau,355,2,357
11,Île-de-France,77,2,02,053,Brie-Comte-Robert,15901,291,16192
11,Île-de-France,77,3,20,054,La Brosse-Montceaux,707,9,716
11,Île-de-France,77,5,36,055,Brou-sur-Chantereine,4219,46,4265
11,Île-de-France,77,4,03,056,Burcy,154,5,159
11,Île-de-France,77,1,12,057,Bussières,474,5,479
11,Île-de-France,77,5,35,058,Bussy-Saint-Georges,21108,294,21402
11,Île-de-France,77,5,35,059,Bussy-Saint-Martin,719,22,741
11,Île-de-France,77,4,03,060,Buthiers,747,22,769
11,Île-de-France,77,3,20,061,Cannes-Écluse,2624,41,2665
11,Île-de-France,77,5,43,062,Carnetin,449,10,459
11,Île-de-France,77,1,07,063,La Celle-sur-Morin,1206,15,1221
11,Île-de-France,77,2,32,065,Cély,1150,21,1171
11,Île-de-France,77,3,29,066,Cerneux,292,12,304
11,Île-de-France,77,2,42,067,Cesson,8012,181,8193
11,Île-de-France,77,3,10,068,Cessoy-en-Montois,218,1,219
11,Île-de-France,77,2,32,069,Chailly-en-Bière,2097,37,2134
11,Île-de-France,77,1,07,070,Chailly-en-Brie,1382,205,1587
11,Île-de-France,77,4,04,071,Chaintreaux,871,15,886
11,Île-de-France,77,3,29,072,Chalautre-la-Grande,692,7,699
11,Île-de-France,77,3,25,073,Chalautre-la-Petite,551,22,573
11,Île-de-France,77,5,43,075,Chalifert,1162,17,1179
11,Île-de-France,77,3,01,076,Chalmaison,704,58,762
11,Île-de-France,77,1,17,077,Chambry,880,2,882
11,Île-de-France,77,1,12,078,Chamigny,1281,59,1340
11,Île-de-France,77,4,21,079,Champagne-sur-Seine,6461,127,6588
11,Île-de-France,77,3,29,080,Champcenest,126,1,127
11,Île-de-France,77,2,22,081,Champdeuil,653,9,662
11,Île-de-France,77,2,22,082,Champeaux,767,11,778
11,Île-de-France,77,5,38,083,Champs-sur-Marne,24105,208,24313
11,Île-de-France,77,1,12,084,Changis-sur-Marne,1057,12,1069
11,Île-de-France,77,5,43,085,Chanteloup-en-Brie,1948,14,1962
11,Île-de-France,77,2,22,086,La Chapelle-Gauthier,1416,10,1426
11,Île-de-France,77,3,27,087,La Chapelle-Iger,163,3,166
11,Île-de-France,77,4,03,088,La Chapelle-la-Reine,2643,36,2679
11,Île-de-France,77,3,11,093,La Chapelle-Moutils,345,6,351
11,Île-de-France,77,3,23,089,La Chapelle-Rablais,920,14,934
11,Île-de-France,77,3,25,090,La Chapelle-Saint-Sulpice,200,0,200
11,Île-de-France,77,3,27,091,Les Chapelles-Bourbon,397,4,401
11,Île-de-France,77,1,37,094,Charmentray,256,3,259
11,Île-de-France,77,1,37,095,Charny,1201,13,1214
11,Île-de-France,77,2,05,096,Chartrettes,2540,66,2606
11,Île-de-France,77,3,11,097,Chartronges,268,7,275
11,Île-de-France,77,4,04,099,Château-Landon,3083,76,3159
11,Île-de-France,77,3,23,098,Châteaubleau,313,7,320
11,Île-de-France,77,2,05,100,Le Châtelet-en-Brie,4412,68,4480
11,Île-de-France,77,3,10,101,Châtenay-sur-Seine,892,23,915
11,Île-de-France,77,4,24,102,Châtenoy,139,1,140
11,Île-de-France,77,2,05,103,Châtillon-la-Borde,225,7,232
11,Île-de-France,77,2,28,104,Châtres,577,7,584
11,Île-de-France,77,1,17,335,Chauconin-Neufmontiers,2634,30,2664
11,Île-de-France,77,3,26,106,Chauffry,937,9,946
11,Île-de-France,77,2,28,107,Chaumes-en-Brie,3007,59,3066
11,Île-de-France,77,5,97,108,Chelles,52765,452,53217
11,Île-de-France,77,3,25,109,Chenoise,1257,20,1277
11,Île-de-France,77,4,04,110,Chenou,289,5,294
11,Île-de-France,77,5,43,111,Chessy,3827,33,3860
11,Île-de-France,77,4,24,112,Chevrainvilliers,222,2,224
11,Île-de-France,77,3,11,113,Chevru,1102,12,1114
11,Île-de-France,77,2,02,114,Chevry-Cossigny,3668,34,3702
11,Île-de-France,77,4,16,115,Chevry-en-Sereine,470,6,476
11,Île-de-France,77,3,11,116,Choisy-en-Brie,1321,17,1338
11,Île-de-France,77,1,12,117,Citry,759,7,766
11,Île-de-France,77,5,06,118,Claye-Souilly,11272,189,11461
11,Île-de-France,77,2,22,119,Clos-Fontaine,253,9,262
11,Île-de-France,77,1,15,120,Cocherel,578,2,580
11,Île-de-France,77,5,35,121,Collégien,3138,28,3166
11,Île-de-France,77,2,41,122,Combs-la-Ville,21324,262,21586
11,Île-de-France,77,1,37,123,Compans,701,14,715
11,Île-de-France,77,5,43,124,Conches-sur-Gondoire,1723,24,1747
11,Île-de-France,77,1,08,125,Condé-Sainte-Libiaire,1418,19,1437
11,Île-de-France,77,1,15,126,Congis-sur-Thérouanne,1773,185,1958
11,Île-de-France,77,2,02,127,Coubert,1799,35,1834
11,Île-de-France,77,1,08,128,Couilly-Pont-aux-Dames,2074,33,2107
11,Île-de-France,77,1,15,129,Coulombs-en-Valois,584,20,604
11,Île-de-France,77,1,08,130,Coulommes,407,4,411
11,Île-de-France,77,1,07,131,Coulommiers,13723,382,14105
11,Île-de-France,77,5,43,132,Coupvray,2792,39,2831
11,Île-de-France,77,3,20,133,Courcelles-en-Bassée,220,2,222
11,Île-de-France,77,3,29,134,Courchamp,151,2,153
11,Île-de-France,77,3,27,135,Courpalay,1387,13,1400
11,Île-de-France,77,2,28,136,Courquetaine,191,4,195
11,Île-de-France,77,3,29,137,Courtacon,191,1,192
11,Île-de-France,77,2,22,138,Courtomer,544,9,553
11,Île-de-France,77,5,06,139,Courtry,6026,58,6084
11,Île-de-France,77,3,10,140,Coutençon,263,4,267
11,Île-de-France,77,1,08,141,Coutevroult,853,9,862
11,Île-de-France,77,1,08,142,Crécy-la-Chapelle,4083,65,4148
11,Île-de-France,77,1,17,143,Crégy-lès-Meaux,4197,73,4270
11,Île-de-France,77,3,27,144,Crèvecoeur-en-Brie,303,3,306
11,Île-de-France,77,2,22,145,Crisenoy,634,9,643
11,Île-de-France,77,5,35,146,Croissy-Beaubourg,2057,26,2083
11,Île-de-France,77,3,23,147,La Croix-en-Brie,663,13,676
11,Île-de-France,77,1,15,148,Crouy-sur-Ourcq,1720,29,1749
11,Île-de-France,77,3,25,149,Cucharmoy,238,4,242
11,Île-de-France,77,1,09,150,Cuisy,448,3,451
11,Île-de-France,77,3,11,151,Dagny,342,3,345
11,Île-de-France,77,2,32,152,Dammarie-les-Lys,20068,197,20265
11,Île-de-France,77,1,09,153,Dammartin-en-Goële,7986,97,8083
11,Île-de-France,77,3,27,154,Dammartin-sur-Tigeaux,846,29,875
11,Île-de-France,77,5,43,155,Dampmart,3109,24,3133
11,Île-de-France,77,4,24,156,Darvault,785,14,799
11,Île-de-France,77,1,15,157,Dhuisy,265,3,268
11,Île-de-France,77,4,16,158,Diant,212,2,214
11,Île-de-France,77,3,10,159,Donnemarie-Dontilly,2776,32,2808
11,Île-de-France,77,4,21,161,Dormelles,859,10,869
11,Île-de-France,77,3,26,162,Doue,1005,19,1024
11,Île-de-France,77,1,15,163,Douy-la-Ramée,282,3,285
11,Île-de-France,77,2,05,164,Échouboulains,522,6,528
11,Île-de-France,77,2,05,165,Les Écrennes,623,2,625
11,Île-de-France,77,4,21,166,Écuelles,2546,93,2639
11,Île-de-France,77,3,10,167,Égligny,330,0,330
11,Île-de-France,77,4,16,168,Égreville,2143,39,2182
11,Île-de-France,77,5,38,169,Émerainville,7322,74,7396
11,Île-de-France,77,4,21,170,Épisy,504,12,516
11,Île-de-France,77,1,08,171,Esbly,5602,61,5663
11,Île-de-France,77,3,20,172,Esmans,872,13,885
11,Île-de-France,77,1,15,173,Étrépilly,834,5,839
11,Île-de-France,77,3,01,174,Everly,600,10,610
11,Île-de-France,77,2,02,175,Évry-Grégy-sur-Yerre,2270,25,2295
11,Île-de-France,77,1,07,176,Faremoutiers,2396,51,2447
11,Île-de-France,77,2,28,177,Favières,1115,5,1120
11,Île-de-France,77,4,24,178,Faÿ-lès-Nemours,459,13,472
11,Île-de-France,77,2,05,179,Féricy,619,29,648
11,Île-de-France,77,2,02,180,Férolles-Attilly,1118,26,1144
11,Île-de-France,77,5,35,181,Ferrières-en-Brie,2138,26,2164
11,Île-de-France,77,3,11,182,La Ferté-Gaucher,4165,45,4210
11,Île-de-France,77,1,12,183,La Ferté-sous-Jouarre,9032,125,9157
11,Île-de-France,77,4,16,184,Flagy,632,12,644
11,Île-de-France,77,2,32,185,Fleury-en-Bière,631,11,642
11,Île-de-France,77,3,01,187,Fontaine-Fourches,572,7,579
11,Île-de-France,77,2,05,188,Fontaine-le-Port,915,39,954
11,Île-de-France,77,4,13,186,Fontainebleau,15411,534,15945
11,Île-de-France,77,3,23,190,Fontains,263,3,266
11,Île-de-France,77,2,22,191,Fontenailles,1019,9,1028
11,Île-de-France,77,3,27,192,Fontenay-Trésigny,5063,48,5111
11,Île-de-France,77,1,09,193,Forfry,253,1,254
11,Île-de-France,77,3,20,194,Forges,409,150,559
11,Île-de-France,77,2,22,195,Fouju,508,8,516
11,Île-de-France,77,1,37,196,Fresnes-sur-Marne,653,4,657
11,Île-de-France,77,3,23,197,Frétoy,153,1,154
11,Île-de-France,77,4,03,198,Fromont,234,9,243
11,Île-de-France,77,1,31,199,Fublaines,1190,11,1201
11,Île-de-France,77,4,24,200,Garentreville,101,0,101
11,Île-de-France,77,3,23,201,Gastins,647,5,652
11,Île-de-France,77,4,24,202,La Genevraye,631,17,648
11,Île-de-France,77,1,17,203,Germigny-l'Évêque,1303,32,1335
11,Île-de-France,77,1,15,204,Germigny-sous-Coulombs,198,3,201
11,Île-de-France,77,1,09,205,Gesvres-le-Chapitre,163,0,163
11,Île-de-France,77,1,07,206,Giremoutiers,135,1,136
11,Île-de-France,77,4,04,207,Gironville,188,5,193
11,Île-de-France,77,3,01,208,Gouaix,1430,70,1500
11,Île-de-France,77,5,14,209,Gouvernes,1111,21,1132
11,Île-de-France,77,3,20,210,La Grande-Paroisse,2565,50,2615
11,Île-de-France,77,2,22,211,Grandpuits-Bailly-Carrois,963,14,977
11,Île-de-France,77,3,01,212,Gravon,137,0,137
11,Île-de-France,77,1,37,214,Gressy,920,3,923
11,Île-de-France,77,2,28,215,Gretz-Armainvilliers,7861,74,7935
11,Île-de-France,77,4,24,216,Grez-sur-Loing,1376,29,1405
11,Île-de-France,77,2,02,217,Grisy-Suisnes,2321,39,2360
11,Île-de-France,77,3,01,218,Grisy-sur-Seine,103,10,113
11,Île-de-France,77,1,07,219,Guérard,2203,37,2240
11,Île-de-France,77,4,03,220,Guercheville,286,6,292
11,Île-de-France,77,5,43,221,Guermantes,1276,29,1305
11,Île-de-France,77,2,22,222,Guignes,3116,27,3143
11,Île-de-France,77,3,10,223,Gurcy-le-Châtel,535,8,543
11,Île-de-France,77,1,08,225,La Haute-Maison,288,6,294
11,Île-de-France,77,3,27,224,Hautefeuille,325,4,329
11,Île-de-France,77,4,13,226,Héricy,2574,88,2662
11,Île-de-France,77,3,01,227,Hermé,579,3,582
11,Île-de-France,77,3,26,228,Hondevilliers,240,5,245
11,Île-de-France,77,3,27,229,La Houssaye-en-Brie,1626,14,1640
11,Île-de-France,77,4,04,230,Ichy,152,5,157
11,Île-de-France,77,1,15,231,Isles-les-Meldeuses,762,5,767
11,Île-de-France,77,1,31,232,Isles-lès-Villenoy,884,6,890
11,Île-de-France,77,1,37,233,Iverny,593,10,603
11,Île-de-France,77,5,43,234,Jablines,634,7,641
11,Île-de-France,77,1,15,235,Jaignes,326,1,327
11,Île-de-France,77,3,01,236,Jaulnes,343,6,349
11,Île-de-France,77,5,43,237,Jossigny,644,6,650
11,Île-de-France,77,1,12,238,Jouarre,4158,53,4211
11,Île-de-France,77,3,23,239,Jouy-le-Châtel,1420,15,1435
11,Île-de-France,77,3,11,240,Jouy-sur-Morin,2053,29,2082
11,Île-de-France,77,1,09,241,Juilly,1914,395,2309
11,Île-de-France,77,3,10,242,Jutigny,579,3,582
11,Île-de-France,77,5,14,243,Lagny-sur-Marne,20232,271,20503
11,Île-de-France,77,4,03,244,Larchant,723,10,733
11,Île-de-France,77,3,20,245,Laval-en-Brie,453,11,464
11,Île-de-France,77,3,29,246,Léchelle,541,8,549
11,Île-de-France,77,3,11,247,Lescherolles,475,15,490
11,Île-de-France,77,5,43,248,Lesches,705,8,713
11,Île-de-France,77,2,02,249,Lésigny,7536,116,7652
11,Île-de-France,77,3,11,250,Leudon-en-Brie,119,2,121
11,Île-de-France,77,2,41,251,Lieusaint,10210,131,10341
11,Île-de-France,77,2,02,252,Limoges-Fourches,457,4,461
11,Île-de-France,77,2,02,253,Lissy,190,2,192
11,Île-de-France,77,2,28,254,Liverdy-en-Brie,1234,13,1247
11,Île-de-France,77,2,19,255,Livry-sur-Seine,1902,41,1943
11,Île-de-France,77,3,10,256,Lizines,165,3,168
11,Île-de-France,77,1,15,257,Lizy-sur-Ourcq,3457,143,3600
11,Île-de-France,77,5,39,258,Lognes,15028,148,15176
11,Île-de-France,77,1,09,259,Longperrier,2341,16,2357
11,Île-de-France,77,3,25,260,Longueville,1644,29,1673
11,Île-de-France,77,4,16,261,Lorrez-le-Bocage-Préaux,1247,19,1266
11,Île-de-France,77,3,29,262,Louan-Villegruis-Fontaine,510,12,522
11,Île-de-France,77,3,10,263,Luisetaines,225,2,227
11,Île-de-France,77,3,27,264,Lumigny-Nesles-Ormeaux,1508,19,1527
11,Île-de-France,77,1,12,265,Luzancy,997,49,1046
11,Île-de-France,77,2,05,266,Machault,702,7,709
11,Île-de-France,77,4,04,267,La Madeleine-sur-Loing,353,5,358
11,Île-de-France,77,5,43,268,Magny-le-Hongre,5329,49,5378
11,Île-de-France,77,2,18,269,Maincy,1721,60,1781
11,Île-de-France,77,3,23,272,Maison-Rouge,831,12,843
11,Île-de-France,77,1,07,270,Maisoncelles-en-Brie,832,11,843
11,Île-de-France,77,4,04,271,Maisoncelles-en-Gâtinais,136,1,137
11,Île-de-France,77,1,09,273,Marchémoret,565,5,570
11,Île-de-France,77,1,15,274,Marcilly,411,1,412
11,Île-de-France,77,3,29,275,Les Marêts,152,6,158
11,Île-de-France,77,1,31,276,Mareuil-lès-Meaux,2047,53,2100
11,Île-de-France,77,3,27,277,Marles-en-Brie,1414,32,1446
11,Île-de-France,77,3,11,278,Marolles-en-Brie,420,11,431
11,Île-de-France,77,3,20,279,Marolles-sur-Seine,1568,22,1590
11,Île-de-France,77,1,15,280,Mary-sur-Marne,1192,16,1208
11,Île-de-France,77,1,07,281,Mauperthuis,476,6,482
11,Île-de-France,77,1,09,282,Mauregard,271,4,275
11,Île-de-France,77,1,15,283,May-en-Multien,851,8,859
11,Île-de-France,77,1,98,284,Meaux,48653,1767,50420
11,Île-de-France,77,2,42,285,Le Mée-sur-Seine,20827,226,21053
11,Île-de-France,77,3,10,286,Meigneux,215,3,218
11,Île-de-France,77,3,11,287,Meilleray,482,13,495
11,Île-de-France,77,2,99,288,Melun,38938,1073,40011
11,Île-de-France,77,3,29,289,Melz-sur-Seine,379,3,382
11,Île-de-France,77,1,12,290,Méry-sur-Marne,607,58,665
11,Île-de-France,77,1,09,291,Le Mesnil-Amelot,880,4,884
11,Île-de-France,77,1,37,292,Messy,1104,9,1113
11,Île-de-France,77,3,20,293,Misy-sur-Yonne,947,8,955
11,Île-de-France,77,1,37,294,Mitry-Mory,18513,150,18663
11,Île-de-France,77,2,05,295,Moisenay,1105,25,1130
11,Île-de-France,77,2,41,296,Moissy-Cramayel,17186,152,17338
11,Île-de-France,77,4,04,297,Mondreville,354,7,361
11,Île-de-France,77,3,10,298,Mons-en-Montois,457,13,470
11,Île-de-France,77,4,21,299,Montarlot,208,15,223
11,Île-de-France,77,1,31,300,Montceaux-lès-Meaux,610,5,615
11,Île-de-France,77,3,29,301,Montceaux-lès-Provins,335,4,339
11,Île-de-France,77,4,24,302,Montcourt-Fromonville,2113,64,2177
11,Île-de-France,77,3,26,303,Montdauphin,219,7,226
11,Île-de-France,77,3,26,304,Montenils,37,1,38
11,Île-de-France,77,3,20,305,Montereau-Fault-Yonne,16275,239,16514
11,Île-de-France,77,2,18,306,Montereau-sur-le-Jard,576,7,583
11,Île-de-France,77,5,43,307,Montévrain,7532,99,7631
11,Île-de-France,77,1,09,308,Montgé-en-Goële,693,7,700
11,Île-de-France,77,1,09,309,Monthyon,1638,27,1665
11,Île-de-France,77,3,01,310,Montigny-le-Guesdier,292,9,301
11,Île-de-France,77,3,10,311,Montigny-Lencoup,1255,23,1278
11,Île-de-France,77,4,21,312,Montigny-sur-Loing,2764,83,2847
11,Île-de-France,77,4,16,313,Montmachoux,229,1,230
11,Île-de-France,77,3,11,314,Montolivet,248,8,256
11,Île-de-France,77,1,08,315,Montry,3231,14,3245
11,Île-de-France,77,4,21,316,Moret-sur-Loing,4423,149,4572
11,Île-de-France,77,2,22,317,Mormant,4326,37,4363
11,Île-de-France,77,3,27,318,Mortcerf,1449,18,1467
11,Île-de-France,77,3,25,319,Mortery,174,0,174
11,Île-de-France,77,1,07,320,Mouroux,4737,49,4786
11,Île-de-France,77,3,01,321,Mousseaux-lès-Bray,665,8,673
11,Île-de-France,77,1,09,322,Moussy-le-Neuf,2686,32,2718
11,Île-de-France,77,1,09,323,Moussy-le-Vieux,1069,7,1076
11,Île-de-France,77,3,01,325,Mouy-sur-Seine,371,5,376
11,Île-de-France,77,2,34,326,Nandy,5852,79,5931
11,Île-de-France,77,3,23,327,Nangis,7637,124,7761
11,Île-de-France,77,4,03,328,Nanteau-sur-Essonne,430,5,435
11,Île-de-France,77,4,24,329,Nanteau-sur-Lunain,676,8,684
11,Île-de-France,77,1,31,330,Nanteuil-lès-Meaux,5348,70,5418
11,Île-de-France,77,1,12,331,Nanteuil-sur-Marne,462,2,464
11,Île-de-France,77,1,37,332,Nantouillet,265,6,271
11,Île-de-France,77,4,24,333,Nemours,12645,129,12774
11,Île-de-France,77,3,27,336,Neufmoutiers-en-Brie,1007,83,1090
11,Île-de-France,77,5,39,337,Noisiel,15634,128,15762
11,Île-de-France,77,4,16,338,Noisy-Rudignon,579,8,587
11,Île-de-France,77,4,03,339,Noisy-sur-École,1948,58,2006
11,Île-de-France,77,4,24,340,Nonville,622,5,627
11,Île-de-France,77,3,01,341,Noyen-sur-Seine,369,18,387
11,Île-de-France,77,4,04,342,Obsonville,109,2,111
11,Île-de-France,77,1,15,343,Ocquerre,393,26,419
11,Île-de-France,77,1,09,344,Oissery,2136,41,2177
11,Île-de-France,77,3,26,345,Orly-sur-Morin,650,5,655
11,Île-de-France,77,3,01,347,Les Ormes-sur-Voulzie,841,15,856
11,Île-de-France,77,4,24,348,Ormesson,250,3,253
11,Île-de-France,77,1,09,349,Othis,6497,43,6540
11,Île-de-France,77,5,33,350,Ozoir-la-Ferrière,20528,317,20845
11,Île-de-France,77,2,28,352,Ozouer-le-Voulgis,1750,15,1765
11,Île-de-France,77,4,16,353,Paley,425,9,434
11,Île-de-France,77,2,05,354,Pamfou,936,9,945
11,Île-de-France,77,3,10,355,Paroy,171,8,179
11,Île-de-France,77,3,01,356,Passy-sur-Seine,41,0,41
11,Île-de-France,77,3,23,357,Pécy,821,23,844
11,Île-de-France,77,1,17,358,Penchard,1029,24,1053
11,Île-de-France,77,2,32,359,Perthes,2096,35,2131
11,Île-de-France,77,3,27,360,Pézarches,369,5,374
11,Île-de-France,77,1,12,361,Pierre-Levée,450,5,455
11,Île-de-France,77,5,06,363,Le Pin,1197,14,1211
11,Île-de-France,77,1,37,364,Le Plessis-aux-Bois,247,2,249
11,Île-de-France,77,3,27,365,Le Plessis-Feu-Aussoux,538,11,549
11,Île-de-France,77,1,09,366,Le Plessis-l'Évêque,243,3,246
11,Île-de-France,77,1,15,367,Le Plessis-Placy,266,6,272
11,Île-de-France,77,3,25,368,Poigny,460,4,464
11,Île-de-France,77,1,17,369,Poincy,712,28,740
11,Île-de-France,77,4,24,370,Poligny,813,25,838
11,Île-de-France,77,1,07,371,Pommeuse,2693,44,2737
11,Île-de-France,77,5,14,372,Pomponne,3333,46,3379
11,Île-de-France,77,5,40,373,Pontault-Combault,34815,298,35113
11,Île-de-France,77,5,33,374,Pontcarré,1996,13,2009
11,Île-de-France,77,1,37,376,Précy-sur-Marne,719,13,732
11,Île-de-France,77,2,28,377,Presles-en-Brie,2147,39,2186
11,Île-de-France,77,2,32,378,Pringy,2578,64,2642
11,Île-de-France,77,3,25,379,Provins,12264,363,12627
11,Île-de-France,77,1,15,380,Puisieux,294,5,299
11,Île-de-France,77,2,22,381,Quiers,663,7,670
11,Île-de-France,77,1,08,382,Quincy-Voisins,4986,81,5067
11,Île-de-France,77,3,23,383,Rampillon,786,10,796
11,Île-de-France,77,2,41,384,Réau,1046,9,1055
11,Île-de-France,77,3,26,385,Rebais,2125,15,2140
11,Île-de-France,77,4,03,386,Recloses,692,15,707
11,Île-de-France,77,4,16,387,Remauville,444,7,451
11,Île-de-France,77,1,12,388,Reuil-en-Brie,858,15,873
11,Île-de-France,77,2,19,389,La Rochette,2975,76,3051
11,Île-de-France,77,5,33,390,Roissy-en-Brie,22178,174,22352
11,Île-de-France,77,3,25,391,Rouilly,487,2,489
11,Île-de-France,77,1,09,392,Rouvres,624,10,634
11,Île-de-France,77,3,27,393,Rozay-en-Brie,2721,45,2766
11,Île-de-France,77,2,18,394,Rubelles,1817,57,1874
11,Île-de-France,77,4,03,395,Rumont,126,3,129
11,Île-de-France,77,3,29,396,Rupéreux,98,0,98
11,Île-de-France,77,1,12,397,Saâcy-sur-Marne,1734,63,1797
11,Île-de-France,77,3,26,398,Sablonnières,682,14,696
11,Île-de-France,77,4,16,399,Saint-Ange-le-Viel,235,4,239
11,Île-de-France,77,1,07,400,Saint-Augustin,1661,26,1687
11,Île-de-France,77,3,11,402,Saint-Barthélemy,353,4,357
11,Île-de-France,77,3,25,403,Saint-Brice,751,15,766
11,Île-de-France,77,3,26,405,Saint-Cyr-sur-Morin,1835,25,1860
11,Île-de-France,77,3,26,406,Saint-Denis-lès-Rebais,931,21,952
11,Île-de-France,77,2,32,407,Saint-Fargeau-Ponthierry,12278,144,12422
11,Île-de-France,77,1,08,408,Saint-Fiacre,376,8,384
11,Île-de-France,77,3,20,409,Saint-Germain-Laval,2740,53,2793
11,Île-de-France,77,2,18,410,Saint-Germain-Laxis,519,8,527
11,Île-de-France,77,3,26,411,Saint-Germain-sous-Doue,478,9,487
11,Île-de-France,77,2,32,412,Saint-Germain-sur-École,361,3,364
11,Île-de-France,77,1,08,413,Saint-Germain-sur-Morin,3406,49,3455
11,Île-de-France,77,3,25,414,Saint-Hilliers,429,4,433
11,Île-de-France,77,1,12,415,Saint-Jean-les-Deux-Jumeaux,1177,18,1195
11,Île-de-France,77,3,23,416,Saint-Just-en-Brie,258,3,261
11,Île-de-France,77,3,26,417,Saint-Léger,201,4,205
11,Île-de-France,77,3,25,418,Saint-Loup-de-Naud,889,10,899
11,Île-de-France,77,4,21,419,Saint-Mammès,3195,108,3303
11,Île-de-France,77,1,09,420,Saint-Mard,3709,41,3750
11,Île-de-France,77,3,11,421,Saint-Mars-Vieux-Maisons,283,9,292
11,Île-de-France,77,3,11,423,Saint-Martin-des-Champs,697,9,706
11,Île-de-France,77,3,29,424,Saint-Martin-du-Boschet,283,3,286
11,Île-de-France,77,2,32,425,Saint-Martin-en-Bière,823,19,842
11,Île-de-France,77,2,22,426,Saint-Méry,391,9,400
11,Île-de-France,77,1,37,427,Saint-Mesmes,535,4,539
11,Île-de-France,77,2,22,428,Saint-Ouen-en-Brie,843,10,853
11,Île-de-France,77,3,26,429,Saint-Ouen-sur-Morin,564,1,565
11,Île-de-France,77,1,09,430,Saint-Pathus,5367,50,5417
11,Île-de-France,77,4,24,431,Saint-Pierre-lès-Nemours,5716,146,5862
11,Île-de-France,77,3,11,432,Saint-Rémy-la-Vanne,950,16,966
11,Île-de-France,77,3,01,434,Saint-Sauveur-lès-Bray,320,0,320
11,Île-de-France,77,2,32,435,Saint-Sauveur-sur-École,1095,18,1113
11,Île-de-France,77,3,11,436,Saint-Siméon,848,12,860
11,Île-de-France,77,1,09,437,Saint-Soupplets,3273,26,3299
11,Île-de-France,77,5,14,438,Saint-Thibault-des-Vignes,6417,89,6506
11,Île-de-France,77,1,12,401,Sainte-Aulde,626,4,630
11,Île-de-France,77,3,25,404,Sainte-Colombe,1736,34,1770
11,Île-de-France,77,1,07,433,Saints,1287,26,1313
11,Île-de-France,77,3,20,439,Salins,1014,9,1023
11,Île-de-France,77,1,12,440,Sammeron,1022,11,1033
11,Île-de-France,77,4,13,441,Samois-sur-Seine,2084,77,2161
11,Île-de-France,77,4,13,442,Samoreau,2333,54,2387
11,Île-de-France,77,1,08,443,Sancy,368,6,374
11,Île-de-France,77,3,29,444,Sancy-lès-Provins,312,8,320
11,Île-de-France,77,2,34,445,Savigny-le-Temple,27757,285,28042
11,Île-de-France,77,3,10,446,Savins,620,17,637
11,Île-de-France,77,2,34,447,Seine-Port,1939,41,1980
11,Île-de-France,77,1,12,448,Sept-Sorts,449,8,457
11,Île-de-France,77,5,43,449,Serris,7123,40,7163
11,Île-de-France,77,2,02,450,Servon,2910,49,2959
11,Île-de-France,77,1,12,451,Signy-Signets,601,11,612
11,Île-de-France,77,3,10,452,Sigy,55,1,56
11,Île-de-France,77,2,05,453,Sivry-Courtry,981,26,1007
11,Île-de-France,77,3,10,454,Sognolles-en-Montois,424,6,430
11,Île-de-France,77,2,02,455,Soignolles-en-Brie,2015,23,2038
11,Île-de-France,77,3,25,456,Soisy-Bouy,792,15,807
11,Île-de-France,77,2,02,457,Solers,1288,11,1299
11,Île-de-France,77,4,04,458,Souppes-sur-Loing,5667,110,5777
11,Île-de-France,77,3,29,459,Sourdun,1556,18,1574
11,Île-de-France,77,1,15,460,Tancrou,338,8,346
11,Île-de-France,77,3,10,461,Thénisy,277,6,283
11,Île-de-France,77,1,09,462,Thieux,809,7,816
11,Île-de-France,77,4,21,463,Thomery,3385,87,3472
11,Île-de-France,77,5,43,464,Thorigny-sur-Marne,9409,100,9509
11,Île-de-France,77,4,16,465,Thoury-Férottes,620,8,628
11,Île-de-France,77,3,27,466,Tigeaux,375,2,377
11,Île-de-France,77,3,01,467,La Tombe,220,0,220
11,Île-de-France,77,5,35,468,Torcy,21931,177,22108
11,Île-de-France,77,3,27,469,Touquin,1098,21,1119
11,Île-de-France,77,2,28,470,Tournan-en-Brie,8178,123,8301
11,Île-de-France,77,4,03,471,Tousson,382,12,394
11,Île-de-France,77,3,26,472,La Trétoire,368,4,372
11,Île-de-France,77,4,24,473,Treuzy-Levelay,451,8,459
11,Île-de-France,77,1,31,474,Trilbardou,613,7,620
11,Île-de-France,77,1,31,475,Trilport,4840,75,4915
11,Île-de-France,77,1,15,476,Trocy-en-Multien,266,4,270
11,Île-de-France,77,4,03,477,Ury,819,24,843
11,Île-de-France,77,1,12,478,Ussy-sur-Marne,942,15,957
11,Île-de-France,77,5,36,479,Vaires-sur-Marne,11962,116,12078
11,Île-de-France,77,2,05,480,Valence-en-Brie,899,8,907
11,Île-de-France,77,3,23,481,Vanvillé,172,6,178
11,Île-de-France,77,3,20,482,Varennes-sur-Seine,3232,59,3291
11,Île-de-France,77,1,17,483,Varreddes,1862,26,1888
11,Île-de-France,77,1,08,484,Vaucourtois,211,2,213
11,Île-de-France,77,4,03,485,Le Vaudoué,748,20,768
11,Île-de-France,77,3,27,486,Vaudoy-en-Brie,814,9,823
11,Île-de-France,77,2,18,487,Vaux-le-Pénil,11257,220,11477
11,Île-de-France,77,4,16,489,Vaux-sur-Lunain,196,3,199
11,Île-de-France,77,1,15,490,Vendrest,719,4,723
11,Île-de-France,77,4,21,491,Veneux-les-Sablons,4776,100,4876
11,Île-de-France,77,3,26,492,Verdelot,738,13,751
11,Île-de-France,77,2,22,493,Verneuil-l'Étang,3142,29,3171
11,Île-de-France,77,4,21,494,Vernou-la-Celle-sur-Seine,2693,42,2735
11,Île-de-France,77,2,42,495,Vert-Saint-Denis,7012,96,7108
11,Île-de-France,77,3,23,496,Vieux-Champagne,175,5,180
11,Île-de-France,77,1,31,498,Vignely,245,6,251
11,Île-de-France,77,4,21,516,Ville-Saint-Jacques,722,16,738
11,Île-de-France,77,4,16,500,Villebéon,459,6,465
11,Île-de-France,77,4,21,501,Villecerf,806,10,816
11,Île-de-France,77,4,16,504,Villemaréchal,838,17,855
11,Île-de-France,77,1,08,505,Villemareuil,383,4,387
11,Île-de-France,77,4,21,506,Villemer,659,9,668
11,Île-de-France,77,3,01,507,Villenauxe-la-Petite,470,6,476
11,Île-de-France,77,3,27,508,Villeneuve-le-Comte,1766,30,1796
11,Île-de-France,77,3,10,509,Villeneuve-les-Bordes,580,9,589
11,Île-de-France,77,3,27,510,Villeneuve-Saint-Denis,699,6,705
11,Île-de-France,77,1,09,511,Villeneuve-sous-Dammartin,614,8,622
11,Île-de-France,77,3,26,512,Villeneuve-sur-Bellot,1136,18,1154
11,Île-de-France,77,1,31,513,Villenoy,4033,42,4075
11,Île-de-France,77,5,06,514,Villeparisis,23879,190,24069
11,Île-de-France,77,1,37,515,Villeroy,676,8,684
11,Île-de-France,77,5,06,517,Villevaudé,1708,36,1744
11,Île-de-France,77,2,32,518,Villiers-en-Bière,211,5,216
11,Île-de-France,77,3,29,519,Villiers-Saint-Georges,1163,16,1179
11,Île-de-France,77,4,03,520,Villiers-sous-Grez,763,21,784
11,Île-de-France,77,1,08,521,Villiers-sur-Morin,1741,24,1765
11,Île-de-France,77,3,01,522,Villiers-sur-Seine,331,11,342
11,Île-de-France,77,3,01,523,Villuis,256,2,258
11,Île-de-France,77,3,10,524,Vimpelles,486,9,495
11,Île-de-France,77,1,09,525,Vinantes,334,4,338
11,Île-de-France,77,1,15,526,Vincy-Manoeuvre,206,8,214
11,Île-de-France,77,3,27,527,Voinsles,564,11,575
11,Île-de-France,77,2,18,528,Voisenon,1096,48,1144
11,Île-de-France,77,1,08,529,Voulangis,1490,14,1504
11,Île-de-France,77,3,29,530,Voulton,311,15,326
11,Île-de-France,77,4,16,531,Voulx,1744,82,1826
11,Île-de-France,77,3,25,532,Vulaines-lès-Provins,61,2,63
11,Île-de-France,77,4,13,533,Vulaines-sur-Seine,2549,52,2601
11,Île-de-France,77,2,22,534,Yèbles,620,12,632
11,Île-de-France,78,2,19,003,Ablis,3260,46,3306
11,Île-de-France,78,3,20,005,Achères,19733,165,19898
11,Île-de-France,78,1,08,006,Adainville,770,17,787
11,Île-de-France,78,3,21,007,Aigremont,1086,35,1121
11,Île-de-France,78,2,19,009,Allainville,306,6,312
11,Île-de-France,78,3,17,010,Les Alluets-le-Roi,1194,29,1223
11,Île-de-France,78,1,07,013,Andelu,484,1,485
11,Île-de-France,78,3,39,015,Andrésy,12233,149,12382
11,Île-de-France,78,1,07,020,Arnouville-lès-Mantes,827,20,847
11,Île-de-France,78,1,01,029,Aubergenville,12134,78,12212
11,Île-de-France,78,2,18,030,Auffargis,1963,61,2024
11,Île-de-France,78,1,07,031,Auffreville-Brasseuil,596,18,614
11,Île-de-France,78,1,01,033,Aulnay-sur-Mauldre,1157,20,1177
11,Île-de-France,78,2,15,034,Auteuil,913,20,933
11,Île-de-France,78,2,15,036,Autouillet,463,9,472
11,Île-de-France,78,3,22,043,Bailly,3975,166,4141
11,Île-de-France,78,1,08,048,Bazainville,1375,29,1404
11,Île-de-France,78,1,01,049,Bazemont,1525,54,1579
11,Île-de-France,78,2,15,050,Bazoches-sur-Guyonne,599,7,606
11,Île-de-France,78,2,15,053,Béhoust,458,12,470
11,Île-de-France,78,1,02,057,Bennecourt,1790,34,1824
11,Île-de-France,78,2,15,062,Beynes,7577,109,7686
11,Île-de-France,78,1,02,068,Blaru,932,33,965
11,Île-de-France,78,1,07,070,Boinville-en-Mantois,295,3,298
11,Île-de-France,78,2,19,071,Boinville-le-Gaillard,594,5,599
11,Île-de-France,78,1,07,072,Boinvilliers,266,7,273
11,Île-de-France,78,4,36,073,Bois-d'Arcy,13612,183,13795
11,Île-de-France,78,1,08,076,Boissets,271,8,279
11,Île-de-France,78,2,18,077,La Boissière-École,768,112,880
11,Île-de-France,78,1,02,082,Boissy-Mauvoisin,625,8,633
11,Île-de-France,78,2,15,084,Boissy-sans-Avoir,603,6,609
11,Île-de-France,78,2,19,087,Bonnelles,1992,59,2051
11,Île-de-France,78,1,02,089,Bonnières-sur-Seine,4135,48,4183
11,Île-de-France,78,1,01,090,Bouafle,2183,21,2204
11,Île-de-France,78,3,03,092,Bougival,8430,112,8542
11,Île-de-France,78,1,08,096,Bourdonné,467,13,480
11,Île-de-France,78,1,07,104,Breuil-Bois-Robert,706,14,720
11,Île-de-France,78,1,02,107,Bréval,1928,35,1963
11,Île-de-France,78,2,18,108,Les Bréviaires,1124,28,1152
11,Île-de-France,78,1,10,113,Brueil-en-Vexin,670,20,690
11,Île-de-France,78,4,29,117,Buc,5446,176,5622
11,Île-de-France,78,1,33,118,Buchelay,2212,33,2245
11,Île-de-France,78,2,19,120,Bullion,1940,38,1978
11,Île-de-France,78,3,16,123,Carrières-sous-Poissy,14512,144,14656
11,Île-de-France,78,3,09,124,Carrières-sur-Seine,15415,150,15565
11,Île-de-France,78,2,19,125,La Celle-les-Bordes,934,23,957
11,Île-de-France,78,3,03,126,La Celle-Saint-Cloud,20870,419,21289
11,Île-de-France,78,2,05,128,Cernay-la-Ville,1629,44,1673
11,Île-de-France,78,3,21,133,Chambourcy,5961,155,6116
11,Île-de-France,78,3,39,138,Chanteloup-les-Vignes,9325,95,9420
11,Île-de-France,78,1,14,140,Chapet,1191,11,1202
11,Île-de-France,78,4,29,143,Châteaufort,1401,52,1453
11,Île-de-France,78,3,04,146,Chatou,29940,499,30439
11,Île-de-France,78,1,02,147,Chaufour-lès-Bonnières,412,12,424
11,Île-de-France,78,3,22,152,Chavenay,1851,67,1918
11,Île-de-France,78,4,32,158,Le Chesnay,29309,688,29997
11,Île-de-France,78,2,05,160,Chevreuse,5713,124,5837
11,Île-de-France,78,2,05,162,Choisel,523,18,541
11,Île-de-France,78,1,08,163,Civry-la-Forêt,330,6,336
11,Île-de-France,78,2,19,164,Clairefontaine-en-Yvelines,772,112,884
11,Île-de-France,78,4,38,165,Les Clayes-sous-Bois,17222,166,17388
11,Île-de-France,78,2,34,168,Coignières,4526,37,4563
11,Île-de-France,78,1,08,171,Condé-sur-Vesgre,1074,16,1090
11,Île-de-France,78,3,06,172,Conflans-Sainte-Honorine,34814,598,35412
11,Île-de-France,78,1,08,185,Courgent,383,11,394
11,Île-de-France,78,1,02,188,Cravent,397,3,400
11,Île-de-France,78,3,17,189,Crespières,1628,61,1689
11,Île-de-France,78,3,04,190,Croissy-sur-Seine,10133,259,10392
11,Île-de-France,78,1,08,192,Dammartin-en-Serve,993,11,1004
11,Île-de-France,78,2,05,193,Dampierre-en-Yvelines,1137,22,1159
11,Île-de-France,78,1,08,194,Dannemarie,246,2,248
11,Île-de-France,78,3,17,196,Davron,357,10,367
11,Île-de-France,78,1,10,202,Drocourt,485,5,490
11,Île-de-France,78,1,01,206,Ecquevilly,4176,42,4218
11,Île-de-France,78,2,34,208,Élancourt,27337,486,27823
11,Île-de-France,78,2,18,209,Émancé,799,27,826
11,Île-de-France,78,1,07,217,Épône,6332,116,6448
11,Île-de-France,78,2,18,220,Les Essarts-le-Roi,6266,141,6407
11,Île-de-France,78,3,22,224,L' Étang-la-Ville,4800,134,4934
11,Île-de-France,78,1,14,227,Évecquemont,777,14,791
11,Île-de-France,78,1,07,230,La Falaise,618,23,641
11,Île-de-France,78,1,02,231,Favrieux,139,2,141
11,Île-de-France,78,3,22,233,Feucherolles,3029,114,3143
11,Île-de-France,78,1,07,234,Flacourt,146,1,147
11,Île-de-France,78,2,15,236,Flexanville,560,17,577
11,Île-de-France,78,1,08,237,Flins-Neuve-Église,165,2,167
11,Île-de-France,78,1,01,238,Flins-sur-Seine,2383,31,2414
11,Île-de-France,78,1,10,239,Follainville-Dennemont,1858,29,1887
11,Île-de-France,78,4,36,242,Fontenay-le-Fleury,12792,131,12923
11,Île-de-France,78,1,02,245,Fontenay-Mauvoisin,429,10,439
11,Île-de-France,78,1,10,246,Fontenay-Saint-Père,994,26,1020
11,Île-de-France,78,3,35,251,Fourqueux,4144,254,4398
11,Île-de-France,78,1,02,255,Freneuse,3873,59,3932
11,Île-de-France,78,1,14,261,Gaillon-sur-Montcient,676,14,690
11,Île-de-France,78,2,15,262,Galluis,1140,19,1159
11,Île-de-France,78,1,08,263,Gambais,2422,38,2460
11,Île-de-France,78,2,18,264,Gambaiseuil,63,0,63
11,Île-de-France,78,2,15,265,Garancières,2356,60,2416
11,Île-de-France,78,1,10,267,Gargenville,6684,90,6774
11,Île-de-France,78,2,18,269,Gazeran,1187,30,1217
11,Île-de-France,78,1,02,276,Gommecourt,645,8,653
11,Île-de-France,78,2,15,278,Goupillières,421,7,428
11,Île-de-France,78,1,07,281,Goussonville,600,11,611
11,Île-de-France,78,1,08,283,Grandchamp,302,3,305
11,Île-de-France,78,1,08,285,Gressey,540,14,554
11,Île-de-France,78,2,15,289,Grosrouvre,866,22,888
11,Île-de-France,78,1,10,290,Guernes,976,12,988
11,Île-de-France,78,1,07,291,Guerville,2020,18,2038
11,Île-de-France,78,1,10,296,Guitrancourt,631,12,643
11,Île-de-France,78,4,28,297,Guyancourt,28600,530,29130
11,Île-de-France,78,1,14,299,Hardricourt,2034,35,2069
11,Île-de-France,78,1,07,300,Hargeville,374,4,378
11,Île-de-France,78,1,08,302,La Hauteville,178,3,181
11,Île-de-France,78,1,01,305,Herbeville,330,14,344
11,Île-de-France,78,2,18,307,Hermeray,932,16,948
11,Île-de-France,78,1,08,310,Houdan,3257,47,3304
11,Île-de-France,78,3,09,311,Houilles,30908,282,31190
11,Île-de-France,78,1,10,314,Issou,4473,49,4522
11,Île-de-France,78,1,10,317,Jambville,785,12,797
11,Île-de-France,78,1,02,320,Jeufosse,432,5,437
11,Île-de-France,78,2,15,321,Jouars-Pontchartrain,5192,83,5275
11,Île-de-France,78,4,29,322,Jouy-en-Josas,8107,131,8238
11,Île-de-France,78,1,02,324,Jouy-Mauvoisin,532,4,536
11,Île-de-France,78,1,07,325,Jumeauville,586,1,587
11,Île-de-France,78,1,10,327,Juziers,3767,60,3827
11,Île-de-France,78,1,10,329,Lainville-en-Vexin,779,11,790
11,Île-de-France,78,2,05,334,Lévis-Saint-Nom,1701,57,1758
11,Île-de-France,78,1,10,335,Limay,15961,235,16196
11,Île-de-France,78,1,02,337,Limetz-Villez,1930,15,1945
11,Île-de-France,78,4,29,343,Les Loges-en-Josas,1493,47,1540
11,Île-de-France,78,1,02,344,Lommoye,619,11,630
11,Île-de-France,78,1,08,346,Longnes,1471,31,1502
11,Île-de-France,78,2,19,349,Longvilliers,500,12,512
11,Île-de-France,78,3,13,350,Louveciennes,7260,165,7425
11,Île-de-France,78,1,33,354,Magnanville,5566,161,5727
11,Île-de-France,78,2,05,356,Magny-les-Hameaux,8881,145,9026
11,Île-de-France,78,3,11,358,Maisons-Laffitte,22569,478,23047
11,Île-de-France,78,1,12,361,Mantes-la-Jolie,42593,388,42981
11,Île-de-France,78,1,33,362,Mantes-la-Ville,18891,196,19087
11,Île-de-France,78,2,15,364,Marcq,704,13,717
11,Île-de-France,78,2,15,366,Mareil-le-Guyon,425,7,432
11,Île-de-France,78,3,35,367,Mareil-Marly,3481,100,3581
11,Île-de-France,78,1,01,368,Mareil-sur-Mauldre,1737,49,1786
11,Île-de-France,78,3,13,372,Marly-le-Roi,16873,272,17145
11,Île-de-France,78,1,01,380,Maule,5885,161,6046
11,Île-de-France,78,1,08,381,Maulette,742,21,763
11,Île-de-France,78,3,39,382,Maurecourt,4212,46,4258
11,Île-de-France,78,2,34,383,Maurepas,18752,281,19033
11,Île-de-France,78,3,16,384,Médan,1479,31,1510
11,Île-de-France,78,1,02,385,Ménerville,197,4,201
11,Île-de-France,78,2,15,389,Méré,1706,88,1794
11,Île-de-France,78,1,02,391,Méricourt,394,10,404
11,Île-de-France,78,3,11,396,Le Mesnil-le-Roi,6416,103,6519
11,Île-de-France,78,2,05,397,Le Mesnil-Saint-Denis,6596,136,6732
11,Île-de-France,78,2,15,398,Les Mesnuls,878,19,897
11,Île-de-France,78,1,14,401,Meulan,8738,82,8820
11,Île-de-France,78,1,07,402,Mézières-sur-Seine,3502,64,3566
11,Île-de-France,78,1,14,403,Mézy-sur-Seine,1923,23,1946
11,Île-de-France,78,2,15,404,Millemont,251,3,254
11,Île-de-France,78,2,05,406,Milon-la-Chapelle,323,12,335
11,Île-de-France,78,2,18,407,Mittainville,622,15,637
11,Île-de-France,78,1,02,410,Moisson,918,20,938
11,Île-de-France,78,1,08,413,Mondreville,353,3,356
11,Île-de-France,78,1,01,415,Montainville,569,14,583
11,Île-de-France,78,1,10,416,Montalet-le-Bois,326,3,329
11,Île-de-France,78,1,08,417,Montchauvet,294,7,301
11,Île-de-France,78,3,30,418,Montesson,15090,243,15333
11,Île-de-France,78,2,15,420,Montfort-l'Amaury,3102,74,3176
11,Île-de-France,78,4,28,423,Montigny-le-Bretonneux,33993,605,34598
11,Île-de-France,78,3,17,431,Morainvilliers,2412,56,2468
11,Île-de-France,78,1,02,437,Mousseaux-sur-Seine,613,8,621
11,Île-de-France,78,1,08,439,Mulcent,99,0,99
11,Île-de-France,78,1,14,440,Les Mureaux,32337,277,32614
11,Île-de-France,78,2,15,442,Neauphle-le-Château,2981,56,3037
11,Île-de-France,78,2,15,443,Neauphle-le-Vieux,691,9,700
11,Île-de-France,78,1,02,444,Neauphlette,909,10,919
11,Île-de-France,78,1,01,451,Nézel,968,10,978
11,Île-de-France,78,3,22,455,Noisy-le-Roi,7964,298,8262
11,Île-de-France,78,1,10,460,Oinville-sur-Montcient,1131,20,1151
11,Île-de-France,78,2,18,464,Orcemont,855,20,875
11,Île-de-France,78,1,08,465,Orgerus,2347,45,2392
11,Île-de-France,78,3,17,466,Orgeval,5828,134,5962
11,Île-de-France,78,2,18,470,Orphin,918,23,941
11,Île-de-France,78,2,19,472,Orsonville,333,1,334
11,Île-de-France,78,1,08,474,Orvilliers,589,6,595
11,Île-de-France,78,1,08,475,Osmoy,393,8,401
11,Île-de-France,78,2,19,478,Paray-Douaville,233,4,237
11,Île-de-France,78,3,35,481,Le Pecq,16406,298,16704
11,Île-de-France,78,1,02,484,Perdreauville,596,4,600
11,Île-de-France,78,2,18,486,Le Perray-en-Yvelines,6460,122,6582
11,Île-de-France,78,4,38,490,Plaisir,30773,383,31156
11,Île-de-France,78,2,18,497,Poigny-la-Forêt,1032,46,1078
11,Île-de-France,78,3,97,498,Poissy,37466,369,37835
11,Île-de-France,78,2,19,499,Ponthévrard,581,6,587
11,Île-de-France,78,1,10,501,Porcheville,2664,34,2698
11,Île-de-France,78,3,13,502,Le Port-Marly,4712,73,4785
11,Île-de-France,78,1,02,503,Port-Villez,233,2,235
11,Île-de-France,78,2,19,506,Prunay-en-Yvelines,806,9,815
11,Île-de-France,78,1,08,505,Prunay-le-Temple,376,5,381
11,Île-de-France,78,2,15,513,La Queue-les-Yvelines,2073,37,2110
11,Île-de-France,78,2,18,516,Raizeux,831,17,848
11,Île-de-France,78,2,18,517,Rambouillet,25827,825,26652
11,Île-de-France,78,3,22,518,Rennemoulin,131,6,137
11,Île-de-France,78,1,08,520,Richebourg,1474,69,1543
11,Île-de-France,78,2,19,522,Rochefort-en-Yvelines,953,25,978
11,Île-de-France,78,4,32,524,Rocquencourt,3273,76,3349
11,Île-de-France,78,1,02,528,Rolleboise,408,6,414
11,Île-de-France,78,1,07,530,Rosay,371,4,375
11,Île-de-France,78,1,33,531,Rosny-sur-Seine,5317,73,5390
11,Île-de-France,78,1,10,536,Sailly,374,3,377
11,Île-de-France,78,2,19,537,Saint-Arnoult-en-Yvelines,5984,113,6097
11,Île-de-France,78,4,36,545,Saint-Cyr-l'École,17590,563,18153
11,Île-de-France,78,2,05,548,Saint-Forget,482,9,491
11,Île-de-France,78,2,15,550,Saint-Germain-de-la-Grange,1827,47,1874
11,Île-de-France,78,3,98,551,Saint-Germain-en-Laye,40940,1640,42580
11,Île-de-France,78,2,18,557,Saint-Hilarion,903,15,918
11,Île-de-France,78,1,02,558,Saint-Illiers-la-Ville,279,8,287
11,Île-de-France,78,1,02,559,Saint-Illiers-le-Bois,447,6,453
11,Île-de-France,78,2,05,561,Saint-Lambert,402,22,424
11,Île-de-France,78,2,18,562,Saint-Léger-en-Yvelines,1456,29,1485
11,Île-de-France,78,2,19,564,Saint-Martin-de-Bréthencourt,611,13,624
11,Île-de-France,78,1,08,565,Saint-Martin-des-Champs,328,6,334
11,Île-de-France,78,1,10,567,Saint-Martin-la-Garenne,877,15,892
11,Île-de-France,78,3,22,571,Saint-Nom-la-Bretèche,5053,224,5277
11,Île-de-France,78,2,15,576,Saint-Rémy-l'Honoré,1393,31,1424
11,Île-de-France,78,2,05,575,Saint-Rémy-lès-Chevreuse,7965,195,8160
11,Île-de-France,78,2,19,569,Sainte-Mesme,873,23,896
11,Île-de-France,78,3,23,586,Sartrouville,51447,483,51930
11,Île-de-France,78,2,15,588,Saulx-Marchais,836,13,849
11,Île-de-France,78,2,05,590,Senlisse,539,15,554
11,Île-de-France,78,1,08,591,Septeuil,2154,63,2217
11,Île-de-France,78,1,07,597,Soindres,595,4,599
11,Île-de-France,78,2,19,601,Sonchamp,1577,67,1644
11,Île-de-France,78,1,08,605,Tacoignières,1028,15,1043
11,Île-de-France,78,1,08,606,Le Tartre-Gaudran,32,0,32
11,Île-de-France,78,1,02,608,Le Tertre-Saint-Denis,106,2,108
11,Île-de-France,78,1,14,609,Tessancourt-sur-Aubette,947,16,963
11,Île-de-France,78,4,38,615,Thiverval-Grignon,1009,17,1026
11,Île-de-France,78,2,15,616,Thoiry,1117,22,1139
11,Île-de-France,78,1,08,618,Tilly,507,12,519
11,Île-de-France,78,4,29,620,Toussus-le-Noble,872,25,897
11,Île-de-France,78,4,24,621,Trappes,28541,274,28815
11,Île-de-France,78,2,15,623,Le Tremblay-sur-Mauldre,971,111,1082
11,Île-de-France,78,3,25,624,Triel-sur-Seine,11932,212,12144
11,Île-de-France,78,1,14,638,Vaux-sur-Seine,4852,69,4921
11,Île-de-France,78,4,37,640,Vélizy-Villacoublay,19978,247,20225
11,Île-de-France,78,3,25,642,Verneuil-sur-Seine,15431,350,15781
11,Île-de-France,78,3,25,643,Vernouillet,9370,167,9537
11,Île-de-France,78,2,34,644,La Verrière,6075,105,6180
11,Île-de-France,78,4,99,646,Versailles,86686,1955,88641
11,Île-de-France,78,1,07,647,Vert,782,15,797
11,Île-de-France,78,3,30,650,Le Vésinet,16339,539,16878
11,Île-de-France,78,2,15,653,Vicq,318,2,320
11,Île-de-France,78,2,18,655,Vieille-Église-en-Yvelines,801,34,835
11,Île-de-France,78,1,02,668,La Villeneuve-en-Chevrie,559,14,573
11,Île-de-France,78,3,16,672,Villennes-sur-Seine,5078,131,5209
11,Île-de-France,78,3,22,674,Villepreux,9887,237,10124
11,Île-de-France,78,1,07,677,Villette,516,10,526
11,Île-de-France,78,2,15,681,Villiers-le-Mahieu,714,11,725
11,Île-de-France,78,2,15,683,Villiers-Saint-Fréderic,2719,79,2798
11,Île-de-France,78,4,31,686,Viroflay,16076,266,16342
11,Île-de-France,78,2,05,688,Voisins-le-Bretonneux,12086,422,12508
54,Poitou-Charentes,79,3,18,001,L' Absie,1031,24,1055
54,Poitou-Charentes,79,3,22,002,Adilly,320,11,331
54,Poitou-Charentes,79,2,23,003,Aiffres,5109,185,5294
54,Poitou-Charentes,79,2,06,004,Aigonnay,605,14,619
54,Poitou-Charentes,79,3,01,005,Airvault,3096,79,3175
54,Poitou-Charentes,79,2,28,006,Les Alleuds,289,8,297
54,Poitou-Charentes,79,3,29,007,Allonne,629,16,645
54,Poitou-Charentes,79,3,22,008,Amailloux,842,6,848
54,Poitou-Charentes,79,2,12,009,Amuré,445,5,450
54,Poitou-Charentes,79,2,10,011,Ardilleux,157,2,159
54,Poitou-Charentes,79,2,11,012,Ardin,1209,27,1236
54,Poitou-Charentes,79,1,97,014,Argenton-l'Église,1619,42,1661
54,Poitou-Charentes,79,1,02,013,Argenton-les-Vallées,1577,53,1630
54,Poitou-Charentes,79,2,12,010,Arçais,620,21,641
54,Poitou-Charentes,79,2,05,015,Asnières-en-Poitou,201,1,202
54,Poitou-Charentes,79,3,24,016,Assais-les-Jumeaux,758,12,770
54,Poitou-Charentes,79,2,10,018,Aubigné,214,0,214
54,Poitou-Charentes,79,3,30,019,Aubigny,176,5,181
54,Poitou-Charentes,79,2,25,020,Augé,904,21,925
54,Poitou-Charentes,79,3,01,022,Availles-Thouarsais,214,8,222
54,Poitou-Charentes,79,2,19,023,Avon,83,0,83
54,Poitou-Charentes,79,2,25,024,Azay-le-Brûlé,1753,139,1892
54,Poitou-Charentes,79,3,29,025,Azay-sur-Thouet,1073,16,1089
54,Poitou-Charentes,79,2,10,027,La Bataille,79,7,86
54,Poitou-Charentes,79,3,15,029,Beaulieu-sous-Parthenay,650,18,668
54,Poitou-Charentes,79,2,06,030,Beaussais,404,5,409
54,Poitou-Charentes,79,2,03,031,Beauvoir-sur-Niort,1683,28,1711
54,Poitou-Charentes,79,2,11,032,Béceleuf,675,8,683
54,Poitou-Charentes,79,2,03,033,Belleville,113,2,115
54,Poitou-Charentes,79,2,12,034,Bessines,1582,51,1633
54,Poitou-Charentes,79,2,11,035,Le Beugnon,326,10,336
54,Poitou-Charentes,79,1,04,038,Boismé,1149,38,1187
54,Poitou-Charentes,79,2,03,039,Boisserolles,53,1,54
54,Poitou-Charentes,79,3,15,040,La Boissière-en-Gâtine,239,9,248
54,Poitou-Charentes,79,2,19,042,Bougon,195,4,199
54,Poitou-Charentes,79,1,02,043,Bouillé-Loretz,1048,20,1068
54,Poitou-Charentes,79,1,02,044,Bouillé-Saint-Paul,405,74,479
54,Poitou-Charentes,79,2,10,045,Bouin,146,5,151
54,Poitou-Charentes,79,2,14,046,Le Bourdet,517,14,531
54,Poitou-Charentes,79,3,01,047,Boussais,400,7,407
54,Poitou-Charentes,79,1,04,049,Bressuire,18605,1073,19678
54,Poitou-Charentes,79,1,07,050,Bretignolles,629,9,638
54,Poitou-Charentes,79,3,18,051,Le Breuil-Bernard,460,13,473
54,Poitou-Charentes,79,1,02,053,Le Breuil-sous-Argenton,405,19,424
54,Poitou-Charentes,79,1,31,054,Brie,193,1,194
54,Poitou-Charentes,79,2,05,055,Brieuil-sur-Chizé,123,2,125
54,Poitou-Charentes,79,1,32,056,Brion-près-Thouet,757,28,785
54,Poitou-Charentes,79,2,05,057,Brioux-sur-Boutonne,1508,39,1547
54,Poitou-Charentes,79,2,23,058,Brûlain,664,10,674
54,Poitou-Charentes,79,2,11,059,Le Busseau,695,9,704
54,Poitou-Charentes,79,2,28,060,Caunay,163,1,164
54,Poitou-Charentes,79,2,06,061,Celles-sur-Belle,3695,106,3801
54,Poitou-Charentes,79,1,07,062,Cerizay,4619,78,4697
54,Poitou-Charentes,79,1,02,063,Cersay,984,24,1008
54,Poitou-Charentes,79,2,16,064,Chail,505,11,516
54,Poitou-Charentes,79,2,08,066,Champdeniers-Saint-Denis,1632,30,1662
54,Poitou-Charentes,79,3,17,068,Chantecorps,339,6,345
54,Poitou-Charentes,79,3,18,069,Chanteloup,969,20,989
54,Poitou-Charentes,79,2,08,070,La Chapelle-Bâton,345,13,358
54,Poitou-Charentes,79,3,22,071,La Chapelle-Bertrand,501,5,506
54,Poitou-Charentes,79,1,27,072,La Chapelle-Gaudin,222,6,228
54,Poitou-Charentes,79,2,28,074,La Chapelle-Pouilloux,202,8,210
54,Poitou-Charentes,79,3,18,075,La Chapelle-Saint-Étienne,323,14,337
54,Poitou-Charentes,79,3,18,076,La Chapelle-Saint-Laurent,1859,49,1908
54,Poitou-Charentes,79,2,11,077,La Chapelle-Thireuil,430,11,441
54,Poitou-Charentes,79,3,22,080,Châtillon-sur-Thouet,2831,53,2884
54,Poitou-Charentes,79,2,20,081,Chauray,5190,180,5370
54,Poitou-Charentes,79,2,10,083,Chef-Boutonne,2223,108,2331
54,Poitou-Charentes,79,2,13,084,Chenay,483,15,498
54,Poitou-Charentes,79,2,05,085,Chérigné,133,7,140
54,Poitou-Charentes,79,2,25,086,Cherveux,1594,44,1638
54,Poitou-Charentes,79,2,13,087,Chey,624,11,635
54,Poitou-Charentes,79,1,04,088,Chiché,1569,37,1606
54,Poitou-Charentes,79,3,24,089,Le Chillou,187,4,191
54,Poitou-Charentes,79,2,05,090,Chizé,932,24,956
54,Poitou-Charentes,79,1,07,091,Cirières,958,31,989
54,Poitou-Charentes,79,3,15,092,Clavé,329,5,334
54,Poitou-Charentes,79,3,18,094,Clessé,923,21,944
54,Poitou-Charentes,79,2,28,095,Clussais-la-Pommeraie,614,13,627
54,Poitou-Charentes,79,1,07,096,Combrand,1119,33,1152
54,Poitou-Charentes,79,2,19,098,La Couarde,264,8,272
54,Poitou-Charentes,79,1,02,099,La Coudre,229,3,232
54,Poitou-Charentes,79,2,21,100,Coulon,2210,122,2332
54,Poitou-Charentes,79,2,11,101,Coulonges-sur-l'Autize,2370,41,2411
54,Poitou-Charentes,79,1,27,102,Coulonges-Thouarsais,423,4,427
54,Poitou-Charentes,79,1,07,103,Courlay,2383,59,2442
54,Poitou-Charentes,79,2,08,104,Cours,530,12,542
54,Poitou-Charentes,79,3,17,105,Coutières,150,3,153
54,Poitou-Charentes,79,2,10,106,Couture-d'Argenson,407,13,420
54,Poitou-Charentes,79,2,25,048,La Crèche,5432,138,5570
54,Poitou-Charentes,79,2,10,107,Crézières,57,2,59
54,Poitou-Charentes,79,3,30,108,Doux,241,2,243
54,Poitou-Charentes,79,2,20,109,Échiré,3275,79,3354
54,Poitou-Charentes,79,2,05,111,Ensigné,274,6,280
54,Poitou-Charentes,79,2,12,112,Épannes,782,20,802
54,Poitou-Charentes,79,1,02,113,Étusson,310,4,314
54,Poitou-Charentes,79,2,26,114,Exireuil,1537,34,1571
54,Poitou-Charentes,79,2,19,115,Exoudun,577,15,592
54,Poitou-Charentes,79,1,04,116,Faye-l'Abbesse,1026,19,1045
54,Poitou-Charentes,79,2,11,117,Faye-sur-Ardin,587,10,597
54,Poitou-Charentes,79,3,22,118,Fénery,312,4,316
54,Poitou-Charentes,79,2,11,119,Fenioux,727,15,742
54,Poitou-Charentes,79,3,30,120,La Ferrière-en-Parthenay,786,22,808
54,Poitou-Charentes,79,3,17,121,Fomperron,401,6,407
54,Poitou-Charentes,79,2,10,122,Fontenille-Saint-Martin-d'Entraigues,578,13,591
54,Poitou-Charentes,79,1,07,123,La Forêt-sur-Sèvre,2319,52,2371
54,Poitou-Charentes,79,3,17,124,Les Forges,124,6,130
54,Poitou-Charentes,79,2,23,125,Fors,1643,33,1676
54,Poitou-Charentes,79,2,05,126,Les Fosses,426,7,433
54,Poitou-Charentes,79,2,03,127,La Foye-Monjault,743,12,755
54,Poitou-Charentes,79,2,25,128,François,857,23,880
54,Poitou-Charentes,79,2,06,129,Fressines,1268,41,1309
54,Poitou-Charentes,79,2,12,130,Frontenay-Rohan-Rohan,3043,79,3122
54,Poitou-Charentes,79,1,27,131,Geay,345,2,347
54,Poitou-Charentes,79,1,02,132,Genneton,343,3,346
54,Poitou-Charentes,79,2,08,133,Germond-Rouvre,1099,24,1123
54,Poitou-Charentes,79,1,27,134,Glénay,531,20,551
54,Poitou-Charentes,79,3,24,135,Gourgé,907,25,932
54,Poitou-Charentes,79,2,10,136,Gournay-Loizé,619,8,627
54,Poitou-Charentes,79,2,03,137,Granzay-Gript,854,15,869
54,Poitou-Charentes,79,3,15,139,Les Groseillers,70,3,73
54,Poitou-Charentes,79,2,10,140,Hanc,250,3,253
54,Poitou-Charentes,79,3,01,141,Irais,209,3,212
54,Poitou-Charentes,79,2,05,142,Juillé,102,1,103
54,Poitou-Charentes,79,2,23,144,Juscorps,346,5,351
54,Poitou-Charentes,79,3,22,145,Lageon,365,10,375
54,Poitou-Charentes,79,3,18,147,Largeasse,724,19,743
54,Poitou-Charentes,79,2,13,148,Lezay,2052,43,2095
54,Poitou-Charentes,79,3,30,149,Lhoumois,140,3,143
54,Poitou-Charentes,79,2,28,150,Limalonges,876,9,885
54,Poitou-Charentes,79,2,28,152,Lorigné,292,5,297
54,Poitou-Charentes,79,2,10,153,Loubigné,167,3,170
54,Poitou-Charentes,79,2,10,154,Loubillé,371,4,375
54,Poitou-Charentes,79,3,24,156,Louin,746,15,761
54,Poitou-Charentes,79,1,32,157,Louzy,1228,25,1253
54,Poitou-Charentes,79,2,05,158,Luché-sur-Brioux,136,3,139
54,Poitou-Charentes,79,1,27,159,Luché-Thouarsais,378,1,379
54,Poitou-Charentes,79,2,05,160,Lusseray,170,7,177
54,Poitou-Charentes,79,1,27,161,Luzay,546,25,571
54,Poitou-Charentes,79,2,21,162,Magné,2890,86,2976
54,Poitou-Charentes,79,2,28,163,Mairé-Levescault,560,12,572
54,Poitou-Charentes,79,2,16,164,Maisonnay,261,6,267
54,Poitou-Charentes,79,3,24,165,Maisontiers,181,1,182
54,Poitou-Charentes,79,2,03,166,Marigny,901,16,917
54,Poitou-Charentes,79,3,01,167,Marnes,231,3,234
54,Poitou-Charentes,79,1,02,168,Massais,607,8,615
54,Poitou-Charentes,79,1,09,079,Mauléon,7980,286,8266
54,Poitou-Charentes,79,2,14,170,Mauzé-sur-le-Mignon,2711,65,2776
54,Poitou-Charentes,79,1,32,171,Mauzé-Thouarsais,2049,50,2099
54,Poitou-Charentes,79,3,15,172,Mazières-en-Gâtine,970,26,996
54,Poitou-Charentes,79,2,16,173,Mazières-sur-Béronne,395,6,401
54,Poitou-Charentes,79,2,16,174,Melle,3623,251,3874
54,Poitou-Charentes,79,2,28,175,Melleran,512,10,522
54,Poitou-Charentes,79,3,17,176,Ménigoute,876,18,894
54,Poitou-Charentes,79,2,13,177,Messé,174,7,181
54,Poitou-Charentes,79,1,31,178,Missé,878,28,906
54,Poitou-Charentes,79,3,18,179,Moncoutant,3075,128,3203
54,Poitou-Charentes,79,2,28,180,Montalembert,275,8,283
54,Poitou-Charentes,79,1,07,183,Montravers,377,12,389
54,Poitou-Charentes,79,2,19,184,La Mothe-Saint-Héray,1812,48,1860
54,Poitou-Charentes,79,2,06,185,Mougon,1918,52,1970
54,Poitou-Charentes,79,1,02,187,Moutiers-sous-Argenton,549,22,571
54,Poitou-Charentes,79,3,18,188,Moutiers-sous-Chantemerle,616,18,634
54,Poitou-Charentes,79,2,26,189,Nanteuil,1651,28,1679
54,Poitou-Charentes,79,3,29,190,Neuvy-Bouin,489,4,493
54,Poitou-Charentes,79,2,98,191,Niort,58072,2314,60386
54,Poitou-Charentes,79,1,09,195,Nueil-les-Aubiers,5412,91,5503
54,Poitou-Charentes,79,1,31,196,Oiron,956,12,968
54,Poitou-Charentes,79,3,30,197,Oroux,100,0,100
54,Poitou-Charentes,79,2,05,198,Paizay-le-Chapt,265,3,268
54,Poitou-Charentes,79,2,16,199,Paizay-le-Tort,467,5,472
54,Poitou-Charentes,79,2,08,200,Pamplie,270,0,270
54,Poitou-Charentes,79,2,19,201,Pamproux,1674,26,1700
54,Poitou-Charentes,79,3,22,202,Parthenay,10406,612,11018
54,Poitou-Charentes,79,1,31,203,Pas-de-Jeu,378,10,388
54,Poitou-Charentes,79,2,05,204,Périgné,1013,27,1040
54,Poitou-Charentes,79,2,28,205,Pers,71,1,72
54,Poitou-Charentes,79,1,09,207,La Petite-Boissière,627,18,645
54,Poitou-Charentes,79,3,30,208,La Peyratte,1153,88,1241
54,Poitou-Charentes,79,1,27,209,Pierrefitte,332,8,340
54,Poitou-Charentes,79,1,07,210,Le Pin,1036,26,1062
54,Poitou-Charentes,79,2,10,211,Pioussay,318,4,322
54,Poitou-Charentes,79,2,28,212,Pliboux,197,0,197
54,Poitou-Charentes,79,3,22,213,Pompaire,1937,91,2028
54,Poitou-Charentes,79,2,16,214,Pouffonds,364,1,365
54,Poitou-Charentes,79,3,29,215,Pougne-Hérisson,360,4,364
54,Poitou-Charentes,79,2,23,216,Prahecq,2023,58,2081
54,Poitou-Charentes,79,2,06,217,Prailles,675,17,692
54,Poitou-Charentes,79,3,30,218,Pressigny,196,0,196
54,Poitou-Charentes,79,2,14,219,Priaires,117,4,121
54,Poitou-Charentes,79,2,14,220,Prin-Deyrançon,578,11,589
54,Poitou-Charentes,79,2,03,078,Prissé-la-Charrière,609,7,616
54,Poitou-Charentes,79,3,18,222,Pugny,246,7,253
54,Poitou-Charentes,79,2,11,223,Puihardy,48,1,49
54,Poitou-Charentes,79,3,17,225,Reffannes,371,7,378
54,Poitou-Charentes,79,3,29,226,Le Retail,260,9,269
54,Poitou-Charentes,79,2,14,229,La Rochénard,482,5,487
54,Poitou-Charentes,79,2,13,230,Rom,785,11,796
54,Poitou-Charentes,79,2,26,231,Romans,718,11,729
54,Poitou-Charentes,79,1,09,235,Saint-Amand-sur-Sèvre,1276,49,1325
54,Poitou-Charentes,79,1,07,236,Saint-André-sur-Sèvre,665,18,683
54,Poitou-Charentes,79,1,02,238,Saint-Aubin-du-Plain,528,20,548
54,Poitou-Charentes,79,3,29,239,Saint-Aubin-le-Cloud,1764,148,1912
54,Poitou-Charentes,79,2,08,241,Saint-Christophe-sur-Roc,558,14,572
54,Poitou-Charentes,79,1,02,242,Saint-Clémentin,541,22,563
54,Poitou-Charentes,79,2,13,243,Saint-Coutant,264,1,265
54,Poitou-Charentes,79,1,31,244,Saint-Cyr-la-Lande,338,10,348
54,Poitou-Charentes,79,2,03,247,Saint-Étienne-la-Cigogne,125,2,127
54,Poitou-Charentes,79,2,20,249,Saint-Gelais,1672,54,1726
54,Poitou-Charentes,79,2,16,251,Saint-Génard,341,7,348
54,Poitou-Charentes,79,3,01,252,Saint-Généroux,347,8,355
54,Poitou-Charentes,79,3,15,253,Saint-Georges-de-Noisné,697,14,711
54,Poitou-Charentes,79,2,14,254,Saint-Georges-de-Rex,391,10,401
54,Poitou-Charentes,79,3,22,255,Saint-Germain-de-Longue-Chaume,389,4,393
54,Poitou-Charentes,79,3,17,256,Saint-Germier,183,1,184
54,Poitou-Charentes,79,2,14,257,Saint-Hilaire-la-Palud,1575,36,1611
54,Poitou-Charentes,79,1,31,258,Saint-Jacques-de-Thouars,462,11,473
54,Poitou-Charentes,79,1,31,259,Saint-Jean-de-Thouars,1360,43,1403
54,Poitou-Charentes,79,3,01,260,Saint-Jouin-de-Marnes,600,11,611
54,Poitou-Charentes,79,1,07,261,Saint-Jouin-de-Milly,208,8,216
54,Poitou-Charentes,79,2,11,263,Saint-Laurs,494,13,507
54,Poitou-Charentes,79,2,16,264,Saint-Léger-de-la-Martinière,980,58,1038
54,Poitou-Charentes,79,1,31,265,Saint-Léger-de-Montbrun,1197,31,1228
54,Poitou-Charentes,79,3,15,267,Saint-Lin,372,5,377
54,Poitou-Charentes,79,3,24,268,Saint-Loup-Lamairé,959,44,1003
54,Poitou-Charentes,79,2,11,269,Saint-Maixent-de-Beugné,338,11,349
54,Poitou-Charentes,79,2,99,270,Saint-Maixent-l'École,7537,181,7718
54,Poitou-Charentes,79,3,15,271,Saint-Marc-la-Lande,365,4,369
54,Poitou-Charentes,79,2,23,273,Saint-Martin-de-Bernegoue,758,16,774
54,Poitou-Charentes,79,1,31,274,Saint-Martin-de-Mâcon,307,6,313
54,Poitou-Charentes,79,2,26,276,Saint-Martin-de-Saint-Maixent,1058,30,1088
54,Poitou-Charentes,79,1,32,277,Saint-Martin-de-Sanzay,932,18,950
54,Poitou-Charentes,79,3,17,278,Saint-Martin-du-Fouilloux,215,3,218
54,Poitou-Charentes,79,2,16,279,Saint-Martin-lès-Melle,856,26,882
54,Poitou-Charentes,79,1,02,280,Saint-Maurice-la-Fougereuse,549,14,563
54,Poitou-Charentes,79,2,20,281,Saint-Maxire,1132,30,1162
54,Poitou-Charentes,79,2,06,282,Saint-Médard,103,3,106
54,Poitou-Charentes,79,3,15,285,Saint-Pardoux,1502,35,1537
54,Poitou-Charentes,79,3,18,286,Saint-Paul-en-Gâtine,443,6,449
54,Poitou-Charentes,79,1,09,289,Saint-Pierre-des-Échaubrognes,1378,25,1403
54,Poitou-Charentes,79,2,11,290,Saint-Pompain,893,22,915
54,Poitou-Charentes,79,2,20,293,Saint-Rémy,1060,32,1092
54,Poitou-Charentes,79,2,23,294,Saint-Romans-des-Champs,177,5,182
54,Poitou-Charentes,79,2,16,295,Saint-Romans-lès-Melle,660,28,688
54,Poitou-Charentes,79,2,12,298,Saint-Symphorien,1782,43,1825
54,Poitou-Charentes,79,1,27,299,Saint-Varent,2463,38,2501
54,Poitou-Charentes,79,2,16,301,Saint-Vincent-la-Châtre,560,17,577
54,Poitou-Charentes,79,2,06,240,Sainte-Blandine,628,16,644
54,Poitou-Charentes,79,2,26,246,Sainte-Eanne,656,16,672
54,Poitou-Charentes,79,1,27,250,Sainte-Gemme,375,3,378
54,Poitou-Charentes,79,2,26,283,Sainte-Néomaye,1251,35,1286
54,Poitou-Charentes,79,2,08,284,Sainte-Ouenne,738,12,750
54,Poitou-Charentes,79,1,32,292,Sainte-Radegonde,1959,65,2024
54,Poitou-Charentes,79,2,13,297,Sainte-Soline,387,12,399
54,Poitou-Charentes,79,1,32,300,Sainte-Verge,1472,35,1507
54,Poitou-Charentes,79,2,25,302,Saivres,1326,29,1355
54,Poitou-Charentes,79,2,19,303,Salles,344,5,349
54,Poitou-Charentes,79,2,12,304,Sansais,733,21,754
54,Poitou-Charentes,79,3,30,306,Saurais,182,2,184
54,Poitou-Charentes,79,2,28,307,Sauzé-Vaussais,1634,40,1674
54,Poitou-Charentes,79,2,20,308,Sciecq,551,22,573
54,Poitou-Charentes,79,2,11,309,Scillé,377,7,384
54,Poitou-Charentes,79,2,05,310,Secondigné-sur-Belle,530,12,542
54,Poitou-Charentes,79,3,29,311,Secondigny,1744,53,1797
54,Poitou-Charentes,79,2,05,312,Séligné,123,2,125
54,Poitou-Charentes,79,2,13,313,Sepvret,550,16,566
54,Poitou-Charentes,79,2,16,314,Sompt,289,7,296
54,Poitou-Charentes,79,2,19,316,Soudan,430,6,436
54,Poitou-Charentes,79,3,15,318,Soutiers,241,16,257
54,Poitou-Charentes,79,2,26,319,Souvigné,866,21,887
54,Poitou-Charentes,79,2,08,320,Surin,599,10,609
54,Poitou-Charentes,79,1,31,321,Taizé,759,24,783
54,Poitou-Charentes,79,3,22,322,Le Tallud,1950,53,2003
54,Poitou-Charentes,79,3,24,325,Tessonnière,298,6,304
54,Poitou-Charentes,79,3,30,326,Thénezay,1463,30,1493
54,Poitou-Charentes,79,2,06,327,Thorigné,1216,32,1248
54,Poitou-Charentes,79,2,03,328,Thorigny-sur-le-Mignon,80,4,84
54,Poitou-Charentes,79,1,95,329,Thouars,9853,278,10131
54,Poitou-Charentes,79,2,10,330,Tillou,298,9,307
54,Poitou-Charentes,79,1,31,331,Tourtenay,141,3,144
54,Poitou-Charentes,79,3,18,332,Trayes,132,2,134
54,Poitou-Charentes,79,1,02,333,Ulcot,59,1,60
54,Poitou-Charentes,79,2,14,334,Usseau,867,18,885
54,Poitou-Charentes,79,2,12,335,Vallans,739,15,754
54,Poitou-Charentes,79,2,12,337,Le Vanneau-Irleau,933,14,947
54,Poitou-Charentes,79,2,13,338,Vanzay,207,2,209
54,Poitou-Charentes,79,2,13,336,Vançais,265,3,268
54,Poitou-Charentes,79,3,17,339,Vasles,1680,26,1706
54,Poitou-Charentes,79,3,17,340,Vausseroux,351,7,358
54,Poitou-Charentes,79,3,17,341,Vautebis,115,3,118
54,Poitou-Charentes,79,3,29,342,Vernoux-en-Gâtine,611,13,624
54,Poitou-Charentes,79,2,05,343,Vernoux-sur-Boutonne,149,5,154
54,Poitou-Charentes,79,3,15,345,Verruyes,905,22,927
54,Poitou-Charentes,79,2,05,346,Le Vert,130,3,133
54,Poitou-Charentes,79,3,22,347,Viennay,1113,33,1146
54,Poitou-Charentes,79,2,05,348,Villefollet,198,2,200
54,Poitou-Charentes,79,2,10,349,Villemain,172,9,181
54,Poitou-Charentes,79,2,05,350,Villiers-en-Bois,153,8,161
54,Poitou-Charentes,79,2,11,351,Villiers-en-Plaine,1589,53,1642
54,Poitou-Charentes,79,2,05,352,Villiers-sur-Chizé,158,7,165
54,Poitou-Charentes,79,2,06,353,Vitré,518,55,573
54,Poitou-Charentes,79,3,15,354,Vouhé,367,4,371
54,Poitou-Charentes,79,2,23,355,Vouillé,3119,127,3246
54,Poitou-Charentes,79,1,02,356,Voultegon,541,9,550
54,Poitou-Charentes,79,2,08,357,Xaintray,233,3,236
22,Picardie,80,1,98,001,Abbeville,24129,796,24925
22,Picardie,80,4,15,002,Ablaincourt-Pressoir,257,9,266
22,Picardie,80,2,03,003,Acheux-en-Amiénois,545,10,555
22,Picardie,80,1,29,004,Acheux-en-Vimeu,511,4,515
22,Picardie,80,2,12,005,Agenville,111,1,112
22,Picardie,80,1,31,006,Agenvillers,191,3,194
22,Picardie,80,1,22,008,Aigneville,850,11,861
22,Picardie,80,1,04,009,Ailly-le-Haut-Clocher,861,19,880
22,Picardie,80,3,05,010,Ailly-sur-Noye,2728,23,2751
22,Picardie,80,2,34,011,Ailly-sur-Somme,3186,25,3211
22,Picardie,80,2,26,013,Airaines,2207,14,2221
22,Picardie,80,4,36,014,Aizecourt-le-Bas,56,2,58
22,Picardie,80,4,33,015,Aizecourt-le-Haut,88,4,92
22,Picardie,80,4,06,016,Albert,9800,317,10117
22,Picardie,80,4,33,017,Allaines,431,15,446
22,Picardie,80,1,11,018,Allenay,241,10,251
22,Picardie,80,1,23,019,Allery,786,14,800
22,Picardie,80,2,45,020,Allonville,647,15,662
22,Picardie,80,2,99,021,Amiens,134381,2994,137375
22,Picardie,80,1,32,022,Andainville,225,0,225
22,Picardie,80,3,27,023,Andechy,252,1,253
22,Picardie,80,2,08,024,Argoeuves,546,12,558
22,Picardie,80,1,39,025,Argoules,339,6,345
22,Picardie,80,2,25,026,Arguel,30,0,30
22,Picardie,80,3,38,027,Armancourt,19,0,19
22,Picardie,80,2,03,028,Arquèves,149,0,149
22,Picardie,80,1,40,029,Arrest,867,14,881
22,Picardie,80,1,39,030,Arry,191,8,199
22,Picardie,80,3,28,031,Arvillers,738,18,756
22,Picardie,80,3,27,032,Assainvillers,167,4,171
22,Picardie,80,4,15,033,Assevillers,282,6,288
22,Picardie,80,4,24,034,Athies,647,23,670
22,Picardie,80,3,28,035,Aubercourt,58,1,59
22,Picardie,80,2,18,036,Aubigny,518,3,521
22,Picardie,80,3,05,037,Aubvillers,119,1,120
22,Picardie,80,4,06,038,Auchonvillers,130,5,135
22,Picardie,80,1,11,039,Ault,1782,22,1804
22,Picardie,80,1,32,040,Aumâtre,207,2,209
22,Picardie,80,2,25,041,Aumont,143,1,144
22,Picardie,80,2,12,042,Autheux,102,1,103
22,Picardie,80,2,03,043,Authie,283,6,289
22,Picardie,80,2,21,044,Authieule,350,5,355
22,Picardie,80,4,06,045,Authuille,165,5,170
22,Picardie,80,2,26,046,Avelesges,50,0,50
22,Picardie,80,4,06,047,Aveluy,501,12,513
22,Picardie,80,1,32,048,Avesnes-Chaussoy,63,2,65
22,Picardie,80,3,27,049,Ayencourt,177,17,194
22,Picardie,80,2,17,050,Bacouel-sur-Selle,502,10,512
22,Picardie,80,1,23,051,Bailleul,262,2,264
22,Picardie,80,2,18,052,Baizieux,231,1,232
22,Picardie,80,3,38,053,Balâtre,86,3,89
22,Picardie,80,4,33,054,Barleux,282,13,295
22,Picardie,80,2,12,055,Barly,157,1,158
22,Picardie,80,2,41,056,Bavelincourt,117,0,117
22,Picardie,80,2,03,057,Bayencourt,78,3,81
22,Picardie,80,3,37,058,Bayonvillers,356,8,364
22,Picardie,80,4,06,059,Bazentin,73,1,74
22,Picardie,80,2,12,060,Béalcourt,102,0,102
22,Picardie,80,2,25,061,Beaucamps-le-Jeune,188,4,192
22,Picardie,80,2,25,062,Beaucamps-le-Vieux,1450,23,1473
22,Picardie,80,1,22,063,Beauchamps,1083,20,1103
22,Picardie,80,3,28,064,Beaucourt-en-Santerre,176,4,180
22,Picardie,80,4,06,065,Beaucourt-sur-l'Ancre,90,0,90
22,Picardie,80,2,41,066,Beaucourt-sur-l'Hallue,239,4,243
22,Picardie,80,3,37,067,Beaufort-en-Santerre,174,2,176
22,Picardie,80,2,12,068,Beaumetz,205,2,207
22,Picardie,80,4,06,069,Beaumont-Hamel,179,3,182
22,Picardie,80,2,21,070,Beauquesne,1291,70,1361
22,Picardie,80,2,21,071,Beauval,2146,30,2176
22,Picardie,80,4,06,073,Bécordel-Bécourt,168,2,170
22,Picardie,80,3,27,074,Becquigny,107,3,110
22,Picardie,80,1,29,076,Béhen,447,15,462
22,Picardie,80,2,41,077,Béhencourt,359,3,362
22,Picardie,80,1,01,078,Bellancourt,505,15,520
22,Picardie,80,2,17,079,Belleuse,330,1,331
22,Picardie,80,4,15,080,Belloy-en-Santerre,175,7,182
22,Picardie,80,2,25,081,Belloy-Saint-Léonard,88,1,89
22,Picardie,80,2,34,082,Belloy-sur-Somme,734,11,745
22,Picardie,80,2,35,083,Bergicourt,158,2,160
22,Picardie,80,1,32,084,Bermesnil,245,5,250
22,Picardie,80,2,12,085,Bernâtre,41,1,42
22,Picardie,80,2,12,086,Bernaville,1076,28,1104
22,Picardie,80,1,39,087,Bernay-en-Ponthieu,246,5,251
22,Picardie,80,4,36,088,Bernes,294,12,306
22,Picardie,80,2,20,089,Berneuil,258,4,262
22,Picardie,80,4,15,090,Berny-en-Santerre,149,1,150
22,Picardie,80,2,41,092,Bertangles,598,12,610
22,Picardie,80,2,20,093,Berteaucourt-les-Dames,1158,10,1168
22,Picardie,80,3,28,094,Berteaucourt-lès-Thennes,370,6,376
22,Picardie,80,2,03,095,Bertrancourt,219,5,224
22,Picardie,80,1,11,096,Béthencourt-sur-Mer,1059,11,1070
22,Picardie,80,4,30,097,Béthencourt-sur-Somme,137,5,142
22,Picardie,80,2,35,098,Bettembos,100,1,101
22,Picardie,80,2,26,099,Bettencourt-Rivière,224,4,228
22,Picardie,80,2,34,100,Bettencourt-Saint-Ouen,552,5,557
22,Picardie,80,3,38,101,Beuvraignes,796,6,802
22,Picardie,80,4,33,102,Biaches,405,17,422
22,Picardie,80,3,38,103,Biarre,58,2,60
22,Picardie,80,1,22,104,Biencourt,125,3,128
22,Picardie,80,3,38,105,Billancourt,171,4,175
22,Picardie,80,2,35,106,Blangy-sous-Poix,186,5,191
22,Picardie,80,2,13,107,Blangy-Tronville,526,7,533
22,Picardie,80,2,12,108,Boisbergues,86,2,88
22,Picardie,80,1,19,109,Le Boisle,379,4,383
22,Picardie,80,1,40,110,Boismont,460,5,465
22,Picardie,80,2,18,112,Bonnay,252,3,255
22,Picardie,80,2,20,113,Bonneville,353,7,360
22,Picardie,80,2,17,114,Bosquel,299,3,302
22,Picardie,80,4,33,115,Bouchavesnes-Bergen,325,19,344
22,Picardie,80,3,37,116,Bouchoir,274,4,278
22,Picardie,80,2,34,117,Bouchon,152,2,154
22,Picardie,80,1,19,118,Boufflers,106,0,106
22,Picardie,80,2,26,119,Bougainville,478,2,480
22,Picardie,80,1,22,120,Bouillancourt-en-Séry,541,8,549
22,Picardie,80,3,27,121,Bouillancourt-la-Bataille,139,2,141
22,Picardie,80,2,21,122,Bouquemaison,482,12,494
22,Picardie,80,2,34,123,Bourdon,382,6,388
22,Picardie,80,1,46,124,Bourseville,726,20,746
22,Picardie,80,3,27,125,Boussicourt,75,0,75
22,Picardie,80,1,22,126,Bouttencourt,1047,19,1066
22,Picardie,80,1,22,127,Bouvaincourt-sur-Bresle,834,8,842
22,Picardie,80,4,33,128,Bouvincourt-en-Vermandois,151,6,157
22,Picardie,80,4,06,129,Bouzincourt,522,9,531
22,Picardie,80,2,26,130,Bovelles,379,2,381
22,Picardie,80,2,13,131,Boves,2869,24,2893
22,Picardie,80,3,28,132,Braches,223,3,226
22,Picardie,80,1,19,133,Brailly-Cornehotte,234,1,235
22,Picardie,80,2,17,134,Brassy,63,3,66
22,Picardie,80,1,02,135,Bray-lès-Mareuil,247,10,257
22,Picardie,80,4,14,136,Bray-sur-Somme,1252,33,1285
22,Picardie,80,2,34,137,Breilly,475,2,477
22,Picardie,80,2,18,138,Bresle,102,1,103
22,Picardie,80,3,38,139,Breuil,49,4,53
22,Picardie,80,2,21,140,Brévillers,102,0,102
22,Picardie,80,4,33,141,Brie,346,11,357
22,Picardie,80,2,26,142,Briquemesnil-Floxicourt,160,4,164
22,Picardie,80,2,25,143,Brocourt,99,4,103
22,Picardie,80,4,24,144,Brouchy,579,23,602
22,Picardie,80,1,04,145,Brucamps,139,1,140
22,Picardie,80,1,40,146,Brutelles,189,3,192
22,Picardie,80,1,04,147,Buigny-l'Abbé,321,7,328
22,Picardie,80,1,22,148,Buigny-lès-Gamaches,395,6,401
22,Picardie,80,1,31,149,Buigny-Saint-Maclou,519,7,526
22,Picardie,80,4,33,150,Buire-Courcelles,258,8,266
22,Picardie,80,4,06,151,Buire-sur-l'Ancre,334,3,337
22,Picardie,80,3,27,152,Bus-la-Mésière,143,2,145
22,Picardie,80,2,03,153,Bus-lès-Artois,144,3,147
22,Picardie,80,4,33,154,Bussu,217,7,224
22,Picardie,80,1,04,155,Bussus-Bussuel,277,4,281
22,Picardie,80,2,18,156,Bussy-lès-Daours,336,5,341
22,Picardie,80,2,35,157,Bussy-lès-Poix,91,1,92
22,Picardie,80,4,30,158,Buverchy,39,1,40
22,Picardie,80,2,13,159,Cachy,249,3,252
22,Picardie,80,2,42,160,Cagny,1277,21,1298
22,Picardie,80,1,29,161,Cahon,211,9,220
22,Picardie,80,3,37,162,Caix,720,3,723
22,Picardie,80,1,02,163,Cambron,713,12,725
22,Picardie,80,2,10,164,Camon,4633,59,4692
22,Picardie,80,2,26,165,Camps-en-Amiénois,170,8,178
22,Picardie,80,2,20,166,Canaples,602,14,616
22,Picardie,80,1,31,167,Canchy,304,6,310
22,Picardie,80,2,12,168,Candas,1018,17,1035
22,Picardie,80,1,32,169,Cannessières,78,7,85
22,Picardie,80,3,27,170,Cantigny,115,6,121
22,Picardie,80,1,01,171,Caours,607,13,620
22,Picardie,80,4,14,172,Cappy,551,1,552
22,Picardie,80,2,41,173,Cardonnette,432,7,439
22,Picardie,80,3,27,174,Le Cardonnois,89,0,89
22,Picardie,80,4,16,175,Carnoy,110,2,112
22,Picardie,80,3,38,176,Carrépuis,291,5,296
22,Picardie,80,4,33,177,Cartigny,693,15,708
22,Picardie,80,2,35,179,Caulières,211,1,212
22,Picardie,80,2,34,180,Cavillon,113,4,117
22,Picardie,80,3,28,181,Cayeux-en-Santerre,101,3,104
22,Picardie,80,1,40,182,Cayeux-sur-Mer,2886,46,2932
22,Picardie,80,4,14,184,Cerisy,457,2,459
22,Picardie,80,1,22,183,Cerisy-Buleux,252,4,256
22,Picardie,80,3,38,185,Champien,297,6,303
22,Picardie,80,4,15,186,Chaulnes,1941,41,1982
22,Picardie,80,2,34,187,La Chaussée-Tirancourt,664,6,670
22,Picardie,80,3,05,188,Chaussoy-Epagny,610,7,617
22,Picardie,80,3,37,189,La Chavatte,54,1,55
22,Picardie,80,1,29,190,Chépy,1295,25,1320
22,Picardie,80,3,37,191,Chilly,183,2,185
22,Picardie,80,4,14,192,Chipilly,184,2,186
22,Picardie,80,3,05,193,Chirmont,121,2,123
22,Picardie,80,4,15,194,Chuignes,119,3,122
22,Picardie,80,4,14,195,Chuignolles,155,2,157
22,Picardie,80,1,23,196,Citerne,259,8,267
22,Picardie,80,4,30,197,Cizancourt,39,3,42
22,Picardie,80,2,26,198,Clairy-Saulchoix,376,6,382
22,Picardie,80,4,33,199,Cléry-sur-Somme,534,26,560
22,Picardie,80,1,04,200,Cocquerel,202,4,206
22,Picardie,80,2,03,201,Coigneux,46,3,49
22,Picardie,80,2,41,202,Coisy,288,3,291
22,Picardie,80,2,03,203,Colincamps,91,1,92
22,Picardie,80,4,16,204,Combles,710,15,725
22,Picardie,80,2,34,205,Condé-Folie,845,10,855
22,Picardie,80,4,06,206,Contalmaison,124,1,125
22,Picardie,80,2,41,207,Contay,375,2,377
22,Picardie,80,1,19,208,Conteville,196,3,199
22,Picardie,80,3,28,209,Contoire,357,4,361
22,Picardie,80,2,17,210,Contre,122,4,126
22,Picardie,80,2,17,211,Conty,1708,53,1761
22,Picardie,80,2,18,212,Corbie,6411,92,6503
22,Picardie,80,2,13,213,Cottenchy,439,145,584
22,Picardie,80,3,05,214,Coullemelle,290,4,294
22,Picardie,80,1,04,215,Coulonvillers,243,3,246
22,Picardie,80,4,06,216,Courcelette,148,3,151
22,Picardie,80,2,03,217,Courcelles-au-Bois,76,0,76
22,Picardie,80,2,35,218,Courcelles-sous-Moyencourt,135,4,139
22,Picardie,80,2,17,219,Courcelles-sous-Thoix,57,1,58
22,Picardie,80,3,27,220,Courtemanche,96,1,97
22,Picardie,80,1,04,221,Cramont,298,2,300
22,Picardie,80,1,19,222,Crécy-en-Ponthieu,1527,44,1571
22,Picardie,80,3,38,223,Crémery,155,3,158
22,Picardie,80,3,38,224,Cressy-Omencourt,100,3,103
22,Picardie,80,2,26,225,Creuse,197,4,201
22,Picardie,80,4,24,226,Croix-Moligneaux,309,9,318
22,Picardie,80,2,35,227,Croixrault,421,2,423
22,Picardie,80,1,39,228,Le Crotoy,2320,31,2351
22,Picardie,80,2,34,229,Crouy-Saint-Pierre,327,1,328
22,Picardie,80,3,38,230,Curchy,324,10,334
22,Picardie,80,4,16,231,Curlu,139,1,140
22,Picardie,80,3,38,232,Damery,214,4,218
22,Picardie,80,3,38,233,Dancourt-Popincourt,146,5,151
22,Picardie,80,2,18,234,Daours,778,5,783
22,Picardie,80,1,22,235,Dargnies,1325,23,1348
22,Picardie,80,3,27,236,Davenescourt,492,5,497
22,Picardie,80,3,28,237,Démuin,465,6,471
22,Picardie,80,4,06,238,Dernancourt,444,12,456
22,Picardie,80,4,24,239,Devise,59,8,67
22,Picardie,80,4,33,240,Doingt,1325,59,1384
22,Picardie,80,2,20,241,Domart-en-Ponthieu,1168,11,1179
22,Picardie,80,3,28,242,Domart-sur-la-Luce,423,3,426
22,Picardie,80,2,12,243,Domesmont,39,0,39
22,Picardie,80,1,19,244,Dominois,164,3,167
22,Picardie,80,1,19,245,Domléger-Longvillers,276,11,287
22,Picardie,80,2,13,246,Dommartin,375,3,378
22,Picardie,80,4,15,247,Dompierre-Becquincourt,629,22,651
22,Picardie,80,1,19,248,Dompierre-sur-Authie,417,6,423
22,Picardie,80,1,04,249,Domqueur,277,6,283
22,Picardie,80,1,31,250,Domvast,325,1,326
22,Picardie,80,1,23,251,Doudelainville,276,3,279
22,Picardie,80,4,24,252,Douilly,249,10,259
22,Picardie,80,2,21,253,Doullens,6454,588,7042
22,Picardie,80,2,07,256,Dreuil-lès-Amiens,1264,17,1281
22,Picardie,80,4,36,258,Driencourt,87,3,90
22,Picardie,80,2,25,259,Dromesnil,99,4,103
22,Picardie,80,1,01,260,Drucat,873,41,914
22,Picardie,80,2,13,261,Dury,1263,66,1329
22,Picardie,80,1,02,262,Eaucourt-sur-Somme,392,9,401
22,Picardie,80,3,38,263,L' Échelle-Saint-Aurin,55,0,55
22,Picardie,80,4,14,264,Éclusier-Vaux,89,56,145
22,Picardie,80,1,22,265,Embreville,577,5,582
22,Picardie,80,2,03,266,Englebelmer,243,5,248
22,Picardie,80,4,24,267,Ennemain,226,5,231
22,Picardie,80,1,02,268,Épagne-Épagnette,578,23,601
22,Picardie,80,1,32,269,Épaumesnil,118,0,118
22,Picardie,80,2,12,270,Épécamps,7,0,7
22,Picardie,80,4,36,271,Épehy,1166,17,1183
22,Picardie,80,4,30,272,Épénancourt,102,0,102
22,Picardie,80,2,35,273,Éplessier,376,9,385
22,Picardie,80,4,24,274,Eppeville,1914,66,1980
22,Picardie,80,4,16,275,Équancourt,320,5,325
22,Picardie,80,2,35,276,Équennes-Éramecourt,318,5,323
22,Picardie,80,3,27,278,Erches,168,2,170
22,Picardie,80,3,38,279,Ercheu,799,10,809
22,Picardie,80,1,29,280,Ercourt,136,0,136
22,Picardie,80,1,04,281,Ergnies,198,8,206
22,Picardie,80,1,23,282,Érondelle,505,11,516
22,Picardie,80,3,05,283,Esclainvillers,142,0,142
22,Picardie,80,4,24,284,Esmery-Hallon,772,14,786
22,Picardie,80,2,17,285,Essertaux,246,3,249
22,Picardie,80,1,40,287,Estréboeuf,273,5,278
22,Picardie,80,4,15,288,Estrées-Deniécourt,292,13,305
22,Picardie,80,1,19,290,Estrées-lès-Crécy,372,7,379
22,Picardie,80,4,33,557,Estrées-Mons,571,17,588
22,Picardie,80,2,13,291,Estrées-sur-Noye,281,6,287
22,Picardie,80,3,38,292,Étalon,142,5,147
22,Picardie,80,3,27,293,Ételfay,378,3,381
22,Picardie,80,4,33,294,Éterpigny,177,10,187
22,Picardie,80,4,14,295,Étinehem,308,5,313
22,Picardie,80,2,34,296,L' Étoile,1231,12,1243
22,Picardie,80,1,32,297,Étréjust,43,0,43
22,Picardie,80,4,16,298,Étricourt-Manancourt,486,4,490
22,Picardie,80,3,05,299,La Faloise,237,1,238
22,Picardie,80,4,30,300,Falvy,128,13,141
22,Picardie,80,2,35,301,Famechon,234,0,234
22,Picardie,80,3,27,302,Faverolles,158,3,161
22,Picardie,80,1,39,303,Favières,459,17,476
22,Picardie,80,4,15,304,Fay,117,0,117
22,Picardie,80,2,34,305,Ferrières,465,9,474
22,Picardie,80,3,27,306,Fescamps,146,5,151
22,Picardie,80,4,33,307,Feuillères,142,5,147
22,Picardie,80,1,29,308,Feuquières-en-Vimeu,2491,36,2527
22,Picardie,80,2,20,566,Fieffes-Montrelet,324,6,330
22,Picardie,80,2,12,310,Fienvillers,572,5,577
22,Picardie,80,3,27,311,Fignières,142,2,144
22,Picardie,80,4,36,312,Fins,277,4,281
22,Picardie,80,4,33,313,Flaucourt,328,6,334
22,Picardie,80,4,16,314,Flers,166,3,169
22,Picardie,80,3,05,315,Flers-sur-Noye,370,14,384
22,Picardie,80,2,41,316,Flesselles,2065,23,2088
22,Picardie,80,2,17,317,Fleury,227,8,235
22,Picardie,80,2,34,318,Flixecourt,3183,69,3252
22,Picardie,80,2,26,319,Fluy,302,4,306
22,Picardie,80,3,37,320,Folies,118,2,120
22,Picardie,80,3,05,321,Folleville,137,2,139
22,Picardie,80,3,38,322,Fonches-Fonchette,145,3,148
22,Picardie,80,1,32,324,Fontaine-le-Sec,133,4,137
22,Picardie,80,4,15,325,Fontaine-lès-Cappy,44,0,44
22,Picardie,80,3,27,326,Fontaine-sous-Montdidier,122,6,128
22,Picardie,80,1,19,327,Fontaine-sur-Maye,153,2,155
22,Picardie,80,1,23,328,Fontaine-sur-Somme,532,7,539
22,Picardie,80,2,03,329,Forceville,167,4,171
22,Picardie,80,1,32,330,Forceville-en-Vimeu,270,4,274
22,Picardie,80,1,31,331,Forest-l'Abbaye,316,3,319
22,Picardie,80,1,31,332,Forest-Montiers,403,1,404
22,Picardie,80,1,39,333,Fort-Mahon-Plage,1317,20,1337
22,Picardie,80,2,17,334,Fossemanant,109,1,110
22,Picardie,80,4,15,335,Foucaucourt-en-Santerre,270,5,275
22,Picardie,80,1,32,336,Foucaucourt-Hors-Nesle,78,3,81
22,Picardie,80,2,13,337,Fouencamps,231,2,233
22,Picardie,80,2,18,338,Fouilloy,1822,10,1832
22,Picardie,80,3,37,339,Fouquescourt,154,0,154
22,Picardie,80,2,35,340,Fourcigny,176,6,182
22,Picardie,80,2,34,341,Fourdrinoy,343,10,353
22,Picardie,80,4,15,342,Framerville-Rainecourt,432,7,439
22,Picardie,80,1,22,343,Framicourt,160,5,165
22,Picardie,80,1,04,344,Francières,179,0,179
22,Picardie,80,1,40,345,Franleu,512,5,517
22,Picardie,80,2,20,346,Franqueville,166,0,166
22,Picardie,80,3,37,347,Fransart,143,4,147
22,Picardie,80,2,20,348,Fransu,131,0,131
22,Picardie,80,3,05,349,Fransures,136,2,138
22,Picardie,80,2,18,350,Franvillers,492,3,495
22,Picardie,80,2,41,351,Fréchencourt,229,7,236
22,Picardie,80,2,17,352,Frémontiers,158,0,158
22,Picardie,80,4,15,353,Fresnes-Mazancourt,110,0,110
22,Picardie,80,1,32,354,Fresnes-Tilloloy,145,0,145
22,Picardie,80,1,32,355,Fresneville,107,5,112
22,Picardie,80,1,32,356,Fresnoy-Andainville,90,0,90
22,Picardie,80,2,26,357,Fresnoy-au-Val,247,4,251
22,Picardie,80,3,28,358,Fresnoy-en-Chaussée,108,1,109
22,Picardie,80,3,38,359,Fresnoy-lès-Roye,312,3,315
22,Picardie,80,1,46,360,Fressenneville,2266,36,2302
22,Picardie,80,1,32,361,Frettecuisse,72,0,72
22,Picardie,80,1,22,362,Frettemeule,276,3,279
22,Picardie,80,1,11,364,Friaucourt,711,18,729
22,Picardie,80,2,35,365,Fricamps,139,2,141
22,Picardie,80,4,06,366,Fricourt,502,16,518
22,Picardie,80,4,14,367,Frise,185,3,188
22,Picardie,80,1,46,368,Friville-Escarbotin,4501,110,4611
22,Picardie,80,2,12,369,Frohen-sur-Authie,213,1,214
22,Picardie,80,1,19,371,Froyelles,99,1,100
22,Picardie,80,1,23,372,Frucourt,135,0,135
22,Picardie,80,1,22,373,Gamaches,2834,120,2954
22,Picardie,80,1,31,374,Gapennes,258,2,260
22,Picardie,80,2,35,375,Gauville,396,8,404
22,Picardie,80,2,13,376,Gentelles,468,11,479
22,Picardie,80,2,21,377,Gézaincourt,428,10,438
22,Picardie,80,4,16,378,Ginchy,66,0,66
22,Picardie,80,2,13,379,Glisy,566,8,574
22,Picardie,80,1,04,380,Gorenflos,247,7,254
22,Picardie,80,2,12,381,Gorges,43,1,44
22,Picardie,80,3,38,383,Goyencourt,95,1,96
22,Picardie,80,1,01,385,Grand-Laviers,336,46,382
22,Picardie,80,4,06,384,Grandcourt,173,1,174
22,Picardie,80,3,27,386,Gratibus,168,5,173
22,Picardie,80,2,13,387,Grattepanche,295,3,298
22,Picardie,80,1,29,388,Grébault-Mesnil,199,3,202
22,Picardie,80,4,30,389,Grécourt,24,0,24
22,Picardie,80,3,05,390,Grivesnes,354,9,363
22,Picardie,80,3,27,391,Grivillers,57,3,60
22,Picardie,80,2,21,392,Grouches-Luchuel,579,9,588
22,Picardie,80,3,38,393,Gruny,319,3,322
22,Picardie,80,3,27,395,Guerbigny,260,4,264
22,Picardie,80,1,19,396,Gueschart,319,5,324
22,Picardie,80,4,16,397,Gueudecourt,103,2,105
22,Picardie,80,2,26,399,Guignemicourt,243,3,246
22,Picardie,80,3,37,400,Guillaucourt,384,5,389
22,Picardie,80,4,16,401,Guillemont,126,4,130
22,Picardie,80,2,35,402,Guizancourt,133,0,133
22,Picardie,80,4,36,404,Guyencourt-Saulcourt,128,2,130
22,Picardie,80,2,13,403,Guyencourt-sur-Noye,167,6,173
22,Picardie,80,2,13,405,Hailles,428,1,429
22,Picardie,80,1,23,406,Hallencourt,1392,24,1416
22,Picardie,80,3,05,407,Hallivillers,132,4,136
22,Picardie,80,2,20,408,Halloy-lès-Pernois,367,4,371
22,Picardie,80,3,37,409,Hallu,172,7,179
22,Picardie,80,4,24,410,Ham,5181,221,5402
22,Picardie,80,2,18,411,Le Hamel,521,5,526
22,Picardie,80,2,18,412,Hamelet,468,5,473
22,Picardie,80,4,36,413,Hancourt,103,6,109
22,Picardie,80,3,28,414,Hangard,118,2,120
22,Picardie,80,3,28,415,Hangest-en-Santerre,1012,11,1023
22,Picardie,80,2,34,416,Hangest-sur-Somme,687,6,693
22,Picardie,80,3,37,417,Harbonnières,1480,10,1490
22,Picardie,80,4,16,418,Hardecourt-aux-Bois,77,0,77
22,Picardie,80,3,27,419,Hargicourt,377,2,379
22,Picardie,80,2,03,420,Harponville,155,0,155
22,Picardie,80,3,38,421,Hattencourt,246,8,254
22,Picardie,80,1,31,422,Hautvillers-Ouville,454,6,460
22,Picardie,80,2,20,423,Havernas,384,4,388
22,Picardie,80,2,13,424,Hébécourt,507,4,511
22,Picardie,80,2,03,425,Hédauville,105,2,107
22,Picardie,80,2,18,426,Heilly,397,5,402
22,Picardie,80,2,21,427,Hem-Hardinval,356,5,361
22,Picardie,80,4,16,428,Hem-Monacu,131,4,135
22,Picardie,80,2,18,429,Hénencourt,181,2,183
22,Picardie,80,4,14,430,Herbécourt,179,5,184
22,Picardie,80,2,03,431,Hérissart,534,6,540
22,Picardie,80,4,15,432,Herleville,127,1,128
22,Picardie,80,3,38,433,Herly,47,0,47
22,Picardie,80,4,36,434,Hervilly,187,3,190
22,Picardie,80,4,36,435,Hesbécourt,58,7,65
22,Picardie,80,2,35,436,Hescamps,486,8,494
22,Picardie,80,1,32,437,Heucourt-Croquoison,116,2,118
22,Picardie,80,4,36,438,Heudicourt,508,13,521
22,Picardie,80,2,12,439,Heuzecourt,146,3,149
22,Picardie,80,1,19,440,Hiermont,126,4,130
22,Picardie,80,4,30,442,Hombleux,1000,31,1031
22,Picardie,80,2,25,443,Hornoy-le-Bourg,1674,29,1703
22,Picardie,80,1,29,444,Huchenneville,660,10,670
22,Picardie,80,2,21,445,Humbercourt,255,5,260
22,Picardie,80,1,23,446,Huppy,780,20,800
22,Picardie,80,4,15,447,Hyencourt-le-Grand,89,1,90
22,Picardie,80,3,28,449,Ignaucourt,81,0,81
22,Picardie,80,1,32,450,Inval-Boiron,85,2,87
22,Picardie,80,4,06,451,Irles,117,2,119
22,Picardie,80,3,05,452,Jumel,352,8,360
22,Picardie,80,3,27,453,Laboissière-en-Santerre,145,1,146
22,Picardie,80,2,35,455,Lachapelle,66,1,67
22,Picardie,80,2,25,456,Lafresguimont-Saint-Martin,521,14,535
22,Picardie,80,2,18,458,Lahoussoye,347,5,352
22,Picardie,80,2,26,459,Laleu,93,2,95
22,Picardie,80,2,35,460,Lamaronde,77,4,81
22,Picardie,80,2,18,461,Lamotte-Brebière,207,9,216
22,Picardie,80,1,31,462,Lamotte-Buleux,351,4,355
22,Picardie,80,2,18,463,Lamotte-Warfusée,572,1,573
22,Picardie,80,1,40,464,Lanchères,1008,11,1019
22,Picardie,80,2,20,466,Lanches-Saint-Hilaire,128,2,130
22,Picardie,80,4,30,465,Languevoisin-Quiquery,210,2,212
22,Picardie,80,3,38,467,Laucourt,184,4,188
22,Picardie,80,4,06,468,Laviéville,157,2,159
22,Picardie,80,3,05,469,Lawarde-Mauger-l'Hortoy,171,1,172
22,Picardie,80,2,03,470,Léalvillers,181,6,187
22,Picardie,80,4,16,472,Lesboeufs,162,5,167
22,Picardie,80,3,38,473,Liancourt-Fosse,247,6,253
22,Picardie,80,4,30,474,Licourt,400,4,404
22,Picardie,80,4,36,475,Liéramont,207,3,210
22,Picardie,80,1,23,476,Liercourt,356,2,358
22,Picardie,80,1,19,477,Ligescourt,228,8,236
22,Picardie,80,3,27,478,Lignières,141,1,142
22,Picardie,80,2,35,479,Lignières-Châtelain,350,4,354
22,Picardie,80,1,32,480,Lignières-en-Vimeu,113,0,113
22,Picardie,80,4,15,481,Lihons,376,6,382
22,Picardie,80,1,23,482,Limeux,139,3,142
22,Picardie,80,2,25,484,Liomer,376,8,384
22,Picardie,80,2,17,485,Loeuilly,832,10,842
22,Picardie,80,1,04,486,Long,665,10,675
22,Picardie,80,4,36,487,Longavesnes,94,1,95
22,Picardie,80,1,23,488,Longpré-les-Corps-Saints,1670,31,1701
22,Picardie,80,2,10,489,Longueau,5353,55,5408
22,Picardie,80,4,16,490,Longueval,275,5,280
22,Picardie,80,2,21,491,Longuevillette,78,1,79
22,Picardie,80,2,03,493,Louvencourt,263,0,263
22,Picardie,80,3,05,494,Louvrechy,178,0,178
22,Picardie,80,2,21,495,Lucheux,591,50,641
22,Picardie,80,1,39,496,Machiel,155,7,162
22,Picardie,80,1,39,497,Machy,127,5,132
22,Picardie,80,2,03,498,Mailly-Maillet,602,10,612
22,Picardie,80,3,05,499,Mailly-Raineval,253,2,255
22,Picardie,80,1,22,500,Maisnières,510,9,519
22,Picardie,80,1,19,501,Maison-Ponthieu,277,10,287
22,Picardie,80,1,04,502,Maison-Roland,115,2,117
22,Picardie,80,2,12,503,Maizicourt,180,0,180
22,Picardie,80,3,27,504,Malpart,69,0,69
22,Picardie,80,4,06,505,Mametz,164,9,173
22,Picardie,80,2,18,507,Marcelcave,1045,15,1060
22,Picardie,80,3,38,508,Marché-Allouarde,74,1,75
22,Picardie,80,4,30,509,Marchélepot,458,4,462
22,Picardie,80,3,27,511,Marestmontiers,99,0,99
22,Picardie,80,1,02,512,Mareuil-Caubert,904,116,1020
22,Picardie,80,4,16,513,Maricourt,158,8,166
22,Picardie,80,2,03,514,Marieux,110,1,111
22,Picardie,80,2,35,515,Marlers,155,3,158
22,Picardie,80,4,36,516,Marquaix,220,6,226
22,Picardie,80,3,27,517,Marquivillers,156,3,159
22,Picardie,80,1,22,518,Martainneville,383,7,390
22,Picardie,80,4,24,519,Matigny,507,10,517
22,Picardie,80,3,37,520,Maucourt,150,2,152
22,Picardie,80,4,16,521,Maurepas,207,2,209
22,Picardie,80,1,32,522,Le Mazis,98,3,101
22,Picardie,80,4,06,523,Méaulte,1315,26,1341
22,Picardie,80,3,37,524,Méharicourt,595,11,606
22,Picardie,80,2,35,525,Meigneux,159,0,159
22,Picardie,80,2,12,526,Le Meillard,154,5,159
22,Picardie,80,1,11,527,Méneslies,302,3,305
22,Picardie,80,2,35,528,Méréaucourt,12,3,15
22,Picardie,80,1,23,529,Mérélessart,202,4,206
22,Picardie,80,2,25,531,Méricourt-en-Vimeu,113,0,113
22,Picardie,80,4,14,530,Méricourt-l'Abbé,575,4,579
22,Picardie,80,4,14,532,Méricourt-sur-Somme,178,3,181
22,Picardie,80,1,11,533,Mers-les-Bains,3289,57,3346
22,Picardie,80,2,34,535,Le Mesge,177,1,178
22,Picardie,80,4,33,536,Mesnil-Bruntel,305,12,317
22,Picardie,80,1,04,537,Mesnil-Domqueur,86,0,86
22,Picardie,80,4,16,538,Mesnil-en-Arrouaise,137,8,145
22,Picardie,80,4,06,540,Mesnil-Martinsart,230,7,237
22,Picardie,80,3,27,541,Mesnil-Saint-Georges,180,4,184
22,Picardie,80,4,30,542,Mesnil-Saint-Nicaise,541,4,545
22,Picardie,80,2,26,543,Métigny,100,3,103
22,Picardie,80,2,12,544,Mézerolles,199,1,200
22,Picardie,80,3,28,545,Mézières-en-Santerre,543,13,556
22,Picardie,80,1,29,546,Miannay,584,46,630
22,Picardie,80,4,06,547,Millencourt,227,5,232
22,Picardie,80,1,31,548,Millencourt-en-Ponthieu,350,8,358
22,Picardie,80,4,06,549,Miraumont,713,12,725
22,Picardie,80,2,41,550,Mirvaux,149,2,151
22,Picardie,80,4,30,551,Misery,128,1,129
22,Picardie,80,4,33,552,Moislains,1296,57,1353
22,Picardie,80,2,41,553,Molliens-au-Bois,333,5,338
22,Picardie,80,2,26,554,Molliens-Dreuil,896,6,902
22,Picardie,80,4,24,555,Monchy-Lagache,710,33,743
22,Picardie,80,1,40,556,Mons-Boubert,538,10,548
22,Picardie,80,2,17,558,Monsures,240,2,242
22,Picardie,80,2,26,559,Montagne-Fayel,172,6,178
22,Picardie,80,4,16,560,Montauban-de-Picardie,214,3,217
22,Picardie,80,3,27,561,Montdidier,6046,126,6172
22,Picardie,80,2,12,563,Montigny-les-Jongleurs,78,1,79
22,Picardie,80,2,41,562,Montigny-sur-l'Hallue,211,3,214
22,Picardie,80,2,41,565,Montonvillers,96,0,96
22,Picardie,80,4,30,568,Morchain,302,4,306
22,Picardie,80,4,14,569,Morcourt,274,3,277
22,Picardie,80,3,28,570,Moreuil,3976,39,4015
22,Picardie,80,3,28,571,Morisel,533,9,542
22,Picardie,80,4,14,572,Morlancourt,363,17,380
22,Picardie,80,2,35,573,Morvillers-Saint-Saturnin,361,13,374
22,Picardie,80,1,04,574,Mouflers,90,1,91
22,Picardie,80,1,32,575,Mouflières,91,0,91
22,Picardie,80,3,38,576,Moyencourt,300,0,300
22,Picardie,80,2,35,577,Moyencourt-lès-Poix,161,1,162
22,Picardie,80,1,29,578,Moyenneville,657,13,670
22,Picardie,80,4,24,579,Muille-Villette,829,27,856
22,Picardie,80,1,39,580,Nampont,270,9,279
22,Picardie,80,2,17,582,Namps-Maisnil,1025,13,1038
22,Picardie,80,2,17,583,Nampty,240,1,241
22,Picardie,80,2,20,584,Naours,1143,16,1159
22,Picardie,80,4,30,585,Nesle,2499,66,2565
22,Picardie,80,1,32,586,Nesle-l'Hôpital,188,1,189
22,Picardie,80,1,32,587,Neslette,93,1,94
22,Picardie,80,1,01,588,Neufmoulin,352,10,362
22,Picardie,80,1,31,590,Neuilly-l'Hôpital,319,4,323
22,Picardie,80,1,19,589,Neuilly-le-Dien,106,5,111
22,Picardie,80,1,32,591,Neuville-au-Bois,180,2,182
22,Picardie,80,1,32,592,Neuville-Coppegueule,594,4,598
22,Picardie,80,4,14,593,La Neuville-lès-Bray,273,2,275
22,Picardie,80,2,17,594,Neuville-lès-Loeuilly,117,4,121
22,Picardie,80,3,28,595,La Neuville-Sire-Bernard,276,2,278
22,Picardie,80,2,21,596,Neuvillette,182,1,183
22,Picardie,80,1,46,597,Nibas,845,22,867
22,Picardie,80,1,31,598,Nouvion,1235,38,1273
22,Picardie,80,1,19,599,Noyelles-en-Chaussée,260,2,262
22,Picardie,80,1,31,600,Noyelles-sur-Mer,836,18,854
22,Picardie,80,4,33,601,Nurlu,380,11,391
22,Picardie,80,2,12,602,Occoches,131,2,133
22,Picardie,80,1,46,603,Ochancourt,267,4,271
22,Picardie,80,2,35,604,Offignies,66,2,68
22,Picardie,80,4,24,605,Offoy,216,5,221
22,Picardie,80,1,32,606,Oisemont,1239,58,1297
22,Picardie,80,2,26,607,Oissy,236,4,240
22,Picardie,80,4,15,608,Omiécourt,246,2,248
22,Picardie,80,1,04,609,Oneux,361,10,371
22,Picardie,80,2,17,611,Oresmaux,838,11,849
22,Picardie,80,1,11,613,Oust-Marest,653,12,665
22,Picardie,80,2,12,614,Outrebois,278,3,281
22,Picardie,80,4,06,615,Ovillers-la-Boisselle,387,6,393
22,Picardie,80,4,30,616,Pargny,134,1,135
22,Picardie,80,3,37,617,Parvillers-le-Quesnoy,202,3,205
22,Picardie,80,1,40,618,Pendé,1135,16,1151
22,Picardie,80,2,20,619,Pernois,714,14,728
22,Picardie,80,4,33,620,Péronne,8077,537,8614
22,Picardie,80,4,30,621,Pertain,369,10,379
22,Picardie,80,2,34,622,Picquigny,1382,9,1391
22,Picardie,80,3,27,623,Piennes-Onvillers,343,11,354
22,Picardie,80,2,41,624,Pierregot,250,3,253
22,Picardie,80,3,28,625,Pierrepont-sur-Avre,546,11,557
22,Picardie,80,2,26,626,Pissy,275,9,284
22,Picardie,80,2,17,627,Plachy-Buyon,892,11,903
22,Picardie,80,3,28,628,Le Plessier-Rozainvillers,617,3,620
22,Picardie,80,4,36,629,Poeuilly,102,6,108
22,Picardie,80,2,35,630,Poix-de-Picardie,2369,16,2385
22,Picardie,80,1,19,631,Ponches-Estruval,109,1,110
22,Picardie,80,2,44,632,Pont-de-Metz,1952,26,1978
22,Picardie,80,2,41,634,Pont-Noyelles,728,4,732
22,Picardie,80,1,04,635,Pont-Remy,1463,27,1490
22,Picardie,80,1,31,633,Ponthoile,610,14,624
22,Picardie,80,1,31,637,Port-le-Grand,298,9,307
22,Picardie,80,4,30,638,Potte,105,6,111
22,Picardie,80,2,45,639,Poulainville,1300,29,1329
22,Picardie,80,4,06,640,Pozières,242,2,244
22,Picardie,80,2,12,642,Prouville,305,4,309
22,Picardie,80,2,17,643,Prouzel,495,10,505
22,Picardie,80,4,15,644,Proyart,606,16,622
22,Picardie,80,2,03,645,Puchevillers,508,7,515
22,Picardie,80,3,37,646,Punchy,73,0,73
22,Picardie,80,4,15,647,Puzeaux,243,2,245
22,Picardie,80,4,06,648,Pys,99,1,100
22,Picardie,80,1,39,649,Quend,1385,30,1415
22,Picardie,80,2,41,650,Querrieu,688,6,694
22,Picardie,80,2,25,651,Le Quesne,277,2,279
22,Picardie,80,3,28,652,Le Quesnel,690,8,698
22,Picardie,80,1,29,654,Quesnoy-le-Montant,569,10,579
22,Picardie,80,2,26,655,Quesnoy-sur-Airaines,461,7,468
22,Picardie,80,2,26,656,Quevauvillers,1052,21,1073
22,Picardie,80,3,05,657,Quiry-le-Sec,305,7,312
22,Picardie,80,4,24,658,Quivières,173,3,176
22,Picardie,80,2,03,659,Raincheval,276,4,280
22,Picardie,80,2,41,661,Rainneville,757,9,766
22,Picardie,80,1,22,662,Ramburelles,259,3,262
22,Picardie,80,1,22,663,Rambures,419,7,426
22,Picardie,80,4,16,664,Rancourt,178,3,181
22,Picardie,80,1,39,665,Regnière-Écluse,138,2,140
22,Picardie,80,2,12,666,Remaisnil,39,0,39
22,Picardie,80,3,27,667,Remaugies,116,1,117
22,Picardie,80,2,13,668,Remiencourt,182,6,188
22,Picardie,80,3,38,669,Rethonvillers,336,9,345
22,Picardie,80,2,26,670,Revelles,534,6,540
22,Picardie,80,2,20,671,Ribeaucourt,201,4,205
22,Picardie,80,2,18,672,Ribemont-sur-Ancre,650,10,660
22,Picardie,80,2,26,673,Riencourt,166,3,169
22,Picardie,80,2,09,674,Rivery,3396,53,3449
22,Picardie,80,3,05,675,Rogy,139,5,144
22,Picardie,80,3,38,676,Roiglise,174,7,181
22,Picardie,80,4,36,677,Roisel,1803,100,1903
22,Picardie,80,3,27,678,Rollot,727,8,735
22,Picardie,80,4,36,679,Ronssoy,530,9,539
22,Picardie,80,3,37,680,Rosières-en-Santerre,2849,41,2890
22,Picardie,80,3,05,681,Rouvrel,275,3,278
22,Picardie,80,3,37,682,Rouvroy-en-Santerre,205,4,209
22,Picardie,80,4,30,683,Rouy-le-Grand,109,2,111
22,Picardie,80,4,30,684,Rouy-le-Petit,127,1,128
22,Picardie,80,3,38,685,Roye,6199,115,6314
22,Picardie,80,2,41,686,Rubempré,781,11,792
22,Picardie,80,3,27,687,Rubescourt,134,3,137
22,Picardie,80,1,39,688,Rue,3099,104,3203
22,Picardie,80,2,13,690,Rumigny,588,4,592
22,Picardie,80,1,40,691,Saigneville,395,4,399
22,Picardie,80,1,31,692,Sailly-Flibeaucourt,1019,4,1023
22,Picardie,80,4,14,693,Sailly-Laurette,299,6,305
22,Picardie,80,4,14,694,Sailly-le-Sec,376,1,377
22,Picardie,80,4,16,695,Sailly-Saillisel,450,8,458
22,Picardie,80,2,13,696,Sains-en-Amiénois,1201,30,1231
22,Picardie,80,2,12,697,Saint-Acheul,27,1,28
22,Picardie,80,2,26,698,Saint-Aubin-Montenoy,214,1,215
22,Picardie,80,1,32,699,Saint-Aubin-Rivière,118,1,119
22,Picardie,80,1,40,700,Saint-Blimont,946,18,964
22,Picardie,80,4,30,701,Saint-Christ-Briost,451,8,459
22,Picardie,80,2,13,702,Saint-Fuscien,918,22,940
22,Picardie,80,2,25,703,Saint-Germain-sur-Bresle,182,10,192
22,Picardie,80,2,41,704,Saint-Gratien,356,7,363
22,Picardie,80,2,03,705,Saint-Léger-lès-Authie,90,3,93
22,Picardie,80,2,20,706,Saint-Léger-lès-Domart,1868,18,1886
22,Picardie,80,1,32,707,Saint-Léger-sur-Bresle,80,1,81
22,Picardie,80,3,38,708,Saint-Mard,189,10,199
22,Picardie,80,1,32,709,Saint-Maulvis,256,4,260
22,Picardie,80,1,29,710,Saint-Maxent,399,4,403
22,Picardie,80,2,20,711,Saint-Ouen,2049,16,2065
22,Picardie,80,1,39,713,Saint-Quentin-en-Tourmont,310,9,319
22,Picardie,80,1,11,714,Saint-Quentin-la-Motte-Croix-au-Bailly,1311,26,1337
22,Picardie,80,1,04,716,Saint-Riquier,1262,20,1282
22,Picardie,80,2,13,717,Saint-Sauflieu,874,16,890
22,Picardie,80,2,08,718,Saint-Sauveur,1385,12,1397
22,Picardie,80,2,41,722,Saint-Vaast-en-Chaussée,513,3,516
22,Picardie,80,1,40,721,Saint-Valery-sur-Somme,2785,32,2817
22,Picardie,80,2,35,719,Sainte-Segrée,57,0,57
22,Picardie,80,2,26,723,Saisseval,220,3,223
22,Picardie,80,2,13,724,Saleux,2386,25,2411
22,Picardie,80,2,13,725,Salouël,4548,104,4652
22,Picardie,80,4,24,726,Sancourt,278,12,290
22,Picardie,80,2,35,728,Saulchoy-sous-Poix,50,0,50
22,Picardie,80,3,05,729,Sauvillers-Mongival,187,1,188
22,Picardie,80,2,07,730,Saveuse,726,12,738
22,Picardie,80,1,32,732,Senarpont,695,20,715
22,Picardie,80,2,03,733,Senlis-le-Sec,284,2,286
22,Picardie,80,2,17,734,Sentelie,208,5,213
22,Picardie,80,2,26,735,Seux,165,1,166
22,Picardie,80,4,36,737,Sorel,168,0,168
22,Picardie,80,1,23,736,Sorel-en-Vimeu,222,1,223
22,Picardie,80,2,34,738,Soues,127,1,128
22,Picardie,80,3,05,740,Sourdon,281,6,287
22,Picardie,80,4,15,741,Soyécourt,188,8,196
22,Picardie,80,2,20,742,Surcamps,70,0,70
22,Picardie,80,4,14,743,Suzanne,191,9,200
22,Picardie,80,2,26,744,Tailly,65,1,66
22,Picardie,80,2,41,746,Talmas,1117,20,1137
22,Picardie,80,4,36,747,Templeux-la-Fosse,150,3,153
22,Picardie,80,4,36,748,Templeux-le-Guérard,197,3,200
22,Picardie,80,2,21,749,Terramesnil,276,4,280
22,Picardie,80,4,24,750,Tertry,184,4,188
22,Picardie,80,3,28,751,Thennes,460,5,465
22,Picardie,80,2,13,752,Thézy-Glimont,452,1,453
22,Picardie,80,4,06,753,Thiepval,113,1,114
22,Picardie,80,2,25,754,Thieulloy-l'Abbaye,311,0,311
22,Picardie,80,2,35,755,Thieulloy-la-Ville,105,1,106
22,Picardie,80,2,03,756,Thièvres,57,0,57
22,Picardie,80,2,17,757,Thoix,134,1,135
22,Picardie,80,3,05,758,Thory,163,2,165
22,Picardie,80,3,38,759,Tilloloy,381,12,393
22,Picardie,80,1,22,760,Tilloy-Floriville,372,8,380
22,Picardie,80,2,17,761,Tilloy-lès-Conty,252,5,257
22,Picardie,80,4,36,762,Tincourt-Boucly,401,9,410
22,Picardie,80,1,31,763,Le Titre,376,2,378
22,Picardie,80,1,29,764,Toeufles,280,12,292
22,Picardie,80,1,29,765,Tours-en-Vimeu,872,9,881
22,Picardie,80,2,03,766,Toutencourt,501,10,511
22,Picardie,80,1,22,767,Le Translay,201,2,203
22,Picardie,80,4,14,769,Treux,252,2,254
22,Picardie,80,1,46,770,Tully,634,11,645
22,Picardie,80,4,24,771,Ugny-l'Équipée,41,0,41
22,Picardie,80,2,41,773,Vadencourt,100,1,101
22,Picardie,80,2,18,774,Vaire-sous-Corbie,262,3,265
22,Picardie,80,1,46,775,Valines,637,10,647
22,Picardie,80,2,03,776,Varennes,198,3,201
22,Picardie,80,2,03,777,Vauchelles-lès-Authie,126,4,130
22,Picardie,80,2,20,778,Vauchelles-lès-Domart,129,2,131
22,Picardie,80,1,01,779,Vauchelles-les-Quesnoy,907,19,926
22,Picardie,80,1,46,780,Vaudricourt,425,12,437
22,Picardie,80,4,15,781,Vauvillers,281,1,282
22,Picardie,80,2,41,782,Vaux-en-Amiénois,433,6,439
22,Picardie,80,1,23,783,Vaux-Marquenneville,79,2,81
22,Picardie,80,2,18,784,Vaux-sur-Somme,321,6,327
22,Picardie,80,2,18,785,Vecquemont,548,7,555
22,Picardie,80,2,17,786,Velennes,157,1,158
22,Picardie,80,1,39,787,Vercourt,112,5,117
22,Picardie,80,1,32,788,Vergies,190,1,191
22,Picardie,80,4,15,789,Vermandovillers,119,0,119
22,Picardie,80,3,38,790,Verpillières,168,9,177
22,Picardie,80,2,13,791,Vers-sur-Selles,688,9,697
22,Picardie,80,2,20,792,La Vicogne,261,1,262
22,Picardie,80,2,34,793,Vignacourt,2279,21,2300
22,Picardie,80,2,34,795,Ville-le-Marclet,485,40,525
22,Picardie,80,4,14,807,Ville-sur-Ancre,279,3,282
22,Picardie,80,4,24,794,Villecourt,61,2,63
22,Picardie,80,1,32,796,Villeroy,213,3,216
22,Picardie,80,3,28,797,Villers-aux-Érables,132,1,133
22,Picardie,80,2,41,798,Villers-Bocage,1434,93,1527
22,Picardie,80,2,18,799,Villers-Bretonneux,4185,42,4227
22,Picardie,80,2,25,800,Villers-Campsart,153,1,154
22,Picardie,80,4,33,801,Villers-Carbonnel,307,5,312
22,Picardie,80,4,36,802,Villers-Faucon,665,16,681
22,Picardie,80,3,38,803,Villers-lès-Roye,223,1,224
22,Picardie,80,1,04,804,Villers-sous-Ailly,184,3,187
22,Picardie,80,1,39,806,Villers-sur-Authie,393,13,406
22,Picardie,80,3,27,805,Villers-Tournelle,162,4,166
22,Picardie,80,1,39,808,Vironchaux,425,10,435
22,Picardie,80,1,22,809,Vismes,385,6,391
22,Picardie,80,1,19,810,Vitz-sur-Authie,109,0,109
22,Picardie,80,4,30,811,Voyennes,600,16,616
22,Picardie,80,4,36,812,Vraignes-en-Vermandois,170,0,170
22,Picardie,80,2,25,813,Vraignes-lès-Hornoy,89,2,91
22,Picardie,80,3,37,814,Vrély,455,6,461
22,Picardie,80,1,39,815,Vron,850,17,867
22,Picardie,80,2,20,819,Wargnies,90,1,91
22,Picardie,80,2,18,820,Warloy-Baillon,762,6,768
22,Picardie,80,2,26,821,Warlus,227,2,229
22,Picardie,80,3,27,822,Warsy,114,4,118
22,Picardie,80,3,37,823,Warvillers,126,2,128
22,Picardie,80,3,28,824,Wiencourt-l'Équipée,254,0,254
22,Picardie,80,1,23,825,Wiry-au-Mont,118,6,124
22,Picardie,80,1,11,826,Woignarue,810,12,822
22,Picardie,80,1,46,827,Woincourt,1485,33,1518
22,Picardie,80,1,32,828,Woirel,34,0,34
22,Picardie,80,4,24,829,Y,81,5,86
22,Picardie,80,1,04,830,Yaucourt-Bussus,219,7,226
22,Picardie,80,1,02,836,Yonval,236,4,240
22,Picardie,80,1,19,832,Yvrench,288,8,296
22,Picardie,80,1,19,833,Yvrencheux,152,6,158
22,Picardie,80,1,11,834,Yzengremer,561,41,602
22,Picardie,80,2,34,835,Yzeux,258,7,265
73,Midi-Pyrénées,81,2,10,001,Aguts,222,3,225
73,Midi-Pyrénées,81,2,42,002,Aiguefonde,2710,76,2786
73,Midi-Pyrénées,81,1,01,003,Alban,966,57,1023
73,Midi-Pyrénées,81,1,96,004,Albi,48847,2428,51275
73,Midi-Pyrénées,81,2,28,005,Albine,543,7,550
73,Midi-Pyrénées,81,2,10,006,Algans,213,8,221
73,Midi-Pyrénées,81,1,23,008,Almayrac,292,11,303
73,Midi-Pyrénées,81,1,07,007,Alos,115,1,116
73,Midi-Pyrénées,81,1,09,009,Amarens,68,4,72
73,Midi-Pyrénées,81,1,36,010,Ambialet,442,13,455
73,Midi-Pyrénées,81,2,17,011,Ambres,888,30,918
73,Midi-Pyrénées,81,1,07,012,Andillac,117,1,118
73,Midi-Pyrénées,81,1,32,013,Andouque,390,7,397
73,Midi-Pyrénées,81,2,03,014,Anglès,551,19,570
73,Midi-Pyrénées,81,2,24,015,Appelle,61,4,65
73,Midi-Pyrénées,81,2,11,016,Arfons,187,7,194
73,Midi-Pyrénées,81,2,21,017,Arifat,163,0,163
73,Midi-Pyrénées,81,1,43,018,Arthès,2418,66,2484
73,Midi-Pyrénées,81,1,33,019,Assac,159,1,160
73,Midi-Pyrénées,81,1,05,020,Aussac,271,6,277
73,Midi-Pyrénées,81,2,42,021,Aussillon,6624,184,6808
73,Midi-Pyrénées,81,2,17,022,Bannières,152,4,156
73,Midi-Pyrénées,81,2,22,023,Barre,210,4,214
73,Midi-Pyrénées,81,1,30,024,Beauvais-sur-Tescou,290,11,301
73,Midi-Pyrénées,81,2,17,025,Belcastel,188,9,197
73,Midi-Pyrénées,81,1,36,026,Bellegarde,392,8,400
73,Midi-Pyrénées,81,2,11,027,Belleserre,161,9,170
73,Midi-Pyrénées,81,2,15,028,Berlats,106,5,111
73,Midi-Pyrénées,81,1,12,029,Bernac,164,4,168
73,Midi-Pyrénées,81,2,24,030,Bertre,92,2,94
73,Midi-Pyrénées,81,2,04,031,Le Bez,793,23,816
73,Midi-Pyrénées,81,2,24,032,Blan,950,16,966
73,Midi-Pyrénées,81,1,39,033,Blaye-les-Mines,3068,148,3216
73,Midi-Pyrénées,81,2,19,034,Boissezon,383,9,392
73,Midi-Pyrénées,81,1,09,035,Bournazel,171,6,177
73,Midi-Pyrénées,81,2,28,036,Bout-du-Pont-de-Larn,1039,35,1074
73,Midi-Pyrénées,81,2,04,037,Brassac,1410,32,1442
73,Midi-Pyrénées,81,1,12,038,Brens,2142,57,2199
73,Midi-Pyrénées,81,2,13,039,Briatexte,1863,36,1899
73,Midi-Pyrénées,81,2,16,040,Brousse,316,11,327
73,Midi-Pyrénées,81,1,12,041,Broze,103,2,105
73,Midi-Pyrénées,81,2,27,042,Burlats,1886,62,1948
73,Midi-Pyrénées,81,2,13,043,Busque,714,20,734
73,Midi-Pyrénées,81,2,29,044,Cabanès,202,3,205
73,Midi-Pyrénées,81,1,09,045,Les Cabannes,349,4,353
73,Midi-Pyrénées,81,1,05,046,Cadalen,1399,27,1426
73,Midi-Pyrénées,81,1,33,047,Cadix,233,9,242
73,Midi-Pyrénées,81,1,37,048,Cagnac-les-Mines,2231,51,2282
73,Midi-Pyrénées,81,2,11,049,Cahuzac,343,4,347
73,Midi-Pyrénées,81,1,07,051,Cahuzac-sur-Vère,1026,24,1050
73,Midi-Pyrénées,81,1,36,052,Cambon,1834,53,1887
73,Midi-Pyrénées,81,2,10,050,Cambon-lès-Lavaur,260,3,263
73,Midi-Pyrénées,81,2,04,053,Cambounès,339,9,348
73,Midi-Pyrénées,81,2,24,054,Cambounet-sur-le-Sor,804,22,826
73,Midi-Pyrénées,81,2,11,055,Les Cammazes,319,10,329
73,Midi-Pyrénées,81,1,07,056,Campagnac,101,2,103
73,Midi-Pyrénées,81,2,35,058,Carbes,193,9,202
73,Midi-Pyrénées,81,1,38,059,Carlus,658,12,670
73,Midi-Pyrénées,81,1,97,060,Carmaux,10152,191,10343
73,Midi-Pyrénées,81,1,12,061,Castanet,182,2,184
73,Midi-Pyrénées,81,2,04,062,Castelnau-de-Brassac,779,28,807
73,Midi-Pyrénées,81,1,37,063,Castelnau-de-Lévis,1507,35,1542
73,Midi-Pyrénées,81,1,07,064,Castelnau-de-Montmiral,952,24,976
73,Midi-Pyrénées,81,2,98,065,Castres,43010,1632,44642
73,Midi-Pyrénées,81,2,42,066,Caucalières,328,16,344
73,Midi-Pyrénées,81,1,12,067,Cestayrols,501,14,515
73,Midi-Pyrénées,81,1,20,068,Combefa,143,9,152
73,Midi-Pyrénées,81,1,09,069,Cordes-sur-Ciel,1017,59,1076
73,Midi-Pyrénées,81,1,25,070,Coufouleux,2165,66,2231
73,Midi-Pyrénées,81,1,33,071,Courris,83,1,84
73,Midi-Pyrénées,81,1,32,072,Crespin,118,0,118
73,Midi-Pyrénées,81,1,32,073,Crespinet,144,0,144
73,Midi-Pyrénées,81,1,36,074,Cunac,1404,37,1441
73,Midi-Pyrénées,81,2,35,075,Cuq,477,16,493
73,Midi-Pyrénées,81,2,10,076,Cuq-Toulza,640,9,649
73,Midi-Pyrénées,81,1,01,077,Curvalle,453,14,467
73,Midi-Pyrénées,81,2,29,078,Damiatte,896,19,915
73,Midi-Pyrénées,81,1,26,079,Dénat,720,18,738
73,Midi-Pyrénées,81,1,09,080,Donnazac,90,2,92
73,Midi-Pyrénées,81,2,11,081,Dourgne,1279,55,1334
73,Midi-Pyrénées,81,1,33,082,Le Dourn,129,4,133
73,Midi-Pyrénées,81,2,11,083,Durfort,282,9,291
73,Midi-Pyrénées,81,2,14,084,Escoussens,639,11,650
73,Midi-Pyrénées,81,2,15,085,Escroux,49,2,51
73,Midi-Pyrénées,81,2,15,086,Espérausses,150,4,154
73,Midi-Pyrénées,81,1,26,088,Fauch,479,6,485
73,Midi-Pyrénées,81,1,33,089,Faussergues,138,3,141
73,Midi-Pyrénées,81,1,12,087,Fayssac,348,11,359
73,Midi-Pyrénées,81,1,05,090,Fénols,237,9,246
73,Midi-Pyrénées,81,2,31,091,Ferrières,147,3,150
73,Midi-Pyrénées,81,2,29,092,Fiac,831,25,856
73,Midi-Pyrénées,81,1,05,093,Florentin,681,38,719
73,Midi-Pyrénées,81,1,33,094,Fraissines,92,6,98
73,Midi-Pyrénées,81,1,09,095,Frausseilles,94,1,95
73,Midi-Pyrénées,81,1,36,096,Le Fraysse,388,13,401
73,Midi-Pyrénées,81,1,44,097,Fréjairolles,1271,30,1301
73,Midi-Pyrénées,81,2,35,098,Fréjeville,636,11,647
73,Midi-Pyrénées,81,1,12,099,Gaillac,13127,339,13466
73,Midi-Pyrénées,81,2,11,100,Garrevaques,322,6,328
73,Midi-Pyrénées,81,1,43,101,Le Garric,1130,32,1162
73,Midi-Pyrénées,81,2,17,102,Garrigues,294,13,307
73,Midi-Pyrénées,81,2,15,103,Gijounet,135,2,137
73,Midi-Pyrénées,81,2,17,104,Giroussens,1328,28,1356
73,Midi-Pyrénées,81,2,13,105,Graulhet,12229,279,12508
73,Midi-Pyrénées,81,1,25,106,Grazac,473,11,484
73,Midi-Pyrénées,81,2,35,132,Guitalens-L'Albarède,763,14,777
73,Midi-Pyrénées,81,1,34,108,Itzac,133,2,135
73,Midi-Pyrénées,81,2,16,109,Jonquières,478,11,489
73,Midi-Pyrénées,81,1,23,110,Jouqueviel,98,1,99
73,Midi-Pyrénées,81,1,09,111,Labarthe-Bleys,83,4,87
73,Midi-Pyrénées,81,1,12,112,Labastide-de-Lévis,955,24,979
73,Midi-Pyrénées,81,1,26,113,Labastide-Dénat,361,7,368
73,Midi-Pyrénées,81,1,39,114,Labastide-Gabausse,440,9,449
73,Midi-Pyrénées,81,2,28,115,Labastide-Rouairoux,1605,21,1626
73,Midi-Pyrénées,81,2,17,116,Labastide-Saint-Georges,1658,44,1702
73,Midi-Pyrénées,81,1,05,117,Labessière-Candeil,735,23,758
73,Midi-Pyrénées,81,2,40,118,Laboulbène,142,4,146
73,Midi-Pyrénées,81,1,26,119,Laboutarie,454,5,459
73,Midi-Pyrénées,81,2,14,120,Labruguière,6014,197,6211
73,Midi-Pyrénées,81,2,28,121,Lacabarède,311,7,318
73,Midi-Pyrénées,81,1,33,122,Lacapelle-Pinet,67,0,67
73,Midi-Pyrénées,81,1,09,123,Lacapelle-Ségalar,96,3,99
73,Midi-Pyrénées,81,2,15,124,Lacaune,2690,96,2786
73,Midi-Pyrénées,81,2,31,125,Lacaze,315,6,321
73,Midi-Pyrénées,81,2,17,126,Lacougotte-Cadoul,156,2,158
73,Midi-Pyrénées,81,2,10,127,Lacroisille,138,4,142
73,Midi-Pyrénées,81,2,27,128,Lacrouzette,1764,39,1803
73,Midi-Pyrénées,81,2,11,129,Lagardiolle,226,12,238
73,Midi-Pyrénées,81,2,14,130,Lagarrigue,1726,48,1774
73,Midi-Pyrénées,81,1,12,131,Lagrave,1774,24,1798
73,Midi-Pyrénées,81,1,26,133,Lamillarié,412,6,418
73,Midi-Pyrénées,81,2,03,134,Lamontélarié,61,2,63
73,Midi-Pyrénées,81,1,20,135,Laparrouquial,103,3,106
73,Midi-Pyrénées,81,1,07,136,Larroque,171,3,174
73,Midi-Pyrénées,81,2,03,137,Lasfaillades,73,2,75
73,Midi-Pyrénées,81,1,05,138,Lasgraisses,354,4,358
73,Midi-Pyrénées,81,2,16,139,Lautrec,1722,36,1758
73,Midi-Pyrénées,81,2,17,140,Lavaur,10364,513,10877
73,Midi-Pyrénées,81,1,33,141,Lédas-et-Penthiès,164,2,166
73,Midi-Pyrénées,81,2,24,142,Lempaut,669,16,685
73,Midi-Pyrénées,81,2,24,143,Lescout,534,7,541
73,Midi-Pyrénées,81,1,43,144,Lescure-d'Albigeois,4043,102,4145
73,Midi-Pyrénées,81,1,18,145,Lisle-sur-Tarn,4191,63,4254
73,Midi-Pyrénées,81,1,09,146,Livers-Cazelles,243,3,246
73,Midi-Pyrénées,81,1,26,147,Lombers,985,20,1005
73,Midi-Pyrénées,81,1,09,148,Loubers,96,4,100
73,Midi-Pyrénées,81,1,25,149,Loupiac,358,10,368
73,Midi-Pyrénées,81,2,17,150,Lugan,423,10,433
73,Midi-Pyrénées,81,2,29,151,Magrin,131,6,137
73,Midi-Pyrénées,81,1,37,152,Mailhoc,235,4,239
73,Midi-Pyrénées,81,2,04,153,Le Margnès,46,0,46
73,Midi-Pyrénées,81,1,34,154,Marnaves,81,0,81
73,Midi-Pyrénées,81,1,36,155,Marsal,280,8,288
73,Midi-Pyrénées,81,1,45,156,Marssac-sur-Tarn,2876,58,2934
73,Midi-Pyrénées,81,2,17,157,Marzens,296,17,313
73,Midi-Pyrénées,81,2,31,158,Le Masnau-Massuguiès,310,6,316
73,Midi-Pyrénées,81,2,29,159,Massac-Séran,289,8,297
73,Midi-Pyrénées,81,2,11,160,Massaguel,437,0,437
73,Midi-Pyrénées,81,1,01,161,Massals,125,10,135
73,Midi-Pyrénées,81,2,10,162,Maurens-Scopont,176,2,178
73,Midi-Pyrénées,81,2,99,163,Mazamet,9963,459,10422
73,Midi-Pyrénées,81,1,25,164,Mézens,403,15,418
73,Midi-Pyrénées,81,1,34,165,Milhars,262,6,268
73,Midi-Pyrénées,81,1,37,166,Milhavet,85,2,87
73,Midi-Pyrénées,81,1,01,167,Miolles,106,2,108
73,Midi-Pyrénées,81,1,23,168,Mirandol-Bourgnounac,1071,21,1092
73,Midi-Pyrénées,81,2,13,169,Missècle,93,1,94
73,Midi-Pyrénées,81,1,20,170,Monestiés,1302,30,1332
73,Midi-Pyrénées,81,2,21,183,Mont-Roc,183,2,185
73,Midi-Pyrénées,81,1,12,171,Montans,1294,28,1322
73,Midi-Pyrénées,81,1,23,172,Montauriol,53,0,53
73,Midi-Pyrénées,81,2,17,173,Montcabrier,223,0,223
73,Midi-Pyrénées,81,2,16,174,Montdragon,599,6,605
73,Midi-Pyrénées,81,1,30,175,Montdurausse,312,4,316
73,Midi-Pyrénées,81,1,07,176,Montels,109,3,112
73,Midi-Pyrénées,81,2,27,177,Montfa,341,9,350
73,Midi-Pyrénées,81,1,30,178,Montgaillard,330,13,343
73,Midi-Pyrénées,81,2,10,179,Montgey,266,9,275
73,Midi-Pyrénées,81,1,20,180,Montirat,264,6,270
73,Midi-Pyrénées,81,2,16,181,Montpinier,166,5,171
73,Midi-Pyrénées,81,2,21,182,Montredon-Labessonnié,2054,53,2107
73,Midi-Pyrénées,81,1,34,184,Montrosier,30,0,30
73,Midi-Pyrénées,81,1,30,185,Montvalen,208,12,220
73,Midi-Pyrénées,81,1,23,186,Moularès,277,12,289
73,Midi-Pyrénées,81,2,13,187,Moulayrès,165,2,167
73,Midi-Pyrénées,81,2,22,188,Moulin-Mage,328,14,342
73,Midi-Pyrénées,81,2,10,189,Mouzens,127,3,130
73,Midi-Pyrénées,81,1,09,191,Mouzieys-Panens,210,7,217
73,Midi-Pyrénées,81,1,36,190,Mouzieys-Teulet,423,6,429
73,Midi-Pyrénées,81,2,22,192,Murat-sur-Vèbre,848,22,870
73,Midi-Pyrénées,81,2,22,193,Nages,341,9,350
73,Midi-Pyrénées,81,2,46,195,Navès,715,35,750
73,Midi-Pyrénées,81,2,14,196,Noailhac,817,24,841
73,Midi-Pyrénées,81,1,09,197,Noailles,186,4,190
73,Midi-Pyrénées,81,1,26,198,Orban,311,4,315
73,Midi-Pyrénées,81,1,33,199,Padiès,192,8,200
73,Midi-Pyrénées,81,2,11,200,Palleville,417,60,477
73,Midi-Pyrénées,81,1,23,201,Pampelonne,711,13,724
73,Midi-Pyrénées,81,1,18,202,Parisot,811,18,829
73,Midi-Pyrénées,81,1,01,203,Paulinet,544,18,562
73,Midi-Pyrénées,81,2,19,204,Payrin-Augmontel,2164,75,2239
73,Midi-Pyrénées,81,2,10,205,Péchaudier,193,3,196
73,Midi-Pyrénées,81,1,34,206,Penne,556,10,566
73,Midi-Pyrénées,81,2,16,207,Peyregoux,92,32,124
73,Midi-Pyrénées,81,1,18,208,Peyrole,471,12,483
73,Midi-Pyrénées,81,2,19,209,Pont-de-Larn,2879,91,2970
73,Midi-Pyrénées,81,2,24,210,Poudis,214,2,216
73,Midi-Pyrénées,81,1,26,211,Poulan-Pouzols,432,6,438
73,Midi-Pyrénées,81,2,29,212,Prades,139,4,143
73,Midi-Pyrénées,81,2,29,213,Pratviel,89,0,89
73,Midi-Pyrénées,81,2,10,214,Puéchoursi,89,5,94
73,Midi-Pyrénées,81,2,13,215,Puybegon,555,6,561
73,Midi-Pyrénées,81,2,16,216,Puycalvel,200,4,204
73,Midi-Pyrénées,81,1,07,217,Puycelci,490,11,501
73,Midi-Pyrénées,81,1,38,218,Puygouzon,2859,94,2953
73,Midi-Pyrénées,81,2,24,219,Puylaurens,3043,97,3140
73,Midi-Pyrénées,81,1,25,220,Rabastens,4892,129,5021
73,Midi-Pyrénées,81,2,21,221,Rayssac,260,3,263
73,Midi-Pyrénées,81,1,26,222,Réalmont,3245,60,3305
73,Midi-Pyrénées,81,2,19,223,Le Rialet,47,0,47
73,Midi-Pyrénées,81,1,34,224,Le Riols,113,4,117
73,Midi-Pyrénées,81,1,12,225,Rivières,914,14,928
73,Midi-Pyrénées,81,1,26,226,Ronel,230,2,232
73,Midi-Pyrénées,81,2,27,227,Roquecourbe,2233,43,2276
73,Midi-Pyrénées,81,1,25,228,Roquemaure,362,6,368
73,Midi-Pyrénées,81,2,10,229,Roquevidal,121,1,122
73,Midi-Pyrénées,81,1,06,230,Rosières,741,16,757
73,Midi-Pyrénées,81,2,28,231,Rouairoux,376,5,381
73,Midi-Pyrénées,81,1,38,232,Rouffiac,559,16,575
73,Midi-Pyrénées,81,1,26,233,Roumégoux,238,3,241
73,Midi-Pyrénées,81,1,34,234,Roussayrolles,70,2,72
73,Midi-Pyrénées,81,2,14,235,Saint-Affrique-les-Montagnes,698,25,723
73,Midi-Pyrénées,81,2,17,236,Saint-Agnan,225,11,236
73,Midi-Pyrénées,81,2,11,237,Saint-Amancet,171,5,176
73,Midi-Pyrénées,81,2,28,238,Saint-Amans-Soult,1677,82,1759
73,Midi-Pyrénées,81,2,28,239,Saint-Amans-Valtoret,907,29,936
73,Midi-Pyrénées,81,1,01,240,Saint-André,101,5,106
73,Midi-Pyrénées,81,1,26,241,Saint-Antonin-de-Lacalm,246,4,250
73,Midi-Pyrénées,81,2,11,242,Saint-Avit,236,7,243
73,Midi-Pyrénées,81,1,07,243,Saint-Beauzile,115,1,116
73,Midi-Pyrénées,81,1,06,244,Saint-Benoît-de-Carmaux,2137,18,2155
73,Midi-Pyrénées,81,1,20,245,Saint-Christophe,127,3,130
73,Midi-Pyrénées,81,1,33,247,Saint-Cirgue,220,7,227
73,Midi-Pyrénées,81,2,13,248,Saint-Gauzens,752,16,768
73,Midi-Pyrénées,81,2,16,250,Saint-Genest-de-Contest,245,2,247
73,Midi-Pyrénées,81,2,24,251,Saint-Germain-des-Prés,808,25,833
73,Midi-Pyrénées,81,2,27,252,Saint-Germier,132,8,140
73,Midi-Pyrénées,81,1,32,253,Saint-Grégoire,422,7,429
73,Midi-Pyrénées,81,1,32,254,Saint-Jean-de-Marcel,334,3,337
73,Midi-Pyrénées,81,2,17,255,Saint-Jean-de-Rives,368,13,381
73,Midi-Pyrénées,81,2,27,256,Saint-Jean-de-Vals,64,0,64
73,Midi-Pyrénées,81,1,36,257,Saint-Juéry,6967,124,7091
73,Midi-Pyrénées,81,2,16,258,Saint-Julien-du-Puy,387,6,393
73,Midi-Pyrénées,81,1,33,259,Saint-Julien-Gaulène,194,3,197
73,Midi-Pyrénées,81,1,26,260,Saint-Lieux-Lafenasse,450,4,454
73,Midi-Pyrénées,81,2,17,261,Saint-Lieux-lès-Lavaur,842,12,854
73,Midi-Pyrénées,81,1,09,262,Saint-Marcel-Campes,249,1,250
73,Midi-Pyrénées,81,1,09,263,Saint-Martin-Laguépie,441,12,453
73,Midi-Pyrénées,81,1,34,265,Saint-Michel-de-Vax,65,4,69
73,Midi-Pyrénées,81,1,33,264,Saint-Michel-Labadié,90,3,93
73,Midi-Pyrénées,81,2,29,266,Saint-Paul-Cap-de-Joux,1049,18,1067
73,Midi-Pyrénées,81,2,31,267,Saint-Pierre-de-Trivisy,625,7,632
73,Midi-Pyrénées,81,2,31,268,Saint-Salvi-de-Carcavès,90,1,91
73,Midi-Pyrénées,81,2,19,269,Saint-Salvy-de-la-Balme,567,13,580
73,Midi-Pyrénées,81,2,24,270,Saint-Sernin-lès-Lavaur,125,2,127
73,Midi-Pyrénées,81,2,17,271,Saint-Sulpice,7766,203,7969
73,Midi-Pyrénées,81,1,30,272,Saint-Urcisse,226,3,229
73,Midi-Pyrénées,81,1,07,246,Sainte-Cécile-du-Cayrou,119,2,121
73,Midi-Pyrénées,81,1,37,326,Sainte-Croix,340,12,352
73,Midi-Pyrénées,81,1,23,249,Sainte-Gemme,788,15,803
73,Midi-Pyrénées,81,2,46,273,Saïx,3314,118,3432
73,Midi-Pyrénées,81,1,38,274,Saliès,774,17,791
73,Midi-Pyrénées,81,1,20,275,Salles,194,4,198
73,Midi-Pyrénées,81,1,30,276,Salvagnac,1045,27,1072
73,Midi-Pyrénées,81,1,32,277,Saussenac,482,19,501
73,Midi-Pyrénées,81,2,28,278,Sauveterre,176,3,179
73,Midi-Pyrénées,81,1,30,279,La Sauzière-Saint-Jean,218,5,223
73,Midi-Pyrénées,81,1,20,280,Le Ségur,245,3,248
73,Midi-Pyrénées,81,2,35,281,Sémalens,1988,52,2040
73,Midi-Pyrénées,81,2,15,282,Senaux,41,1,42
73,Midi-Pyrénées,81,1,12,283,Senouillac,1020,36,1056
73,Midi-Pyrénées,81,1,38,284,Le Sequestre,1570,59,1629
73,Midi-Pyrénées,81,1,32,285,Sérénac,487,5,492
73,Midi-Pyrénées,81,2,35,286,Serviès,603,11,614
73,Midi-Pyrénées,81,1,26,287,Sieurac,204,4,208
73,Midi-Pyrénées,81,2,11,288,Sorèze,2557,59,2616
73,Midi-Pyrénées,81,2,11,289,Soual,2207,27,2234
73,Midi-Pyrénées,81,1,09,290,Souel,175,2,177
73,Midi-Pyrénées,81,1,39,291,Taïx,327,5,332
73,Midi-Pyrénées,81,1,23,292,Tanus,525,13,538
73,Midi-Pyrénées,81,1,30,293,Tauriac,236,3,239
73,Midi-Pyrénées,81,1,05,294,Técou,823,14,837
73,Midi-Pyrénées,81,1,01,295,Teillet,457,8,465
73,Midi-Pyrénées,81,1,26,296,Terre-Clapier,241,9,250
73,Midi-Pyrénées,81,1,45,297,Terssac,1004,16,1020
73,Midi-Pyrénées,81,2,17,298,Teulat,453,14,467
73,Midi-Pyrénées,81,2,29,299,Teyssode,349,13,362
73,Midi-Pyrénées,81,1,09,300,Tonnac,126,1,127
73,Midi-Pyrénées,81,1,26,301,Le Travet,131,3,134
73,Midi-Pyrénées,81,1,23,302,Tréban,45,1,46
73,Midi-Pyrénées,81,1,33,303,Trébas,412,18,430
73,Midi-Pyrénées,81,1,20,304,Trévien,191,4,195
73,Midi-Pyrénées,81,2,31,305,Vabre,819,18,837
73,Midi-Pyrénées,81,1,32,306,Valderiès,882,15,897
73,Midi-Pyrénées,81,2,14,307,Valdurenque,765,15,780
73,Midi-Pyrénées,81,1,33,308,Valence-d'Albigeois,1274,16,1290
73,Midi-Pyrénées,81,1,34,309,Vaour,300,8,308
73,Midi-Pyrénées,81,2,17,310,Veilhes,113,2,115
73,Midi-Pyrénées,81,2,16,311,Vénès,710,18,728
73,Midi-Pyrénées,81,2,11,312,Verdalle,961,201,1162
73,Midi-Pyrénées,81,1,07,313,Le Verdier,231,7,238
73,Midi-Pyrénées,81,2,15,314,Viane,613,60,673
73,Midi-Pyrénées,81,2,35,315,Vielmur-sur-Agout,1375,24,1399
73,Midi-Pyrénées,81,1,07,316,Vieux,173,3,176
73,Midi-Pyrénées,81,1,36,317,Villefranche-d'Albigeois,1058,17,1075
73,Midi-Pyrénées,81,2,17,318,Villeneuve-lès-Lavaur,138,3,141
73,Midi-Pyrénées,81,1,37,319,Villeneuve-sur-Vère,436,5,441
73,Midi-Pyrénées,81,1,09,320,Vindrac-Alayrac,148,6,154
73,Midi-Pyrénées,81,2,19,321,Le Vintrou,84,1,85
73,Midi-Pyrénées,81,1,20,322,Virac,230,4,234
73,Midi-Pyrénées,81,2,29,323,Viterbe,352,9,361
73,Midi-Pyrénées,81,2,17,324,Viviers-lès-Lavaur,174,10,184
73,Midi-Pyrénées,81,2,14,325,Viviers-lès-Montagnes,1681,51,1732
73,Midi-Pyrénées,82,1,25,001,Albefeuille-Lagarde,642,21,663
73,Midi-Pyrénées,82,2,19,002,Albias,2656,46,2702
73,Midi-Pyrénées,82,1,21,003,Angeville,197,6,203
73,Midi-Pyrénées,82,1,10,004,Asques,130,3,133
73,Midi-Pyrénées,82,2,23,005,Aucamville,963,22,985
73,Midi-Pyrénées,82,1,02,006,Auterive,60,1,61
73,Midi-Pyrénées,82,2,12,007,Auty,114,3,117
73,Midi-Pyrénées,82,1,01,008,Auvillar,968,59,1027
73,Midi-Pyrénées,82,1,10,009,Balignac,27,0,27
73,Midi-Pyrénées,82,1,01,010,Bardigues,257,8,265
73,Midi-Pyrénées,82,1,25,011,Barry-d'Islemade,816,10,826
73,Midi-Pyrénées,82,1,25,012,Les Barthes,465,15,480
73,Midi-Pyrénées,82,1,02,013,Beaumont-de-Lomagne,3771,244,4015
73,Midi-Pyrénées,82,2,23,014,Beaupuy,286,1,287
73,Midi-Pyrénées,82,1,02,015,Belbèse,109,0,109
73,Midi-Pyrénées,82,1,14,016,Belvèze,212,8,220
73,Midi-Pyrénées,82,2,07,017,Bessens,1195,8,1203
73,Midi-Pyrénées,82,2,19,018,Bioule,952,21,973
73,Midi-Pyrénées,82,1,11,019,Boudou,667,17,684
73,Midi-Pyrénées,82,2,23,020,Bouillac,531,13,544
73,Midi-Pyrénées,82,1,09,021,Bouloc,222,4,226
73,Midi-Pyrénées,82,1,03,022,Bourg-de-Visa,403,12,415
73,Midi-Pyrénées,82,2,23,023,Bourret,702,9,711
73,Midi-Pyrénées,82,1,03,024,Brassac,265,4,269
73,Midi-Pyrénées,82,2,17,025,Bressols,3536,76,3612
73,Midi-Pyrénées,82,2,13,026,Bruniquel,580,23,603
73,Midi-Pyrénées,82,2,07,027,Campsas,1139,34,1173
73,Midi-Pyrénées,82,2,07,028,Canals,630,7,637
73,Midi-Pyrénées,82,2,20,029,Castanet,235,2,237
73,Midi-Pyrénées,82,1,21,030,Castelferrus,434,17,451
73,Midi-Pyrénées,82,1,21,031,Castelmayran,1085,13,1098
73,Midi-Pyrénées,82,1,22,032,Castelsagrat,539,13,552
73,Midi-Pyrénées,82,1,97,033,Castelsarrasin,12964,492,13456
73,Midi-Pyrénées,82,1,10,034,Castéra-Bouzet,118,1,119
73,Midi-Pyrénées,82,1,21,035,Caumont,316,2,318
73,Midi-Pyrénées,82,1,02,036,Le Causé,166,1,167
73,Midi-Pyrénées,82,2,05,037,Caussade,6547,224,6771
73,Midi-Pyrénées,82,2,06,038,Caylus,1536,30,1566
73,Midi-Pyrénées,82,2,05,039,Cayrac,478,5,483
73,Midi-Pyrénées,82,2,05,040,Cayriech,266,12,278
73,Midi-Pyrénées,82,2,20,041,Cazals,223,6,229
73,Midi-Pyrénées,82,1,09,042,Cazes-Mondenard,1185,23,1208
73,Midi-Pyrénées,82,2,23,043,Comberouger,306,2,308
73,Midi-Pyrénées,82,2,24,044,Corbarieu,1526,24,1550
73,Midi-Pyrénées,82,1,21,045,Cordes-Tolosannes,257,7,264
73,Midi-Pyrénées,82,1,21,046,Coutures,103,0,103
73,Midi-Pyrénées,82,1,02,047,Cumont,65,0,65
73,Midi-Pyrénées,82,2,07,048,Dieupentale,1261,17,1278
73,Midi-Pyrénées,82,1,01,049,Donzac,1021,15,1036
73,Midi-Pyrénées,82,1,01,050,Dunes,1117,10,1127
73,Midi-Pyrénées,82,1,09,051,Durfort-Lacapelette,775,99,874
73,Midi-Pyrénées,82,2,17,052,Escatalens,997,66,1063
73,Midi-Pyrénées,82,1,02,053,Escazeaux,282,10,292
73,Midi-Pyrénées,82,1,22,054,Espalais,408,12,420
73,Midi-Pyrénées,82,1,02,055,Esparsac,248,8,256
73,Midi-Pyrénées,82,2,06,056,Espinas,179,9,188
73,Midi-Pyrénées,82,2,07,057,Fabas,491,11,502
73,Midi-Pyrénées,82,1,21,058,Fajolles,106,0,106
73,Midi-Pyrénées,82,1,02,059,Faudoas,291,8,299
73,Midi-Pyrénées,82,1,03,060,Fauroux,213,5,218
73,Midi-Pyrénées,82,2,20,061,Féneyrols,176,8,184
73,Midi-Pyrénées,82,2,17,062,Finhan,1320,28,1348
73,Midi-Pyrénées,82,1,21,063,Garganvillar,601,7,608
73,Midi-Pyrénées,82,1,02,064,Gariès,101,5,106
73,Midi-Pyrénées,82,1,22,065,Gasques,405,15,420
73,Midi-Pyrénées,82,2,13,066,Génébrières,603,12,615
73,Midi-Pyrénées,82,1,10,067,Gensac,108,3,111
73,Midi-Pyrénées,82,1,02,068,Gimat,172,6,178
73,Midi-Pyrénées,82,2,20,069,Ginals,197,4,201
73,Midi-Pyrénées,82,1,02,070,Glatens,56,0,56
73,Midi-Pyrénées,82,1,02,071,Goas,38,0,38
73,Midi-Pyrénées,82,1,22,072,Golfech,848,28,876
73,Midi-Pyrénées,82,1,22,073,Goudourville,897,30,927
73,Midi-Pyrénées,82,1,10,074,Gramont,154,7,161
73,Midi-Pyrénées,82,2,07,075,Grisolles,3366,44,3410
73,Midi-Pyrénées,82,2,08,076,L' Honor-de-Cos,1578,38,1616
73,Midi-Pyrénées,82,2,12,077,Labarthe,369,3,372
73,Midi-Pyrénées,82,2,18,078,Labastide-de-Penne,129,2,131
73,Midi-Pyrénées,82,1,25,080,Labastide-du-Temple,1041,42,1083
73,Midi-Pyrénées,82,2,07,079,Labastide-Saint-Pierre,3503,85,3588
73,Midi-Pyrénées,82,1,21,081,Labourgade,172,4,176
73,Midi-Pyrénées,82,2,06,082,Lacapelle-Livron,188,6,194
73,Midi-Pyrénées,82,1,10,083,Lachapelle,115,3,118
73,Midi-Pyrénées,82,1,03,084,Lacour,186,2,188
73,Midi-Pyrénées,82,2,17,085,Lacourt-Saint-Pierre,1047,20,1067
73,Midi-Pyrénées,82,1,21,086,Lafitte,231,6,237
73,Midi-Pyrénées,82,2,08,087,Lafrançaise,2817,98,2915
73,Midi-Pyrénées,82,2,20,088,Laguépie,740,10,750
73,Midi-Pyrénées,82,1,22,089,Lamagistère,1235,15,1250
73,Midi-Pyrénées,82,2,15,090,Lamothe-Capdeville,972,63,1035
73,Midi-Pyrénées,82,1,02,091,Lamothe-Cumont,115,2,117
73,Midi-Pyrénées,82,2,18,092,Lapenche,168,3,171
73,Midi-Pyrénées,82,1,02,093,Larrazet,613,5,618
73,Midi-Pyrénées,82,1,09,094,Lauzerte,1505,31,1536
73,Midi-Pyrénées,82,2,05,095,Lavaurette,213,8,221
73,Midi-Pyrénées,82,1,10,097,Lavit,1529,29,1558
73,Midi-Pyrénées,82,2,27,098,Léojac,1090,34,1124
73,Midi-Pyrénées,82,1,26,099,Lizac,455,3,458
73,Midi-Pyrénées,82,2,06,100,Loze,128,4,132
73,Midi-Pyrénées,82,1,11,101,Malause,981,27,1008
73,Midi-Pyrénées,82,1,10,102,Mansonville,267,3,270
73,Midi-Pyrénées,82,1,02,103,Marignac,98,4,102
73,Midi-Pyrénées,82,1,10,104,Marsac,189,1,190
73,Midi-Pyrénées,82,2,23,105,Mas-Grenier,1099,16,1115
73,Midi-Pyrénées,82,1,02,106,Maubec,142,8,150
73,Midi-Pyrénées,82,1,10,107,Maumusson,46,0,46
73,Midi-Pyrénées,82,1,25,108,Meauzac,1055,24,1079
73,Midi-Pyrénées,82,1,01,109,Merles,245,6,251
73,Midi-Pyrénées,82,2,05,110,Mirabel,973,11,984
73,Midi-Pyrénées,82,1,03,111,Miramont-de-Quercy,340,8,348
73,Midi-Pyrénées,82,1,98,112,Moissac,12290,465,12755
73,Midi-Pyrénées,82,2,12,113,Molières,1087,17,1104
73,Midi-Pyrénées,82,2,07,114,Monbéqui,573,3,576
73,Midi-Pyrénées,82,2,13,115,Monclar-de-Quercy,1623,27,1650
73,Midi-Pyrénées,82,1,09,116,Montagudet,174,4,178
73,Midi-Pyrénées,82,1,14,117,Montaigu-de-Quercy,1415,42,1457
73,Midi-Pyrénées,82,1,21,118,Montaïn,101,1,102
73,Midi-Pyrénées,82,2,18,119,Montalzat,600,9,609
73,Midi-Pyrénées,82,2,08,120,Montastruc,272,12,284
73,Midi-Pyrénées,82,2,99,121,Montauban,55974,1791,57765
73,Midi-Pyrénées,82,1,09,122,Montbarla,171,3,174
73,Midi-Pyrénées,82,2,17,123,Montbartier,1213,27,1240
73,Midi-Pyrénées,82,2,17,124,Montbeton,3448,100,3548
73,Midi-Pyrénées,82,2,17,125,Montech,5308,82,5390
73,Midi-Pyrénées,82,2,05,126,Monteils,1274,27,1301
73,Midi-Pyrénées,82,1,26,127,Montesquieu,759,19,778
73,Midi-Pyrénées,82,2,18,128,Montfermier,109,0,109
73,Midi-Pyrénées,82,1,10,129,Montgaillard,88,2,90
73,Midi-Pyrénées,82,1,22,130,Montjoi,182,1,183
73,Midi-Pyrénées,82,2,18,131,Montpezat-de-Quercy,1442,24,1466
73,Midi-Pyrénées,82,2,19,132,Montricoux,1045,18,1063
73,Midi-Pyrénées,82,2,06,133,Mouillac,79,2,81
73,Midi-Pyrénées,82,2,19,134,Nègrepelisse,4799,77,4876
73,Midi-Pyrénées,82,2,07,135,Nohic,1145,23,1168
73,Midi-Pyrénées,82,2,07,136,Orgueil,1335,19,1354
73,Midi-Pyrénées,82,2,20,137,Parisot,545,14,559
73,Midi-Pyrénées,82,1,22,138,Perville,109,3,112
73,Midi-Pyrénées,82,1,01,139,Le Pin,118,2,120
73,Midi-Pyrénées,82,2,08,140,Piquecos,372,10,382
73,Midi-Pyrénées,82,1,22,141,Pommevic,517,9,526
73,Midi-Pyrénées,82,2,07,142,Pompignan,1328,11,1339
73,Midi-Pyrénées,82,1,10,143,Poupas,91,1,92
73,Midi-Pyrénées,82,2,12,144,Puycornet,634,9,643
73,Midi-Pyrénées,82,1,10,146,Puygaillard-de-Lomagne,58,1,59
73,Midi-Pyrénées,82,2,13,145,Puygaillard-de-Quercy,324,4,328
73,Midi-Pyrénées,82,2,06,147,Puylagarde,341,8,349
73,Midi-Pyrénées,82,2,18,148,Puylaroque,656,13,669
73,Midi-Pyrénées,82,2,05,149,Réalville,1799,54,1853
73,Midi-Pyrénées,82,2,24,150,Reyniès,882,12,894
73,Midi-Pyrénées,82,1,14,151,Roquecor,454,6,460
73,Midi-Pyrénées,82,1,21,152,Saint-Aignan,414,11,425
73,Midi-Pyrénées,82,1,09,154,Saint-Amans-de-Pellagal,239,3,242
73,Midi-Pyrénées,82,1,14,153,Saint-Amans-du-Pech,189,4,193
73,Midi-Pyrénées,82,2,20,155,Saint-Antonin-Noble-Val,1791,36,1827
73,Midi-Pyrénées,82,1,21,156,Saint-Arroumex,141,1,142
73,Midi-Pyrénées,82,1,14,157,Saint-Beauzeil,121,0,121
73,Midi-Pyrénées,82,1,01,158,Saint-Cirice,166,3,169
73,Midi-Pyrénées,82,2,05,159,Saint-Cirq,443,15,458
73,Midi-Pyrénées,82,1,22,160,Saint-Clair,243,7,250
73,Midi-Pyrénées,82,2,19,161,Saint-Étienne-de-Tulmont,3297,61,3358
73,Midi-Pyrénées,82,2,05,162,Saint-Georges,204,4,208
73,Midi-Pyrénées,82,1,10,163,Saint-Jean-du-Bouzet,66,2,68
73,Midi-Pyrénées,82,1,01,165,Saint-Loup,469,17,486
73,Midi-Pyrénées,82,1,01,166,Saint-Michel,248,9,257
73,Midi-Pyrénées,82,2,24,167,Saint-Nauphary,1672,17,1689
73,Midi-Pyrénées,82,1,03,168,Saint-Nazaire-de-Valentane,331,7,338
73,Midi-Pyrénées,82,1,21,169,Saint-Nicolas-de-la-Grave,2153,62,2215
73,Midi-Pyrénées,82,1,11,170,Saint-Paul-d'Espis,604,16,620
73,Midi-Pyrénées,82,2,17,171,Saint-Porquier,1318,19,1337
73,Midi-Pyrénées,82,2,06,172,Saint-Projet,292,4,296
73,Midi-Pyrénées,82,2,23,173,Saint-Sardos,818,15,833
73,Midi-Pyrénées,82,2,05,174,Saint-Vincent,312,5,317
73,Midi-Pyrénées,82,1,11,175,Saint-Vincent-Lespinasse,225,6,231
73,Midi-Pyrénées,82,1,09,164,Sainte-Juliette,117,5,122
73,Midi-Pyrénées,82,2,13,176,La Salvetat-Belmontet,580,20,600
73,Midi-Pyrénées,82,1,09,177,Sauveterre,167,2,169
73,Midi-Pyrénées,82,2,23,178,Savenès,699,10,709
73,Midi-Pyrénées,82,2,05,179,Septfonds,2090,34,2124
73,Midi-Pyrénées,82,1,02,180,Sérignac,494,13,507
73,Midi-Pyrénées,82,1,01,181,Sistels,191,2,193
73,Midi-Pyrénées,82,1,03,182,Touffailles,388,6,394
73,Midi-Pyrénées,82,1,09,183,Tréjouls,260,7,267
73,Midi-Pyrénées,82,2,19,184,Vaïssac,735,16,751
73,Midi-Pyrénées,82,1,14,185,Valeilles,235,1,236
73,Midi-Pyrénées,82,1,22,186,Valence,5092,186,5278
73,Midi-Pyrénées,82,2,20,187,Varen,712,17,729
73,Midi-Pyrénées,82,2,24,188,Varennes,583,10,593
73,Midi-Pyrénées,82,2,12,189,Vazerac,732,6,738
73,Midi-Pyrénées,82,2,23,190,Verdun-sur-Garonne,4017,66,4083
73,Midi-Pyrénées,82,2,20,191,Verfeil,325,5,330
73,Midi-Pyrénées,82,2,24,192,Verlhac-Tescou,447,11,458
73,Midi-Pyrénées,82,1,02,193,Vigueron,117,1,118
73,Midi-Pyrénées,82,2,17,096,La Ville-Dieu-du-Temple,2683,67,2750
73,Midi-Pyrénées,82,2,24,194,Villebrumier,1227,24,1251
73,Midi-Pyrénées,82,2,15,195,Villemade,685,23,708
93,Provence-Alpes-Côte d'Azur,83,1,13,001,Les Adrets-de-l'Estérel,2683,69,2752
93,Provence-Alpes-Côte d'Azur,83,3,01,002,Aiguines,255,2,257
93,Provence-Alpes-Côte d'Azur,83,1,11,003,Ampus,871,18,889
93,Provence-Alpes-Côte d'Azur,83,1,16,004,Les Arcs,6212,164,6376
93,Provence-Alpes-Côte d'Azur,83,3,26,005,Artignosc-sur-Verdon,275,13,288
93,Provence-Alpes-Côte d'Azur,83,3,19,006,Artigues,211,2,213
93,Provence-Alpes-Côte d'Azur,83,3,01,007,Aups,2065,63,2128
93,Provence-Alpes-Côte d'Azur,83,1,13,008,Bagnols-en-Forêt,2283,29,2312
93,Provence-Alpes-Côte d'Azur,83,2,18,009,Bandol,8769,112,8881
93,Provence-Alpes-Côte d'Azur,83,1,08,010,Bargème,141,2,143
93,Provence-Alpes-Côte d'Azur,83,1,06,011,Bargemon,1464,28,1492
93,Provence-Alpes-Côte d'Azur,83,3,02,012,Barjols,3034,47,3081
93,Provence-Alpes-Côte d'Azur,83,1,08,013,La Bastide,190,3,193
93,Provence-Alpes-Côte d'Azur,83,3,01,014,Baudinard-sur-Verdon,163,5,168
93,Provence-Alpes-Côte d'Azur,83,3,01,015,Bauduen,317,10,327
93,Provence-Alpes-Côte d'Azur,83,2,03,016,Le Beausset,8972,159,9131
93,Provence-Alpes-Côte d'Azur,83,2,25,017,Belgentier,2398,33,2431
93,Provence-Alpes-Côte d'Azur,83,3,04,018,Besse-sur-Issole,2793,26,2819
93,Provence-Alpes-Côte d'Azur,83,2,07,019,Bormes-les-Mimosas,7255,106,7361
93,Provence-Alpes-Côte d'Azur,83,1,08,020,Le Bourguet,24,0,24
93,Provence-Alpes-Côte d'Azur,83,3,02,021,Bras,2281,35,2316
93,Provence-Alpes-Côte d'Azur,83,1,08,022,Brenon,26,2,28
93,Provence-Alpes-Côte d'Azur,83,3,05,023,Brignoles,15912,423,16335
93,Provence-Alpes-Côte d'Azur,83,3,02,025,Brue-Auriac,1161,29,1190
93,Provence-Alpes-Côte d'Azur,83,3,04,026,Cabasse,1830,34,1864
93,Provence-Alpes-Côte d'Azur,83,2,03,027,La Cadière-d'Azur,5264,91,5355
93,Provence-Alpes-Côte d'Azur,83,1,06,028,Callas,1776,26,1802
93,Provence-Alpes-Côte d'Azur,83,1,12,029,Callian,3049,61,3110
93,Provence-Alpes-Côte d'Azur,83,3,05,030,Camps-la-Source,1586,33,1619
93,Provence-Alpes-Côte d'Azur,83,1,17,031,Le Cannet-des-Maures,3954,82,4036
93,Provence-Alpes-Côte d'Azur,83,3,09,032,Carcès,3128,52,3180
93,Provence-Alpes-Côte d'Azur,83,2,10,033,Carnoules,3182,41,3223
93,Provence-Alpes-Côte d'Azur,83,2,36,034,Carqueiranne,9779,174,9953
93,Provence-Alpes-Côte d'Azur,83,2,03,035,Le Castellet,4255,79,4334
93,Provence-Alpes-Côte d'Azur,83,1,22,036,Cavalaire-sur-Mer,6667,119,6786
93,Provence-Alpes-Côte d'Azur,83,3,05,037,La Celle,1278,80,1358
93,Provence-Alpes-Côte d'Azur,83,1,06,038,Châteaudouble,468,10,478
93,Provence-Alpes-Côte d'Azur,83,3,02,039,Châteauvert,128,31,159
93,Provence-Alpes-Côte d'Azur,83,1,08,040,Châteauvieux,71,0,71
93,Provence-Alpes-Côte d'Azur,83,1,06,041,Claviers,633,16,649
93,Provence-Alpes-Côte d'Azur,83,1,14,042,Cogolin,11104,190,11294
93,Provence-Alpes-Côte d'Azur,83,2,07,043,Collobrières,1796,82,1878
93,Provence-Alpes-Côte d'Azur,83,1,08,044,Comps-sur-Artuby,324,10,334
93,Provence-Alpes-Côte d'Azur,83,3,09,045,Correns,792,22,814
93,Provence-Alpes-Côte d'Azur,83,3,09,046,Cotignac,2152,69,2221
93,Provence-Alpes-Côte d'Azur,83,2,36,047,La Crau,16356,459,16815
93,Provence-Alpes-Côte d'Azur,83,1,22,048,La Croix-Valmer,3273,131,3404
93,Provence-Alpes-Côte d'Azur,83,2,10,049,Cuers,9933,134,10067
93,Provence-Alpes-Côte d'Azur,83,1,11,050,Draguignan,36648,1001,37649
93,Provence-Alpes-Côte d'Azur,83,3,09,051,Entrecasteaux,1017,8,1025
93,Provence-Alpes-Côte d'Azur,83,3,02,052,Esparron,283,5,288
93,Provence-Alpes-Côte d'Azur,83,2,18,053,Évenos,2160,53,2213
93,Provence-Alpes-Côte d'Azur,83,2,25,054,La Farlède,7993,121,8114
93,Provence-Alpes-Côte d'Azur,83,1,12,055,Fayence,4895,87,4982
93,Provence-Alpes-Côte d'Azur,83,1,06,056,Figanières,2523,49,2572
93,Provence-Alpes-Côte d'Azur,83,3,04,057,Flassans-sur-Issole,2948,46,2994
93,Provence-Alpes-Côte d'Azur,83,1,11,058,Flayosc,4391,106,4497
93,Provence-Alpes-Côte d'Azur,83,3,20,059,Forcalqueiret,2170,25,2195
93,Provence-Alpes-Côte d'Azur,83,3,26,060,Fox-Amphoux,432,6,438
93,Provence-Alpes-Côte d'Azur,83,1,13,061,Fréjus,52687,835,53522
93,Provence-Alpes-Côte d'Azur,83,2,42,062,La Garde,26203,383,26586
93,Provence-Alpes-Côte d'Azur,83,1,14,063,La Garde-Freinet,1776,39,1815
93,Provence-Alpes-Côte d'Azur,83,3,20,064,Garéoult,5592,111,5703
93,Provence-Alpes-Côte d'Azur,83,1,22,065,Gassin,2884,73,2957
93,Provence-Alpes-Côte d'Azur,83,3,19,066,Ginasservis,1442,23,1465
93,Provence-Alpes-Côte d'Azur,83,3,04,067,Gonfaron,3976,54,4030
93,Provence-Alpes-Côte d'Azur,83,1,14,068,Grimaud,4272,69,4341
93,Provence-Alpes-Côte d'Azur,83,2,97,069,Hyères,55135,1312,56447
93,Provence-Alpes-Côte d'Azur,83,2,07,070,Le Lavandou,5778,90,5868
93,Provence-Alpes-Côte d'Azur,83,2,36,071,La Londe-les-Maures,10028,140,10168
93,Provence-Alpes-Côte d'Azur,83,1,16,072,Lorgues,8909,331,9240
93,Provence-Alpes-Côte d'Azur,83,1,17,073,Le Luc,9043,109,9152
93,Provence-Alpes-Côte d'Azur,83,1,08,074,La Martre,163,3,166
93,Provence-Alpes-Côte d'Azur,83,1,17,075,Les Mayons,613,10,623
93,Provence-Alpes-Côte d'Azur,83,3,20,076,Mazaugues,758,11,769
93,Provence-Alpes-Côte d'Azur,83,3,20,077,Méounes-lès-Montrieux,1910,31,1941
93,Provence-Alpes-Côte d'Azur,83,3,26,078,Moissac-Bellevue,273,4,277
93,Provence-Alpes-Côte d'Azur,83,1,22,079,La Môle,970,16,986
93,Provence-Alpes-Côte d'Azur,83,1,12,080,Mons,864,20,884
93,Provence-Alpes-Côte d'Azur,83,1,12,081,Montauroux,5350,98,5448
93,Provence-Alpes-Côte d'Azur,83,1,06,082,Montferrat,1145,8,1153
93,Provence-Alpes-Côte d'Azur,83,3,09,083,Montfort-sur-Argens,1151,8,1159
93,Provence-Alpes-Côte d'Azur,83,3,26,084,Montmeyan,525,9,534
93,Provence-Alpes-Côte d'Azur,83,1,11,085,La Motte,2900,28,2928
93,Provence-Alpes-Côte d'Azur,83,1,37,086,Le Muy,8900,145,9045
93,Provence-Alpes-Côte d'Azur,83,3,21,087,Nans-les-Pins,4099,72,4171
93,Provence-Alpes-Côte d'Azur,83,3,20,088,Néoules,2438,47,2485
93,Provence-Alpes-Côte d'Azur,83,3,21,089,Ollières,633,15,648
93,Provence-Alpes-Côte d'Azur,83,2,18,090,Ollioules,12995,236,13231
93,Provence-Alpes-Côte d'Azur,83,2,10,091,Pierrefeu-du-Var,5163,79,5242
93,Provence-Alpes-Côte d'Azur,83,3,04,092,Pignans,3205,44,3249
93,Provence-Alpes-Côte d'Azur,83,3,21,093,Plan-d'Aups-Sainte-Baume,1296,21,1317
93,Provence-Alpes-Côte d'Azur,83,1,14,094,Le Plan-de-la-Tour,2806,53,2859
93,Provence-Alpes-Côte d'Azur,83,3,02,095,Pontevès,672,19,691
93,Provence-Alpes-Côte d'Azur,83,3,21,096,Pourcieux,1082,10,1092
93,Provence-Alpes-Côte d'Azur,83,3,21,097,Pourrières,4439,59,4498
93,Provence-Alpes-Côte d'Azur,83,2,42,098,Le Pradet,11214,288,11502
93,Provence-Alpes-Côte d'Azur,83,1,37,099,Puget-sur-Argens,6857,130,6987
93,Provence-Alpes-Côte d'Azur,83,2,10,100,Puget-Ville,3616,50,3666
93,Provence-Alpes-Côte d'Azur,83,1,22,101,Ramatuelle,2298,55,2353
93,Provence-Alpes-Côte d'Azur,83,1,22,152,Rayol-Canadel-sur-Mer,630,11,641
93,Provence-Alpes-Côte d'Azur,83,3,26,102,Régusse,1979,21,2000
93,Provence-Alpes-Côte d'Azur,83,2,41,103,Le Revest-les-Eaux,3696,79,3775
93,Provence-Alpes-Côte d'Azur,83,3,19,104,Rians,4202,54,4256
93,Provence-Alpes-Côte d'Azur,83,2,03,105,Riboux,35,0,35
93,Provence-Alpes-Côte d'Azur,83,3,20,106,Rocbaron,3452,71,3523
93,Provence-Alpes-Côte d'Azur,83,1,08,109,La Roque-Esclapon,242,2,244
93,Provence-Alpes-Côte d'Azur,83,1,37,107,Roquebrune-sur-Argens,11262,229,11491
93,Provence-Alpes-Côte d'Azur,83,3,20,108,La Roquebrussanne,2236,33,2269
93,Provence-Alpes-Côte d'Azur,83,3,21,110,Rougiers,1424,24,1448
93,Provence-Alpes-Côte d'Azur,83,3,09,154,Saint-Antonin-du-Var,614,11,625
93,Provence-Alpes-Côte d'Azur,83,2,03,112,Saint-Cyr-sur-Mer,11830,150,11980
93,Provence-Alpes-Côte d'Azur,83,3,19,113,Saint-Julien,1864,20,1884
93,Provence-Alpes-Côte d'Azur,83,2,38,153,Saint-Mandrier-sur-Mer,6038,69,6107
93,Provence-Alpes-Côte d'Azur,83,3,02,114,Saint-Martin,194,2,196
93,Provence-Alpes-Côte d'Azur,83,3,21,116,Saint-Maximin-la-Sainte-Baume,13911,323,14234
93,Provence-Alpes-Côte d'Azur,83,1,12,117,Saint-Paul-en-Forêt,1557,42,1599
93,Provence-Alpes-Côte d'Azur,83,1,39,118,Saint-Raphaël,34006,598,34604
93,Provence-Alpes-Côte d'Azur,83,1,22,119,Saint-Tropez,5275,89,5364
93,Provence-Alpes-Côte d'Azur,83,3,21,120,Saint-Zacharie,4800,59,4859
93,Provence-Alpes-Côte d'Azur,83,3,20,111,Sainte-Anastasie-sur-Issole,1844,30,1874
93,Provence-Alpes-Côte d'Azur,83,1,14,115,Sainte-Maxime,13652,256,13908
93,Provence-Alpes-Côte d'Azur,83,1,23,121,Salernes,3602,81,3683
93,Provence-Alpes-Côte d'Azur,83,3,01,122,Les Salles-sur-Verdon,218,4,222
93,Provence-Alpes-Côte d'Azur,83,2,18,123,Sanary-sur-Mer,17068,251,17319
93,Provence-Alpes-Côte d'Azur,83,1,12,124,Seillans,2555,48,2603
93,Provence-Alpes-Côte d'Azur,83,3,02,125,Seillons-Source-d'Argens,2115,31,2146
93,Provence-Alpes-Côte d'Azur,83,2,98,126,La Seyne-sur-Mer,59999,807,60806
93,Provence-Alpes-Côte d'Azur,83,2,03,127,Signes,2886,36,2922
93,Provence-Alpes-Côte d'Azur,83,3,26,128,Sillans-la-Cascade,531,66,597
93,Provence-Alpes-Côte d'Azur,83,2,40,129,Six-Fours-les-Plages,34803,419,35222
93,Provence-Alpes-Côte d'Azur,83,2,25,130,Solliès-Pont,10963,121,11084
93,Provence-Alpes-Côte d'Azur,83,2,25,131,Solliès-Toucas,5059,95,5154
93,Provence-Alpes-Côte d'Azur,83,2,25,132,Solliès-Ville,2447,50,2497
93,Provence-Alpes-Côte d'Azur,83,1,12,133,Tanneron,1473,19,1492
93,Provence-Alpes-Côte d'Azur,83,1,16,134,Taradeau,1710,28,1738
93,Provence-Alpes-Côte d'Azur,83,3,26,135,Tavernes,1124,10,1134
93,Provence-Alpes-Côte d'Azur,83,1,16,136,Le Thoronet,2138,35,2173
93,Provence-Alpes-Côte d'Azur,83,2,99,137,Toulon,166733,2277,169010
93,Provence-Alpes-Côte d'Azur,83,1,12,138,Tourrettes,2658,45,2703
93,Provence-Alpes-Côte d'Azur,83,1,23,139,Tourtour,550,9,559
93,Provence-Alpes-Côte d'Azur,83,3,05,140,Tourves,4806,74,4880
93,Provence-Alpes-Côte d'Azur,83,1,11,141,Trans-en-Provence,5403,110,5513
93,Provence-Alpes-Côte d'Azur,83,1,08,142,Trigance,160,3,163
93,Provence-Alpes-Côte d'Azur,83,3,05,143,Le Val,3975,74,4049
93,Provence-Alpes-Côte d'Azur,83,2,41,144,La Valette-du-Var,21439,341,21780
93,Provence-Alpes-Côte d'Azur,83,3,02,145,Varages,1111,29,1140
93,Provence-Alpes-Côte d'Azur,83,3,19,146,La Verdière,1425,15,1440
93,Provence-Alpes-Côte d'Azur,83,3,01,147,Vérignon,15,0,15
93,Provence-Alpes-Côte d'Azur,83,1,17,148,Vidauban,9750,148,9898
93,Provence-Alpes-Côte d'Azur,83,1,23,149,Villecroze,1105,37,1142
93,Provence-Alpes-Côte d'Azur,83,3,19,150,Vinon-sur-Verdon,3946,69,4015
93,Provence-Alpes-Côte d'Azur,83,3,05,151,Vins-sur-Caramy,845,12,857
93,Provence-Alpes-Côte d'Azur,84,3,10,001,Althen-des-Paluds,2486,38,2524
93,Provence-Alpes-Côte d'Azur,84,1,19,002,Ansouis,1109,35,1144
93,Provence-Alpes-Côte d'Azur,84,1,01,003,Apt,11144,295,11439
93,Provence-Alpes-Côte d'Azur,84,3,09,004,Aubignan,4740,126,4866
93,Provence-Alpes-Côte d'Azur,84,3,20,005,Aurel,182,6,188
93,Provence-Alpes-Côte d'Azur,84,1,01,006,Auribeau,73,1,74
93,Provence-Alpes-Côte d'Azur,84,2,97,007,Avignon,90109,2230,92339
93,Provence-Alpes-Côte d'Azur,84,3,14,008,Le Barroux,620,12,632
93,Provence-Alpes-Côte d'Azur,84,1,19,009,La Bastide-des-Jourdans,1297,66,1363
93,Provence-Alpes-Côte d'Azur,84,1,19,010,La Bastidonne,741,25,766
93,Provence-Alpes-Côte d'Azur,84,3,18,011,Le Beaucet,370,14,384
93,Provence-Alpes-Côte d'Azur,84,3,04,012,Beaumes-de-Venise,2262,40,2302
93,Provence-Alpes-Côte d'Azur,84,1,12,013,Beaumettes,214,2,216
93,Provence-Alpes-Côte d'Azur,84,1,19,014,Beaumont-de-Pertuis,1021,13,1034
93,Provence-Alpes-Côte d'Azur,84,3,14,015,Beaumont-du-Ventoux,322,0,322
93,Provence-Alpes-Côte d'Azur,84,2,05,016,Bédarrides,5121,70,5191
93,Provence-Alpes-Côte d'Azur,84,3,15,017,Bédoin,3076,70,3146
93,Provence-Alpes-Côte d'Azur,84,3,15,018,Blauvac,436,9,445
93,Provence-Alpes-Côte d'Azur,84,2,06,019,Bollène,14091,292,14383
93,Provence-Alpes-Côte d'Azur,84,1,07,020,Bonnieux,1416,41,1457
93,Provence-Alpes-Côte d'Azur,84,3,14,021,Brantes,82,1,83
93,Provence-Alpes-Côte d'Azur,84,3,21,022,Buisson,302,8,310
93,Provence-Alpes-Côte d'Azur,84,1,07,023,Buoux,128,3,131
93,Provence-Alpes-Côte d'Azur,84,1,19,024,Cabrières-d'Aigues,844,23,867
93,Provence-Alpes-Côte d'Azur,84,2,13,025,Cabrières-d'Avignon,1808,36,1844
93,Provence-Alpes-Côte d'Azur,84,1,08,026,Cadenet,4014,84,4098
93,Provence-Alpes-Côte d'Azur,84,2,17,027,Caderousse,2727,53,2780
93,Provence-Alpes-Côte d'Azur,84,3,21,028,Cairanne,914,19,933
93,Provence-Alpes-Côte d'Azur,84,2,16,029,Camaret-sur-Aigues,4361,93,4454
93,Provence-Alpes-Côte d'Azur,84,3,09,030,Caromb,3204,51,3255
93,Provence-Alpes-Côte d'Azur,84,3,98,031,Carpentras,29015,1052,30067
93,Provence-Alpes-Côte d'Azur,84,1,01,032,Caseneuve,413,15,428
93,Provence-Alpes-Côte d'Azur,84,1,01,033,Castellet,106,2,108
93,Provence-Alpes-Côte d'Azur,84,1,11,034,Caumont-sur-Durance,4584,85,4669
93,Provence-Alpes-Côte d'Azur,84,1,11,035,Cavaillon,25417,523,25940
93,Provence-Alpes-Côte d'Azur,84,2,13,036,Châteauneuf-de-Gadagne,3238,72,3310
93,Provence-Alpes-Côte d'Azur,84,2,17,037,Châteauneuf-du-Pape,2116,38,2154
93,Provence-Alpes-Côte d'Azur,84,1,11,038,Cheval-Blanc,4104,84,4188
93,Provence-Alpes-Côte d'Azur,84,2,05,039,Courthézon,5307,78,5385
93,Provence-Alpes-Côte d'Azur,84,3,21,040,Crestet,474,5,479
93,Provence-Alpes-Côte d'Azur,84,3,15,041,Crillon-le-Brave,457,12,469
93,Provence-Alpes-Côte d'Azur,84,1,08,042,Cucuron,1829,34,1863
93,Provence-Alpes-Côte d'Azur,84,3,10,043,Entraigues-sur-la-Sorgue,7581,119,7700
93,Provence-Alpes-Côte d'Azur,84,3,14,044,Entrechaux,1012,14,1026
93,Provence-Alpes-Côte d'Azur,84,3,21,045,Faucon,411,11,422
93,Provence-Alpes-Côte d'Azur,84,3,15,046,Flassan,412,8,420
93,Provence-Alpes-Côte d'Azur,84,2,13,139,Fontaine-de-Vaucluse,690,14,704
93,Provence-Alpes-Côte d'Azur,84,1,01,047,Gargas,2986,109,3095
93,Provence-Alpes-Côte d'Azur,84,1,01,048,Gignac,61,3,64
93,Provence-Alpes-Côte d'Azur,84,3,04,049,Gigondas,572,11,583
93,Provence-Alpes-Côte d'Azur,84,1,12,050,Gordes,2134,45,2179
93,Provence-Alpes-Côte d'Azur,84,1,12,051,Goult,1176,64,1240
93,Provence-Alpes-Côte d'Azur,84,1,19,052,Grambois,1138,26,1164
93,Provence-Alpes-Côte d'Azur,84,2,22,053,Grillon,1704,45,1749
93,Provence-Alpes-Côte d'Azur,84,2,13,054,L' Isle-sur-la-Sorgue,18933,525,19458
93,Provence-Alpes-Côte d'Azur,84,2,13,055,Jonquerettes,1269,21,1290
93,Provence-Alpes-Côte d'Azur,84,2,16,056,Jonquières,4309,66,4375
93,Provence-Alpes-Côte d'Azur,84,1,12,057,Joucas,316,9,325
93,Provence-Alpes-Côte d'Azur,84,1,07,058,Lacoste,423,13,436
93,Provence-Alpes-Côte d'Azur,84,3,04,059,Lafare,104,3,107
93,Provence-Alpes-Côte d'Azur,84,1,01,060,Lagarde-d'Apt,36,0,36
93,Provence-Alpes-Côte d'Azur,84,2,06,061,Lagarde-Paréol,285,14,299
93,Provence-Alpes-Côte d'Azur,84,2,13,062,Lagnes,1693,43,1736
93,Provence-Alpes-Côte d'Azur,84,2,06,063,Lamotte-du-Rhône,401,13,414
93,Provence-Alpes-Côte d'Azur,84,2,06,064,Lapalud,3539,77,3616
93,Provence-Alpes-Côte d'Azur,84,1,08,065,Lauris,3420,72,3492
93,Provence-Alpes-Côte d'Azur,84,1,12,066,Lioux,255,7,262
93,Provence-Alpes-Côte d'Azur,84,3,09,067,Loriol-du-Comtat,2288,25,2313
93,Provence-Alpes-Côte d'Azur,84,1,08,068,Lourmarin,997,36,1033
93,Provence-Alpes-Côte d'Azur,84,3,14,069,Malaucène,2652,59,2711
93,Provence-Alpes-Côte d'Azur,84,3,15,070,Malemort-du-Comtat,1435,29,1464
93,Provence-Alpes-Côte d'Azur,84,1,11,071,Maubec,1829,39,1868
93,Provence-Alpes-Côte d'Azur,84,3,10,072,Mazan,5585,113,5698
93,Provence-Alpes-Côte d'Azur,84,1,07,073,Ménerbes,1153,30,1183
93,Provence-Alpes-Côte d'Azur,84,1,08,074,Mérindol,1939,37,1976
93,Provence-Alpes-Côte d'Azur,84,3,15,075,Méthamis,395,5,400
93,Provence-Alpes-Côte d'Azur,84,1,19,076,Mirabeau,1097,20,1117
93,Provence-Alpes-Côte d'Azur,84,3,15,077,Modène,388,4,392
93,Provence-Alpes-Côte d'Azur,84,2,06,078,Mondragon,3574,62,3636
93,Provence-Alpes-Côte d'Azur,84,3,20,079,Monieux,344,8,352
93,Provence-Alpes-Côte d'Azur,84,3,10,080,Monteux,10789,200,10989
93,Provence-Alpes-Côte d'Azur,84,2,23,081,Morières-lès-Avignon,7530,124,7654
93,Provence-Alpes-Côte d'Azur,84,3,15,082,Mormoiron,1849,41,1890
93,Provence-Alpes-Côte d'Azur,84,2,06,083,Mornas,2265,52,2317
93,Provence-Alpes-Côte d'Azur,84,1,19,084,La Motte-d'Aigues,1328,33,1361
93,Provence-Alpes-Côte d'Azur,84,1,12,085,Murs,433,8,441
93,Provence-Alpes-Côte d'Azur,84,1,07,086,Oppède,1336,33,1369
93,Provence-Alpes-Côte d'Azur,84,2,99,087,Orange,29527,701,30228
93,Provence-Alpes-Côte d'Azur,84,3,18,088,Pernes-les-Fontaines,10440,190,10630
93,Provence-Alpes-Côte d'Azur,84,1,19,089,Pertuis,18872,276,19148
93,Provence-Alpes-Côte d'Azur,84,1,19,090,Peypin-d'Aigues,596,18,614
93,Provence-Alpes-Côte d'Azur,84,2,17,091,Piolenc,4701,99,4800
93,Provence-Alpes-Côte d'Azur,84,2,02,092,Le Pontet,16886,199,17085
93,Provence-Alpes-Côte d'Azur,84,1,08,093,Puget,663,13,676
93,Provence-Alpes-Côte d'Azur,84,3,21,094,Puyméras,636,14,650
93,Provence-Alpes-Côte d'Azur,84,1,08,095,Puyvert,731,15,746
93,Provence-Alpes-Côte d'Azur,84,3,21,096,Rasteau,766,16,782
93,Provence-Alpes-Côte d'Azur,84,2,22,097,Richerenches,684,73,757
93,Provence-Alpes-Côte d'Azur,84,3,21,098,Roaix,611,13,624
93,Provence-Alpes-Côte d'Azur,84,1,11,099,Robion,4084,91,4175
93,Provence-Alpes-Côte d'Azur,84,3,04,100,La Roque-Alric,68,1,69
93,Provence-Alpes-Côte d'Azur,84,3,18,101,La Roque-sur-Pernes,416,10,426
93,Provence-Alpes-Côte d'Azur,84,1,12,102,Roussillon,1291,29,1320
93,Provence-Alpes-Côte d'Azur,84,1,01,103,Rustrel,711,12,723
93,Provence-Alpes-Côte d'Azur,84,3,04,104,Sablet,1267,35,1302
93,Provence-Alpes-Côte d'Azur,84,1,01,105,Saignon,1031,35,1066
93,Provence-Alpes-Côte d'Azur,84,3,20,107,Saint-Christol,1194,10,1204
93,Provence-Alpes-Côte d'Azur,84,3,18,108,Saint-Didier,2084,25,2109
93,Provence-Alpes-Côte d'Azur,84,3,09,109,Saint-Hippolyte-le-Graveyron,166,5,171
93,Provence-Alpes-Côte d'Azur,84,3,14,110,Saint-Léger-du-Ventoux,30,1,31
93,Provence-Alpes-Côte d'Azur,84,3,21,111,Saint-Marcellin-lès-Vaison,343,7,350
93,Provence-Alpes-Côte d'Azur,84,1,01,112,Saint-Martin-de-Castillon,734,30,764
93,Provence-Alpes-Côte d'Azur,84,1,19,113,Saint-Martin-de-la-Brasque,736,14,750
93,Provence-Alpes-Côte d'Azur,84,1,12,114,Saint-Pantaléon,190,3,193
93,Provence-Alpes-Côte d'Azur,84,3,15,115,Saint-Pierre-de-Vassols,489,14,503
93,Provence-Alpes-Côte d'Azur,84,3,21,116,Saint-Romain-en-Viennois,847,24,871
93,Provence-Alpes-Côte d'Azur,84,3,21,117,Saint-Roman-de-Malegarde,305,6,311
93,Provence-Alpes-Côte d'Azur,84,1,01,118,Saint-Saturnin-lès-Apt,2637,83,2720
93,Provence-Alpes-Côte d'Azur,84,2,13,119,Saint-Saturnin-lès-Avignon,5042,88,5130
93,Provence-Alpes-Côte d'Azur,84,3,20,120,Saint-Trinit,123,5,128
93,Provence-Alpes-Côte d'Azur,84,2,06,106,Sainte-Cécile-les-Vignes,2241,82,2323
93,Provence-Alpes-Côte d'Azur,84,1,19,121,Sannes,165,3,168
93,Provence-Alpes-Côte d'Azur,84,3,09,122,Sarrians,5757,78,5835
93,Provence-Alpes-Côte d'Azur,84,3,20,123,Sault,1330,34,1364
93,Provence-Alpes-Côte d'Azur,84,2,13,124,Saumane-de-Vaucluse,802,18,820
93,Provence-Alpes-Côte d'Azur,84,3,14,125,Savoillan,97,1,98
93,Provence-Alpes-Côte d'Azur,84,3,21,126,Séguret,912,35,947
93,Provence-Alpes-Côte d'Azur,84,2,16,127,Sérignan-du-Comtat,2404,74,2478
93,Provence-Alpes-Côte d'Azur,84,1,07,128,Sivergues,48,1,49
93,Provence-Alpes-Côte d'Azur,84,2,05,129,Sorgues,18232,206,18438
93,Provence-Alpes-Côte d'Azur,84,3,04,130,Suzette,118,4,122
93,Provence-Alpes-Côte d'Azur,84,1,11,131,Taillades,1927,28,1955
93,Provence-Alpes-Côte d'Azur,84,2,13,132,Le Thor,7916,170,8086
93,Provence-Alpes-Côte d'Azur,84,1,19,133,La Tour-d'Aigues,3919,144,4063
93,Provence-Alpes-Côte d'Azur,84,2,16,134,Travaillan,667,14,681
93,Provence-Alpes-Côte d'Azur,84,2,16,135,Uchaux,1369,61,1430
93,Provence-Alpes-Côte d'Azur,84,3,04,136,Vacqueyras,1056,20,1076
93,Provence-Alpes-Côte d'Azur,84,3,21,137,Vaison-la-Romaine,6201,143,6344
93,Provence-Alpes-Côte d'Azur,84,2,22,138,Valréas,9894,320,10214
93,Provence-Alpes-Côte d'Azur,84,1,08,140,Vaugines,555,14,569
93,Provence-Alpes-Côte d'Azur,84,2,05,141,Vedène,9937,315,10252
93,Provence-Alpes-Côte d'Azur,84,3,18,142,Velleron,3060,60,3120
93,Provence-Alpes-Côte d'Azur,84,3,18,143,Venasque,1125,21,1146
93,Provence-Alpes-Côte d'Azur,84,1,01,144,Viens,576,11,587
93,Provence-Alpes-Côte d'Azur,84,1,01,145,Villars,734,16,750
93,Provence-Alpes-Côte d'Azur,84,3,21,146,Villedieu,506,15,521
93,Provence-Alpes-Côte d'Azur,84,1,08,147,Villelaure,3130,78,3208
93,Provence-Alpes-Côte d'Azur,84,3,15,148,Villes-sur-Auzon,1278,25,1303
93,Provence-Alpes-Côte d'Azur,84,2,16,149,Violès,1539,42,1581
93,Provence-Alpes-Côte d'Azur,84,2,22,150,Visan,1984,36,2020
93,Provence-Alpes-Côte d'Azur,84,1,19,151,Vitrolles-en-Lubéron,182,7,189
52,Pays de la Loire,85,1,11,001,L' Aiguillon-sur-Mer,2303,34,2337
52,Pays de la Loire,85,3,26,002,L' Aiguillon-sur-Vie,1595,18,1613
52,Pays de la Loire,85,2,20,003,Aizenay,7754,159,7913
52,Pays de la Loire,85,3,17,004,Angles,2212,39,2251
52,Pays de la Loire,85,1,05,005,Antigny,1005,35,1040
52,Pays de la Loire,85,3,19,006,Apremont,1470,27,1497
52,Pays de la Loire,85,2,31,008,Aubigny,2886,61,2947
52,Pays de la Loire,85,1,07,009,Auzay,586,19,605
52,Pays de la Loire,85,3,30,010,Avrillé,1149,13,1162
52,Pays de la Loire,85,3,18,011,Barbâtre,1779,33,1812
52,Pays de la Loire,85,3,29,012,La Barre-de-Monts,2134,39,2173
52,Pays de la Loire,85,2,25,013,Bazoges-en-Paillers,1033,8,1041
52,Pays de la Loire,85,1,05,014,Bazoges-en-Pareds,1150,27,1177
52,Pays de la Loire,85,2,20,015,Beaufou,1120,27,1147
52,Pays de la Loire,85,3,16,016,Beaulieu-sous-la-Roche,1963,32,1995
52,Pays de la Loire,85,2,08,017,Beaurepaire,2081,63,2144
52,Pays de la Loire,85,3,01,018,Beauvoir-sur-Mer,3725,62,3787
52,Pays de la Loire,85,2,20,019,Belleville-sur-Vie,3673,82,3755
52,Pays de la Loire,85,1,12,020,Benet,3610,96,3706
52,Pays de la Loire,85,3,30,022,Le Bernard,925,25,950
52,Pays de la Loire,85,2,14,021,La Bernardière,1578,29,1607
52,Pays de la Loire,85,2,13,023,Bessay,407,9,416
52,Pays de la Loire,85,3,03,024,Bois-de-Céné,1535,31,1566
52,Pays de la Loire,85,2,14,025,La Boissière-de-Montaigu,1993,39,2032
52,Pays de la Loire,85,3,17,026,La Boissière-des-Landes,1267,35,1302
52,Pays de la Loire,85,2,14,027,Boufféré,2622,65,2687
52,Pays de la Loire,85,1,12,028,Bouillé-Courdault,456,4,460
52,Pays de la Loire,85,3,01,029,Bouin,2196,32,2228
52,Pays de la Loire,85,2,06,030,Boulogne,681,12,693
52,Pays de la Loire,85,1,21,031,Le Boupère,2838,63,2901
52,Pays de la Loire,85,1,09,033,Bourneau,777,15,792
52,Pays de la Loire,85,2,04,034,Bournezeau,2941,83,3024
52,Pays de la Loire,85,3,26,243,Brem-sur-Mer,2539,40,2579
52,Pays de la Loire,85,3,26,035,Bretignolles-sur-Mer,3900,56,3956
52,Pays de la Loire,85,2,13,036,La Bretonnière-la-Claye,640,5,645
52,Pays de la Loire,85,1,05,037,Breuil-Barret,652,18,670
52,Pays de la Loire,85,2,25,038,Les Brouzils,2516,36,2552
52,Pays de la Loire,85,2,14,039,La Bruffière,3459,83,3542
52,Pays de la Loire,85,1,27,040,La Caillère-Saint-Hilaire,1042,43,1085
52,Pays de la Loire,85,1,05,041,Cezais,323,10,333
52,Pays de la Loire,85,1,02,042,Chaillé-les-Marais,1834,32,1866
52,Pays de la Loire,85,2,31,043,Chaillé-sous-les-Ormeaux,1206,19,1225
52,Pays de la Loire,85,1,07,044,Chaix,432,17,449
52,Pays de la Loire,85,3,26,045,La Chaize-Giraud,815,14,829
52,Pays de la Loire,85,2,31,046,La Chaize-le-Vicomte,3210,65,3275
52,Pays de la Loire,85,3,03,047,Challans,18338,630,18968
52,Pays de la Loire,85,2,15,048,Chambretaud,1437,33,1470
52,Pays de la Loire,85,3,17,050,Le Champ-Saint-Père,1560,30,1590
52,Pays de la Loire,85,1,02,049,Champagné-les-Marais,1627,21,1648
52,Pays de la Loire,85,2,04,051,Chantonnay,8088,354,8442
52,Pays de la Loire,85,3,16,052,La Chapelle-Achard,1672,10,1682
52,Pays de la Loire,85,1,05,053,La Chapelle-aux-Lys,247,1,248
52,Pays de la Loire,85,3,16,054,La Chapelle-Hermier,746,7,753
52,Pays de la Loire,85,3,19,055,La Chapelle-Palluau,902,12,914
52,Pays de la Loire,85,1,27,056,La Chapelle-Thémer,333,7,340
52,Pays de la Loire,85,1,11,058,Chasnais,617,14,631
52,Pays de la Loire,85,1,05,059,La Châtaigneraie,2633,48,2681
52,Pays de la Loire,85,3,24,060,Château-d'Olonne,13242,451,13693
52,Pays de la Loire,85,2,13,061,Château-Guibert,1422,28,1450
52,Pays de la Loire,85,3,03,062,Châteauneuf,829,16,845
52,Pays de la Loire,85,1,21,063,Les Châtelliers-Châteaumur,717,28,745
52,Pays de la Loire,85,2,25,064,Chauché,2188,31,2219
52,Pays de la Loire,85,2,25,065,Chavagnes-en-Paillers,3284,86,3370
52,Pays de la Loire,85,1,21,066,Chavagnes-les-Redoux,795,18,813
52,Pays de la Loire,85,1,05,067,Cheffois,928,24,952
52,Pays de la Loire,85,2,31,069,Les Clouzeaux,2453,74,2527
52,Pays de la Loire,85,3,26,070,Coëx,2969,48,3017
52,Pays de la Loire,85,3,26,071,Commequiers,2799,70,2869
52,Pays de la Loire,85,2,25,072,La Copechagnière,853,9,862
52,Pays de la Loire,85,2,13,073,Corpe,888,9,897
52,Pays de la Loire,85,2,13,074,La Couture,197,5,202
52,Pays de la Loire,85,2,14,076,Cugand,3164,82,3246
52,Pays de la Loire,85,3,17,077,Curzon,453,5,458
52,Pays de la Loire,85,1,12,078,Damvix,758,14,772
52,Pays de la Loire,85,1,12,080,Doix,814,18,832
52,Pays de la Loire,85,2,06,081,Dompierre-sur-Yon,3946,87,4033
52,Pays de la Loire,85,2,08,082,Les Epesses,2523,54,2577
52,Pays de la Loire,85,3,18,083,L' Épine,1709,54,1763
52,Pays de la Loire,85,2,06,084,Les Essarts,4946,108,5054
52,Pays de la Loire,85,3,19,086,Falleron,1401,22,1423
52,Pays de la Loire,85,3,17,307,La Faute-sur-Mer,1001,27,1028
52,Pays de la Loire,85,1,28,087,Faymoreau,240,2,242
52,Pays de la Loire,85,3,26,088,Le Fenouiller,4241,96,4337
52,Pays de la Loire,85,2,06,089,La Ferrière,4625,126,4751
52,Pays de la Loire,85,1,21,090,La Flocellière,2367,57,2424
52,Pays de la Loire,85,1,07,091,Fontaines,815,36,851
52,Pays de la Loire,85,1,07,092,Fontenay-le-Comte,14341,766,15107
52,Pays de la Loire,85,2,31,093,Fougeré,932,22,954
52,Pays de la Loire,85,1,28,094,Foussais-Payré,1186,25,1211
52,Pays de la Loire,85,3,03,095,Froidfond,1357,23,1380
52,Pays de la Loire,85,3,03,096,La Garnache,4364,89,4453
52,Pays de la Loire,85,2,15,097,La Gaubretière,2868,63,2931
52,Pays de la Loire,85,2,20,098,La Génétouze,1636,25,1661
52,Pays de la Loire,85,3,16,099,Le Girouard,806,8,814
52,Pays de la Loire,85,3,26,100,Givrand,1891,45,1936
52,Pays de la Loire,85,3,17,101,Le Givre,403,10,413
52,Pays de la Loire,85,3,19,102,Grand'Landes,472,4,476
52,Pays de la Loire,85,3,30,103,Grosbreuil,1953,22,1975
52,Pays de la Loire,85,1,11,104,Grues,781,11,792
52,Pays de la Loire,85,1,02,105,Le Gué-de-Velluire,528,4,532
52,Pays de la Loire,85,3,18,106,La Guérinière,1506,50,1556
52,Pays de la Loire,85,2,14,107,La Guyonnière,2677,166,2843
52,Pays de la Loire,85,2,22,108,L' Herbergement,2632,66,2698
52,Pays de la Loire,85,2,08,109,Les Herbiers,14811,528,15339
52,Pays de la Loire,85,1,09,110,L' Hermenault,851,22,873
52,Pays de la Loire,85,1,02,111,L' Île-d'Elle,1403,36,1439
52,Pays de la Loire,85,3,24,112,L' Île-d'Olonne,2627,47,2674
52,Pays de la Loire,85,3,10,113,L' Île-d'Yeu,4807,154,4961
52,Pays de la Loire,85,3,30,114,Jard-sur-Mer,2493,52,2545
52,Pays de la Loire,85,1,27,115,La Jaudonnière,577,12,589
52,Pays de la Loire,85,3,17,116,La Jonchère,381,8,389
52,Pays de la Loire,85,1,11,117,Lairoux,608,16,624
52,Pays de la Loire,85,3,16,118,Landeronde,2100,59,2159
52,Pays de la Loire,85,2,15,119,Les Landes-Genusson,2282,41,2323
52,Pays de la Loire,85,3,26,120,Landevieille,1143,16,1159
52,Pays de la Loire,85,1,07,121,Le Langon,1080,17,1097
52,Pays de la Loire,85,1,12,123,Liez,273,7,280
52,Pays de la Loire,85,1,05,125,Loge-Fougereuse,356,11,367
52,Pays de la Loire,85,1,07,126,Longèves,1188,42,1230
52,Pays de la Loire,85,3,30,127,Longeville-sur-Mer,2328,37,2365
52,Pays de la Loire,85,2,20,129,Les Lucs-sur-Boulogne,3231,41,3272
52,Pays de la Loire,85,1,11,128,Luçon,9753,380,10133
52,Pays de la Loire,85,3,19,130,Maché,1306,24,1330
52,Pays de la Loire,85,1,11,131,Les Magnils-Reigniers,1481,44,1525
52,Pays de la Loire,85,1,12,132,Maillé,766,13,779
52,Pays de la Loire,85,1,12,133,Maillezais,970,53,1023
52,Pays de la Loire,85,2,15,134,Mallièvre,239,9,248
52,Pays de la Loire,85,2,13,135,Mareuil-sur-Lay-Dissais,2629,115,2744
52,Pays de la Loire,85,1,05,136,Marillet,118,3,121
52,Pays de la Loire,85,1,09,137,Marsais-Sainte-Radégonde,505,16,521
52,Pays de la Loire,85,3,16,138,Martinet,804,10,814
52,Pays de la Loire,85,1,12,139,Le Mazeau,430,17,447
52,Pays de la Loire,85,1,21,140,La Meilleraie-Tillay,1500,32,1532
52,Pays de la Loire,85,1,05,141,Menomblet,668,23,691
52,Pays de la Loire,85,2,06,142,La Merlatière,778,8,786
52,Pays de la Loire,85,1,28,143,Mervent,1083,27,1110
52,Pays de la Loire,85,2,08,144,Mesnard-la-Barotière,1239,19,1258
52,Pays de la Loire,85,1,21,145,Monsireigne,864,12,876
52,Pays de la Loire,85,2,14,146,Montaigu,4959,142,5101
52,Pays de la Loire,85,1,21,147,Montournais,1734,44,1778
52,Pays de la Loire,85,1,07,148,Montreuil,816,26,842
52,Pays de la Loire,85,1,02,149,Moreilles,339,3,342
52,Pays de la Loire,85,2,22,150,Mormaison,1045,16,1061
52,Pays de la Loire,85,2,15,151,Mortagne-sur-Sèvre,6074,177,6251
52,Pays de la Loire,85,3,16,152,La Mothe-Achard,2425,69,2494
52,Pays de la Loire,85,2,08,153,Mouchamps,2580,57,2637
52,Pays de la Loire,85,1,05,154,Mouilleron-en-Pareds,1246,72,1318
52,Pays de la Loire,85,2,23,155,Mouilleron-le-Captif,4375,116,4491
52,Pays de la Loire,85,3,17,156,Moutiers-les-Mauxfaits,1745,27,1772
52,Pays de la Loire,85,2,13,157,Moutiers-sur-le-Lay,613,9,622
52,Pays de la Loire,85,1,09,158,Mouzeuil-Saint-Martin,1139,23,1162
52,Pays de la Loire,85,1,09,159,Nalliers,2160,36,2196
52,Pays de la Loire,85,2,31,160,Nesmy,2457,50,2507
52,Pays de la Loire,85,3,16,161,Nieul-le-Dolent,2166,33,2199
52,Pays de la Loire,85,1,28,162,Nieul-sur-l'Autise,1150,28,1178
52,Pays de la Loire,85,3,18,163,Noirmoutier-en-l'Île,4756,144,4900
52,Pays de la Loire,85,3,29,164,Notre-Dame-de-Monts,1841,23,1864
52,Pays de la Loire,85,3,26,189,Notre-Dame-de-Riez,1865,26,1891
52,Pays de la Loire,85,2,06,165,L' Oie,1102,16,1118
52,Pays de la Loire,85,3,24,166,Olonne-sur-Mer,13025,592,13617
52,Pays de la Loire,85,1,07,167,L' Orbrie,838,29,867
52,Pays de la Loire,85,1,28,168,Oulmes,740,28,768
52,Pays de la Loire,85,3,19,169,Palluau,921,17,938
52,Pays de la Loire,85,2,13,171,Péault,525,11,536
52,Pays de la Loire,85,3,29,172,Le Perrier,1822,36,1858
52,Pays de la Loire,85,1,09,174,Petosse,561,11,572
52,Pays de la Loire,85,2,13,175,Les Pineaux,562,11,573
52,Pays de la Loire,85,1,07,176,Pissotte,1188,27,1215
52,Pays de la Loire,85,1,07,177,Le Poiré-sur-Velluire,628,13,641
52,Pays de la Loire,85,2,20,178,Le Poiré-sur-Vie,7397,209,7606
52,Pays de la Loire,85,3,30,179,Poiroux,844,25,869
52,Pays de la Loire,85,1,21,180,La Pommeraie-sur-Sèvre,1049,24,1073
52,Pays de la Loire,85,1,09,181,Pouillé,620,6,626
52,Pays de la Loire,85,1,21,182,Pouzauges,5395,186,5581
52,Pays de la Loire,85,1,28,184,Puy-de-Serre,300,9,309
52,Pays de la Loire,85,1,02,185,Puyravault,648,10,658
52,Pays de la Loire,85,2,25,186,La Rabatelière,816,14,830
52,Pays de la Loire,85,1,21,187,Réaumur,800,19,819
52,Pays de la Loire,85,1,27,188,La Réorthe,1008,20,1028
52,Pays de la Loire,85,2,98,191,La Roche-sur-Yon,51727,3364,55091
52,Pays de la Loire,85,2,22,190,Rocheservière,2818,56,2874
52,Pays de la Loire,85,2,04,192,Rochetrejoux,820,18,838
52,Pays de la Loire,85,2,13,193,Rosnay,530,3,533
52,Pays de la Loire,85,3,24,194,Les Sables-d'Olonne,15027,493,15520
52,Pays de la Loire,85,2,25,196,Saint-André-Goule-d'Oie,1628,16,1644
52,Pays de la Loire,85,2,22,197,Saint-André-Treize-Voies,1253,31,1284
52,Pays de la Loire,85,2,15,198,Saint-Aubin-des-Ormeaux,1261,36,1297
52,Pays de la Loire,85,1,27,199,Saint-Aubin-la-Plaine,451,7,458
52,Pays de la Loire,85,3,17,200,Saint-Avaugourd-des-Landes,892,10,902
52,Pays de la Loire,85,3,17,201,Saint-Benoist-sur-Mer,343,5,348
52,Pays de la Loire,85,3,19,204,Saint-Christophe-du-Ligneron,2337,21,2358
52,Pays de la Loire,85,1,09,205,Saint-Cyr-des-Gâts,518,11,529
52,Pays de la Loire,85,3,17,206,Saint-Cyr-en-Talmondais,378,5,383
52,Pays de la Loire,85,1,11,207,Saint-Denis-du-Payré,367,9,376
52,Pays de la Loire,85,2,20,208,Saint-Denis-la-Chevasse,2028,34,2062
52,Pays de la Loire,85,1,27,209,Saint-Étienne-de-Brillouet,463,10,473
52,Pays de la Loire,85,3,19,210,Saint-Étienne-du-Bois,1765,32,1797
52,Pays de la Loire,85,2,31,213,Saint-Florent-des-Bois,2562,104,2666
52,Pays de la Loire,85,2,25,215,Saint-Fulgent,3467,136,3603
52,Pays de la Loire,85,2,14,217,Saint-Georges-de-Montaigu,3766,65,3831
52,Pays de la Loire,85,3,16,218,Saint-Georges-de-Pointindoux,1474,23,1497
52,Pays de la Loire,85,2,04,220,Saint-Germain-de-Prinçay,1463,36,1499
52,Pays de la Loire,85,1,05,219,Saint-Germain-l'Aiguiller,390,10,400
52,Pays de la Loire,85,3,01,221,Saint-Gervais,2178,38,2216
52,Pays de la Loire,85,3,26,222,Saint-Gilles-Croix-de-Vie,7245,163,7408
52,Pays de la Loire,85,2,14,224,Saint-Hilaire-de-Loulay,4123,121,4244
52,Pays de la Loire,85,3,26,226,Saint-Hilaire-de-Riez,10432,224,10656
52,Pays de la Loire,85,1,05,229,Saint-Hilaire-de-Voust,633,13,646
52,Pays de la Loire,85,1,28,227,Saint-Hilaire-des-Loges,1886,34,1920
52,Pays de la Loire,85,3,30,231,Saint-Hilaire-la-Forêt,600,8,608
52,Pays de la Loire,85,2,04,232,Saint-Hilaire-le-Vouhis,953,16,969
52,Pays de la Loire,85,1,27,233,Saint-Jean-de-Beugné,556,2,558
52,Pays de la Loire,85,3,29,234,Saint-Jean-de-Monts,7882,224,8106
52,Pays de la Loire,85,1,27,235,Saint-Juire-Champgillon,442,8,450
52,Pays de la Loire,85,3,16,236,Saint-Julien-des-Landes,1311,13,1324
52,Pays de la Loire,85,1,09,237,Saint-Laurent-de-la-Salle,371,13,384
52,Pays de la Loire,85,2,15,238,Saint-Laurent-sur-Sèvre,3440,908,4348
52,Pays de la Loire,85,3,26,239,Saint-Maixent-sur-Vie,830,10,840
52,Pays de la Loire,85,2,15,240,Saint-Malô-du-Bois,1451,69,1520
52,Pays de la Loire,85,2,08,242,Saint-Mars-la-Réorthe,829,25,854
52,Pays de la Loire,85,1,28,244,Saint-Martin-de-Fraigneau,842,47,889
52,Pays de la Loire,85,1,09,245,Saint-Martin-des-Fontaines,159,2,161
52,Pays de la Loire,85,2,06,246,Saint-Martin-des-Noyers,2203,24,2227
52,Pays de la Loire,85,2,15,247,Saint-Martin-des-Tilleuls,924,20,944
52,Pays de la Loire,85,1,27,248,Saint-Martin-Lars-en-Sainte-Hermine,433,7,440
52,Pays de la Loire,85,3,16,250,Saint-Mathurin,1729,44,1773
52,Pays de la Loire,85,1,05,251,Saint-Maurice-des-Noues,608,26,634
52,Pays de la Loire,85,1,05,252,Saint-Maurice-le-Girard,587,17,604
52,Pays de la Loire,85,1,21,254,Saint-Mesmin,1850,38,1888
52,Pays de la Loire,85,1,11,255,Saint-Michel-en-l'Herm,2072,82,2154
52,Pays de la Loire,85,1,28,256,Saint-Michel-le-Cloucq,1231,44,1275
52,Pays de la Loire,85,1,21,257,Saint-Michel-Mont-Mercure,1944,198,2142
52,Pays de la Loire,85,2,08,259,Saint-Paul-en-Pareds,1150,21,1171
52,Pays de la Loire,85,3,19,260,Saint-Paul-Mont-Penit,620,15,635
52,Pays de la Loire,85,2,22,262,Saint-Philbert-de-Bouaine,2641,51,2692
52,Pays de la Loire,85,1,05,264,Saint-Pierre-du-Chemin,1364,37,1401
52,Pays de la Loire,85,1,12,265,Saint-Pierre-le-Vieux,958,28,986
52,Pays de la Loire,85,2,04,266,Saint-Prouant,1454,29,1483
52,Pays de la Loire,85,3,26,268,Saint-Révérend,1313,20,1333
52,Pays de la Loire,85,1,12,269,Saint-Sigismond,384,1,385
52,Pays de la Loire,85,1,05,271,Saint-Sulpice-en-Pareds,390,6,396
52,Pays de la Loire,85,2,22,272,Saint-Sulpice-le-Verdon,803,19,822
52,Pays de la Loire,85,3,01,273,Saint-Urbain,1462,16,1478
52,Pays de la Loire,85,1,09,274,Saint-Valérien,481,16,497
52,Pays de la Loire,85,2,04,276,Saint-Vincent-Sterlanges,680,14,694
52,Pays de la Loire,85,3,17,277,Saint-Vincent-sur-Graon,1300,28,1328
52,Pays de la Loire,85,3,30,278,Saint-Vincent-sur-Jard,1203,17,1220
52,Pays de la Loire,85,2,06,202,Sainte-Cécile,1481,139,1620
52,Pays de la Loire,85,3,16,211,Sainte-Flaive-des-Loups,2014,42,2056
52,Pays de la Loire,85,2,06,212,Sainte-Florence,1064,20,1084
52,Pays de la Loire,85,3,24,214,Sainte-Foy,1805,41,1846
52,Pays de la Loire,85,1,11,216,Sainte-Gemme-la-Plaine,1884,202,2086
52,Pays de la Loire,85,1,27,223,Sainte-Hermine,2557,70,2627
52,Pays de la Loire,85,2,13,261,Sainte-Pexine,235,2,237
52,Pays de la Loire,85,1,02,267,Sainte-Radégonde-des-Noyers,777,20,797
52,Pays de la Loire,85,2,20,279,Saligny,1665,29,1694
52,Pays de la Loire,85,3,03,280,Sallertaine,2740,56,2796
52,Pays de la Loire,85,1,09,281,Sérigné,1009,26,1035
52,Pays de la Loire,85,2,04,282,Sigournais,828,20,848
52,Pays de la Loire,85,3,29,284,Soullans,3981,97,4078
52,Pays de la Loire,85,2,31,285,Le Tablier,578,14,592
52,Pays de la Loire,85,1,02,286,La Taillée,517,6,523
52,Pays de la Loire,85,1,21,287,Tallud-Sainte-Gemme,446,15,461
52,Pays de la Loire,85,3,30,288,Talmont-Saint-Hilaire,6764,125,6889
52,Pays de la Loire,85,1,05,289,La Tardière,1263,24,1287
52,Pays de la Loire,85,1,27,290,Thiré,543,5,548
52,Pays de la Loire,85,2,31,291,Thorigny,1035,27,1062
52,Pays de la Loire,85,1,05,292,Thouarsais-Bouildroux,694,13,707
52,Pays de la Loire,85,2,15,293,Tiffauges,1463,43,1506
52,Pays de la Loire,85,3,17,294,La Tranche-sur-Mer,2702,49,2751
52,Pays de la Loire,85,2,14,295,Treize-Septiers,2782,64,2846
52,Pays de la Loire,85,2,15,296,Treize-Vents,1064,25,1089
52,Pays de la Loire,85,1,11,297,Triaize,983,17,1000
52,Pays de la Loire,85,3,24,298,Vairé,1449,27,1476
52,Pays de la Loire,85,1,07,299,Velluire,536,11,547
52,Pays de la Loire,85,2,23,300,Venansault,4258,152,4410
52,Pays de la Loire,85,2,08,301,Vendrennes,1409,26,1435
52,Pays de la Loire,85,2,15,302,La Verrie,3668,99,3767
52,Pays de la Loire,85,1,12,303,Vix,1739,41,1780
52,Pays de la Loire,85,1,02,304,Vouillé-les-Marais,674,8,682
52,Pays de la Loire,85,1,05,305,Vouvant,865,65,930
52,Pays de la Loire,85,1,28,306,Xanton-Chassenon,701,16,717
54,Poitou-Charentes,86,2,09,001,Adriers,731,23,754
54,Poitou-Charentes,86,3,15,002,Amberre,492,10,502
54,Poitou-Charentes,86,2,06,003,Anché,307,3,310
54,Poitou-Charentes,86,2,25,004,Angles-sur-l'Anglin,393,5,398
54,Poitou-Charentes,86,1,16,005,Angliers,661,11,672
54,Poitou-Charentes,86,2,25,006,Antigny,600,9,609
54,Poitou-Charentes,86,1,10,007,Antran,1129,36,1165
54,Poitou-Charentes,86,1,31,009,Archigny,1029,17,1046
54,Poitou-Charentes,86,1,12,008,Arçay,403,7,410
54,Poitou-Charentes,86,3,28,010,Aslonnes,996,22,1018
54,Poitou-Charentes,86,2,09,011,Asnières-sur-Blour,208,5,213
54,Poitou-Charentes,86,2,02,012,Asnois,146,2,148
54,Poitou-Charentes,86,1,16,013,Aulnay,106,1,107
54,Poitou-Charentes,86,1,31,014,Availles-en-Châtellerault,1540,54,1594
54,Poitou-Charentes,86,2,01,015,Availles-Limouzine,1307,27,1334
54,Poitou-Charentes,86,3,19,016,Avanton,1824,30,1854
54,Poitou-Charentes,86,3,30,017,Ayron,1101,16,1117
54,Poitou-Charentes,86,1,12,018,Basses,348,12,360
54,Poitou-Charentes,86,1,31,019,Beaumont,1769,32,1801
54,Poitou-Charentes,86,1,31,020,Bellefonds,236,4,240
54,Poitou-Charentes,86,3,30,021,Benassay,843,37,880
54,Poitou-Charentes,86,1,27,022,Berrie,263,3,266
54,Poitou-Charentes,86,1,18,023,Berthegon,275,5,280
54,Poitou-Charentes,86,3,30,024,Béruges,1279,36,1315
54,Poitou-Charentes,86,2,25,025,Béthines,484,12,496
54,Poitou-Charentes,86,1,12,026,Beuxes,513,11,524
54,Poitou-Charentes,86,3,36,027,Biard,1618,76,1694
54,Poitou-Charentes,86,3,24,028,Bignoux,1041,29,1070
54,Poitou-Charentes,86,2,05,029,Blanzay,826,14,840
54,Poitou-Charentes,86,3,19,030,Blaslay,517,7,524
54,Poitou-Charentes,86,3,24,031,Bonnes,1674,32,1706
54,Poitou-Charentes,86,1,31,032,Bonneuil-Matours,1995,41,2036
54,Poitou-Charentes,86,2,14,034,Bouresse,589,21,610
54,Poitou-Charentes,86,2,17,035,Bourg-Archambault,191,11,202
54,Poitou-Charentes,86,1,27,036,Bournand,664,19,683
54,Poitou-Charentes,86,2,26,037,Brigueil-le-Chantre,508,8,516
54,Poitou-Charentes,86,2,08,038,Brion,243,3,246
54,Poitou-Charentes,86,2,06,039,Brux,669,14,683
54,Poitou-Charentes,86,2,25,040,La Bussière,366,12,378
54,Poitou-Charentes,86,3,22,041,Buxerolles,9879,214,10093
54,Poitou-Charentes,86,1,07,042,Buxeuil,935,19,954
54,Poitou-Charentes,86,2,06,043,Ceaux-en-Couhé,518,14,532
54,Poitou-Charentes,86,1,12,044,Ceaux-en-Loudun,598,8,606
54,Poitou-Charentes,86,3,13,045,Celle-Lévescault,1320,9,1329
54,Poitou-Charentes,86,1,31,046,Cenon-sur-Vienne,1822,53,1875
54,Poitou-Charentes,86,1,11,047,Cernay,430,12,442
54,Poitou-Charentes,86,3,19,048,Chabournay,879,18,897
54,Poitou-Charentes,86,1,12,049,Chalais,524,14,538
54,Poitou-Charentes,86,3,30,050,Chalandray,751,7,758
54,Poitou-Charentes,86,2,05,051,Champagné-le-Sec,209,9,218
54,Poitou-Charentes,86,2,08,052,Champagné-Saint-Hilaire,933,22,955
54,Poitou-Charentes,86,3,15,053,Champigny-le-Sec,1066,24,1090
54,Poitou-Charentes,86,2,05,054,Champniers,361,10,371
54,Poitou-Charentes,86,2,02,055,La Chapelle-Bâton,368,7,375
54,Poitou-Charentes,86,3,30,056,La Chapelle-Montreuil,629,7,636
54,Poitou-Charentes,86,3,24,058,La Chapelle-Moulière,617,19,636
54,Poitou-Charentes,86,2,04,059,Chapelle-Viviers,441,44,485
54,Poitou-Charentes,86,3,19,060,Charrais,912,14,926
54,Poitou-Charentes,86,2,02,061,Charroux,1162,28,1190
54,Poitou-Charentes,86,3,37,062,Chasseneuil-du-Poitou,4569,96,4665
54,Poitou-Charentes,86,2,02,063,Chatain,318,12,330
54,Poitou-Charentes,86,2,08,064,Château-Garnier,633,7,640
54,Poitou-Charentes,86,3,29,065,Château-Larcher,929,29,958
54,Poitou-Charentes,86,1,97,066,Châtellerault,33540,1100,34640
54,Poitou-Charentes,86,2,06,067,Châtillon,217,4,221
54,Poitou-Charentes,86,2,06,068,Chaunay,1197,15,1212
54,Poitou-Charentes,86,1,16,069,La Chaussée,162,3,165
54,Poitou-Charentes,86,2,04,070,Chauvigny,6875,139,7014
54,Poitou-Charentes,86,3,19,071,Cheneché,311,4,315
54,Poitou-Charentes,86,1,20,072,Chenevelles,457,5,462
54,Poitou-Charentes,86,3,15,073,Cherves,567,14,581
54,Poitou-Charentes,86,3,30,074,Chiré-en-Montreuil,868,25,893
54,Poitou-Charentes,86,1,18,075,Chouppes,740,11,751
54,Poitou-Charentes,86,3,19,076,Cissé,2485,44,2529
54,Poitou-Charentes,86,2,14,077,Civaux,958,13,971
54,Poitou-Charentes,86,2,05,078,Civray,2835,182,3017
54,Poitou-Charentes,86,3,13,080,Cloué,445,5,450
54,Poitou-Charentes,86,1,38,081,Colombiers,1477,26,1503
54,Poitou-Charentes,86,2,06,082,Couhé,1860,88,1948
54,Poitou-Charentes,86,3,13,083,Coulombiers,1088,13,1101
54,Poitou-Charentes,86,2,26,084,Coulonges,265,6,271
54,Poitou-Charentes,86,1,18,085,Coussay,270,7,277
54,Poitou-Charentes,86,1,20,086,Coussay-les-Bois,851,13,864
54,Poitou-Charentes,86,1,16,087,Craon,201,3,204
54,Poitou-Charentes,86,3,35,088,Croutelle,813,12,825
54,Poitou-Charentes,86,3,15,089,Cuhon,374,4,378
54,Poitou-Charentes,86,3,13,091,Curzay-sur-Vonne,461,7,468
54,Poitou-Charentes,86,1,27,090,Curçay-sur-Dive,230,3,233
54,Poitou-Charentes,86,1,07,092,Dangé-Saint-Romain,3144,57,3201
54,Poitou-Charentes,86,1,18,093,Dercé,157,2,159
54,Poitou-Charentes,86,3,28,094,Dienné,497,9,506
54,Poitou-Charentes,86,3,23,095,Dissay,2922,42,2964
54,Poitou-Charentes,86,1,11,096,Doussay,610,6,616
54,Poitou-Charentes,86,2,08,097,La Ferrière-Airoux,333,4,337
54,Poitou-Charentes,86,2,04,098,Fleix,151,3,154
54,Poitou-Charentes,86,3,28,099,Fleuré,999,11,1010
54,Poitou-Charentes,86,3,35,100,Fontaine-le-Comte,3453,80,3533
54,Poitou-Charentes,86,3,30,102,Frozes,485,11,496
54,Poitou-Charentes,86,2,02,104,Genouillé,527,7,534
54,Poitou-Charentes,86,2,08,103,Gençay,1781,44,1825
54,Poitou-Charentes,86,3,28,105,Gizay,379,8,387
54,Poitou-Charentes,86,1,27,106,Glénouze,114,0,114
54,Poitou-Charentes,86,2,14,107,Gouex,500,15,515
54,Poitou-Charentes,86,1,16,108,La Grimaudière,389,11,400
54,Poitou-Charentes,86,1,18,109,Guesnes,232,2,234
54,Poitou-Charentes,86,2,26,110,Haims,230,5,235
54,Poitou-Charentes,86,1,07,111,Ingrandes,1811,109,1920
54,Poitou-Charentes,86,2,09,112,L' Isle-Jourdain,1225,25,1250
54,Poitou-Charentes,86,3,29,113,Iteuil,2818,58,2876
54,Poitou-Charentes,86,3,24,114,Jardres,1059,76,1135
54,Poitou-Charentes,86,3,23,115,Jaunay-Clan,5822,173,5995
54,Poitou-Charentes,86,3,13,116,Jazeneuil,790,16,806
54,Poitou-Charentes,86,2,17,117,Jouhet,512,11,523
54,Poitou-Charentes,86,2,26,118,Journet,376,4,380
54,Poitou-Charentes,86,2,02,119,Joussé,341,1,342
54,Poitou-Charentes,86,2,17,120,Lathus-Saint-Rémy,1217,25,1242
54,Poitou-Charentes,86,3,30,121,Latillé,1429,22,1451
54,Poitou-Charentes,86,2,04,122,Lauthiers,96,3,99
54,Poitou-Charentes,86,3,30,123,Lavausseau,783,11,794
54,Poitou-Charentes,86,3,24,124,Lavoux,1118,19,1137
54,Poitou-Charentes,86,1,20,125,Leigné-les-Bois,580,13,593
54,Poitou-Charentes,86,1,10,127,Leigné-sur-Usseau,459,15,474
54,Poitou-Charentes,86,2,04,126,Leignes-sur-Fontaine,558,8,566
54,Poitou-Charentes,86,1,11,128,Lencloître,2392,33,2425
54,Poitou-Charentes,86,1,20,129,Lésigny,536,2,538
54,Poitou-Charentes,86,1,07,130,Leugny,446,4,450
54,Poitou-Charentes,86,2,14,131,Lhommaizé,809,17,826
54,Poitou-Charentes,86,2,26,132,Liglet,292,8,300
54,Poitou-Charentes,86,3,35,133,Ligugé,2935,65,3000
54,Poitou-Charentes,86,2,05,134,Linazay,217,4,221
54,Poitou-Charentes,86,3,24,135,Liniers,504,11,515
54,Poitou-Charentes,86,2,05,136,Lizant,464,5,469
54,Poitou-Charentes,86,1,12,137,Loudun,7146,331,7477
54,Poitou-Charentes,86,2,09,138,Luchapt,302,5,307
54,Poitou-Charentes,86,3,13,139,Lusignan,2610,56,2666
54,Poitou-Charentes,86,2,14,140,Lussac-les-Châteaux,2355,80,2435
54,Poitou-Charentes,86,2,08,141,Magné,618,11,629
54,Poitou-Charentes,86,3,30,142,Maillé,570,7,577
54,Poitou-Charentes,86,1,20,143,Mairé,191,4,195
54,Poitou-Charentes,86,3,15,144,Maisonneuve,298,6,304
54,Poitou-Charentes,86,3,19,146,Marigny-Brizay,1130,17,1147
54,Poitou-Charentes,86,3,29,147,Marigny-Chemereau,509,2,511
54,Poitou-Charentes,86,3,29,148,Marnay,598,10,608
54,Poitou-Charentes,86,1,16,149,Martaizé,371,7,378
54,Poitou-Charentes,86,3,29,145,Marçay,802,13,815
54,Poitou-Charentes,86,3,15,150,Massognes,274,3,277
54,Poitou-Charentes,86,1,12,151,Maulay,190,1,191
54,Poitou-Charentes,86,2,01,152,Mauprévoir,652,13,665
54,Poitou-Charentes,86,2,14,153,Mazerolles,784,26,810
54,Poitou-Charentes,86,1,16,154,Mazeuil,244,7,251
54,Poitou-Charentes,86,1,12,156,Messemé,217,1,218
54,Poitou-Charentes,86,3,33,157,Mignaloux-Beauvoir,3939,210,4149
54,Poitou-Charentes,86,3,21,158,Migné-Auxances,5984,119,6103
54,Poitou-Charentes,86,2,09,159,Millac,523,19,542
54,Poitou-Charentes,86,3,15,160,Mirebeau,2222,41,2263
54,Poitou-Charentes,86,1,16,161,Moncontour,1029,21,1050
54,Poitou-Charentes,86,1,10,162,Mondion,138,4,142
54,Poitou-Charentes,86,3,37,163,Montamisé,3088,59,3147
54,Poitou-Charentes,86,1,31,164,Monthoiron,652,6,658
54,Poitou-Charentes,86,2,17,165,Montmorillon,6443,414,6857
54,Poitou-Charentes,86,3,30,166,Montreuil-Bonnin,648,18,666
54,Poitou-Charentes,86,1,18,167,Monts-sur-Guesnes,652,13,665
54,Poitou-Charentes,86,1,27,169,Morton,350,5,355
54,Poitou-Charentes,86,2,17,170,Moulismes,409,10,419
54,Poitou-Charentes,86,2,09,171,Moussac,486,20,506
54,Poitou-Charentes,86,1,12,173,Mouterre-Silly,713,13,726
54,Poitou-Charentes,86,2,09,172,Mouterre-sur-Blourde,179,1,180
54,Poitou-Charentes,86,1,32,174,Naintré,5782,125,5907
54,Poitou-Charentes,86,2,25,175,Nalliers,309,3,312
54,Poitou-Charentes,86,2,09,176,Nérignac,141,4,145
54,Poitou-Charentes,86,3,19,177,Neuville-de-Poitou,4892,87,4979
54,Poitou-Charentes,86,3,28,178,Nieuil-l'Espoir,2289,23,2312
54,Poitou-Charentes,86,3,28,180,Nouaillé-Maupertuis,2741,73,2814
54,Poitou-Charentes,86,1,18,181,Nueil-sous-Faye,247,7,254
54,Poitou-Charentes,86,1,11,182,Orches,405,4,409
54,Poitou-Charentes,86,1,07,183,Les Ormes,1591,18,1609
54,Poitou-Charentes,86,1,11,184,Ouzilly,825,11,836
54,Poitou-Charentes,86,1,07,186,Oyré,929,28,957
54,Poitou-Charentes,86,2,04,187,Paizay-le-Sec,446,7,453
54,Poitou-Charentes,86,2,06,188,Payré,989,70,1059
54,Poitou-Charentes,86,2,02,189,Payroux,505,13,518
54,Poitou-Charentes,86,2,14,190,Persac,847,42,889
54,Poitou-Charentes,86,2,17,191,Pindray,255,6,261
54,Poitou-Charentes,86,2,17,192,Plaisance,171,2,173
54,Poitou-Charentes,86,1,20,193,Pleumartin,1180,17,1197
54,Poitou-Charentes,86,3,99,194,Poitiers,89282,2683,91965
54,Poitou-Charentes,86,1,07,195,Port-de-Piles,536,9,545
54,Poitou-Charentes,86,1,18,197,Pouant,419,13,432
54,Poitou-Charentes,86,1,27,196,Pouançay,232,9,241
54,Poitou-Charentes,86,3,24,198,Pouillé,603,9,612
54,Poitou-Charentes,86,2,01,200,Pressac,580,6,586
54,Poitou-Charentes,86,1,18,201,Prinçay,240,1,241
54,Poitou-Charentes,86,1,20,202,La Puye,581,6,587
54,Poitou-Charentes,86,2,09,203,Queaux,599,18,617
54,Poitou-Charentes,86,3,30,204,Quinçay,2114,53,2167
54,Poitou-Charentes,86,1,27,205,Ranton,193,2,195
54,Poitou-Charentes,86,1,27,206,Raslay,111,3,114
54,Poitou-Charentes,86,1,20,207,La Roche-Posay,1555,47,1602
54,Poitou-Charentes,86,1,12,079,La Roche-Rigault,537,44,581
54,Poitou-Charentes,86,3,30,208,Le Rochereau,698,18,716
54,Poitou-Charentes,86,3,28,209,Roches-Prémarie-Andillé,1680,26,1706
54,Poitou-Charentes,86,1,27,210,Roiffé,676,5,681
54,Poitou-Charentes,86,2,06,211,Romagne,855,109,964
54,Poitou-Charentes,86,3,13,213,Rouillé,2453,186,2639
54,Poitou-Charentes,86,3,34,214,Saint-Benoît,6997,247,7244
54,Poitou-Charentes,86,1,10,217,Saint-Christophe,352,7,359
54,Poitou-Charentes,86,1,16,218,Saint-Clair,203,1,204
54,Poitou-Charentes,86,3,23,219,Saint-Cyr,1018,9,1027
54,Poitou-Charentes,86,2,05,220,Saint-Gaudent,292,12,304
54,Poitou-Charentes,86,1,11,221,Saint-Genest-d'Ambière,1222,17,1239
54,Poitou-Charentes,86,3,23,222,Saint-Georges-lès-Baillargeaux,3782,57,3839
54,Poitou-Charentes,86,2,25,223,Saint-Germain,979,20,999
54,Poitou-Charentes,86,1,10,224,Saint-Gervais-les-Trois-Clochers,1320,24,1344
54,Poitou-Charentes,86,1,16,225,Saint-Jean-de-Sauves,1309,43,1352
54,Poitou-Charentes,86,3,24,226,Saint-Julien-l'Ars,2273,36,2309
54,Poitou-Charentes,86,1,12,227,Saint-Laon,126,1,127
54,Poitou-Charentes,86,2,14,228,Saint-Laurent-de-Jourdes,167,1,168
54,Poitou-Charentes,86,1,27,229,Saint-Léger-de-Montbrillais,385,6,391
54,Poitou-Charentes,86,2,26,230,Saint-Léomer,180,4,184
54,Poitou-Charentes,86,2,05,231,Saint-Macoux,474,11,485
54,Poitou-Charentes,86,2,01,234,Saint-Martin-l'Ars,411,2,413
54,Poitou-Charentes,86,2,08,235,Saint-Maurice-la-Clouère,1162,32,1194
54,Poitou-Charentes,86,2,05,237,Saint-Pierre-d'Exideuil,789,39,828
54,Poitou-Charentes,86,2,25,236,Saint-Pierre-de-Maillé,924,19,943
54,Poitou-Charentes,86,1,07,241,Saint-Rémy-sur-Creuse,402,7,409
54,Poitou-Charentes,86,2,02,242,Saint-Romain,418,8,426
54,Poitou-Charentes,86,3,13,244,Saint-Sauvant,1326,24,1350
54,Poitou-Charentes,86,1,03,245,Saint-Sauveur,1057,13,1070
54,Poitou-Charentes,86,2,25,246,Saint-Savin,906,31,937
54,Poitou-Charentes,86,2,05,247,Saint-Saviol,468,6,474
54,Poitou-Charentes,86,2,08,248,Saint-Secondin,557,7,564
54,Poitou-Charentes,86,2,04,239,Sainte-Radégonde,145,0,145
54,Poitou-Charentes,86,1,18,249,Saires,148,6,154
54,Poitou-Charentes,86,1,27,250,Saix,222,4,226
54,Poitou-Charentes,86,1,12,252,Sammarçolles,602,9,611
54,Poitou-Charentes,86,3,13,253,Sanxay,543,14,557
54,Poitou-Charentes,86,2,17,254,Saulgé,963,24,987
54,Poitou-Charentes,86,2,05,255,Savigné,1302,30,1332
54,Poitou-Charentes,86,3,24,256,Savigny-Lévescault,1028,29,1057
54,Poitou-Charentes,86,1,11,257,Savigny-sous-Faye,332,9,341
54,Poitou-Charentes,86,1,11,258,Scorbé-Clairvaux,2387,65,2452
54,Poitou-Charentes,86,1,32,259,Senillé,647,25,672
54,Poitou-Charentes,86,1,10,260,Sérigny,292,3,295
54,Poitou-Charentes,86,3,24,261,Sèvres-Anxaumont,1902,103,2005
54,Poitou-Charentes,86,2,14,262,Sillars,611,22,633
54,Poitou-Charentes,86,3,28,263,Smarves,2447,50,2497
54,Poitou-Charentes,86,2,08,264,Sommières-du-Clain,784,15,799
54,Poitou-Charentes,86,1,11,265,Sossais,418,8,426
54,Poitou-Charentes,86,2,02,266,Surin,144,1,145
54,Poitou-Charentes,86,3,24,268,Tercé,1067,22,1089
54,Poitou-Charentes,86,1,27,269,Ternay,195,5,200
54,Poitou-Charentes,86,2,26,270,Thollet,175,4,179
54,Poitou-Charentes,86,3,15,271,Thurageau,820,12,832
54,Poitou-Charentes,86,1,38,272,Thuré,2833,153,2986
54,Poitou-Charentes,86,2,26,273,La Trimouille,971,15,986
54,Poitou-Charentes,86,1,27,274,Les Trois-Moutiers,1040,25,1065
54,Poitou-Charentes,86,1,10,275,Usseau,646,19,665
54,Poitou-Charentes,86,2,08,276,Usson-du-Poitou,1315,34,1349
54,Poitou-Charentes,86,2,04,233,Valdivienne,2473,36,2509
54,Poitou-Charentes,86,3,15,277,Varennes,368,7,375
54,Poitou-Charentes,86,2,06,278,Vaux,712,7,719
54,Poitou-Charentes,86,1,10,279,Vaux-sur-Vienne,586,18,604
54,Poitou-Charentes,86,1,10,280,Vellèches,370,14,384
54,Poitou-Charentes,86,3,19,281,Vendeuvre-du-Poitou,2881,49,2930
54,Poitou-Charentes,86,3,28,284,Vernon,604,11,615
54,Poitou-Charentes,86,2,14,285,Verrières,888,29,917
54,Poitou-Charentes,86,1,18,286,Verrue,376,1,377
54,Poitou-Charentes,86,1,27,287,Vézières,347,13,360
54,Poitou-Charentes,86,1,20,288,Vicq-sur-Gartempe,727,17,744
54,Poitou-Charentes,86,2,09,289,Le Vigeant,704,33,737
54,Poitou-Charentes,86,3,28,290,La Villedieu-du-Clain,1472,22,1494
54,Poitou-Charentes,86,2,25,291,Villemort,113,0,113
54,Poitou-Charentes,86,3,19,292,Villiers,813,6,819
54,Poitou-Charentes,86,3,29,293,Vivonne,3124,48,3172
54,Poitou-Charentes,86,3,30,294,Vouillé,3415,54,3469
54,Poitou-Charentes,86,2,05,295,Voulême,365,6,371
54,Poitou-Charentes,86,2,06,296,Voulon,362,4,366
54,Poitou-Charentes,86,3,35,297,Vouneuil-sous-Biard,4893,133,5026
54,Poitou-Charentes,86,1,31,298,Vouneuil-sur-Vienne,1972,50,2022
54,Poitou-Charentes,86,3,15,299,Vouzailles,519,6,525
54,Poitou-Charentes,86,3,19,300,Yversay,262,5,267
74,Limousin,87,2,01,001,Aixe-sur-Vienne,5498,71,5569
74,Limousin,87,2,02,002,Ambazac,5349,76,5425
74,Limousin,87,1,28,003,Arnac-la-Poste,1025,13,1038
74,Limousin,87,2,09,004,Augne,107,4,111
74,Limousin,87,2,37,005,Aureil,877,12,889
74,Limousin,87,1,08,006,Azat-le-Ris,271,1,272
74,Limousin,87,1,07,007,Balledent,209,1,210
74,Limousin,87,1,08,008,La Bazeuge,166,2,168
74,Limousin,87,2,09,009,Beaumont-du-Lac,159,3,162
74,Limousin,87,1,03,011,Bellac,4372,229,4601
74,Limousin,87,1,17,012,Berneuil,415,6,421
74,Limousin,87,2,10,013,Bersac-sur-Rivalier,619,11,630
74,Limousin,87,1,04,014,Bessines-sur-Gartempe,2876,47,2923
74,Limousin,87,2,01,015,Beynac,616,76,692
74,Limousin,87,2,02,016,Les Billanges,302,4,306
74,Limousin,87,1,03,017,Blanzac,460,10,470
74,Limousin,87,1,03,018,Blond,737,40,777
74,Limousin,87,2,21,019,Boisseuil,2538,91,2629
74,Limousin,87,2,02,020,Bonnac-la-Côte,1481,17,1498
74,Limousin,87,2,01,021,Bosmie-l'Aiguille,2288,44,2332
74,Limousin,87,1,17,022,Breuilaufa,145,3,148
74,Limousin,87,1,17,023,Le Buis,196,3,199
74,Limousin,87,2,09,024,Bujaleuf,886,17,903
74,Limousin,87,2,01,025,Burgnac,731,10,741
74,Limousin,87,1,16,026,Bussière-Boffy,347,7,354
74,Limousin,87,2,05,027,Bussière-Galant,1392,32,1424
74,Limousin,87,1,16,028,Bussière-Poitevine,948,16,964
74,Limousin,87,2,05,029,Les Cars,598,7,605
74,Limousin,87,3,38,030,Chaillac-sur-Vienne,1077,41,1118
74,Limousin,87,2,29,031,Le Chalard,296,5,301
74,Limousin,87,2,05,032,Châlus,1628,80,1708
74,Limousin,87,1,17,033,Chamboret,760,18,778
74,Limousin,87,3,20,034,Champagnac-la-Rivière,558,11,569
74,Limousin,87,2,26,035,Champnétery,533,10,543
74,Limousin,87,3,20,036,Champsac,597,8,605
74,Limousin,87,3,27,037,La Chapelle-Montbrandeix,252,5,257
74,Limousin,87,2,19,038,Chaptelat,1644,27,1671
74,Limousin,87,2,23,039,Château-Chervix,779,18,797
74,Limousin,87,2,06,040,Châteauneuf-la-Forêt,1633,30,1663
74,Limousin,87,1,07,041,Châteauponsac,2164,49,2213
74,Limousin,87,2,26,042,Le Châtenet-en-Dognon,416,7,423
74,Limousin,87,2,09,043,Cheissoux,201,11,212
74,Limousin,87,3,22,044,Chéronnac,310,7,317
74,Limousin,87,1,17,045,Cieux,989,27,1016
74,Limousin,87,3,25,046,Cognac-la-Forêt,1047,61,1108
74,Limousin,87,1,17,047,Compreignac,1689,28,1717
74,Limousin,87,2,36,048,Condat-sur-Vienne,4677,86,4763
74,Limousin,87,2,29,049,Coussac-Bonneval,1356,37,1393
74,Limousin,87,2,33,050,Couzeix,7878,188,8066
74,Limousin,87,2,06,051,La Croisille-sur-Briance,707,26,733
74,Limousin,87,1,08,052,La Croix-sur-Gartempe,175,4,179
74,Limousin,87,1,28,053,Cromac,266,3,269
74,Limousin,87,3,20,054,Cussac,1187,65,1252
74,Limousin,87,1,08,055,Darnac,380,2,382
74,Limousin,87,1,08,056,Dinsac,257,12,269
74,Limousin,87,1,15,057,Dompierre-les-Églises,361,8,369
74,Limousin,87,2,09,058,Domps,139,2,141
74,Limousin,87,1,08,059,Le Dorat,1828,139,1967
74,Limousin,87,3,27,060,Dournazac,686,7,693
74,Limousin,87,1,15,061,Droux,418,12,430
74,Limousin,87,2,26,062,Eybouleuf,379,6,385
74,Limousin,87,2,21,063,Eyjeaux,1193,28,1221
74,Limousin,87,2,09,064,Eymoutiers,2055,33,2088
74,Limousin,87,2,37,065,Feytiat,5754,104,5858
74,Limousin,87,2,05,066,Flavignac,1045,12,1057
74,Limousin,87,1,04,067,Folles,538,7,545
74,Limousin,87,1,04,068,Fromental,533,7,540
74,Limousin,87,1,16,069,Gajoubert,171,4,175
74,Limousin,87,2,26,070,La Geneytouse,812,19,831
74,Limousin,87,2,29,071,Glandon,825,26,851
74,Limousin,87,2,23,072,Glanges,510,8,518
74,Limousin,87,3,25,073,Gorre,391,15,406
74,Limousin,87,1,28,074,Les Grands-Chézeaux,261,9,270
74,Limousin,87,2,31,075,Isle,7488,172,7660
74,Limousin,87,2,10,076,Jabreilles-les-Bordes,268,3,271
74,Limousin,87,2,18,077,Janailhac,451,12,463
74,Limousin,87,3,24,078,Javerdat,622,6,628
74,Limousin,87,2,10,079,La Jonchère-Saint-Maurice,788,13,801
74,Limousin,87,1,28,080,Jouac,208,1,209
74,Limousin,87,2,01,081,Jourgnac,991,24,1015
74,Limousin,87,2,29,082,Ladignac-le-Long,1122,15,1137
74,Limousin,87,2,10,083,Laurière,612,4,616
74,Limousin,87,2,05,084,Lavignac,144,10,154
74,Limousin,87,2,99,085,Limoges,140138,2287,142425
74,Limousin,87,2,06,086,Linards,1083,74,1157
74,Limousin,87,1,28,087,Lussac-les-Églises,496,13,509
74,Limousin,87,2,23,088,Magnac-Bourg,1004,18,1022
74,Limousin,87,1,15,089,Magnac-Laval,1889,169,2058
74,Limousin,87,1,28,090,Mailhac-sur-Benaize,311,5,316
74,Limousin,87,3,27,091,Maisonnais-sur-Tardoire,450,7,457
74,Limousin,87,3,27,092,Marval,579,12,591
74,Limousin,87,2,06,093,Masléon,349,4,353
74,Limousin,87,2,18,094,Meilhac,482,11,493
74,Limousin,87,2,23,095,Meuzac,725,19,744
74,Limousin,87,2,18,096,La Meyze,841,26,867
74,Limousin,87,1,16,097,Mézières-sur-Issoire,863,26,889
74,Limousin,87,2,26,099,Moissannes,353,13,366
74,Limousin,87,1,16,100,Montrol-Sénard,238,6,244
74,Limousin,87,1,16,101,Mortemart,125,3,128
74,Limousin,87,1,17,103,Nantiat,1633,46,1679
74,Limousin,87,2,09,104,Nedde,531,16,547
74,Limousin,87,2,06,105,Neuvic-Entier,964,18,982
74,Limousin,87,2,18,106,Nexon,2435,39,2474
74,Limousin,87,2,19,107,Nieul,1565,23,1588
74,Limousin,87,1,16,108,Nouic,537,8,545
74,Limousin,87,1,08,109,Oradour-Saint-Genest,396,63,459
74,Limousin,87,3,24,110,Oradour-sur-Glane,2222,34,2256
74,Limousin,87,3,20,111,Oradour-sur-Vayres,1510,26,1536
74,Limousin,87,2,05,112,Pageas,614,17,631
74,Limousin,87,2,35,113,Le Palais-sur-Vienne,5862,119,5981
74,Limousin,87,2,37,114,Panazol,10115,239,10354
74,Limousin,87,3,27,115,Pensol,184,0,184
74,Limousin,87,1,03,116,Peyrat-de-Bellac,1128,29,1157
74,Limousin,87,2,09,117,Peyrat-le-Château,1012,24,1036
74,Limousin,87,2,19,118,Peyrilhac,1164,18,1182
74,Limousin,87,2,21,119,Pierre-Buffière,1148,14,1162
74,Limousin,87,2,23,120,La Porcherie,602,10,612
74,Limousin,87,1,07,121,Rancon,542,14,556
74,Limousin,87,1,04,122,Razès,1099,14,1113
74,Limousin,87,2,09,123,Rempnat,166,6,172
74,Limousin,87,2,18,124,Rilhac-Lastours,337,7,344
74,Limousin,87,2,02,125,Rilhac-Rancon,4050,81,4131
74,Limousin,87,2,18,127,La Roche-l'Abeille,598,8,606
74,Limousin,87,3,22,126,Rochechouart,3831,121,3952
74,Limousin,87,1,17,128,Roussac,463,13,476
74,Limousin,87,2,26,129,Royères,834,19,853
74,Limousin,87,2,06,130,Roziers-Saint-Georges,193,1,194
74,Limousin,87,3,38,131,Saillat-sur-Vienne,799,19,818
74,Limousin,87,2,09,132,Saint-Amand-le-Petit,110,4,114
74,Limousin,87,1,07,133,Saint-Amand-Magnazeix,530,14,544
74,Limousin,87,3,25,135,Saint-Auvent,925,15,940
74,Limousin,87,1,16,136,Saint-Barbant,352,3,355
74,Limousin,87,3,20,137,Saint-Bazile,138,6,144
74,Limousin,87,2,21,138,Saint-Bonnet-Briance,527,12,539
74,Limousin,87,1,03,139,Saint-Bonnet-de-Bellac,533,10,543
74,Limousin,87,3,24,140,Saint-Brice-sur-Vienne,1482,38,1520
74,Limousin,87,3,25,141,Saint-Cyr,704,13,717
74,Limousin,87,2,26,142,Saint-Denis-des-Murs,507,9,516
74,Limousin,87,2,19,143,Saint-Gence,1948,40,1988
74,Limousin,87,2,21,144,Saint-Genest-sur-Roselle,450,9,459
74,Limousin,87,1,28,145,Saint-Georges-les-Landes,251,7,258
74,Limousin,87,2,23,146,Saint-Germain-les-Belles,1148,29,1177
74,Limousin,87,2,06,147,Saint-Gilles-les-Forêts,54,3,57
74,Limousin,87,2,21,148,Saint-Hilaire-Bonneval,822,15,837
74,Limousin,87,1,15,149,Saint-Hilaire-la-Treille,429,7,436
74,Limousin,87,2,18,150,Saint-Hilaire-les-Places,858,12,870
74,Limousin,87,2,21,151,Saint-Jean-Ligoure,411,4,415
74,Limousin,87,2,19,152,Saint-Jouvent,1607,31,1638
74,Limousin,87,2,09,153,Saint-Julien-le-Petit,303,4,307
74,Limousin,87,3,98,154,Saint-Junien,11539,363,11902
74,Limousin,87,1,03,155,Saint-Junien-les-Combes,194,9,203
74,Limousin,87,2,37,156,Saint-Just-le-Martel,2399,45,2444
74,Limousin,87,2,02,157,Saint-Laurent-les-Églises,799,35,834
74,Limousin,87,3,25,158,Saint-Laurent-sur-Gorre,1442,93,1535
74,Limousin,87,2,10,159,Saint-Léger-la-Montagne,309,6,315
74,Limousin,87,1,15,160,Saint-Léger-Magnazeix,513,10,523
74,Limousin,87,2,26,161,Saint-Léonard-de-Noblat,4657,109,4766
74,Limousin,87,1,16,163,Saint-Martial-sur-Isop,138,2,140
74,Limousin,87,3,24,164,Saint-Martin-de-Jussac,502,9,511
74,Limousin,87,1,28,165,Saint-Martin-le-Mault,126,0,126
74,Limousin,87,2,01,166,Saint-Martin-le-Vieux,820,13,833
74,Limousin,87,2,26,167,Saint-Martin-Terressus,540,13,553
74,Limousin,87,3,27,168,Saint-Mathieu,1171,15,1186
74,Limousin,87,2,18,169,Saint-Maurice-les-Brousses,842,10,852
74,Limousin,87,2,06,170,Saint-Méard,379,5,384
74,Limousin,87,1,08,172,Saint-Ouen-sur-Gartempe,227,7,234
74,Limousin,87,1,04,173,Saint-Pardoux,526,17,543
74,Limousin,87,2,21,174,Saint-Paul,1211,21,1232
74,Limousin,87,2,18,176,Saint-Priest-Ligoure,637,14,651
74,Limousin,87,2,01,177,Saint-Priest-sous-Aixe,1578,35,1613
74,Limousin,87,2,02,178,Saint-Priest-Taurion,2693,63,2756
74,Limousin,87,1,08,179,Saint-Sornin-la-Marche,246,7,253
74,Limousin,87,1,07,180,Saint-Sornin-Leulac,647,10,657
74,Limousin,87,2,10,181,Saint-Sulpice-Laurière,918,24,942
74,Limousin,87,1,28,182,Saint-Sulpice-les-Feuilles,1231,33,1264
74,Limousin,87,2,02,183,Saint-Sylvestre,866,7,873
74,Limousin,87,1,17,184,Saint-Symphorien-sur-Couze,219,3,222
74,Limousin,87,3,24,185,Saint-Victurnien,1652,95,1747
74,Limousin,87,2,23,186,Saint-Vitte-sur-Briance,341,5,346
74,Limousin,87,2,29,187,Saint-Yrieix-la-Perche,6969,466,7435
74,Limousin,87,2,01,188,Saint-Yrieix-sous-Aixe,390,8,398
74,Limousin,87,2,09,134,Sainte-Anne-Saint-Priest,154,1,155
74,Limousin,87,3,25,162,Sainte-Marie-de-Vaux,174,3,177
74,Limousin,87,3,22,189,Les Salles-Lavauguyon,172,2,174
74,Limousin,87,2,26,190,Sauviat-sur-Vige,935,26,961
74,Limousin,87,2,01,191,Séreilhac,1772,22,1794
74,Limousin,87,2,36,192,Solignac,1497,26,1523
74,Limousin,87,2,06,193,Surdoux,43,0,43
74,Limousin,87,2,06,194,Sussac,356,14,370
74,Limousin,87,1,08,195,Tersannes,165,3,168
74,Limousin,87,1,08,196,Thiat,186,4,190
74,Limousin,87,1,17,197,Thouron,492,2,494
74,Limousin,87,1,17,198,Vaulry,409,6,415
74,Limousin,87,3,22,199,Vayres,826,85,911
74,Limousin,87,1,08,200,Verneuil-Moustiers,157,3,160
74,Limousin,87,2,01,201,Verneuil-sur-Vienne,4037,211,4248
74,Limousin,87,2,19,202,Veyrac,1945,31,1976
74,Limousin,87,2,23,203,Vicq-sur-Breuilh,1248,23,1271
74,Limousin,87,3,22,204,Videix,244,2,246
74,Limousin,87,2,36,205,Le Vigen,2043,38,2081
74,Limousin,87,1,15,206,Villefavard,158,8,166
41,Lorraine,88,1,11,001,Les Ableuvenettes,60,2,62
41,Lorraine,88,1,11,002,Ahéville,62,0,62
41,Lorraine,88,2,04,003,Aingeville,68,1,69
41,Lorraine,88,2,15,004,Ainvelle,161,2,163
41,Lorraine,88,3,22,005,Allarmont,241,11,252
41,Lorraine,88,2,16,006,Ambacourt,273,10,283
41,Lorraine,88,1,17,007,Ameuvelle,65,0,65
41,Lorraine,88,1,21,008,Anglemont,176,3,179
41,Lorraine,88,3,13,009,Anould,3323,64,3387
41,Lorraine,88,2,07,010,Aouze,194,5,199
41,Lorraine,88,1,12,011,Arches,1710,119,1829
41,Lorraine,88,1,12,012,Archettes,1072,12,1084
41,Lorraine,88,2,07,013,Aroffe,97,0,97
41,Lorraine,88,3,08,014,Arrentès-de-Corcieux,170,3,173
41,Lorraine,88,2,18,015,Attignéville,223,13,236
41,Lorraine,88,1,10,016,Attigny,258,5,263
41,Lorraine,88,2,04,017,Aulnois,148,4,152
41,Lorraine,88,3,08,018,Aumontzey,473,4,477
41,Lorraine,88,2,09,019,Autigny-la-Tour,173,2,175
41,Lorraine,88,2,09,020,Autreville,167,2,169
41,Lorraine,88,1,21,021,Autrey,303,9,312
41,Lorraine,88,2,04,022,Auzainvilliers,216,5,221
41,Lorraine,88,1,05,023,Avillers,84,2,86
41,Lorraine,88,1,05,024,Avrainville,95,1,96
41,Lorraine,88,2,09,025,Avranville,77,2,79
41,Lorraine,88,1,03,026,Aydoilles,1059,39,1098
41,Lorraine,88,1,06,027,Badménil-aux-Bois,137,2,139
41,Lorraine,88,1,12,028,La Baffe,638,80,718
41,Lorraine,88,1,01,029,Bains-les-Bains,1337,129,1466
41,Lorraine,88,1,11,030,Bainville-aux-Saules,122,7,129
41,Lorraine,88,2,07,031,Balléville,110,2,112
41,Lorraine,88,3,24,032,Ban-de-Laveline,1281,18,1299
41,Lorraine,88,3,26,033,Ban-de-Sapt,337,8,345
41,Lorraine,88,3,13,106,Ban-sur-Meurthe-Clefcy,965,25,990
41,Lorraine,88,3,08,035,Barbey-Seroux,138,3,141
41,Lorraine,88,2,18,036,Barville,85,2,87
41,Lorraine,88,1,25,037,Basse-sur-le-Rupt,887,30,917
41,Lorraine,88,1,05,038,Battexey,29,2,31
41,Lorraine,88,2,16,039,Baudricourt,311,13,324
41,Lorraine,88,1,06,040,Bayecourt,280,4,284
41,Lorraine,88,1,11,041,Bazegney,90,2,92
41,Lorraine,88,1,21,042,Bazien,88,1,89
41,Lorraine,88,2,28,043,Bazoilles-et-Ménil,117,4,121
41,Lorraine,88,2,18,044,Bazoilles-sur-Meuse,577,20,597
41,Lorraine,88,2,18,045,Beaufremont,70,4,74
41,Lorraine,88,1,03,046,Beauménil,128,1,129
41,Lorraine,88,1,11,047,Begnécourt,171,9,180
41,Lorraine,88,1,19,048,Bellefontaine,972,25,997
41,Lorraine,88,1,10,049,Belmont-lès-Darney,122,2,124
41,Lorraine,88,3,02,050,Belmont-sur-Buttant,275,5,280
41,Lorraine,88,2,04,051,Belmont-sur-Vair,126,3,129
41,Lorraine,88,1,10,052,Belrupt,107,3,110
41,Lorraine,88,3,26,053,Belval,175,3,178
41,Lorraine,88,3,24,054,Bertrimoutier,375,8,383
41,Lorraine,88,1,11,055,Bettegney-Saint-Brice,130,0,130
41,Lorraine,88,1,05,056,Bettoncourt,94,2,96
41,Lorraine,88,3,20,057,Le Beulay,105,2,107
41,Lorraine,88,2,16,058,Biécourt,93,2,95
41,Lorraine,88,3,02,059,Biffontaine,445,1,446
41,Lorraine,88,2,16,060,Blémerey,16,1,17
41,Lorraine,88,1,17,061,Bleurville,358,12,370
41,Lorraine,88,2,15,062,Blevaincourt,110,4,114
41,Lorraine,88,1,11,063,Bocquegney,134,4,138
41,Lorraine,88,3,02,064,Bois-de-Champ,113,3,116
41,Lorraine,88,1,10,065,Bonvillet,340,9,349
41,Lorraine,88,2,16,066,Boulaincourt,65,1,66
41,Lorraine,88,3,31,068,La Bourgonce,834,13,847
41,Lorraine,88,1,11,069,Bouxières-aux-Bois,121,2,123
41,Lorraine,88,1,05,070,Bouxurulles,149,7,156
41,Lorraine,88,1,11,071,Bouzemont,57,1,58
41,Lorraine,88,1,05,073,Brantigny,179,3,182
41,Lorraine,88,2,18,074,Brechainville,48,1,49
41,Lorraine,88,1,25,075,La Bresse,4716,215,4931
41,Lorraine,88,3,02,076,Brouvelieures,510,15,525
41,Lorraine,88,1,21,077,Brû,602,13,615
41,Lorraine,88,1,03,078,Bruyères,3335,72,3407
41,Lorraine,88,2,04,079,Bulgnéville,1365,85,1450
41,Lorraine,88,1,21,080,Bult,301,9,310
41,Lorraine,88,1,27,081,Bussang,1612,25,1637
41,Lorraine,88,3,22,082,Celles-sur-Plaine,852,16,868
41,Lorraine,88,2,18,083,Certilleux,240,9,249
41,Lorraine,88,1,05,084,Chamagne,479,8,487
41,Lorraine,88,1,03,086,Champ-le-Duc,560,11,571
41,Lorraine,88,3,08,085,Champdray,161,5,166
41,Lorraine,88,1,30,087,Chantraine,3067,127,3194
41,Lorraine,88,1,29,088,La Chapelle-aux-Bois,658,18,676
41,Lorraine,88,3,08,089,La Chapelle-devant-Bruyères,622,9,631
41,Lorraine,88,1,05,090,Charmes,4597,87,4684
41,Lorraine,88,1,03,091,Charmois-devant-Bruyères,415,20,435
41,Lorraine,88,1,29,092,Charmois-l'Orgueilleux,597,13,610
41,Lorraine,88,3,26,093,Châtas,56,1,57
41,Lorraine,88,1,06,094,Châtel-sur-Moselle,1671,64,1735
41,Lorraine,88,2,07,095,Châtenois,1781,48,1829
41,Lorraine,88,2,15,096,Châtillon-sur-Saône,153,2,155
41,Lorraine,88,2,16,097,Chauffecourt,35,0,35
41,Lorraine,88,1,30,098,Chaumousey,863,29,892
41,Lorraine,88,1,06,099,Chavelot,1501,34,1535
41,Lorraine,88,2,16,100,Chef-Haut,47,2,49
41,Lorraine,88,1,03,101,Cheniménil,1157,36,1193
41,Lorraine,88,2,09,102,Chermisey,96,6,102
41,Lorraine,88,1,11,103,Circourt,101,1,102
41,Lorraine,88,2,18,104,Circourt-sur-Mouzon,220,7,227
41,Lorraine,88,1,17,105,Claudon,208,6,214
41,Lorraine,88,2,09,107,Clérey-la-Côte,35,2,37
41,Lorraine,88,1,29,108,Le Clerjus,565,12,577
41,Lorraine,88,1,23,109,Cleurie,616,22,638
41,Lorraine,88,1,21,110,Clézentaine,217,9,226
41,Lorraine,88,3,24,111,Coinches,345,9,354
41,Lorraine,88,3,20,112,Colroy-la-Grande,574,9,583
41,Lorraine,88,3,24,113,Combrimont,159,7,166
41,Lorraine,88,2,28,114,Contrexéville,3480,225,3705
41,Lorraine,88,3,08,115,Corcieux,1661,30,1691
41,Lorraine,88,1,25,116,Cornimont,3671,68,3739
41,Lorraine,88,2,07,117,Courcelles-sous-Châtenois,86,2,88
41,Lorraine,88,2,09,118,Coussey,715,21,736
41,Lorraine,88,2,04,119,Crainvilliers,189,0,189
41,Lorraine,88,3,13,120,La Croix-aux-Mines,548,7,555
41,Lorraine,88,1,06,121,Damas-aux-Bois,267,3,270
41,Lorraine,88,1,11,122,Damas-et-Bettegney,374,8,382
41,Lorraine,88,2,15,123,Damblain,288,5,293
41,Lorraine,88,1,10,124,Darney,1223,70,1293
41,Lorraine,88,2,07,125,Darney-aux-Chênes,72,4,76
41,Lorraine,88,1,30,126,Darnieulles,1436,41,1477
41,Lorraine,88,1,21,127,Deinvillers,61,2,63
41,Lorraine,88,3,26,128,Denipaire,252,7,259
41,Lorraine,88,1,11,129,Derbamont,89,2,91
41,Lorraine,88,1,03,130,Destord,236,6,242
41,Lorraine,88,1,03,131,Deycimont,278,2,280
41,Lorraine,88,1,12,132,Deyvillers,1501,47,1548
41,Lorraine,88,1,12,133,Dignonville,185,5,190
41,Lorraine,88,1,12,134,Dinozé,495,13,508
41,Lorraine,88,1,03,135,Docelles,1000,25,1025
41,Lorraine,88,1,12,136,Dogneville,1477,51,1528
41,Lorraine,88,2,07,137,Dolaincourt,83,5,88
41,Lorraine,88,1,10,138,Dombasle-devant-Darney,94,1,95
41,Lorraine,88,2,16,139,Dombasle-en-Xaintois,120,2,122
41,Lorraine,88,2,28,140,Dombrot-le-Sec,367,10,377
41,Lorraine,88,2,04,141,Dombrot-sur-Vair,250,4,254
41,Lorraine,88,2,28,144,Domèvre-sous-Montfort,60,4,64
41,Lorraine,88,1,30,142,Domèvre-sur-Avière,448,9,457
41,Lorraine,88,1,06,143,Domèvre-sur-Durbion,258,12,270
41,Lorraine,88,3,02,145,Domfaing,242,2,244
41,Lorraine,88,2,28,146,Domjulien,201,0,201
41,Lorraine,88,1,30,147,Dommartin-aux-Bois,400,9,409
41,Lorraine,88,1,23,148,Dommartin-lès-Remiremont,1853,65,1918
41,Lorraine,88,1,10,149,Dommartin-lès-Vallois,54,3,57
41,Lorraine,88,2,07,150,Dommartin-sur-Vraine,324,6,330
41,Lorraine,88,1,11,151,Dompaire,1050,26,1076
41,Lorraine,88,1,03,152,Dompierre,274,8,282
41,Lorraine,88,1,21,153,Domptail,323,10,333
41,Lorraine,88,2,09,154,Domrémy-la-Pucelle,153,1,154
41,Lorraine,88,2,16,155,Domvallier,124,4,128
41,Lorraine,88,1,21,156,Doncières,151,5,156
41,Lorraine,88,1,29,157,Dounoux,785,22,807
41,Lorraine,88,1,23,158,Éloyes,3290,83,3373
41,Lorraine,88,3,13,159,Entre-deux-Eaux,473,22,495
41,Lorraine,88,1,99,160,Épinal,33043,1789,34832
41,Lorraine,88,1,10,161,Escles,471,9,480
41,Lorraine,88,1,10,162,Esley,178,6,184
41,Lorraine,88,1,05,163,Essegney,676,8,684
41,Lorraine,88,2,28,164,Estrennes,92,3,95
41,Lorraine,88,3,22,165,Étival-Clairefontaine,2422,52,2474
41,Lorraine,88,1,05,166,Évaux-et-Ménil,342,3,345
41,Lorraine,88,1,23,167,Faucompierre,218,5,223
41,Lorraine,88,1,21,168,Fauconcourt,123,6,129
41,Lorraine,88,1,03,169,Fays,241,11,252
41,Lorraine,88,1,27,170,Ferdrupt,797,23,820
41,Lorraine,88,1,17,171,Fignévelle,56,1,57
41,Lorraine,88,1,03,172,Fiménil,258,6,264
41,Lorraine,88,1,05,173,Florémont,440,6,446
41,Lorraine,88,1,30,174,Fomerey,150,5,155
41,Lorraine,88,1,03,175,Fontenay,486,10,496
41,Lorraine,88,1,01,176,Fontenoy-le-Château,671,47,718
41,Lorraine,88,1,23,177,La Forge,573,22,595
41,Lorraine,88,1,30,178,Les Forges,2017,69,2086
41,Lorraine,88,2,15,179,Fouchécourt,53,0,53
41,Lorraine,88,2,15,180,Frain,145,3,148
41,Lorraine,88,3,13,181,Fraize,3053,49,3102
41,Lorraine,88,3,24,182,Frapelle,218,7,225
41,Lorraine,88,2,09,183,Frebécourt,305,14,319
41,Lorraine,88,3,02,184,Fremifontaine,430,10,440
41,Lorraine,88,2,16,185,Frenelle-la-Grande,128,7,135
41,Lorraine,88,2,16,186,Frenelle-la-Petite,46,1,47
41,Lorraine,88,1,10,187,Frénois,42,0,42
41,Lorraine,88,1,27,188,Fresse-sur-Moselle,1896,43,1939
41,Lorraine,88,2,18,189,Fréville,135,5,140
41,Lorraine,88,1,06,190,Frizon,423,10,433
41,Lorraine,88,1,11,192,Gelvécourt-et-Adompt,86,4,90
41,Lorraine,88,3,24,193,Gemaingoutte,121,5,126
41,Lorraine,88,2,28,194,Gemmelaincourt,158,5,163
41,Lorraine,88,2,04,195,Gendreville,113,3,116
41,Lorraine,88,3,14,196,Gérardmer,8700,636,9336
41,Lorraine,88,1,25,197,Gerbamont,356,10,366
41,Lorraine,88,3,08,198,Gerbépal,532,11,543
41,Lorraine,88,1,17,199,Gignéville,61,2,63
41,Lorraine,88,1,06,200,Gigney,65,0,65
41,Lorraine,88,1,30,201,Girancourt,820,24,844
41,Lorraine,88,1,05,202,Gircourt-lès-Viéville,173,3,176
41,Lorraine,88,1,03,203,Girecourt-sur-Durbion,304,6,310
41,Lorraine,88,1,06,204,Girmont,948,21,969
41,Lorraine,88,1,19,205,Girmont-Val-d'Ajol,237,12,249
41,Lorraine,88,2,07,206,Gironcourt-sur-Vraine,977,20,997
41,Lorraine,88,1,17,208,Godoncourt,132,6,138
41,Lorraine,88,1,30,209,Golbey,8229,133,8362
41,Lorraine,88,1,11,210,Gorhey,150,3,153
41,Lorraine,88,2,18,212,Grand,459,10,469
41,Lorraine,88,3,20,213,La Grande-Fosse,115,3,118
41,Lorraine,88,3,26,215,Grandrupt,90,1,91
41,Lorraine,88,1,01,214,Grandrupt-de-Bains,82,2,84
41,Lorraine,88,1,03,216,Grandvillers,697,22,719
41,Lorraine,88,3,08,218,Granges-sur-Vologne,2298,47,2345
41,Lorraine,88,2,09,219,Greux,165,5,170
41,Lorraine,88,2,15,220,Grignoncourt,45,0,45
41,Lorraine,88,1,01,221,Gruey-lès-Surance,247,6,253
41,Lorraine,88,1,03,222,Gugnécourt,185,18,203
41,Lorraine,88,1,11,223,Gugney-aux-Aulx,150,9,159
41,Lorraine,88,1,06,224,Hadigny-les-Verrières,407,9,416
41,Lorraine,88,1,29,225,Hadol,2251,140,2391
41,Lorraine,88,1,11,226,Hagécourt,117,3,120
41,Lorraine,88,2,04,227,Hagnéville-et-Roncourt,82,2,84
41,Lorraine,88,1,06,228,Haillainville,159,2,161
41,Lorraine,88,2,18,229,Harchéchamp,109,2,111
41,Lorraine,88,1,21,230,Hardancourt,45,0,45
41,Lorraine,88,2,28,231,Haréville,538,14,552
41,Lorraine,88,2,09,232,Harmonville,224,7,231
41,Lorraine,88,1,11,233,Harol,570,65,635
41,Lorraine,88,1,01,234,Harsault,415,10,425
41,Lorraine,88,1,01,235,Hautmougey,153,8,161
41,Lorraine,88,1,01,236,La Haye,134,3,137
41,Lorraine,88,1,11,237,Hennecourt,346,12,358
41,Lorraine,88,1,10,238,Hennezel,425,10,435
41,Lorraine,88,1,05,239,Hergugney,138,4,142
41,Lorraine,88,3,08,240,Herpelmont,239,2,241
41,Lorraine,88,2,07,241,Houécourt,433,8,441
41,Lorraine,88,2,18,242,Houéville,40,2,42
41,Lorraine,88,1,21,243,Housseras,457,21,478
41,Lorraine,88,3,08,244,La Houssière,579,8,587
41,Lorraine,88,3,26,245,Hurbache,310,8,318
41,Lorraine,88,2,16,246,Hymont,490,17,507
41,Lorraine,88,1,06,247,Igney,1123,30,1153
41,Lorraine,88,2,15,248,Isches,199,8,207
41,Lorraine,88,2,18,249,Jainvillotte,91,0,91
41,Lorraine,88,1,23,250,Jarménil,417,4,421
41,Lorraine,88,1,21,251,Jeanménil,1047,47,1094
41,Lorraine,88,1,10,252,Jésonville,121,4,125
41,Lorraine,88,1,12,253,Jeuxey,659,38,697
41,Lorraine,88,1,11,254,Jorxey,91,2,93
41,Lorraine,88,2,09,255,Jubainville,88,3,91
41,Lorraine,88,3,08,256,Jussarupt,292,13,305
41,Lorraine,88,2,16,257,Juvaincourt,177,5,182
41,Lorraine,88,2,15,258,Lamarche,1062,27,1089
41,Lorraine,88,2,18,259,Landaville,307,10,317
41,Lorraine,88,1,05,260,Langley,188,0,188
41,Lorraine,88,1,03,261,Laval-sur-Vologne,629,17,646
41,Lorraine,88,1,03,262,Laveline-devant-Bruyères,647,5,652
41,Lorraine,88,1,03,263,Laveline-du-Houx,222,7,229
41,Lorraine,88,1,11,264,Légéville-et-Bonfays,59,0,59
41,Lorraine,88,2,18,265,Lemmecourt,27,2,29
41,Lorraine,88,1,03,266,Lépanges-sur-Vologne,929,21,950
41,Lorraine,88,1,10,267,Lerrain,468,18,486
41,Lorraine,88,3,24,268,Lesseux,150,0,150
41,Lorraine,88,3,14,269,Liézey,284,8,292
41,Lorraine,88,2,18,270,Liffol-le-Grand,2365,60,2425
41,Lorraine,88,2,28,271,Lignéville,295,11,306
41,Lorraine,88,2,15,272,Lironcourt,72,5,77
41,Lorraine,88,1,12,273,Longchamp,403,18,421
41,Lorraine,88,2,07,274,Longchamp-sous-Châtenois,102,9,111
41,Lorraine,88,3,20,275,Lubine,245,3,248
41,Lorraine,88,3,20,276,Lusse,448,6,454
41,Lorraine,88,3,22,277,Luvigny,114,2,116
41,Lorraine,88,2,07,278,Maconcourt,95,4,99
41,Lorraine,88,2,16,279,Madecourt,59,1,60
41,Lorraine,88,1,11,280,Madegney,73,3,76
41,Lorraine,88,1,11,281,Madonne-et-Lamerey,392,14,406
41,Lorraine,88,1,01,282,Le Magny,46,0,46
41,Lorraine,88,2,04,283,Malaincourt,89,6,95
41,Lorraine,88,3,13,284,Mandray,619,15,634
41,Lorraine,88,2,04,285,Mandres-sur-Vair,343,42,385
41,Lorraine,88,1,05,286,Marainville-sur-Madon,86,6,92
41,Lorraine,88,2,15,287,Marey,59,7,66
41,Lorraine,88,1,11,288,Maroncourt,11,0,11
41,Lorraine,88,2,15,289,Martigny-les-Bains,849,71,920
41,Lorraine,88,2,09,290,Martigny-les-Gerbonvaux,121,2,123
41,Lorraine,88,1,17,291,Martinvelle,128,7,135
41,Lorraine,88,2,16,292,Mattaincourt,842,22,864
41,Lorraine,88,2,09,293,Maxey-sur-Meuse,262,9,271
41,Lorraine,88,1,06,294,Mazeley,249,4,253
41,Lorraine,88,2,16,295,Mazirot,219,6,225
41,Lorraine,88,2,04,296,Médonville,72,5,77
41,Lorraine,88,1,03,297,Méménil,152,2,154
41,Lorraine,88,1,21,298,Ménarmont,49,0,49
41,Lorraine,88,1,27,302,Le Ménil,1177,34,1211
41,Lorraine,88,3,26,300,Ménil-de-Senones,139,1,140
41,Lorraine,88,2,16,299,Ménil-en-Xaintois,150,3,153
41,Lorraine,88,1,21,301,Ménil-sur-Belvitte,314,7,321
41,Lorraine,88,2,09,303,Midrevaux,208,3,211
41,Lorraine,88,2,16,304,Mirecourt,5906,470,6376
41,Lorraine,88,2,09,305,Moncel-sur-Vair,221,16,237
41,Lorraine,88,3,26,306,Le Mont,51,1,52
41,Lorraine,88,2,15,307,Mont-lès-Lamarche,101,5,106
41,Lorraine,88,2,18,308,Mont-lès-Neufchâteau,267,6,273
41,Lorraine,88,2,28,309,Monthureux-le-Sec,160,7,167
41,Lorraine,88,1,17,310,Monthureux-sur-Saône,941,16,957
41,Lorraine,88,1,01,311,Montmotier,55,1,56
41,Lorraine,88,2,07,312,Morelmaison,194,7,201
41,Lorraine,88,1,06,313,Moriville,441,4,445
41,Lorraine,88,2,15,314,Morizécourt,127,4,131
41,Lorraine,88,3,02,315,Mortagne,166,4,170
41,Lorraine,88,2,04,316,Morville,62,2,64
41,Lorraine,88,3,26,317,Moussey,700,9,709
41,Lorraine,88,1,21,318,Moyemont,220,4,224
41,Lorraine,88,3,26,319,Moyenmoutier,3302,66,3368
41,Lorraine,88,3,24,320,Nayemont-les-Fosses,901,34,935
41,Lorraine,88,2,18,321,Neufchâteau,7034,338,7372
41,Lorraine,88,1,03,322,La Neuveville-devant-Lépanges,442,5,447
41,Lorraine,88,2,07,324,La Neuveville-sous-Châtenois,364,7,371
41,Lorraine,88,2,28,325,La Neuveville-sous-Montfort,174,2,176
41,Lorraine,88,3,24,326,Neuvillers-sur-Fave,313,8,321
41,Lorraine,88,1,06,327,Nomexy,2161,27,2188
41,Lorraine,88,3,22,328,Nompatelize,558,18,576
41,Lorraine,88,1,17,330,Nonville,182,5,187
41,Lorraine,88,1,03,331,Nonzeville,41,0,41
41,Lorraine,88,2,04,332,Norroy,236,5,241
41,Lorraine,88,1,21,333,Nossoncourt,102,2,104
41,Lorraine,88,2,16,334,Oëlleville,293,12,305
41,Lorraine,88,2,28,335,Offroicourt,154,3,157
41,Lorraine,88,2,07,336,Ollainville,71,1,72
41,Lorraine,88,1,06,337,Oncourt,162,5,167
41,Lorraine,88,1,21,338,Ortoncourt,81,1,82
41,Lorraine,88,1,03,340,Padoux,474,12,486
41,Lorraine,88,3,24,341,Pair-et-Grandrupt,474,16,490
41,Lorraine,88,1,06,342,Pallegney,161,4,165
41,Lorraine,88,2,04,343,Parey-sous-Montfort,140,13,153
41,Lorraine,88,2,18,344,Pargny-sous-Mureau,192,6,198
41,Lorraine,88,3,20,345,La Petite-Fosse,93,1,94
41,Lorraine,88,3,26,346,La Petite-Raon,888,12,900
41,Lorraine,88,1,10,347,Pierrefitte,94,3,97
41,Lorraine,88,1,03,348,Pierrepont-sur-l'Arentèle,167,3,170
41,Lorraine,88,3,13,349,Plainfaing,1826,34,1860
41,Lorraine,88,2,07,350,Pleuvezain,83,1,84
41,Lorraine,88,1,19,351,Plombières-les-Bains,1913,43,1956
41,Lorraine,88,2,18,352,Pompierre,236,12,248
41,Lorraine,88,1,10,353,Pont-lès-Bonfays,87,0,87
41,Lorraine,88,1,05,354,Pont-sur-Madon,154,5,159
41,Lorraine,88,1,05,355,Portieux,1322,11,1333
41,Lorraine,88,3,02,356,Les Poulières,226,1,227
41,Lorraine,88,2,16,357,Poussay,720,21,741
41,Lorraine,88,1,23,358,Pouxeux,1967,45,2012
41,Lorraine,88,1,03,359,Prey,90,4,94
41,Lorraine,88,1,10,360,Provenchères-lès-Darney,162,3,165
41,Lorraine,88,3,20,361,Provenchères-sur-Fave,870,22,892
41,Lorraine,88,3,26,362,Le Puid,98,6,104
41,Lorraine,88,2,09,363,Punerot,178,7,185
41,Lorraine,88,2,16,364,Puzieux,160,1,161
41,Lorraine,88,1,11,365,Racécourt,146,4,150
41,Lorraine,88,2,07,366,Rainville,278,10,288
41,Lorraine,88,1,21,367,Rambervillers,5685,202,5887
41,Lorraine,88,2,16,368,Ramecourt,168,9,177
41,Lorraine,88,1,27,369,Ramonchamp,1995,124,2119
41,Lorraine,88,2,28,370,Rancourt,66,2,68
41,Lorraine,88,1,23,371,Raon-aux-Bois,1171,41,1212
41,Lorraine,88,3,22,372,Raon-l'Étape,6678,191,6869
41,Lorraine,88,3,22,373,Raon-sur-Plaine,159,0,159
41,Lorraine,88,1,05,374,Rapey,16,2,18
41,Lorraine,88,3,24,375,Raves,443,7,450
41,Lorraine,88,2,18,376,Rebeuville,256,15,271
41,Lorraine,88,1,17,377,Regnévelle,144,2,146
41,Lorraine,88,1,11,378,Regney,92,0,92
41,Lorraine,88,1,06,379,Rehaincourt,335,7,342
41,Lorraine,88,3,08,380,Rehaupal,190,6,196
41,Lorraine,88,1,10,381,Relanges,217,6,223
41,Lorraine,88,2,16,382,Remicourt,77,5,82
41,Lorraine,88,1,23,383,Remiremont,8038,489,8527
41,Lorraine,88,3,24,386,Remomeix,465,16,481
41,Lorraine,88,2,28,385,Remoncourt,593,11,604
41,Lorraine,88,2,07,387,Removille,199,8,207
41,Lorraine,88,1,30,388,Renauvoid,119,5,124
41,Lorraine,88,2,16,389,Repel,62,2,64
41,Lorraine,88,2,15,390,Robécourt,119,4,123
41,Lorraine,88,1,25,391,Rochesson,671,19,690
41,Lorraine,88,2,15,392,Rocourt,24,0,24
41,Lorraine,88,2,18,393,Rollainville,327,12,339
41,Lorraine,88,2,15,394,Romain-aux-Bois,43,0,43
41,Lorraine,88,1,21,395,Romont,348,14,362
41,Lorraine,88,3,02,398,Les Rouges-Eaux,79,2,81
41,Lorraine,88,1,03,399,Le Roulier,194,6,200
41,Lorraine,88,2,16,400,Rouvres-en-Xaintois,293,6,299
41,Lorraine,88,2,07,401,Rouvres-la-Chétive,438,15,453
41,Lorraine,88,1,21,402,Roville-aux-Chênes,391,200,591
41,Lorraine,88,2,28,403,Rozerotte,201,7,208
41,Lorraine,88,2,15,404,Rozières-sur-Mouzon,87,0,87
41,Lorraine,88,1,05,406,Rugney,126,2,128
41,Lorraine,88,2,09,407,Ruppes,126,9,135
41,Lorraine,88,1,27,408,Rupt-sur-Moselle,3587,73,3660
41,Lorraine,88,1,23,409,Saint-Amé,2133,70,2203
41,Lorraine,88,1,10,411,Saint-Baslemont,90,2,92
41,Lorraine,88,1,21,412,Saint-Benoît-la-Chipotte,417,9,426
41,Lorraine,88,3,98,413,Saint-Dié-des-Vosges,21705,1038,22743
41,Lorraine,88,1,23,415,Saint-Étienne-lès-Remiremont,3879,95,3974
41,Lorraine,88,1,21,416,Saint-Genest,127,4,131
41,Lorraine,88,1,21,417,Saint-Gorgon,380,5,385
41,Lorraine,88,3,26,419,Saint-Jean-d'Ormont,158,5,163
41,Lorraine,88,2,15,421,Saint-Julien,135,4,139
41,Lorraine,88,3,13,423,Saint-Léonard,1380,25,1405
41,Lorraine,88,1,21,425,Saint-Maurice-sur-Mortagne,177,6,183
41,Lorraine,88,1,27,426,Saint-Maurice-sur-Moselle,1494,28,1522
41,Lorraine,88,2,16,427,Saint-Menge,102,6,108
41,Lorraine,88,3,31,428,Saint-Michel-sur-Meurthe,2037,67,2104
41,Lorraine,88,1,23,429,Saint-Nabord,3987,229,4216
41,Lorraine,88,2,04,430,Saint-Ouen-lès-Parey,492,4,496
41,Lorraine,88,2,07,431,Saint-Paul,137,3,140
41,Lorraine,88,1,21,432,Saint-Pierremont,159,7,166
41,Lorraine,88,2,16,433,Saint-Prancher,74,2,76
41,Lorraine,88,2,04,434,Saint-Remimont,210,4,214
41,Lorraine,88,3,22,435,Saint-Remy,505,14,519
41,Lorraine,88,3,26,436,Saint-Stail,77,4,81
41,Lorraine,88,1,11,437,Saint-Vallier,97,1,98
41,Lorraine,88,1,21,410,Sainte-Barbe,280,5,285
41,Lorraine,88,1,03,418,Sainte-Hélène,460,12,472
41,Lorraine,88,3,24,424,Sainte-Marguerite,2451,65,2516
41,Lorraine,88,3,31,438,La Salle,399,5,404
41,Lorraine,88,1,30,439,Sanchey,786,25,811
41,Lorraine,88,2,07,440,Sandaucourt,204,2,206
41,Lorraine,88,1,10,441,Sans-Vallois,119,6,125
41,Lorraine,88,1,25,442,Sapois,651,16,667
41,Lorraine,88,2,18,443,Sartes,103,4,107
41,Lorraine,88,3,26,444,Le Saulcy,308,8,316
41,Lorraine,88,3,24,445,Saulcy-sur-Meurthe,2360,61,2421
41,Lorraine,88,2,04,446,Saulxures-lès-Bulgnéville,256,6,262
41,Lorraine,88,1,25,447,Saulxures-sur-Moselotte,2796,142,2938
41,Lorraine,88,2,04,448,Sauville,197,3,200
41,Lorraine,88,1,05,449,Savigny,189,9,198
41,Lorraine,88,2,15,450,Senaide,203,5,208
41,Lorraine,88,3,26,451,Senones,2797,65,2862
41,Lorraine,88,1,10,452,Senonges,148,3,151
41,Lorraine,88,2,09,453,Seraumont,48,0,48
41,Lorraine,88,1,06,454,Sercoeur,268,3,271
41,Lorraine,88,2,15,455,Serécourt,105,1,106
41,Lorraine,88,2,15,456,Serocourt,100,1,101
41,Lorraine,88,2,09,457,Sionne,138,7,145
41,Lorraine,88,1,05,458,Socourt,241,5,246
41,Lorraine,88,2,07,459,Soncourt,56,1,57
41,Lorraine,88,2,09,460,Soulosse-sous-Saint-Élophe,603,21,624
41,Lorraine,88,2,04,461,Suriauville,208,5,213
41,Lorraine,88,1,23,462,Le Syndicat,1914,64,1978
41,Lorraine,88,3,31,463,Taintrux,1569,44,1613
41,Lorraine,88,1,23,464,Tendon,496,17,513
41,Lorraine,88,1,06,465,Thaon-les-Vosges,8035,213,8248
41,Lorraine,88,2,28,466,They-sous-Montfort,156,2,158
41,Lorraine,88,1,25,467,Thiéfosse,589,21,610
41,Lorraine,88,1,27,468,Le Thillot,3757,81,3838
41,Lorraine,88,2,16,469,Thiraucourt,104,5,109
41,Lorraine,88,1,23,470,Le Tholy,1596,53,1649
41,Lorraine,88,2,15,471,Les Thons,129,6,135
41,Lorraine,88,2,28,472,Thuillières,140,1,141
41,Lorraine,88,2,15,473,Tignécourt,109,3,112
41,Lorraine,88,2,18,474,Tilleux,69,1,70
41,Lorraine,88,2,15,475,Tollaincourt,121,2,123
41,Lorraine,88,2,16,476,Totainville,134,3,137
41,Lorraine,88,2,18,477,Trampot,112,1,113
41,Lorraine,88,2,09,478,Tranqueville-Graux,80,2,82
41,Lorraine,88,1,01,479,Trémonzey,232,7,239
41,Lorraine,88,1,05,480,Ubexy,170,5,175
41,Lorraine,88,1,29,481,Uriménil,1355,20,1375
41,Lorraine,88,2,04,482,Urville,69,1,70
41,Lorraine,88,1,30,483,Uxegney,2030,52,2082
41,Lorraine,88,1,29,484,Uzemain,1108,15,1123
41,Lorraine,88,2,04,485,La Vacheresse-et-la-Rouillie,122,1,123
41,Lorraine,88,1,25,486,Vagney,3989,132,4121
41,Lorraine,88,1,19,487,Le Val-d'Ajol,4098,155,4253
41,Lorraine,88,2,28,488,Valfroicourt,248,12,260
41,Lorraine,88,2,16,489,Valleroy-aux-Saules,252,1,253
41,Lorraine,88,2,28,490,Valleroy-le-Sec,168,6,174
41,Lorraine,88,1,10,491,Les Vallois,105,2,107
41,Lorraine,88,3,13,492,Le Valtin,92,2,94
41,Lorraine,88,1,05,493,Varmonzey,24,0,24
41,Lorraine,88,1,11,494,Vaubexy,116,5,121
41,Lorraine,88,1,12,495,Vaudéville,174,7,181
41,Lorraine,88,2,04,496,Vaudoncourt,131,3,134
41,Lorraine,88,1,06,497,Vaxoncourt,479,4,483
41,Lorraine,88,1,23,498,Vecoux,990,49,1039
41,Lorraine,88,1,11,499,Velotte-et-Tatignécourt,165,6,171
41,Lorraine,88,1,25,500,Ventron,927,21,948
41,Lorraine,88,3,26,501,Le Vermont,51,1,52
41,Lorraine,88,3,02,502,Vervezelle,146,3,149
41,Lorraine,88,3,22,503,Vexaincourt,213,2,215
41,Lorraine,88,2,07,504,Vicherey,185,5,190
41,Lorraine,88,3,08,505,Vienville,119,2,121
41,Lorraine,88,3,26,506,Vieux-Moulin,312,11,323
41,Lorraine,88,1,11,508,Ville-sur-Illon,506,8,514
41,Lorraine,88,2,16,507,Villers,221,12,233
41,Lorraine,88,1,06,509,Villoncourt,102,4,106
41,Lorraine,88,2,15,510,Villotte,175,6,181
41,Lorraine,88,2,18,511,Villouxel,90,0,90
41,Lorraine,88,1,03,512,Viménil,198,6,204
41,Lorraine,88,1,05,513,Vincey,2282,38,2320
41,Lorraine,88,2,07,514,Viocourt,147,1,148
41,Lorraine,88,1,01,515,Vioménil,141,11,152
41,Lorraine,88,2,28,516,Vittel,5510,155,5665
41,Lorraine,88,1,17,517,Viviers-le-Gras,168,4,172
41,Lorraine,88,2,28,518,Viviers-lès-Offroicourt,30,1,31
41,Lorraine,88,3,31,519,La Voivre,758,24,782
41,Lorraine,88,1,01,520,Les Voivres,324,8,332
41,Lorraine,88,1,21,521,Vomécourt,259,6,265
41,Lorraine,88,1,05,522,Vomécourt-sur-Madon,69,4,73
41,Lorraine,88,2,07,523,Vouxey,166,6,172
41,Lorraine,88,2,04,524,Vrécourt,356,5,361
41,Lorraine,88,2,16,525,Vroville,140,5,145
41,Lorraine,88,3,24,526,Wisembach,404,11,415
41,Lorraine,88,1,21,527,Xaffévillers,150,2,152
41,Lorraine,88,1,03,528,Xamontarupt,153,10,163
41,Lorraine,88,1,05,529,Xaronval,85,2,87
41,Lorraine,88,1,29,530,Xertigny,2782,48,2830
41,Lorraine,88,3,14,531,Xonrupt-Longemer,1587,58,1645
41,Lorraine,88,1,06,532,Zincourt,85,1,86
26,Bourgogne,89,1,34,001,Accolay,467,10,477
26,Bourgogne,89,1,09,002,Aigremont,68,4,72
26,Bourgogne,89,1,01,003,Aillant-sur-Tholon,1434,32,1466
26,Bourgogne,89,2,02,004,Aisy-sur-Armançon,270,3,273
26,Bourgogne,89,2,02,005,Ancy-le-Franc,1034,28,1062
26,Bourgogne,89,2,02,006,Ancy-le-Libre,179,10,189
26,Bourgogne,89,1,13,007,Andryes,475,7,482
26,Bourgogne,89,2,18,008,Angely,124,1,125
26,Bourgogne,89,2,05,009,Annay-la-Côte,361,9,370
26,Bourgogne,89,2,21,010,Annay-sur-Serein,244,6,250
26,Bourgogne,89,2,05,011,Annéot,150,8,158
26,Bourgogne,89,2,18,012,Annoux,96,4,100
26,Bourgogne,89,1,41,013,Appoigny,3146,72,3218
26,Bourgogne,89,3,08,014,Arces-Dilo,596,19,615
26,Bourgogne,89,1,34,015,Arcy-sur-Cure,515,12,527
26,Bourgogne,89,2,02,016,Argentenay,99,3,102
26,Bourgogne,89,2,02,017,Argenteuil-sur-Armançon,249,7,256
26,Bourgogne,89,3,37,018,Armeau,724,20,744
26,Bourgogne,89,2,15,019,Arthonnay,165,6,171
26,Bourgogne,89,2,35,020,Asnières-sous-Bois,151,1,152
26,Bourgogne,89,2,35,021,Asquins,320,10,330
26,Bourgogne,89,2,18,022,Athie,149,2,151
26,Bourgogne,89,1,03,023,Augy,1073,99,1172
26,Bourgogne,89,1,98,024,Auxerre,36856,2600,39456
26,Bourgogne,89,2,05,025,Avallon,7321,371,7692
26,Bourgogne,89,3,36,027,Bagneaux,230,2,232
26,Bourgogne,89,2,15,028,Baon,83,2,85
26,Bourgogne,89,1,39,029,Bassou,764,29,793
26,Bourgogne,89,1,34,030,Bazarnes,408,7,415
26,Bourgogne,89,1,28,031,Beaumont,559,16,575
26,Bourgogne,89,2,23,032,Beauvilliers,95,2,97
26,Bourgogne,89,1,33,033,Beauvoir,338,19,357
26,Bourgogne,89,1,09,034,Beine,479,19,498
26,Bourgogne,89,1,07,035,Bellechaume,461,13,474
26,Bourgogne,89,3,11,036,La Belliole,255,4,259
26,Bourgogne,89,1,19,037,Béon,506,17,523
26,Bourgogne,89,2,16,038,Bernouil,119,2,121
26,Bourgogne,89,2,32,039,Béru,74,1,75
26,Bourgogne,89,1,34,040,Bessy-sur-Cure,165,3,168
26,Bourgogne,89,2,16,041,Beugnon,316,4,320
26,Bourgogne,89,2,17,042,Bierry-les-Belles-Fontaines,212,7,219
26,Bourgogne,89,2,18,043,Blacy,107,3,110
26,Bourgogne,89,2,35,044,Blannay,130,6,136
26,Bourgogne,89,1,03,045,Bleigny-le-Carreau,311,6,317
26,Bourgogne,89,1,06,046,Bléneau,1451,25,1476
26,Bourgogne,89,3,08,048,Boeurs-en-Othe,321,5,326
26,Bourgogne,89,1,34,049,Bois-d'Arcy,35,2,37
26,Bourgogne,89,1,39,050,Bonnard,927,18,945
26,Bourgogne,89,3,37,051,Les Bordes,500,7,507
26,Bourgogne,89,1,01,053,Branches,415,12,427
26,Bourgogne,89,3,11,054,Brannay,676,14,690
26,Bourgogne,89,1,07,055,Brienon-sur-Armançon,3150,53,3203
26,Bourgogne,89,1,39,056,Brion,609,17,626
26,Bourgogne,89,2,35,057,Brosses,285,5,290
26,Bourgogne,89,2,23,058,Bussières,124,5,129
26,Bourgogne,89,1,07,059,Bussy-en-Othe,759,15,774
26,Bourgogne,89,3,37,060,Bussy-le-Repos,379,11,390
26,Bourgogne,89,2,16,061,Butteaux,267,9,276
26,Bourgogne,89,2,16,062,Carisey,377,3,380
26,Bourgogne,89,3,26,063,La Celle-Saint-Cyr,787,12,799
26,Bourgogne,89,2,21,064,Censy,56,0,56
26,Bourgogne,89,3,08,065,Cérilly,48,3,51
26,Bourgogne,89,3,08,066,Cerisiers,948,21,969
26,Bourgogne,89,1,19,067,Cézy,1106,18,1124
26,Bourgogne,89,1,09,068,Chablis,2427,96,2523
26,Bourgogne,89,1,07,069,Chailley,579,9,588
26,Bourgogne,89,1,10,070,Chambeugle,65,0,65
26,Bourgogne,89,2,35,071,Chamoux,84,0,84
26,Bourgogne,89,1,06,072,Champcevrais,314,4,318
26,Bourgogne,89,1,06,073,Champignelles,1041,61,1102
26,Bourgogne,89,3,22,074,Champigny,2090,32,2122
26,Bourgogne,89,1,19,075,Champlay,685,14,699
26,Bourgogne,89,1,07,076,Champlost,797,18,815
26,Bourgogne,89,1,03,077,Champs-sur-Yonne,1582,136,1718
26,Bourgogne,89,1,01,078,Champvallon,576,23,599
26,Bourgogne,89,1,19,079,Chamvres,681,19,700
26,Bourgogne,89,3,31,080,La Chapelle-sur-Oreuse,566,8,574
26,Bourgogne,89,1,20,081,La Chapelle-Vaupelteigne,90,7,97
26,Bourgogne,89,1,41,083,Charbuy,1678,43,1721
26,Bourgogne,89,1,12,084,Charentenay,293,2,295
26,Bourgogne,89,1,39,085,Charmoy,1203,19,1222
26,Bourgogne,89,1,10,086,Charny,1689,30,1719
26,Bourgogne,89,2,02,087,Chassignelles,307,13,320
26,Bourgogne,89,1,01,088,Chassy,484,6,490
26,Bourgogne,89,2,23,089,Chastellux-sur-Cure,163,4,167
26,Bourgogne,89,2,35,091,Châtel-Censoir,673,8,681
26,Bourgogne,89,2,21,092,Châtel-Gérard,255,14,269
26,Bourgogne,89,3,22,093,Chaumont,604,15,619
26,Bourgogne,89,3,37,094,Chaumot,669,12,681
26,Bourgogne,89,1,09,095,Chemilly-sur-Serein,176,3,179
26,Bourgogne,89,1,28,096,Chemilly-sur-Yonne,846,22,868
26,Bourgogne,89,1,10,097,Chêne-Arnoult,119,6,125
26,Bourgogne,89,2,32,098,Cheney,268,7,275
26,Bourgogne,89,1,28,099,Cheny,2532,58,2590
26,Bourgogne,89,3,11,100,Chéroy,1592,12,1604
26,Bourgogne,89,1,25,101,Chéu,530,16,546
26,Bourgogne,89,1,42,102,Chevannes,2207,84,2291
26,Bourgogne,89,1,10,103,Chevillon,312,6,318
26,Bourgogne,89,1,09,104,Chichée,350,8,358
26,Bourgogne,89,1,39,105,Chichery,487,14,501
26,Bourgogne,89,3,36,107,Chigy,268,7,275
26,Bourgogne,89,1,09,108,Chitry,348,8,356
26,Bourgogne,89,2,17,109,Cisery,56,2,58
26,Bourgogne,89,3,36,111,Les Clérimois,250,6,256
26,Bourgogne,89,2,32,112,Collan,184,1,185
26,Bourgogne,89,3,30,113,Collemiers,568,19,587
26,Bourgogne,89,3,31,115,Compigny,160,4,164
26,Bourgogne,89,3,30,116,Cornant,344,14,358
26,Bourgogne,89,1,12,117,Coulangeron,201,3,204
26,Bourgogne,89,1,12,118,Coulanges-la-Vineuse,948,16,964
26,Bourgogne,89,1,13,119,Coulanges-sur-Yonne,556,7,563
26,Bourgogne,89,3,08,120,Coulours,151,3,154
26,Bourgogne,89,3,36,122,Courgenay,549,11,560
26,Bourgogne,89,1,09,123,Courgis,259,9,268
26,Bourgogne,89,3,31,124,Courlon-sur-Yonne,1157,28,1185
26,Bourgogne,89,1,14,125,Courson-les-Carrières,869,22,891
26,Bourgogne,89,3,11,126,Courtoin,40,1,41
26,Bourgogne,89,3,30,127,Courtois-sur-Yonne,764,13,777
26,Bourgogne,89,2,18,128,Coutarnoux,101,4,105
26,Bourgogne,89,1,13,129,Crain,380,11,391
26,Bourgogne,89,1,34,130,Cravant,808,9,817
26,Bourgogne,89,2,15,131,Cruzy-le-Châtel,250,4,254
26,Bourgogne,89,2,02,132,Cry,183,3,186
26,Bourgogne,89,3,26,133,Cudot,356,4,360
26,Bourgogne,89,2,17,134,Cussy-les-Forges,333,11,344
26,Bourgogne,89,3,22,136,Cuy,736,14,750
26,Bourgogne,89,2,32,137,Dannemoine,427,28,455
26,Bourgogne,89,1,10,138,Dicy,323,11,334
26,Bourgogne,89,1,33,139,Diges,1142,33,1175
26,Bourgogne,89,2,18,141,Dissangis,144,4,148
26,Bourgogne,89,3,37,142,Dixmont,902,15,917
26,Bourgogne,89,3,11,143,Dollot,312,6,318
26,Bourgogne,89,3,11,144,Domats,768,15,783
26,Bourgogne,89,2,35,145,Domecy-sur-Cure,376,18,394
26,Bourgogne,89,2,05,146,Domecy-sur-le-Vault,93,3,96
26,Bourgogne,89,1,33,147,Dracy,216,7,223
26,Bourgogne,89,1,14,148,Druyes-les-Belles-Fontaines,301,4,305
26,Bourgogne,89,2,16,149,Dyé,179,10,189
26,Bourgogne,89,1,33,150,Égleny,438,7,445
26,Bourgogne,89,3,30,151,Égriselles-le-Bocage,1219,28,1247
26,Bourgogne,89,1,39,152,Épineau-les-Voves,721,10,731
26,Bourgogne,89,2,32,153,Épineuil,620,45,665
26,Bourgogne,89,1,12,154,Escamps,812,27,839
26,Bourgogne,89,1,12,155,Escolives-Sainte-Camille,724,21,745
26,Bourgogne,89,1,07,156,Esnon,386,7,393
26,Bourgogne,89,1,13,158,Étais-la-Sauvin,698,23,721
26,Bourgogne,89,2,05,159,Étaule,414,17,431
26,Bourgogne,89,3,30,160,Étigny,759,6,765
26,Bourgogne,89,2,21,161,Étivey,238,9,247
26,Bourgogne,89,3,22,162,Évry,362,10,372
26,Bourgogne,89,1,10,163,La Ferté-Loupière,582,7,589
26,Bourgogne,89,1,13,164,Festigny,79,4,83
26,Bourgogne,89,3,36,165,Flacy,146,2,148
26,Bourgogne,89,1,01,167,Fleury-la-Vallée,1128,29,1157
26,Bourgogne,89,2,32,168,Fleys,178,4,182
26,Bourgogne,89,2,16,169,Flogny-la-Chapelle,1005,32,1037
26,Bourgogne,89,2,35,170,Foissy-lès-Vézelay,153,6,159
26,Bourgogne,89,3,36,171,Foissy-sur-Vanne,287,9,296
26,Bourgogne,89,3,29,172,Fontaine-la-Gaillarde,507,20,527
26,Bourgogne,89,1,33,173,Fontaines,471,6,477
26,Bourgogne,89,1,14,174,Fontenailles,71,0,71
26,Bourgogne,89,1,09,175,Fontenay-près-Chablis,132,3,135
26,Bourgogne,89,2,35,176,Fontenay-près-Vézelay,163,1,164
26,Bourgogne,89,1,13,177,Fontenay-sous-Fouronnes,75,1,76
26,Bourgogne,89,1,10,178,Fontenouilles,211,1,212
26,Bourgogne,89,1,27,179,Fontenoy,319,7,326
26,Bourgogne,89,3,11,180,Fouchères,397,13,410
26,Bourgogne,89,3,08,181,Fournaudin,114,1,115
26,Bourgogne,89,1,14,182,Fouronnes,151,4,155
26,Bourgogne,89,2,21,183,Fresnes,74,0,74
26,Bourgogne,89,2,02,184,Fulvy,141,4,145
26,Bourgogne,89,1,25,186,Germigny,570,16,586
26,Bourgogne,89,2,15,187,Gigny,102,7,109
26,Bourgogne,89,2,05,188,Girolles,188,4,192
26,Bourgogne,89,3,22,189,Gisy-les-Nobles,610,15,625
26,Bourgogne,89,2,35,190,Givry,186,3,189
26,Bourgogne,89,2,15,191,Gland,51,1,52
26,Bourgogne,89,1,10,192,Grandchamp,367,8,375
26,Bourgogne,89,2,21,194,Grimault,121,1,122
26,Bourgogne,89,3,30,195,Gron,1225,93,1318
26,Bourgogne,89,1,01,196,Guerchy,634,34,668
26,Bourgogne,89,2,17,197,Guillon,448,8,456
26,Bourgogne,89,1,28,198,Gurgy,1651,43,1694
26,Bourgogne,89,1,12,199,Gy-l'Évêque,461,16,477
26,Bourgogne,89,1,28,200,Hauterive,436,4,440
26,Bourgogne,89,1,28,201,Héry,1857,64,1921
26,Bourgogne,89,1,12,202,Irancy,307,8,315
26,Bourgogne,89,2,05,203,Island,203,15,218
26,Bourgogne,89,2,18,204,L' Isle-sur-Serein,756,22,778
26,Bourgogne,89,1,25,205,Jaulges,452,8,460
26,Bourgogne,89,1,19,206,Joigny,10403,414,10817
26,Bourgogne,89,2,21,207,Jouancy,34,0,34
26,Bourgogne,89,2,18,208,Joux-la-Ville,1186,15,1201
26,Bourgogne,89,3,11,209,Jouy,444,15,459
26,Bourgogne,89,2,02,210,Jully,141,6,147
26,Bourgogne,89,2,32,211,Junay,102,2,104
26,Bourgogne,89,1,12,212,Jussy,444,18,462
26,Bourgogne,89,1,01,213,Laduz,304,3,307
26,Bourgogne,89,3,36,214,Lailly,209,5,214
26,Bourgogne,89,1,14,215,Lain,161,8,169
26,Bourgogne,89,1,27,216,Lainsecq,371,15,386
26,Bourgogne,89,1,33,217,Lalande,130,1,131
26,Bourgogne,89,1,39,218,Laroche-Saint-Cydroine,1383,48,1431
26,Bourgogne,89,2,16,219,Lasson,136,6,142
26,Bourgogne,89,1,24,220,Lavau,526,2,528
26,Bourgogne,89,1,33,221,Leugny,362,11,373
26,Bourgogne,89,1,33,222,Levis,248,4,252
26,Bourgogne,89,2,02,223,Lézinnes,731,21,752
26,Bourgogne,89,1,09,224,Lichères-près-Aigremont,176,6,182
26,Bourgogne,89,2,35,225,Lichères-sur-Yonne,60,1,61
26,Bourgogne,89,1,20,226,Lignorelles,173,8,181
26,Bourgogne,89,1,20,227,Ligny-le-Châtel,1324,29,1353
26,Bourgogne,89,1,33,228,Lindry,1246,40,1286
26,Bourgogne,89,3,22,229,Lixy,441,5,446
26,Bourgogne,89,1,19,230,Looze,460,10,470
26,Bourgogne,89,2,05,232,Lucy-le-Bois,327,18,345
26,Bourgogne,89,1,34,233,Lucy-sur-Cure,210,1,211
26,Bourgogne,89,1,13,234,Lucy-sur-Yonne,149,1,150
26,Bourgogne,89,2,05,235,Magny,808,37,845
26,Bourgogne,89,3,40,236,Maillot,1107,26,1133
26,Bourgogne,89,1,34,237,Mailly-la-Ville,593,8,601
26,Bourgogne,89,1,13,238,Mailly-le-Château,590,8,598
26,Bourgogne,89,3,40,239,Malay-le-Grand,1559,36,1595
26,Bourgogne,89,3,40,240,Malay-le-Petit,348,9,357
26,Bourgogne,89,1,10,241,Malicorne,164,5,169
26,Bourgogne,89,1,20,242,Maligny,741,17,758
26,Bourgogne,89,1,10,243,Marchais-Beton,123,2,125
26,Bourgogne,89,2,17,244,Marmeaux,78,1,79
26,Bourgogne,89,3,30,245,Marsangy,826,27,853
26,Bourgogne,89,2,18,246,Massangis,411,7,418
26,Bourgogne,89,2,15,247,Mélisey,290,7,297
26,Bourgogne,89,2,05,248,Menades,54,1,55
26,Bourgogne,89,1,07,249,Mercy,74,3,77
26,Bourgogne,89,1,20,250,Méré,194,10,204
26,Bourgogne,89,1,01,251,Merry-la-Vallée,421,12,433
26,Bourgogne,89,1,14,252,Merry-Sec,175,3,178
26,Bourgogne,89,1,13,253,Merry-sur-Yonne,217,3,220
26,Bourgogne,89,1,24,254,Mézilles,578,9,587
26,Bourgogne,89,3,22,255,Michery,1020,13,1033
26,Bourgogne,89,1,12,256,Migé,441,9,450
26,Bourgogne,89,1,39,257,Migennes,7376,125,7501
26,Bourgogne,89,2,21,259,Môlay,116,4,120
26,Bourgogne,89,1,14,260,Molesmes,170,4,174
26,Bourgogne,89,3,36,261,Molinons,278,10,288
26,Bourgogne,89,2,32,262,Molosmes,227,5,232
26,Bourgogne,89,1,95,263,Monéteau,3786,138,3924
26,Bourgogne,89,1,28,268,Mont-Saint-Sulpice,772,18,790
26,Bourgogne,89,3,11,264,Montacher-Villegardin,728,16,744
26,Bourgogne,89,1,20,265,Montigny-la-Resle,607,21,628
26,Bourgogne,89,2,35,266,Montillot,280,1,281
26,Bourgogne,89,2,17,267,Montréal,194,7,201
26,Bourgogne,89,1,14,270,Mouffy,122,0,122
26,Bourgogne,89,2,21,271,Moulins-en-Tonnerrois,113,5,118
26,Bourgogne,89,1,33,272,Moulins-sur-Ouanne,272,4,276
26,Bourgogne,89,1,27,273,Moutiers-en-Puisaye,286,5,291
26,Bourgogne,89,3,30,274,Nailly,1201,31,1232
26,Bourgogne,89,1,01,275,Neuilly,434,11,445
26,Bourgogne,89,2,16,276,Neuvy-Sautour,971,25,996
26,Bourgogne,89,2,21,277,Nitry,389,9,398
26,Bourgogne,89,3,40,278,Noé,441,5,446
26,Bourgogne,89,2,21,279,Noyers,715,15,730
26,Bourgogne,89,2,02,280,Nuits,415,14,429
26,Bourgogne,89,1,01,281,Les Ormes,271,6,277
26,Bourgogne,89,1,28,282,Ormoy,667,25,692
26,Bourgogne,89,1,14,283,Ouanne,701,16,717
26,Bourgogne,89,2,02,284,Pacy-sur-Armançon,227,7,234
26,Bourgogne,89,3,31,285,Pailly,233,5,238
26,Bourgogne,89,1,33,286,Parly,800,15,815
26,Bourgogne,89,3,30,287,Paron,4460,134,4594
26,Bourgogne,89,1,07,288,Paroy-en-Othe,207,3,210
26,Bourgogne,89,1,19,289,Paroy-sur-Tholon,318,6,324
26,Bourgogne,89,2,21,290,Pasilly,50,1,51
26,Bourgogne,89,3,40,291,Passy,301,11,312
26,Bourgogne,89,3,31,469,Perceneige,890,25,915
26,Bourgogne,89,2,16,292,Percey,263,3,266
26,Bourgogne,89,1,10,294,Perreux,306,13,319
26,Bourgogne,89,1,41,295,Perrigny,1160,43,1203
26,Bourgogne,89,2,02,296,Perrigny-sur-Armançon,113,4,117
26,Bourgogne,89,2,35,297,Pierre-Perthuis,124,2,126
26,Bourgogne,89,3,37,298,Piffonds,584,8,592
26,Bourgogne,89,2,15,299,Pimelles,63,2,65
26,Bourgogne,89,2,17,300,Pisy,65,0,65
26,Bourgogne,89,3,31,302,Plessis-Saint-Jean,215,1,216
26,Bourgogne,89,2,21,303,Poilly-sur-Serein,275,7,282
26,Bourgogne,89,1,01,304,Poilly-sur-Tholon,704,12,716
26,Bourgogne,89,3,36,308,Pont-sur-Vanne,198,3,201
26,Bourgogne,89,3,22,309,Pont-sur-Yonne,3123,55,3178
26,Bourgogne,89,2,05,306,Pontaubert,391,10,401
26,Bourgogne,89,1,20,307,Pontigny,735,22,757
26,Bourgogne,89,3,36,310,La Postolle,157,5,162
26,Bourgogne,89,1,33,311,Pourrain,1414,47,1461
26,Bourgogne,89,2,18,312,Précy-le-Sec,288,4,292
26,Bourgogne,89,3,26,313,Précy-sur-Vrin,483,9,492
26,Bourgogne,89,1,34,314,Prégilbert,188,6,194
26,Bourgogne,89,1,09,315,Préhy,129,5,134
26,Bourgogne,89,2,18,316,Provency,233,8,241
26,Bourgogne,89,1,10,317,Prunoy,304,5,309
26,Bourgogne,89,2,23,318,Quarré-les-Tombes,716,15,731
26,Bourgogne,89,1,03,319,Quenne,453,10,463
26,Bourgogne,89,2,15,320,Quincerot,74,0,74
26,Bourgogne,89,2,02,321,Ravières,872,25,897
26,Bourgogne,89,2,16,323,Roffey,147,3,150
26,Bourgogne,89,1,06,324,Rogny-les-Sept-Écluses,701,22,723
26,Bourgogne,89,1,24,325,Ronchères,102,1,103
26,Bourgogne,89,3,40,326,Rosoy,1061,31,1092
26,Bourgogne,89,3,37,327,Rousson,380,11,391
26,Bourgogne,89,1,20,328,Rouvray,357,3,360
26,Bourgogne,89,2,15,329,Rugny,105,3,108
26,Bourgogne,89,1,34,330,Sacy,208,2,210
26,Bourgogne,89,1,27,331,Sainpuits,338,1,339
26,Bourgogne,89,3,22,332,Saint-Agnan,908,11,919
26,Bourgogne,89,2,17,333,Saint-André-en-Terre-Plaine,190,13,203
26,Bourgogne,89,1,01,334,Saint-Aubin-Château-Neuf,519,16,535
26,Bourgogne,89,1,19,335,Saint-Aubin-sur-Yonne,475,7,482
26,Bourgogne,89,2,23,336,Saint-Brancher,327,8,335
26,Bourgogne,89,1,03,337,Saint-Bris-le-Vineux,1114,38,1152
26,Bourgogne,89,3,29,338,Saint-Clément,2853,90,2943
26,Bourgogne,89,1,09,341,Saint-Cyr-les-Colons,420,6,426
26,Bourgogne,89,3,30,342,Saint-Denis,676,39,715
26,Bourgogne,89,1,10,343,Saint-Denis-sur-Ouanne,138,3,141
26,Bourgogne,89,1,24,344,Saint-Fargeau,1754,27,1781
26,Bourgogne,89,1,25,345,Saint-Florentin,4921,97,5018
26,Bourgogne,89,1,38,346,Saint-Georges-sur-Baulche,3375,110,3485
26,Bourgogne,89,2,23,347,Saint-Germain-des-Champs,384,8,392
26,Bourgogne,89,3,26,348,Saint-Julien-du-Sault,2350,67,2417
26,Bourgogne,89,2,23,349,Saint-Léger-Vauban,420,9,429
26,Bourgogne,89,3,26,350,Saint-Loup-d'Ordon,229,3,232
26,Bourgogne,89,3,26,353,Saint-Martin-d'Ordon,286,6,292
26,Bourgogne,89,1,24,352,Saint-Martin-des-Champs,282,6,288
26,Bourgogne,89,3,30,354,Saint-Martin-du-Tertre,1521,44,1565
26,Bourgogne,89,2,15,355,Saint-Martin-sur-Armançon,145,3,148
26,Bourgogne,89,1,01,356,Saint-Martin-sur-Ocre,50,1,51
26,Bourgogne,89,1,10,358,Saint-Martin-sur-Ouanne,441,7,448
26,Bourgogne,89,3,36,359,Saint-Maurice-aux-Riches-Hommes,452,1,453
26,Bourgogne,89,1,01,360,Saint-Maurice-le-Vieil,285,7,292
26,Bourgogne,89,1,01,361,Saint-Maurice-Thizouaille,253,3,256
26,Bourgogne,89,2,35,362,Saint-Moré,183,8,191
26,Bourgogne,89,2,35,364,Saint-Père,374,8,382
26,Bourgogne,89,1,06,365,Saint-Privé,557,17,574
26,Bourgogne,89,3,26,366,Saint-Romain-le-Preux,180,4,184
26,Bourgogne,89,1,27,368,Saint-Sauveur-en-Puisaye,951,8,959
26,Bourgogne,89,3,22,369,Saint-Sérotin,523,16,539
26,Bourgogne,89,3,11,370,Saint-Valérien,1603,23,1626
26,Bourgogne,89,2,18,339,Sainte-Colombe,175,3,178
26,Bourgogne,89,1,27,340,Sainte-Colombe-sur-Loing,185,5,190
26,Bourgogne,89,2,17,351,Sainte-Magnance,407,4,411
26,Bourgogne,89,1,34,363,Sainte-Pallaye,120,0,120
26,Bourgogne,89,2,21,371,Sainte-Vertu,106,0,106
26,Bourgogne,89,1,27,367,Saints,590,19,609
26,Bourgogne,89,3,29,373,Saligny,670,25,695
26,Bourgogne,89,2,02,374,Sambourg,95,8,103
26,Bourgogne,89,2,17,375,Santigny,112,2,114
26,Bourgogne,89,2,21,376,Sarry,173,9,182
26,Bourgogne,89,2,17,377,Sauvigny-le-Beuréal,61,0,61
26,Bourgogne,89,2,05,378,Sauvigny-le-Bois,730,18,748
26,Bourgogne,89,2,17,379,Savigny-en-Terre-Plaine,138,21,159
26,Bourgogne,89,3,11,380,Savigny-sur-Clairis,384,11,395
26,Bourgogne,89,2,17,381,Sceaux,140,4,144
26,Bourgogne,89,1,28,382,Seignelay,1587,34,1621
26,Bourgogne,89,1,14,383,Sementron,119,2,121
26,Bourgogne,89,1,01,384,Senan,729,15,744
26,Bourgogne,89,2,15,385,Sennevoy-le-Bas,106,14,120
26,Bourgogne,89,2,15,386,Sennevoy-le-Haut,95,1,96
26,Bourgogne,89,3,99,387,Sens,25899,836,26735
26,Bourgogne,89,3,26,388,Sépeaux,421,12,433
26,Bourgogne,89,3,31,390,Serbonnes,538,9,547
26,Bourgogne,89,3,31,391,Sergines,1199,21,1220
26,Bourgogne,89,2,05,392,Sermizelles,274,2,276
26,Bourgogne,89,2,32,393,Serrigny,122,4,126
26,Bourgogne,89,1,34,394,Sery,113,0,113
26,Bourgogne,89,3,36,395,Les Sièges,439,19,458
26,Bourgogne,89,1,01,397,Sommecaise,336,1,337
26,Bourgogne,89,2,16,398,Sormery,382,11,393
26,Bourgogne,89,3,29,399,Soucy,1412,33,1445
26,Bourgogne,89,1,27,400,Sougères-en-Puisaye,349,7,356
26,Bourgogne,89,2,16,402,Soumaintrain,195,8,203
26,Bourgogne,89,2,02,403,Stigny,129,4,133
26,Bourgogne,89,3,30,404,Subligny,485,15,500
26,Bourgogne,89,1,14,405,Taingy,304,6,310
26,Bourgogne,89,2,18,406,Talcy,88,4,92
26,Bourgogne,89,2,15,407,Tanlay,1140,34,1174
26,Bourgogne,89,1,06,408,Tannerre-en-Puisaye,314,8,322
26,Bourgogne,89,2,35,409,Tharoiseau,71,1,72
26,Bourgogne,89,2,05,410,Tharot,96,6,102
26,Bourgogne,89,3,36,411,Theil-sur-Vanne,528,17,545
26,Bourgogne,89,2,17,412,Thizy,165,1,166
26,Bourgogne,89,2,15,413,Thorey,48,0,48
26,Bourgogne,89,3,31,414,Thorigny-sur-Oreuse,1472,20,1492
26,Bourgogne,89,2,05,415,Thory,192,15,207
26,Bourgogne,89,1,27,416,Thury,456,15,471
26,Bourgogne,89,2,32,417,Tissey,103,8,111
26,Bourgogne,89,2,32,418,Tonnerre,5260,241,5501
26,Bourgogne,89,1,33,419,Toucy,2675,108,2783
26,Bourgogne,89,1,27,420,Treigny,871,15,886
26,Bourgogne,89,2,17,421,Trévilly,60,0,60
26,Bourgogne,89,2,15,422,Trichey,52,1,53
26,Bourgogne,89,2,16,423,Tronchoy,154,8,162
26,Bourgogne,89,1,13,424,Trucy-sur-Yonne,145,3,148
26,Bourgogne,89,1,07,425,Turny,729,26,755
26,Bourgogne,89,1,12,426,Val-de-Mercy,365,7,372
26,Bourgogne,89,1,42,427,Vallan,714,13,727
26,Bourgogne,89,3,11,428,Vallery,505,15,520
26,Bourgogne,89,3,36,429,Vareilles,213,6,219
26,Bourgogne,89,1,20,430,Varennes,283,10,293
26,Bourgogne,89,2,17,431,Vassy,85,2,87
26,Bourgogne,89,3,08,432,Vaudeurs,501,8,509
26,Bourgogne,89,2,05,433,Vault-de-Lugny,325,8,333
26,Bourgogne,89,3,40,434,Vaumort,320,15,335
26,Bourgogne,89,1,07,436,Venizy,878,15,893
26,Bourgogne,89,1,20,437,Venouse,290,12,302
26,Bourgogne,89,1,03,438,Venoy,1710,176,1886
26,Bourgogne,89,1,25,439,Vergigny,1527,25,1552
26,Bourgogne,89,3,26,440,Verlin,425,5,430
26,Bourgogne,89,1,34,441,Vermenton,1204,20,1224
26,Bourgogne,89,3,11,442,Vernoy,198,5,203
26,Bourgogne,89,3,40,443,Véron,1948,41,1989
26,Bourgogne,89,2,32,445,Vézannes,48,3,51
26,Bourgogne,89,2,35,446,Vézelay,475,8,483
26,Bourgogne,89,2,32,447,Vézinnes,163,2,165
26,Bourgogne,89,2,17,448,Vignes,93,2,95
26,Bourgogne,89,3,22,449,Villeblevin,1793,29,1822
26,Bourgogne,89,3,11,450,Villebougis,593,14,607
26,Bourgogne,89,3,08,451,Villechétive,201,3,204
26,Bourgogne,89,1,19,452,Villecien,409,10,419
26,Bourgogne,89,1,38,453,Villefargeau,832,34,866
26,Bourgogne,89,1,10,454,Villefranche,616,9,625
26,Bourgogne,89,3,22,456,Villemanoche,612,10,622
26,Bourgogne,89,1,01,457,Villemer,252,8,260
26,Bourgogne,89,3,22,458,Villenavotte,182,8,190
26,Bourgogne,89,3,36,461,Villeneuve-l'Archevêque,1240,31,1271
26,Bourgogne,89,3,11,459,Villeneuve-la-Dondagre,230,9,239
26,Bourgogne,89,3,22,460,Villeneuve-la-Guyard,3023,51,3074
26,Bourgogne,89,1,06,462,Villeneuve-les-Genêts,310,10,320
26,Bourgogne,89,1,20,463,Villeneuve-Saint-Salves,250,10,260
26,Bourgogne,89,3,37,464,Villeneuve-sur-Yonne,5280,92,5372
26,Bourgogne,89,3,22,465,Villeperrot,318,2,320
26,Bourgogne,89,3,11,466,Villeroy,287,11,298
26,Bourgogne,89,3,22,467,Villethierry,763,17,780
26,Bourgogne,89,1,19,468,Villevallier,436,35,471
26,Bourgogne,89,2,02,470,Villiers-les-Hauts,141,3,144
26,Bourgogne,89,3,36,471,Villiers-Louis,459,14,473
26,Bourgogne,89,1,33,472,Villiers-Saint-Benoît,518,29,547
26,Bourgogne,89,1,01,473,Villiers-sur-Tholon,462,17,479
26,Bourgogne,89,2,16,474,Villiers-Vineux,294,2,296
26,Bourgogne,89,2,15,475,Villon,100,1,101
26,Bourgogne,89,1,20,477,Villy,112,0,112
26,Bourgogne,89,1,12,478,Vincelles,970,86,1056
26,Bourgogne,89,1,12,479,Vincelottes,330,15,345
26,Bourgogne,89,3,31,480,Vinneuf,1299,30,1329
26,Bourgogne,89,2,02,481,Vireaux,161,0,161
26,Bourgogne,89,2,32,482,Viviers,137,2,139
26,Bourgogne,89,3,36,483,Voisines,422,10,432
26,Bourgogne,89,1,01,484,Volgré,322,7,329
26,Bourgogne,89,2,35,485,Voutenay-sur-Cure,207,6,213
26,Bourgogne,89,2,32,486,Yrouerre,197,5,202
43,Franche-Comté,90,1,11,001,Andelnans,1268,16,1284
43,Franche-Comté,90,1,03,002,Angeot,301,10,311
43,Franche-Comté,90,1,05,003,Anjoutey,674,11,685
43,Franche-Comté,90,1,10,004,Argiésans,440,16,456
43,Franche-Comté,90,1,11,082,Autrechêne,294,4,298
43,Franche-Comté,90,1,04,005,Auxelles-Bas,470,10,480
43,Franche-Comté,90,1,04,006,Auxelles-Haut,307,11,318
43,Franche-Comté,90,1,10,007,Banvillars,273,13,286
43,Franche-Comté,90,1,10,008,Bavilliers,4834,160,4994
43,Franche-Comté,90,1,12,009,Beaucourt,5008,82,5090
43,Franche-Comté,90,1,99,010,Belfort,50346,1013,51359
43,Franche-Comté,90,1,10,011,Bermont,325,11,336
43,Franche-Comté,90,1,03,012,Bessoncourt,937,43,980
43,Franche-Comté,90,1,03,013,Bethonvilliers,245,6,251
43,Franche-Comté,90,1,13,014,Boron,417,5,422
43,Franche-Comté,90,1,10,015,Botans,277,9,286
43,Franche-Comté,90,1,05,016,Bourg-sous-Châtelet,130,2,132
43,Franche-Comté,90,1,13,017,Bourogne,1966,23,1989
43,Franche-Comté,90,1,13,018,Brebotte,327,12,339
43,Franche-Comté,90,1,13,019,Bretagne,244,1,245
43,Franche-Comté,90,1,10,020,Buc,301,11,312
43,Franche-Comté,90,1,11,021,Charmois,294,9,303
43,Franche-Comté,90,1,10,022,Châtenois-les-Forges,2767,51,2818
43,Franche-Comté,90,1,04,023,Chaux,1072,25,1097
43,Franche-Comté,90,1,13,024,Chavanatte,161,0,161
43,Franche-Comté,90,1,13,025,Chavannes-les-Grands,314,4,318
43,Franche-Comté,90,1,11,026,Chèvremont,1435,48,1483
43,Franche-Comté,90,1,02,027,Courcelles,120,3,123
43,Franche-Comté,90,1,02,028,Courtelevant,413,7,420
43,Franche-Comté,90,1,06,029,Cravanche,1867,72,1939
43,Franche-Comté,90,1,12,030,Croix,162,4,166
43,Franche-Comté,90,1,03,031,Cunelières,282,7,289
43,Franche-Comté,90,1,11,032,Danjoutin,3543,86,3629
43,Franche-Comté,90,1,02,033,Delle,6000,110,6110
43,Franche-Comté,90,1,03,034,Denney,755,15,770
43,Franche-Comté,90,1,10,035,Dorans,560,19,579
43,Franche-Comté,90,1,03,036,Eguenigue,267,11,278
43,Franche-Comté,90,1,15,037,Éloie,970,23,993
43,Franche-Comté,90,1,06,039,Essert,3176,113,3289
43,Franche-Comté,90,1,05,041,Étueffont,1479,60,1539
43,Franche-Comté,90,1,04,042,Évette-Salbert,2034,87,2121
43,Franche-Comté,90,1,02,043,Faverois,503,7,510
43,Franche-Comté,90,1,12,045,Fêche-l'Église,797,19,816
43,Franche-Comté,90,1,05,044,Felon,254,5,259
43,Franche-Comté,90,1,02,046,Florimont,413,6,419
43,Franche-Comté,90,1,03,047,Fontaine,611,20,631
43,Franche-Comté,90,1,11,048,Fontenelle,131,2,133
43,Franche-Comté,90,1,03,049,Foussemagne,973,11,984
43,Franche-Comté,90,1,03,050,Frais,239,5,244
43,Franche-Comté,90,1,13,051,Froidefontaine,466,7,473
43,Franche-Comté,90,1,04,052,Giromagny,3239,83,3322
43,Franche-Comté,90,1,13,053,Grandvillars,3126,52,3178
43,Franche-Comté,90,1,04,054,Grosmagny,515,20,535
43,Franche-Comté,90,1,13,055,Grosne,311,4,315
43,Franche-Comté,90,1,02,056,Joncherey,1362,28,1390
43,Franche-Comté,90,1,04,057,Lachapelle-sous-Chaux,680,30,710
43,Franche-Comté,90,1,05,058,Lachapelle-sous-Rougemont,528,12,540
43,Franche-Comté,90,1,03,059,Lacollonge,245,3,248
43,Franche-Comté,90,1,03,060,Lagrange,100,5,105
43,Franche-Comté,90,1,05,061,Lamadeleine-Val-des-Anges,32,1,33
43,Franche-Comté,90,1,03,062,Larivière,298,7,305
43,Franche-Comté,90,1,02,063,Lebetain,454,8,462
43,Franche-Comté,90,1,04,065,Lepuix,1212,19,1231
43,Franche-Comté,90,1,02,064,Lepuix-Neuf,274,5,279
43,Franche-Comté,90,1,05,066,Leval,187,3,190
43,Franche-Comté,90,1,03,067,Menoncourt,398,14,412
43,Franche-Comté,90,1,11,068,Meroux,804,25,829
43,Franche-Comté,90,1,13,069,Méziré,1399,20,1419
43,Franche-Comté,90,1,12,070,Montbouton,424,9,433
43,Franche-Comté,90,1,03,071,Montreux-Château,986,12,998
43,Franche-Comté,90,1,13,072,Morvillars,1067,14,1081
43,Franche-Comté,90,1,11,073,Moval,321,6,327
43,Franche-Comté,90,1,11,074,Novillard,249,3,252
43,Franche-Comté,90,1,15,075,Offemont,3164,88,3252
43,Franche-Comté,90,1,11,076,Pérouse,993,36,1029
43,Franche-Comté,90,1,03,077,Petit-Croix,334,7,341
43,Franche-Comté,90,1,05,078,Petitefontaine,196,3,199
43,Franche-Comté,90,1,04,079,Petitmagny,273,11,284
43,Franche-Comté,90,1,03,080,Phaffans,329,11,340
43,Franche-Comté,90,1,02,081,Réchésy,799,19,818
43,Franche-Comté,90,1,13,083,Recouvrance,67,1,68
43,Franche-Comté,90,1,03,084,Reppe,308,9,317
43,Franche-Comté,90,1,04,085,Riervescemont,79,1,80
43,Franche-Comté,90,1,05,086,Romagny-sous-Rougemont,214,6,220
43,Franche-Comté,90,1,15,087,Roppe,820,14,834
43,Franche-Comté,90,1,04,088,Rougegoutte,996,21,1017
43,Franche-Comté,90,1,05,089,Rougemont-le-Château,1400,59,1459
43,Franche-Comté,90,1,12,090,Saint-Dizier-l'Évêque,397,8,405
43,Franche-Comté,90,1,05,091,Saint-Germain-le-Châtelet,599,15,614
43,Franche-Comté,90,1,04,093,Sermamagny,822,15,837
43,Franche-Comté,90,1,11,094,Sevenans,771,23,794
43,Franche-Comté,90,1,13,095,Suarce,437,3,440
43,Franche-Comté,90,1,02,096,Thiancourt,252,5,257
43,Franche-Comté,90,1,10,097,Trévenans,1068,27,1095
43,Franche-Comté,90,1,10,098,Urcerey,232,14,246
43,Franche-Comté,90,1,06,099,Valdoie,5044,240,5284
43,Franche-Comté,90,1,03,100,Vauthiermont,232,8,240
43,Franche-Comté,90,1,13,101,Vellescot,252,3,255
43,Franche-Comté,90,1,04,102,Vescemont,721,24,745
43,Franche-Comté,90,1,15,103,Vétrigne,494,19,513
43,Franche-Comté,90,1,11,104,Vézelois,868,24,892
43,Franche-Comté,90,1,12,105,Villars-le-Sec,144,0,144
11,Île-de-France,91,1,17,001,Abbéville-la-Rivière,285,7,292
11,Île-de-France,91,1,17,016,Angerville,3392,62,3454
11,Île-de-France,91,1,24,017,Angervilliers,1625,13,1638
11,Île-de-France,91,3,01,021,Arpajon,10174,137,10311
11,Île-de-France,91,1,17,022,Arrancourt,132,0,132
11,Île-de-France,91,3,02,027,Athis-Mons,30647,416,31063
11,Île-de-France,91,1,07,035,Authon-la-Plaine,351,6,357
11,Île-de-France,91,2,16,037,Auvernaux,325,4,329
11,Île-de-France,91,1,09,038,Auvers-Saint-Georges,1179,14,1193
11,Île-de-France,91,3,01,041,Avrainville,703,7,710
11,Île-de-France,91,3,35,044,Ballainvilliers,3815,22,3837
11,Île-de-France,91,2,16,045,Ballancourt-sur-Essonne,7260,73,7333
11,Île-de-France,91,1,11,047,Baulne,1345,10,1355
11,Île-de-France,91,3,03,064,Bièvres,4979,119,5098
11,Île-de-France,91,1,17,067,Blandy,123,0,123
11,Île-de-France,91,2,18,069,Boigneville,423,4,427
11,Île-de-France,91,1,17,075,Bois-Herpin,75,0,75
11,Île-de-France,91,1,17,079,Boissy-la-Rivière,521,10,531
11,Île-de-France,91,1,11,080,Boissy-le-Cutté,1319,17,1336
11,Île-de-France,91,1,08,081,Boissy-le-Sec,646,11,657
11,Île-de-France,91,1,24,085,Boissy-sous-Saint-Yon,3669,52,3721
11,Île-de-France,91,2,10,086,Bondoufle,9370,116,9486
11,Île-de-France,91,3,13,093,Boullay-les-Troux,645,14,659
11,Île-de-France,91,1,09,095,Bouray-sur-Juine,1928,18,1946
11,Île-de-France,91,2,38,097,Boussy-Saint-Antoine,6430,49,6479
11,Île-de-France,91,1,08,098,Boutervilliers,333,11,344
11,Île-de-France,91,1,11,099,Boutigny-sur-Essonne,3096,40,3136
11,Île-de-France,91,1,08,100,Bouville,634,12,646
11,Île-de-France,91,3,04,103,Brétigny-sur-Orge,22519,323,22842
11,Île-de-France,91,1,24,105,Breuillet,8255,117,8372
11,Île-de-France,91,1,24,106,Breux-Jouy,1228,13,1241
11,Île-de-France,91,1,08,109,Brières-les-Scellés,956,14,970
11,Île-de-France,91,3,13,111,Briis-sous-Forges,3361,58,3419
11,Île-de-France,91,1,17,112,Brouy,123,5,128
11,Île-de-France,91,2,05,114,Brunoy,25567,331,25898
11,Île-de-France,91,3,01,115,Bruyères-le-Châtel,3114,40,3154
11,Île-de-France,91,2,18,121,Buno-Bonnevaux,471,11,482
11,Île-de-France,91,3,21,122,Bures-sur-Yvette,9691,247,9938
11,Île-de-France,91,1,11,129,Cerny,3233,88,3321
11,Île-de-France,91,1,08,130,Chalo-Saint-Mars,1136,25,1161
11,Île-de-France,91,1,17,131,Chalou-Moulineux,403,6,409
11,Île-de-France,91,1,09,132,Chamarande,1085,15,1100
11,Île-de-France,91,2,16,135,Champcueil,2774,55,2829
11,Île-de-France,91,3,35,136,Champlan,2479,19,2498
11,Île-de-France,91,1,17,137,Champmotteux,360,1,361
11,Île-de-France,91,1,07,145,Chatignonville,61,3,64
11,Île-de-France,91,1,09,148,Chauffour-lès-Étréchy,132,1,133
11,Île-de-France,91,3,01,156,Cheptainville,1871,12,1883
11,Île-de-France,91,2,16,159,Chevannes,1621,24,1645
11,Île-de-France,91,3,28,161,Chilly-Mazarin,18417,111,18528
11,Île-de-France,91,1,17,613,Congerville-Thionville,220,8,228
11,Île-de-France,91,2,96,174,Corbeil-Essonnes,41666,634,42300
11,Île-de-France,91,1,07,175,Corbreuse,1689,29,1718
11,Île-de-France,91,2,16,179,Le Coudray-Montceaux,4430,42,4472
11,Île-de-France,91,2,18,180,Courances,347,5,352
11,Île-de-France,91,2,39,182,Courcouronnes,14101,139,14240
11,Île-de-France,91,2,18,184,Courdimanche-sur-Essonne,277,1,278
11,Île-de-France,91,3,13,186,Courson-Monteloup,584,5,589
11,Île-de-France,91,2,36,191,Crosne,9087,90,9177
11,Île-de-France,91,1,11,198,D'Huison-Longueville,1362,18,1380
11,Île-de-France,91,2,18,195,Dannemois,827,9,836
11,Île-de-France,91,1,07,200,Dourdan,9625,166,9791
11,Île-de-France,91,2,29,201,Draveil,28716,310,29026
11,Île-de-France,91,2,16,204,Écharcon,766,10,776
11,Île-de-France,91,3,01,207,Égly,5268,41,5309
11,Île-de-France,91,2,38,215,Épinay-sous-Sénart,12560,82,12642
11,Île-de-France,91,3,14,216,Épinay-sur-Orge,10155,123,10278
11,Île-de-France,91,1,17,222,Estouches,207,1,208
11,Île-de-France,91,1,08,223,Étampes,22205,354,22559
11,Île-de-France,91,2,32,225,Étiolles,3098,96,3194
11,Île-de-France,91,1,09,226,Étréchy,6206,48,6254
11,Île-de-France,91,2,97,228,Évry,52500,867,53367
11,Île-de-France,91,1,11,232,La Ferté-Alais,4006,49,4055
11,Île-de-France,91,2,31,235,Fleury-Mérogis,9114,32,9146
11,Île-de-France,91,1,17,240,Fontaine-la-Rivière,207,1,208
11,Île-de-France,91,2,16,244,Fontenay-le-Vicomte,1305,14,1319
11,Île-de-France,91,3,13,243,Fontenay-lès-Briis,1782,35,1817
11,Île-de-France,91,1,07,247,La Forêt-le-Roi,472,15,487
11,Île-de-France,91,1,17,248,La Forêt-Sainte-Croix,152,1,153
11,Île-de-France,91,3,13,249,Forges-les-Bains,3691,69,3760
11,Île-de-France,91,3,30,272,Gif-sur-Yvette,21248,535,21783
11,Île-de-France,91,2,18,273,Gironville-sur-Essonne,787,10,797
11,Île-de-France,91,3,13,274,Gometz-la-Ville,1251,20,1271
11,Île-de-France,91,3,13,275,Gometz-le-Châtel,2264,31,2295
11,Île-de-France,91,1,07,284,Les Granges-le-Roi,1000,16,1016
11,Île-de-France,91,2,40,286,Grigny,27196,162,27358
11,Île-de-France,91,3,01,292,Guibeville,735,7,742
11,Île-de-France,91,1,11,293,Guigneville-sur-Essonne,954,18,972
11,Île-de-France,91,1,17,294,Guillerval,745,9,754
11,Île-de-France,91,3,22,312,Igny,10177,528,10705
11,Île-de-France,91,1,11,315,Itteville,6440,65,6505
11,Île-de-France,91,1,09,318,Janville-sur-Juine,1861,63,1924
11,Île-de-France,91,3,13,319,Janvry,605,21,626
11,Île-de-France,91,3,41,326,Juvisy-sur-Orge,14437,103,14540
11,Île-de-France,91,1,09,330,Lardy,5662,66,5728
11,Île-de-France,91,3,04,332,Leudeville,1311,15,1326
11,Île-de-France,91,3,01,333,Leuville-sur-Orge,4182,58,4240
11,Île-de-France,91,3,13,338,Limours,6400,141,6541
11,Île-de-France,91,3,20,339,Linas,6354,87,6441
11,Île-de-France,91,2,10,340,Lisses,6830,88,6918
11,Île-de-France,91,3,14,345,Longjumeau,21365,113,21478
11,Île-de-France,91,3,20,347,Longpont-sur-Orge,6683,54,6737
11,Île-de-France,91,2,18,359,Maisse,2746,51,2797
11,Île-de-France,91,3,20,363,Marcoussis,7729,127,7856
11,Île-de-France,91,1,17,374,Marolles-en-Beauce,220,4,224
11,Île-de-France,91,3,04,376,Marolles-en-Hurepoix,4734,54,4788
11,Île-de-France,91,3,98,377,Massy,40545,425,40970
11,Île-de-France,91,1,09,378,Mauchamps,291,2,293
11,Île-de-France,91,2,16,386,Mennecy,13227,239,13466
11,Île-de-France,91,1,17,390,Méréville,3187,63,3250
11,Île-de-France,91,1,07,393,Mérobert,543,7,550
11,Île-de-France,91,1,17,399,Mespuits,170,8,178
11,Île-de-France,91,2,18,405,Milly-la-Forêt,4738,98,4836
11,Île-de-France,91,2,18,408,Moigny-sur-École,1269,29,1298
11,Île-de-France,91,3,13,411,Les Molières,1942,60,2002
11,Île-de-France,91,1,11,412,Mondeville,666,14,680
11,Île-de-France,91,1,17,414,Monnerville,400,4,404
11,Île-de-France,91,2,19,421,Montgeron,22712,237,22949
11,Île-de-France,91,3,20,425,Montlhéry,6535,279,6814
11,Île-de-France,91,3,28,432,Morangis,11836,77,11913
11,Île-de-France,91,1,08,433,Morigny-Champigny,4322,99,4421
11,Île-de-France,91,2,31,434,Morsang-sur-Orge,21073,145,21218
11,Île-de-France,91,2,32,435,Morsang-sur-Seine,491,45,536
11,Île-de-France,91,2,16,441,Nainville-les-Roches,445,22,467
11,Île-de-France,91,3,01,457,La Norville,4133,84,4217
11,Île-de-France,91,3,20,458,Nozay,4710,57,4767
11,Île-de-France,91,3,01,461,Ollainville,4561,95,4656
11,Île-de-France,91,2,18,463,Oncy-sur-École,946,13,959
11,Île-de-France,91,2,16,468,Ormoy,1773,22,1795
11,Île-de-France,91,1,08,469,Ormoy-la-Rivière,947,61,1008
11,Île-de-France,91,3,21,471,Orsay,16255,216,16471
11,Île-de-France,91,1,11,473,Orveau,203,4,207
11,Île-de-France,91,3,22,477,Palaiseau,30352,406,30758
11,Île-de-France,91,3,02,479,Paray-Vieille-Poste,7160,58,7218
11,Île-de-France,91,3,13,482,Pecqueuse,602,7,609
11,Île-de-France,91,3,04,494,Le Plessis-Pâté,3970,31,4001
11,Île-de-France,91,1,07,495,Plessis-Saint-Benoist,307,7,314
11,Île-de-France,91,2,18,507,Prunay-sur-Essonne,310,4,314
11,Île-de-France,91,1,08,508,Puiselet-le-Marais,279,13,292
11,Île-de-France,91,1,17,511,Pussay,1847,24,1871
11,Île-de-France,91,2,38,514,Quincy-sous-Sénart,7714,78,7792
11,Île-de-France,91,1,07,519,Richarville,429,16,445
11,Île-de-France,91,2,23,521,Ris-Orangis,27006,196,27202
11,Île-de-France,91,1,07,525,Roinville,1190,18,1208
11,Île-de-France,91,1,17,526,Roinvilliers,88,3,91
11,Île-de-France,91,1,17,533,Saclas,1797,12,1809
11,Île-de-France,91,3,03,534,Saclay,3016,52,3068
11,Île-de-France,91,3,03,538,Saint-Aubin,657,24,681
11,Île-de-France,91,1,24,540,Saint-Chéron,4787,85,4872
11,Île-de-France,91,1,17,544,Saint-Cyr-la-Rivière,494,8,502
11,Île-de-France,91,1,24,546,Saint-Cyr-sous-Dourdan,1002,15,1017
11,Île-de-France,91,1,07,547,Saint-Escobille,463,11,474
11,Île-de-France,91,3,01,552,Saint-Germain-lès-Arpajon,9194,72,9266
11,Île-de-France,91,2,32,553,Saint-Germain-lès-Corbeil,7100,120,7220
11,Île-de-France,91,1,08,556,Saint-Hilaire,354,9,363
11,Île-de-France,91,3,20,560,Saint-Jean-de-Beauregard,277,6,283
11,Île-de-France,91,1,24,568,Saint-Maurice-Montcouronne,1604,31,1635
11,Île-de-France,91,3,33,570,Saint-Michel-sur-Orge,20163,222,20385
11,Île-de-France,91,2,32,573,Saint-Pierre-du-Perray,7844,96,7940
11,Île-de-France,91,1,24,578,Saint-Sulpice-de-Favières,325,2,327
11,Île-de-France,91,3,04,579,Saint-Vrain,2790,28,2818
11,Île-de-France,91,1,24,581,Saint-Yon,895,13,908
11,Île-de-France,91,3,25,549,Sainte-Geneviève-des-Bois,34022,312,34334
11,Île-de-France,91,2,32,577,Saintry-sur-Seine,5154,64,5218
11,Île-de-France,91,3,35,587,Saulx-les-Chartreux,4942,57,4999
11,Île-de-France,91,3,99,589,Savigny-sur-Orge,37319,305,37624
11,Île-de-France,91,1,24,593,Sermaise,1651,21,1672
11,Île-de-France,91,2,18,599,Soisy-sur-École,1378,18,1396
11,Île-de-France,91,2,32,600,Soisy-sur-Seine,7174,118,7292
11,Île-de-France,91,1,09,602,Souzy-la-Briche,373,5,378
11,Île-de-France,91,2,32,617,Tigery,2308,98,2406
11,Île-de-France,91,1,09,619,Torfou,270,6,276
11,Île-de-France,91,3,43,692,Les Ulis,24590,261,24851
11,Île-de-France,91,1,24,630,Le Val-Saint-Germain,1470,32,1502
11,Île-de-France,91,1,08,629,Valpuiseaux,617,3,620
11,Île-de-France,91,2,38,631,Varennes-Jarcy,2365,27,2392
11,Île-de-France,91,3,13,634,Vaugrigneuse,1234,15,1249
11,Île-de-France,91,3,03,635,Vauhallan,1997,44,2041
11,Île-de-France,91,1,11,639,Vayres-sur-Essonne,910,64,974
11,Île-de-France,91,3,03,645,Verrières-le-Buisson,15731,248,15979
11,Île-de-France,91,2,16,648,Vert-le-Grand,2412,23,2435
11,Île-de-France,91,2,16,649,Vert-le-Petit,2547,27,2574
11,Île-de-France,91,1,11,654,Videlles,655,10,665
11,Île-de-France,91,2,34,657,Vigneux-sur-Seine,26991,244,27235
11,Île-de-France,91,2,06,659,Villabé,4847,65,4912
11,Île-de-France,91,3,20,665,La Ville-du-Bois,7194,64,7258
11,Île-de-France,91,3,35,661,Villebon-sur-Yvette,9611,152,9763
11,Île-de-France,91,1,09,662,Villeconin,722,11,733
11,Île-de-France,91,3,35,666,Villejust,2189,31,2220
11,Île-de-France,91,3,14,667,Villemoisson-sur-Orge,6841,84,6925
11,Île-de-France,91,1,09,671,Villeneuve-sur-Auvers,614,8,622
11,Île-de-France,91,3,03,679,Villiers-le-Bâcle,1151,12,1163
11,Île-de-France,91,3,14,685,Villiers-sur-Orge,3910,37,3947
11,Île-de-France,91,2,27,687,Viry-Châtillon,31681,337,32018
11,Île-de-France,91,3,28,689,Wissous,5181,160,5341
11,Île-de-France,91,2,36,691,Yerres,29041,334,29375
11,Île-de-France,92,1,87,002,Antony,61240,809,62049
11,Île-de-France,92,2,88,004,Asnières-sur-Seine,81666,599,82265
11,Île-de-France,92,1,04,007,Bagneux,38509,306,38815
11,Île-de-France,92,2,05,009,Bois-Colombes,27809,192,28001
11,Île-de-France,92,3,89,012,Boulogne-Billancourt,112233,1003,113236
11,Île-de-France,92,1,09,014,Bourg-la-Reine,20015,270,20285
11,Île-de-France,92,1,85,019,Châtenay-Malabry,31854,444,32298
11,Île-de-France,92,1,10,020,Châtillon,32510,327,32837
11,Île-de-France,92,3,11,022,Chaville,18126,217,18343
11,Île-de-France,92,1,90,023,Clamart,51407,566,51973
11,Île-de-France,92,2,91,024,Clichy,58388,311,58699
11,Île-de-France,92,2,92,025,Colombes,83695,672,84367
11,Île-de-France,92,2,93,026,Courbevoie,85054,689,85743
11,Île-de-France,92,1,43,032,Fontenay-aux-Roses,24131,246,24377
11,Île-de-France,92,2,18,033,Garches,18157,285,18442
11,Île-de-France,92,2,19,035,La Garenne-Colombes,26699,228,26927
11,Île-de-France,92,2,86,036,Gennevilliers,41822,310,42132
11,Île-de-France,92,3,94,040,Issy-les-Moulineaux,63297,772,64069
11,Île-de-France,92,2,95,044,Levallois-Perret,62995,407,63402
11,Île-de-France,92,1,25,046,Malakoff,30909,266,31175
11,Île-de-France,92,3,11,047,Marnes-la-Coquette,1680,37,1717
11,Île-de-France,92,3,96,048,Meudon,44706,808,45514
11,Île-de-France,92,1,27,049,Montrouge,46682,317,46999
11,Île-de-France,92,2,97,050,Nanterre,89556,2031,91587
11,Île-de-France,92,2,98,051,Neuilly-sur-Seine,60341,715,61056
11,Île-de-France,92,1,32,060,Le Plessis-Robinson,24675,156,24831
11,Île-de-France,92,2,33,062,Puteaux,44548,284,44832
11,Île-de-France,92,2,99,063,Rueil-Malmaison,78112,1254,79366
11,Île-de-France,92,3,35,064,Saint-Cloud,29772,455,30227
11,Île-de-France,92,1,36,071,Sceaux,19625,340,19965
11,Île-de-France,92,3,37,072,Sèvres,23122,387,23509
11,Île-de-France,92,2,38,073,Suresnes,45617,363,45980
11,Île-de-France,92,1,39,075,Vanves,26459,265,26724
11,Île-de-France,92,3,11,076,Vaucresson,8636,308,8944
11,Île-de-France,92,3,11,077,Ville-d'Avray,10861,196,11057
11,Île-de-France,92,2,40,078,Villeneuve-la-Garenne,24711,214,24925
11,Île-de-France,93,3,92,001,Aubervilliers,74528,530,75058
11,Île-de-France,93,2,93,005,Aulnay-sous-Bois,82188,588,82776
11,Île-de-France,93,1,05,006,Bagnolet,33960,324,34284
11,Île-de-France,93,2,06,007,Le Blanc-Mesnil,50668,307,50975
11,Île-de-France,93,1,07,008,Bobigny,47726,301,48027
11,Île-de-France,93,1,94,010,Bondy,53259,372,53631
11,Île-de-France,93,1,09,013,Le Bourget,13610,83,13693
11,Île-de-France,93,2,24,014,Clichy-sous-Bois,29127,177,29304
11,Île-de-France,93,2,15,015,Coubron,4676,61,4737
11,Île-de-France,93,3,10,027,La Courneuve,36915,310,37225
11,Île-de-France,93,1,95,029,Drancy,66194,613,66807
11,Île-de-France,93,1,09,030,Dugny,10483,80,10563
11,Île-de-France,93,3,12,031,Épinay-sur-Seine,52689,272,52961
11,Île-de-France,93,2,13,032,Gagny,38342,360,38702
11,Île-de-France,93,2,19,033,Gournay-sur-Marne,6229,50,6279
11,Île-de-France,93,3,29,039,L' Île-Saint-Denis,7071,38,7109
11,Île-de-France,93,1,23,045,Les Lilas,22157,191,22348
11,Île-de-France,93,2,14,046,Livry-Gargan,41808,209,42017
11,Île-de-France,93,2,15,047,Montfermeil,24457,213,24670
11,Île-de-France,93,1,96,048,Montreuil,102176,826,103002
11,Île-de-France,93,2,18,049,Neuilly-Plaisance,20304,183,20487
11,Île-de-France,93,2,37,050,Neuilly-sur-Marne,33198,260,33458
11,Île-de-France,93,2,19,051,Noisy-le-Grand,63106,507,63613
11,Île-de-France,93,1,20,053,Noisy-le-Sec,38713,250,38963
11,Île-de-France,93,1,97,055,Pantin,52698,328,53026
11,Île-de-France,93,1,22,057,Les Pavillons-sous-Bois,20721,220,20941
11,Île-de-France,93,3,39,059,Pierrefitte-sur-Seine,28871,143,29014
11,Île-de-France,93,1,23,061,Le Pré-Saint-Gervais,17588,90,17678
11,Île-de-France,93,2,24,062,Le Raincy,13622,342,13964
11,Île-de-France,93,1,25,063,Romainville,25621,239,25860
11,Île-de-France,93,1,26,064,Rosny-sous-Bois,40843,293,41136
11,Île-de-France,93,3,98,066,Saint-Denis,103742,1125,104867
11,Île-de-France,93,3,99,070,Saint-Ouen,45595,393,45988
11,Île-de-France,93,2,31,071,Sevran,50770,320,51090
11,Île-de-France,93,3,32,072,Stains,34608,215,34823
11,Île-de-France,93,2,33,073,Tremblay-en-France,35494,236,35730
11,Île-de-France,93,2,15,074,Vaujours,6075,125,6200
11,Île-de-France,93,1,34,077,Villemomble,28169,261,28430
11,Île-de-France,93,2,40,078,Villepinte,35810,245,36055
11,Île-de-France,93,3,39,079,Villetaneuse,12655,79,12734
11,Île-de-France,94,1,28,001,Ablon-sur-Seine,5158,27,5185
11,Île-de-France,94,1,86,002,Alfortville,44728,258,44986
11,Île-de-France,94,3,34,003,Arcueil,19847,160,20007
11,Île-de-France,94,1,02,004,Boissy-Saint-Léger,15680,182,15862
11,Île-de-France,94,1,03,011,Bonneuil-sur-Marne,16541,360,16901
11,Île-de-France,94,2,04,015,Bry-sur-Marne,15316,198,15514
11,Île-de-France,94,3,05,016,Cachan,27676,286,27962
11,Île-de-France,94,2,94,017,Champigny-sur-Marne,75142,677,75819
11,Île-de-France,94,1,07,018,Charenton-le-Pont,28571,267,28838
11,Île-de-France,94,2,08,019,Chennevières-sur-Marne,17698,148,17846
11,Île-de-France,94,3,42,021,Chevilly-Larue,19042,185,19227
11,Île-de-France,94,1,09,022,Choisy-le-Roi,38153,334,38487
11,Île-de-France,94,1,90,028,Créteil,89304,823,90127
11,Île-de-France,94,2,91,033,Fontenay-sous-Bois,52848,511,53359
11,Île-de-France,94,3,37,034,Fresnes,25043,191,25234
11,Île-de-France,94,3,87,037,Gentilly,17362,122,17484
11,Île-de-France,94,3,12,038,L' Haÿ-les-Roses,29496,357,29853
11,Île-de-France,94,1,95,041,Ivry-sur-Seine,56679,392,57071
11,Île-de-France,94,2,15,042,Joinville-le-Pont,17368,126,17494
11,Île-de-France,94,3,16,043,Le Kremlin-Bicêtre,26104,172,26276
11,Île-de-France,94,1,02,044,Limeil-Brévannes,18768,145,18913
11,Île-de-France,94,1,96,046,Maisons-Alfort,52852,525,53377
11,Île-de-France,94,1,26,047,Mandres-les-Roses,4342,49,4391
11,Île-de-France,94,1,26,048,Marolles-en-Brie,5057,137,5194
11,Île-de-France,94,2,19,052,Nogent-sur-Marne,30852,346,31198
11,Île-de-France,94,2,44,053,Noiseau,4426,35,4461
11,Île-de-France,94,1,20,054,Orly,20940,267,21207
11,Île-de-France,94,2,44,055,Ormesson-sur-Marne,9878,85,9963
11,Île-de-France,94,1,26,056,Périgny,2229,22,2251
11,Île-de-France,94,2,21,058,Le Perreux-sur-Marne,32250,276,32526
11,Île-de-France,94,2,38,059,Le Plessis-Trévise,18503,129,18632
11,Île-de-France,94,2,44,060,La Queue-en-Brie,11439,127,11566
11,Île-de-France,94,3,42,065,Rungis,5618,69,5687
11,Île-de-France,94,2,22,067,Saint-Mandé,22518,253,22771
11,Île-de-France,94,1,97,068,Saint-Maur-des-Fossés,75724,992,76716
11,Île-de-France,94,1,07,069,Saint-Maurice,14558,124,14682
11,Île-de-France,94,1,26,070,Santeny,3675,49,3724
11,Île-de-France,94,1,46,071,Sucy-en-Brie,26089,325,26414
11,Île-de-France,94,3,25,073,Thiais,29616,396,30012
11,Île-de-France,94,1,47,074,Valenton,12222,98,12320
11,Île-de-France,94,1,26,075,Villecresnes,9401,131,9532
11,Île-de-France,94,3,93,076,Villejuif,53240,354,53594
11,Île-de-France,94,1,28,077,Villeneuve-le-Roi,18457,81,18538
11,Île-de-France,94,1,88,078,Villeneuve-Saint-Georges,30820,260,31080
11,Île-de-France,94,2,38,079,Villiers-sur-Marne,27457,246,27703
11,Île-de-France,94,2,98,080,Vincennes,48118,474,48592
11,Île-de-France,94,1,99,081,Vitry-sur-Seine,84071,742,84813
11,Île-de-France,95,3,27,002,Ableiges,945,11,956
11,Île-de-France,95,3,16,008,Aincourt,940,9,949
11,Île-de-France,95,3,16,011,Ambleville,375,6,381
11,Île-de-France,95,3,16,012,Amenucourt,180,1,181
11,Île-de-France,95,2,24,014,Andilly,2470,55,2525
11,Île-de-France,95,1,99,018,Argenteuil,103250,1593,104843
11,Île-de-France,95,2,35,019,Arnouville-lès-Gonesse,13230,171,13401
11,Île-de-France,95,3,17,023,Arronville,666,11,677
11,Île-de-France,95,3,16,024,Arthies,288,3,291
11,Île-de-France,95,2,26,026,Asnières-sur-Oise,2532,58,2590
11,Île-de-France,95,2,06,028,Attainville,1822,14,1836
11,Île-de-France,95,3,34,039,Auvers-sur-Oise,6879,168,7047
11,Île-de-France,95,3,27,040,Avernes,813,13,826
11,Île-de-France,95,2,26,042,Baillet-en-France,1922,17,1939
11,Île-de-France,95,3,16,046,Banthelu,120,2,122
11,Île-de-France,95,3,28,051,Beauchamp,8817,90,8907
11,Île-de-France,95,3,03,052,Beaumont-sur-Oise,8873,162,9035
11,Île-de-France,95,3,17,054,Le Bellay-en-Vexin,247,7,254
11,Île-de-France,95,2,15,055,Bellefontaine,453,3,456
11,Île-de-France,95,2,26,056,Belloy-en-France,1836,13,1849
11,Île-de-France,95,3,03,058,Bernes-sur-Oise,2371,19,2390
11,Île-de-France,95,3,17,059,Berville,329,5,334
11,Île-de-France,95,3,25,060,Bessancourt,7219,96,7315
11,Île-de-France,95,3,25,061,Béthemont-la-Forêt,418,7,425
11,Île-de-France,95,1,04,063,Bezons,28023,307,28330
11,Île-de-France,95,3,39,074,Boisemont,733,10,743
11,Île-de-France,95,3,29,078,Boissy-l'Aillerie,1784,19,1803
11,Île-de-France,95,2,38,088,Bonneuil-en-France,707,2,709
11,Île-de-France,95,2,06,091,Bouffémont,5800,53,5853
11,Île-de-France,95,2,13,094,Bouqueval,316,4,320
11,Île-de-France,95,3,16,101,Bray-et-Lû,956,5,961
11,Île-de-France,95,3,17,102,Bréançon,378,4,382
11,Île-de-France,95,3,17,110,Brignancourt,210,8,218
11,Île-de-France,95,3,03,116,Bruyères-sur-Oise,3429,61,3490
11,Île-de-France,95,3,16,119,Buhy,299,2,301
11,Île-de-France,95,3,34,120,Butry-sur-Oise,1963,36,1999
11,Île-de-France,95,3,96,127,Cergy,56108,812,56920
11,Île-de-France,95,3,03,134,Champagne-sur-Oise,4600,49,4649
11,Île-de-France,95,3,16,139,La Chapelle-en-Vexin,324,3,327
11,Île-de-France,95,3,16,141,Charmont,30,1,31
11,Île-de-France,95,3,17,142,Chars,1777,15,1792
11,Île-de-France,95,2,15,144,Châtenay-en-France,65,0,65
11,Île-de-France,95,2,15,149,Chaumontel,3270,46,3316
11,Île-de-France,95,3,16,150,Chaussy,646,15,661
11,Île-de-France,95,3,25,151,Chauvry,296,7,303
11,Île-de-France,95,2,13,154,Chennevières-lès-Louvres,331,2,333
11,Île-de-France,95,3,16,157,Chérence,152,2,154
11,Île-de-France,95,3,27,166,Cléry-en-Vexin,410,10,420
11,Île-de-France,95,3,27,169,Commeny,383,5,388
11,Île-de-France,95,3,27,170,Condécourt,535,4,539
11,Île-de-France,95,1,05,176,Cormeilles-en-Parisis,22403,253,22656
11,Île-de-France,95,3,17,177,Cormeilles-en-Vexin,1023,9,1032
11,Île-de-France,95,3,27,181,Courcelles-sur-Viosne,296,7,303
11,Île-de-France,95,3,39,183,Courdimanche,6581,96,6677
11,Île-de-France,95,2,09,197,Deuil-la-Barre,21684,264,21948
11,Île-de-France,95,2,06,199,Domont,14563,226,14789
11,Île-de-France,95,3,07,203,Eaubonne,23795,293,24088
11,Île-de-France,95,2,08,205,Écouen,7380,87,7467
11,Île-de-France,95,2,09,210,Enghien-les-Bains,12115,149,12264
11,Île-de-France,95,3,34,211,Ennery,2248,21,2269
11,Île-de-France,95,2,13,212,Épiais-lès-Louvres,77,2,79
11,Île-de-France,95,3,17,213,Épiais-Rhus,630,6,636
11,Île-de-France,95,2,15,214,Épinay-Champlâtreux,66,0,66
11,Île-de-France,95,3,37,218,Éragny,16577,248,16825
11,Île-de-France,95,3,10,219,Ermont,27661,312,27973
11,Île-de-France,95,2,08,229,Ézanville,9064,127,9191
11,Île-de-France,95,2,15,241,Fontenay-en-Parisis,1954,13,1967
11,Île-de-France,95,2,15,250,Fosses,9663,64,9727
11,Île-de-France,95,3,11,252,Franconville,33214,245,33459
11,Île-de-France,95,3,27,253,Frémainville,482,3,485
11,Île-de-France,95,3,17,254,Frémécourt,544,8,552
11,Île-de-France,95,3,25,256,Frépillon,2668,32,2700
11,Île-de-France,95,1,31,257,La Frette-sur-Seine,4555,61,4616
11,Île-de-France,95,3,34,258,Frouville,373,12,385
11,Île-de-France,95,3,27,259,Gadancourt,104,0,104
11,Île-de-France,95,2,97,268,Garges-lès-Gonesse,39640,283,39923
11,Île-de-France,95,3,16,270,Genainville,542,5,547
11,Île-de-France,95,3,34,271,Génicourt,503,13,516
11,Île-de-France,95,2,13,277,Gonesse,26498,316,26814
11,Île-de-France,95,2,30,280,Goussainville,30567,257,30824
11,Île-de-France,95,3,27,282,Gouzangrez,167,3,170
11,Île-de-France,95,3,17,287,Grisy-les-Plâtres,589,6,595
11,Île-de-France,95,2,18,288,Groslay,8367,141,8508
11,Île-de-France,95,3,27,295,Guiry-en-Vexin,161,3,164
11,Île-de-France,95,3,17,298,Haravilliers,521,6,527
11,Île-de-France,95,3,16,301,Haute-Isle,332,5,337
11,Île-de-France,95,3,17,303,Le Heaulme,186,7,193
11,Île-de-France,95,3,34,304,Hédouville,267,4,271
11,Île-de-France,95,1,31,306,Herblay,25984,458,26442
11,Île-de-France,95,3,34,308,Hérouville,593,39,632
11,Île-de-France,95,3,16,309,Hodent,268,1,269
11,Île-de-France,95,3,14,313,L' Isle-Adam,11394,200,11594
11,Île-de-France,95,2,15,316,Jagny-sous-Bois,261,2,263
11,Île-de-France,95,3,39,323,Jouy-le-Moutier,16657,239,16896
11,Île-de-France,95,3,34,328,Labbeville,546,11,557
11,Île-de-France,95,2,15,331,Lassy,179,1,180
11,Île-de-France,95,3,34,341,Livilliers,351,7,358
11,Île-de-France,95,3,27,348,Longuesse,527,19,546
11,Île-de-France,95,2,30,351,Louvres,8974,74,9048
11,Île-de-France,95,2,15,352,Luzarches,4152,59,4211
11,Île-de-France,95,2,26,353,Maffliers,1631,12,1643
11,Île-de-France,95,3,16,355,Magny-en-Vexin,5586,60,5646
11,Île-de-France,95,2,15,365,Mareil-en-France,642,6,648
11,Île-de-France,95,2,24,369,Margency,2890,41,2931
11,Île-de-France,95,3,17,370,Marines,3232,64,3296
11,Île-de-France,95,2,15,371,Marly-la-Ville,5530,43,5573
11,Île-de-France,95,3,16,379,Maudétour-en-Vexin,194,3,197
11,Île-de-France,95,3,17,387,Menouville,83,2,85
11,Île-de-France,95,3,39,388,Menucourt,5134,26,5160
11,Île-de-France,95,3,14,392,Mériel,4391,57,4448
11,Île-de-France,95,3,21,394,Méry-sur-Oise,9412,110,9522
11,Île-de-France,95,2,08,395,Le Mesnil-Aubry,934,8,942
11,Île-de-France,95,2,06,409,Moisselles,1133,5,1138
11,Île-de-France,95,3,27,422,Montgeroult,427,3,430
11,Île-de-France,95,1,05,424,Montigny-lès-Cormeilles,18891,229,19120
11,Île-de-France,95,3,20,426,Montlignon,2527,125,2652
11,Île-de-France,95,2,09,427,Montmagny,14112,202,14314
11,Île-de-France,95,2,18,428,Montmorency,21438,273,21711
11,Île-de-France,95,3,16,429,Montreuil-sur-Epte,444,4,448
11,Île-de-France,95,2,26,430,Montsoult,3445,33,3478
11,Île-de-France,95,3,03,436,Mours,1381,13,1394
11,Île-de-France,95,3,17,438,Moussy,156,2,158
11,Île-de-France,95,3,14,445,Nerville-la-Forêt,697,18,715
11,Île-de-France,95,3,34,446,Nesles-la-Vallée,1833,30,1863
11,Île-de-France,95,3,17,447,Neuilly-en-Vexin,210,2,212
11,Île-de-France,95,3,39,450,Neuville-sur-Oise,1579,42,1621
11,Île-de-France,95,3,03,452,Nointel,727,14,741
11,Île-de-France,95,2,26,456,Noisy-sur-Oise,694,9,703
11,Île-de-France,95,3,17,459,Nucourt,760,6,766
11,Île-de-France,95,3,16,462,Omerville,303,6,309
11,Île-de-France,95,3,29,476,Osny,15939,268,16207
11,Île-de-France,95,3,14,480,Parmain,5488,78,5566
11,Île-de-France,95,3,27,483,Le Perchay,534,4,538
11,Île-de-France,95,3,03,487,Persan,10352,86,10438
11,Île-de-France,95,3,28,488,Pierrelaye,7778,166,7944
11,Île-de-France,95,2,08,489,Piscop,707,75,782
11,Île-de-France,95,3,28,491,Le Plessis-Bouchard,7663,61,7724
11,Île-de-France,95,2,08,492,Le Plessis-Gassot,82,0,82
11,Île-de-France,95,2,15,493,Le Plessis-Luzarches,131,1,132
11,Île-de-France,95,3,19,500,Pontoise,29710,1272,30982
11,Île-de-France,95,3,14,504,Presles,3846,49,3895
11,Île-de-France,95,2,15,509,Puiseux-en-France,3394,23,3417
11,Île-de-France,95,3,29,510,Puiseux-Pontoise,472,5,477
11,Île-de-France,95,3,16,523,La Roche-Guyon,452,68,520
11,Île-de-France,95,2,13,527,Roissy-en-France,2517,23,2540
11,Île-de-France,95,3,03,529,Ronquerolles,853,10,863
11,Île-de-France,95,3,27,535,Sagy,1169,17,1186
11,Île-de-France,95,2,08,539,Saint-Brice-sous-Forêt,14306,148,14454
11,Île-de-France,95,3,16,541,Saint-Clair-sur-Epte,885,5,890
11,Île-de-France,95,3,16,543,Saint-Cyr-en-Arthies,232,2,234
11,Île-de-France,95,3,16,554,Saint-Gervais,960,19,979
11,Île-de-France,95,2,40,555,Saint-Gratien,20287,181,20468
11,Île-de-France,95,3,20,563,Saint-Leu-la-Forêt,14669,162,14831
11,Île-de-France,95,2,26,566,Saint-Martin-du-Tertre,2449,13,2462
11,Île-de-France,95,3,21,572,Saint-Ouen-l'Aumône,23238,267,23505
11,Île-de-France,95,3,20,574,Saint-Prix,7446,134,7580
11,Île-de-France,95,2,15,580,Saint-Witz,2558,70,2628
11,Île-de-France,95,1,22,582,Sannois,25914,568,26482
11,Île-de-France,95,3,17,584,Santeuil,594,9,603
11,Île-de-France,95,2,98,585,Sarcelles,59221,608,59829
11,Île-de-France,95,3,27,592,Seraincourt,1356,27,1383
11,Île-de-France,95,2,26,594,Seugy,1049,21,1070
11,Île-de-France,95,2,24,598,Soisy-sous-Montmorency,17449,214,17663
11,Île-de-France,95,2,15,604,Survilliers,3727,34,3761
11,Île-de-France,95,3,25,607,Taverny,26349,274,26623
11,Île-de-France,95,3,27,610,Théméricourt,266,3,269
11,Île-de-France,95,3,17,611,Theuville,30,2,32
11,Île-de-France,95,2,13,612,Le Thillay,4079,38,4117
11,Île-de-France,95,3,27,625,Us,1296,17,1313
11,Île-de-France,95,3,34,627,Vallangoujard,663,8,671
11,Île-de-France,95,3,34,628,Valmondois,1225,22,1247
11,Île-de-France,95,2,13,633,Vaudherland,90,1,91
11,Île-de-France,95,3,39,637,Vauréal,15749,276,16025
11,Île-de-France,95,2,13,641,Vémars,2075,14,2089
11,Île-de-France,95,3,16,651,Vétheuil,878,12,890
11,Île-de-France,95,2,26,652,Viarmes,4741,84,4825
11,Île-de-France,95,3,16,656,Vienne-en-Arthies,401,9,410
11,Île-de-France,95,3,27,658,Vigny,1084,15,1099
11,Île-de-France,95,2,26,660,Villaines-sous-Bois,668,11,679
11,Île-de-France,95,2,13,675,Villeron,722,5,727
11,Île-de-France,95,3,16,676,Villers-en-Arthies,464,8,472
11,Île-de-France,95,3,14,678,Villiers-Adam,812,15,827
11,Île-de-France,95,2,35,680,Villiers-le-Bel,26988,256,27244
11,Île-de-France,95,2,15,682,Villiers-le-Sec,168,0,168
11,Île-de-France,95,3,16,690,Wy-dit-Joli-Village,340,6,346
01,Guadeloupe,971,2,93,101,Les Abymes,59270,727,59997
01,Guadeloupe,971,2,03,102,Anse-Bertrand,4676,64,4740
01,Guadeloupe,971,1,04,103,Baie-Mahault,29503,516,30019
01,Guadeloupe,971,1,36,104,Baillif,5586,94,5680
01,Guadeloupe,971,1,94,105,Basse-Terre,12173,268,12441
01,Guadeloupe,971,1,07,106,Bouillante,7556,94,7650
01,Guadeloupe,971,1,90,107,Capesterre-Belle-Eau,19339,213,19552
01,Guadeloupe,971,2,09,108,Capesterre-de-Marie-Galante,3442,98,3540
01,Guadeloupe,971,1,33,111,Deshaies,4357,61,4418
01,Guadeloupe,971,2,10,110,La Désirade,1587,65,1652
01,Guadeloupe,971,2,91,113,Le Gosier,26895,496,27391
01,Guadeloupe,971,1,42,109,Gourbeyre,8143,232,8375
01,Guadeloupe,971,1,43,114,Goyave,7745,145,7890
01,Guadeloupe,971,2,12,112,Grand-Bourg,5642,234,5876
01,Guadeloupe,971,1,13,115,Lamentin,15831,248,16079
01,Guadeloupe,971,2,95,116,Morne-à-l'Eau,17043,242,17285
01,Guadeloupe,971,2,96,117,Le Moule,21347,269,21616
01,Guadeloupe,971,1,92,118,Petit-Bourg,22171,358,22529
01,Guadeloupe,971,2,19,119,Petit-Canal,8177,68,8245
01,Guadeloupe,971,2,97,120,Pointe-à-Pitre,17216,146,17362
01,Guadeloupe,971,1,24,121,Pointe-Noire,7086,127,7213
01,Guadeloupe,971,2,03,122,Port-Louis,5451,70,5521
01,Guadeloupe,971,1,26,124,Saint-Claude,10380,268,10648
01,Guadeloupe,971,2,27,125,Saint-François,14149,164,14313
01,Guadeloupe,971,2,28,126,Saint-Louis,2788,144,2932
01,Guadeloupe,971,2,98,128,Sainte-Anne,23457,348,23805
01,Guadeloupe,971,1,99,129,Sainte-Rose,19587,236,19823
01,Guadeloupe,971,1,34,130,Terre-de-Bas,1031,45,1076
01,Guadeloupe,971,1,34,131,Terre-de-Haut,1831,53,1884
01,Guadeloupe,971,1,35,132,Trois-Rivières,8841,205,9046
01,Guadeloupe,971,1,35,133,Vieux-Fort,1792,24,1816
01,Guadeloupe,971,1,36,134,Vieux-Habitants,7692,193,7885
02,Martinique,972,2,01,201,L' Ajoupa-Bouillon,1691,30,1721
02,Martinique,972,3,02,202,Les Anses-d'Arlet,3826,39,3865
02,Martinique,972,2,03,203,Basse-Pointe,3804,82,3886
02,Martinique,972,4,05,234,Bellefontaine,1454,71,1525
02,Martinique,972,4,04,204,Le Carbet,3760,49,3809
02,Martinique,972,4,05,205,Case-Pilote,4515,104,4619
02,Martinique,972,3,06,206,Le Diamant,5850,82,5932
02,Martinique,972,3,07,207,Ducos,16433,344,16777
02,Martinique,972,4,29,208,Fonds-Saint-Denis,873,2,875
02,Martinique,972,1,99,209,Fort-de-France,89000,1498,90498
02,Martinique,972,3,94,210,Le François,19189,320,19509
02,Martinique,972,2,18,211,Grand'Rivière,751,10,761
02,Martinique,972,2,15,212,Gros-Morne,10734,149,10883
02,Martinique,972,1,95,213,Le Lamentin,39410,606,40016
02,Martinique,972,2,17,214,Le Lorrain,7650,121,7771
02,Martinique,972,2,18,215,Macouba,1284,19,1303
02,Martinique,972,2,19,216,Le Marigot,3668,65,3733
02,Martinique,972,3,20,217,Le Marin,8954,118,9072
02,Martinique,972,4,21,218,Le Morne-Rouge,5150,94,5244
02,Martinique,972,4,04,233,Le Morne-Vert,1853,44,1897
02,Martinique,972,4,23,219,Le Prêcheur,1682,17,1699
02,Martinique,972,3,24,220,Rivière-Pilote,13617,86,13703
02,Martinique,972,3,25,221,Rivière-Salée,12968,248,13216
02,Martinique,972,2,96,222,Le Robert,23903,193,24096
02,Martinique,972,3,27,223,Saint-Esprit,9045,90,9135
02,Martinique,972,1,28,224,Saint-Joseph,16966,267,17233
02,Martinique,972,4,29,225,Saint-Pierre,4496,48,4544
02,Martinique,972,3,30,226,Sainte-Anne,4833,50,4883
02,Martinique,972,3,31,227,Sainte-Luce,9424,197,9621
02,Martinique,972,2,97,228,Sainte-Marie,19056,177,19233
02,Martinique,972,1,98,229,Schoelcher,21737,424,22161
02,Martinique,972,2,34,230,La Trinité,13802,231,14033
02,Martinique,972,3,35,231,Les Trois-Îlets,7368,95,7463
02,Martinique,972,3,36,232,Le Vauclin,8947,132,9079
03,Guyane,973,2,16,360,Apatou,6458,31,6489
03,Guyane,973,2,09,361,Awala-Yalimapo,1305,14,1319
03,Guyane,973,1,12,356,Camopi,1535,18,1553
03,Guyane,973,1,99,302,Cayenne,57643,286,57929
03,Guyane,973,2,16,357,Grand-Santi,3973,20,3993
03,Guyane,973,1,06,303,Iracoubo,2055,25,2080
03,Guyane,973,1,07,304,Kourou,25934,209,26143
03,Guyane,973,1,08,305,Macouria,8583,103,8686
03,Guyane,973,2,09,306,Mana,8697,66,8763
03,Guyane,973,2,16,353,Maripasoula,6556,40,6596
03,Guyane,973,1,19,307,Matoury,25629,270,25899
03,Guyane,973,1,15,313,Montsinéry-Tonnegrande,2044,15,2059
03,Guyane,973,1,12,314,Ouanary,84,8,92
03,Guyane,973,2,16,362,Papaichton,3136,3,3139
03,Guyane,973,1,01,301,Régina,834,21,855
03,Guyane,973,1,10,309,Remire-Montjoly,18817,420,19237
03,Guyane,973,1,11,310,Roura,2709,67,2776
03,Guyane,973,1,14,358,Saint-Élie,476,1,477
03,Guyane,973,1,12,308,Saint-Georges,3858,88,3946
03,Guyane,973,2,13,311,Saint-Laurent-du-Maroni,35631,178,35809
03,Guyane,973,2,16,352,Saül,158,1,159
03,Guyane,973,1,14,312,Sinnamary,3151,28,3179
04,La Réunion,974,2,01,401,Les Avirons,10336,167,10503
04,La Réunion,974,3,02,402,Bras-Panon,11404,107,11511
04,La Réunion,974,2,22,424,Cilaos,5994,96,6090
04,La Réunion,974,2,03,403,Entre-Deux,6022,82,6104
04,La Réunion,974,2,04,404,L' Étang-Salé,13367,188,13555
04,La Réunion,974,2,05,405,Petite-Île,11692,121,11813
04,La Réunion,974,3,06,406,La Plaine-des-Palmistes,4940,96,5036
04,La Réunion,974,4,91,407,Le Port,38279,285,38564
04,La Réunion,974,4,08,408,La Possession,28798,377,29175
04,La Réunion,974,3,92,409,Saint-André,52956,354,53310
04,La Réunion,974,3,90,410,Saint-Benoît,33802,219,34021
04,La Réunion,974,1,93,411,Saint-Denis,144238,1538,145776
04,La Réunion,974,2,94,412,Saint-Joseph,35062,431,35493
04,La Réunion,974,4,95,413,Saint-Leu,29925,282,30207
04,La Réunion,974,2,96,414,Saint-Louis,50717,464,51181
04,La Réunion,974,4,97,415,Saint-Paul,103008,1376,104384
04,La Réunion,974,2,26,417,Saint-Philippe,5114,54,5168
04,La Réunion,974,2,98,416,Saint-Pierre,76247,784,77031
04,La Réunion,974,1,30,418,Sainte-Marie,30815,389,31204
04,La Réunion,974,3,31,419,Sainte-Rose,6809,71,6880
04,La Réunion,974,1,32,420,Sainte-Suzanne,22411,190,22601
04,La Réunion,974,3,33,421,Salazie,7294,72,7366
04,La Réunion,974,2,99,422,Le Tampon,72026,911,72937
04,La Réunion,974,4,36,423,Les Trois-Bassins,6994,97,7091
