REG;DEP;COM;PMUN;PCAP;PTOT
84;01;01001;779;19;798
84;01;01002;256;1;257
84;01;01004;14134;380;14514
84;01;01005;1751;25;1776
84;01;01006;112;6;118
84;01;01007;2800;115;2915
84;01;01008;762;15;777
84;01;01009;326;9;335
84;01;01010;1105;17;1122
84;01;01011;368;11;379
84;01;01012;329;4;333
84;01;01013;143;4;147
84;01;01014;3349;93;3442
84;01;01015;650;17;667
84;01;01016;460;9;469
84;01;01017;457;16;473
84;01;01019;27;4;31
84;01;01021;1457;28;1485
84;01;01022;1249;18;1267
84;01;01023;76;0;76
84;01;01024;3251;65;3316
84;01;01025;4065;106;4171
84;01;01026;973;68;1041
84;01;01027;2563;52;2615
84;01;01028;617;17;634
84;01;01029;685;8;693
84;01;01030;829;15;844
84;01;01031;3652;234;3886
84;01;01032;3376;29;3405
84;01;01033;16378;350;16728
84;01;01034;9182;400;9582
84;01;01035;310;8;318
84;01;01036;1326;19;1345
84;01;01037;308;4;312
84;01;01038;754;21;775
84;01;01039;443;8;451
84;01;01040;486;10;496
84;01;01041;748;21;769
84;01;01042;291;14;305
84;01;01043;4754;113;4867
84;01;01044;632;16;648
84;01;01045;283;4;287
84;01;01046;895;8;903
84;01;01047;1182;32;1214
84;01;01049;3283;73;3356
84;01;01050;365;4;369
84;01;01051;91;1;92
84;01;01052;328;6;334
84;01;01053;41111;1742;42853
84;01;01054;1457;32;1489
84;01;01056;349;5;354
84;01;01057;519;16;535
84;01;01058;828;21;849
84;01;01060;493;21;514
84;01;01061;1144;35;1179
84;01;01062;934;22;956
84;01;01063;533;7;540
84;01;01064;1070;20;1090
84;01;01065;1812;64;1876
84;01;01066;89;1;90
84;01;01067;255;13;268
84;01;01068;775;15;790
84;01;01069;1503;39;1542
84;01;01071;4808;117;4925
84;01;01072;3194;62;3256
84;01;01073;1000;25;1025
84;01;01074;2589;35;2624
84;01;01075;1382;31;1413
84;01;01076;125;3;128
84;01;01077;196;3;199
84;01;01078;1557;33;1590
84;01;01079;811;31;842
84;01;01080;643;14;657
84;01;01081;735;21;756
84;01;01082;628;14;642
84;01;01083;927;17;944
84;01;01084;895;18;913
84;01;01085;400;5;405
84;01;01087;282;10;292
84;01;01088;903;27;930
84;01;01089;2253;50;2303
84;01;01090;356;6;362
84;01;01092;1604;58;1662
84;01;01093;4931;203;5134
84;01;01094;761;12;773
84;01;01095;853;12;865
84;01;01096;1034;30;1064
84;01;01098;1159;36;1195
84;01;01099;1566;57;1623
84;01;01100;131;4;135
84;01;01101;152;7;159
84;01;01102;961;15;976
84;01;01103;2149;47;2196
84;01;01104;461;10;471
84;01;01105;1829;53;1882
84;01;01106;179;7;186
84;01;01107;133;4;137
84;01;01108;1176;24;1200
84;01;01109;2226;46;2272
84;01;01110;156;2;158
84;01;01111;132;1;133
84;01;01112;450;12;462
84;01;01113;817;12;829
84;01;01114;667;12;679
84;01;01115;1333;30;1363
84;01;01116;498;12;510
84;01;01117;151;2;153
84;01;01118;1278;32;1310
84;01;01121;116;1;117
84;01;01123;1162;35;1197
84;01;01124;689;8;697
84;01;01125;612;13;625
84;01;01127;508;8;516
84;01;01128;305;1;306
84;01;01129;291;6;297
84;01;01130;2363;44;2407
84;01;01133;394;6;400
84;01;01134;1758;45;1803
84;01;01135;2171;64;2235
84;01;01136;893;20;913
84;01;01138;3004;64;3068
84;01;01139;444;5;449
84;01;01140;767;19;786
84;01;01141;453;15;468
84;01;01142;4777;57;4834
84;01;01143;9951;239;10190
84;01;01145;1179;22;1201
84;01;01146;436;3;439
84;01;01147;492;3;495
84;01;01148;1879;46;1925
84;01;01149;1076;28;1104
84;01;01150;214;5;219
84;01;01151;1146;27;1173
84;01;01152;748;20;768
84;01;01153;2115;74;2189
84;01;01155;143;4;147
84;01;01156;815;12;827
84;01;01157;2250;42;2292
84;01;01158;1048;17;1065
84;01;01159;3365;71;3436
84;01;01160;10026;163;10189
84;01;01162;65;3;68
84;01;01163;2038;35;2073
84;01;01165;1594;33;1627
84;01;01166;2423;61;2484
84;01;01167;634;24;658
84;01;01169;641;22;663
84;01;01170;1053;28;1081
84;01;01171;844;42;886
84;01;01173;13121;270;13391
84;01;01174;178;2;180
84;01;01175;784;23;807
84;01;01177;183;6;189
84;01;01179;1881;52;1933
84;01;01180;839;21;860
84;01;01181;1241;50;1291
84;01;01183;1479;29;1508
84;01;01184;763;26;789
84;01;01185;4844;176;5020
84;01;01187;618;21;639
84;01;01188;663;20;683
84;01;01189;1115;26;1141
84;01;01190;87;3;90
84;01;01191;154;4;158
84;01;01192;2277;61;2338
84;01;01193;222;7;229
84;01;01194;6346;93;6439
84;01;01195;1783;54;1837
84;01;01196;1226;13;1239
84;01;01197;351;13;364
84;01;01198;268;3;271
84;01;01199;2137;46;2183
84;01;01200;214;5;219
84;01;01202;7161;147;7308
84;01;01203;1313;42;1355
84;01;01204;735;15;750
84;01;01206;277;6;283
84;01;01207;317;12;329
84;01;01208;131;4;135
84;01;01209;778;16;794
84;01;01210;228;4;232
84;01;01211;1395;35;1430
84;01;01212;718;9;727
84;01;01213;1341;29;1370
84;01;01214;158;6;164
84;01;01215;140;3;143
84;01;01216;894;21;915
84;01;01219;164;3;167
84;01;01224;3225;31;3256
84;01;01225;372;8;380
84;01;01227;643;14;657
84;01;01228;660;14;674
84;01;01229;1235;24;1259
84;01;01230;312;7;319
84;01;01231;1948;48;1996
84;01;01232;2276;47;2323
84;01;01233;130;3;133
84;01;01234;169;3;172
84;01;01235;1159;87;1246
84;01;01236;1011;29;1040
84;01;01237;1667;65;1732
84;01;01238;2670;56;2726
84;01;01239;620;14;634
84;01;01240;627;16;643
84;01;01241;1356;34;1390
84;01;01242;135;2;137
84;01;01243;1253;35;1288
84;01;01244;7923;139;8062
84;01;01245;943;21;964
84;01;01246;2217;36;2253
84;01;01247;312;14;326
84;01;01248;2197;54;2251
84;01;01249;10122;151;10273
84;01;01250;1974;252;2226
84;01;01252;786;22;808
84;01;01254;2116;51;2167
84;01;01255;647;12;659
84;01;01257;351;10;361
84;01;01258;1190;32;1222
84;01;01259;702;16;718
84;01;01260;302;5;307
84;01;01261;668;23;691
84;01;01262;6886;83;6969
84;01;01263;3772;87;3859
84;01;01264;1016;20;1036
84;01;01265;3456;71;3527
84;01;01266;2576;42;2618
84;01;01267;1025;23;1048
84;01;01268;246;3;249
84;01;01269;3454;135;3589
84;01;01272;1500;20;1520
84;01;01273;1800;27;1827
84;01;01274;645;15;660
84;01;01275;2569;50;2619
84;01;01276;1624;27;1651
84;01;01277;117;2;119
84;01;01279;80;6;86
84;01;01280;138;1;139
84;01;01281;4483;170;4653
84;01;01282;258;6;264
84;01;01283;22456;479;22935
84;01;01284;694;13;707
84;01;01285;1229;30;1259
84;01;01286;951;38;989
84;01;01288;2717;55;2772
84;01;01289;6520;291;6811
84;01;01290;1273;32;1305
84;01;01291;842;7;849
84;01;01293;148;4;152
84;01;01294;886;16;902
84;01;01295;686;13;699
84;01;01296;420;8;428
84;01;01297;867;15;882
84;01;01298;150;2;152
84;01;01299;584;8;592
84;01;01301;2547;61;2608
84;01;01302;163;5;168
84;01;01303;1699;36;1735
84;01;01304;2924;53;2977
84;01;01305;2213;43;2256
84;01;01306;1641;64;1705
84;01;01307;836;21;857
84;01;01308;807;14;821
84;01;01309;85;0;85
84;01;01310;251;4;255
84;01;01311;44;0;44
84;01;01313;8711;239;8950
84;01;01314;1729;33;1762
84;01;01317;330;6;336
84;01;01318;726;17;743
84;01;01319;466;9;475
84;01;01320;3791;91;3882
84;01;01321;888;29;917
84;01;01322;4984;140;5124
84;01;01323;989;14;1003
84;01;01325;1032;18;1050
84;01;01328;597;4;601
84;01;01329;153;6;159
84;01;01330;182;6;188
84;01;01331;187;0;187
84;01;01332;779;23;802
84;01;01333;3369;59;3428
84;01;01334;658;9;667
84;01;01335;402;6;408
84;01;01336;1174;22;1196
84;01;01337;1311;27;1338
84;01;01338;1227;37;1264
84;01;01339;1463;43;1506
84;01;01342;554;11;565
84;01;01343;1793;41;1834
84;01;01344;5943;166;6109
84;01;01345;2266;34;2300
84;01;01346;858;19;877
84;01;01347;2035;63;2098
84;01;01348;2938;65;3003
84;01;01349;503;5;508
84;01;01350;2542;40;2582
84;01;01351;1571;26;1597
84;01;01352;583;6;589
84;01;01353;1700;28;1728
84;01;01354;13943;200;14143
84;01;01355;486;7;493
84;01;01356;208;5;213
84;01;01357;502;7;509
84;01;01358;429;3;432
84;01;01359;246;3;249
84;01;01360;1895;48;1943
84;01;01361;1577;48;1625
84;01;01362;786;15;801
84;01;01363;1772;70;1842
84;01;01364;756;7;763
84;01;01365;1162;20;1182
84;01;01366;1082;18;1100
84;01;01367;746;4;750
84;01;01368;838;15;853
84;01;01369;942;25;967
84;01;01370;1688;28;1716
84;01;01371;1242;29;1271
84;01;01372;444;5;449
84;01;01373;1023;30;1053
84;01;01374;1871;45;1916
84;01;01375;782;20;802
84;01;01376;3962;39;4001
84;01;01378;2645;54;2699
84;01;01379;760;11;771
84;01;01380;632;13;645
84;01;01381;921;18;939
84;01;01382;279;2;281
84;01;01383;1562;21;1583
84;01;01384;2188;33;2221
84;01;01385;985;23;1008
84;01;01386;1127;66;1193
84;01;01387;256;3;259
84;01;01388;1102;9;1111
84;01;01389;1834;43;1877
84;01;01390;1246;21;1267
84;01;01391;271;8;279
84;01;01392;656;27;683
84;01;01393;544;5;549
84;01;01396;977;13;990
84;01;01397;978;19;997
84;01;01398;1421;17;1438
84;01;01399;2107;51;2158
84;01;01400;139;3;142
84;01;01401;2167;71;2238
84;01;01402;652;20;672
84;01;01403;1295;41;1336
84;01;01404;135;2;137
84;01;01405;1280;29;1309
84;01;01406;174;1;175
84;01;01407;1002;18;1020
84;01;01408;661;12;673
84;01;01410;300;7;307
84;01;01411;273;6;279
84;01;01412;595;12;607
84;01;01415;499;6;505
84;01;01416;1014;11;1025
84;01;01418;1087;27;1114
84;01;01419;6021;176;6197
84;01;01420;1690;8;1698
84;01;01421;729;16;745
84;01;01422;1355;36;1391
84;01;01423;1124;21;1145
84;01;01424;1776;43;1819
84;01;01425;288;7;295
84;01;01426;2538;59;2597
84;01;01427;6920;164;7084
84;01;01428;126;1;127
84;01;01429;707;13;720
84;01;01430;619;12;631
84;01;01431;1227;30;1257
84;01;01432;323;2;325
84;01;01433;313;4;317
84;01;01434;472;10;482
84;01;01435;2157;69;2226
84;01;01436;481;11;492
84;01;01437;223;5;228
84;01;01439;99;4;103
84;01;01441;734;18;752
84;01;01443;4978;95;5073
84;01;01444;1196;17;1213
84;01;01445;615;21;636
84;01;01446;1548;37;1585
84;01;01447;1342;32;1374
84;01;01448;389;8;397
84;01;01449;759;14;773
84;01;01450;3717;67;3784
84;01;01451;6595;150;6745
84;01;01452;1132;24;1156
84;01;01453;710;23;733
84;01;01454;1112;21;1133
84;01;01456;71;2;73
84;01;01457;3181;59;3240
32;02;02001;502;11;513
32;02;02002;610;8;618
32;02;02003;1021;24;1045
32;02;02004;182;5;187
32;02;02005;380;8;388
32;02;02006;262;9;271
32;02;02007;122;1;123
32;02;02008;294;4;298
32;02;02009;534;6;540
32;02;02010;173;4;177
32;02;02011;1138;54;1192
32;02;02012;71;0;71
32;02;02013;386;9;395
32;02;02014;729;23;752
32;02;02015;72;1;73
32;02;02016;216;9;225
32;02;02017;323;4;327
32;02;02018;2574;53;2627
32;02;02019;362;5;367
32;02;02020;455;8;463
32;02;02021;84;3;87
32;02;02022;403;6;409
32;02;02023;102;3;105
32;02;02024;51;0;51
32;02;02025;367;2;369
32;02;02027;214;7;221
32;02;02028;2606;60;2666
32;02;02029;354;12;366
32;02;02030;257;4;261
32;02;02031;661;6;667
32;02;02032;253;4;257
32;02;02033;104;2;106
32;02;02034;121;4;125
32;02;02035;280;9;289
32;02;02036;72;1;73
32;02;02037;1386;30;1416
32;02;02038;59;0;59
32;02;02039;173;3;176
32;02;02040;180;3;183
32;02;02041;807;15;822
32;02;02042;384;2;386
32;02;02043;65;1;66
32;02;02044;25;0;25
32;02;02046;557;9;566
32;02;02047;108;5;113
32;02;02048;133;4;137
32;02;02049;739;13;752
32;02;02050;323;2;325
32;02;02051;391;6;397
32;02;02052;135;6;141
32;02;02053;571;6;577
32;02;02054;461;4;465
32;02;02055;88;2;90
32;02;02056;179;1;180
32;02;02057;1406;18;1424
32;02;02058;856;10;866
32;02;02059;2714;28;2742
32;02;02060;257;7;264
32;02;02061;246;7;253
32;02;02062;137;4;141
32;02;02063;378;8;386
32;02;02064;3832;53;3885
32;02;02065;600;13;613
32;02;02066;196;2;198
32;02;02067;210;5;215
32;02;02068;88;4;92
32;02;02069;105;2;107
32;02;02070;445;12;457
32;02;02071;658;15;673
32;02;02072;186;2;188
32;02;02073;670;4;674
32;02;02074;593;10;603
32;02;02075;195;2;197
32;02;02076;152;3;155
32;02;02077;379;9;388
32;02;02078;163;3;166
32;02;02079;149;0;149
32;02;02080;333;9;342
32;02;02081;434;8;442
32;02;02082;110;0;110
32;02;02083;750;15;765
32;02;02084;257;5;262
32;02;02085;1015;25;1040
32;02;02086;1006;11;1017
32;02;02087;34;1;35
32;02;02088;92;3;95
32;02;02089;1148;21;1169
32;02;02090;207;10;217
32;02;02091;95;1;96
32;02;02093;1298;59;1357
32;02;02094;464;9;473
32;02;02095;5686;78;5764
32;02;02096;197;3;200
32;02;02097;256;2;258
32;02;02098;379;14;393
32;02;02099;221;5;226
32;02;02100;138;0;138
32;02;02101;192;5;197
32;02;02102;191;6;197
32;02;02103;1339;16;1355
32;02;02104;99;4;103
32;02;02105;196;2;198
32;02;02106;810;12;822
32;02;02107;107;4;111
32;02;02108;159;4;163
32;02;02109;475;10;485
32;02;02110;2235;25;2260
32;02;02111;721;11;732
32;02;02112;553;13;566
32;02;02114;1563;37;1600
32;02;02115;190;6;196
32;02;02116;147;1;148
32;02;02117;68;0;68
32;02;02118;129;2;131
32;02;02119;327;6;333
32;02;02120;196;6;202
32;02;02121;240;4;244
32;02;02122;54;1;55
32;02;02123;301;5;306
32;02;02124;651;10;661
32;02;02125;193;11;204
32;02;02126;455;5;460
32;02;02127;192;5;197
32;02;02128;1475;47;1522
32;02;02129;18;0;18
32;02;02130;194;7;201
32;02;02131;1861;42;1903
32;02;02132;194;3;197
32;02;02133;404;9;413
32;02;02134;862;18;880
32;02;02135;1157;17;1174
32;02;02136;128;3;131
32;02;02137;160;0;160
32;02;02138;200;3;203
32;02;02139;442;5;447
32;02;02140;456;7;463
32;02;02141;1778;79;1857
32;02;02142;253;5;258
32;02;02143;185;6;191
32;02;02144;144;3;147
32;02;02145;545;10;555
32;02;02146;94;1;95
32;02;02148;255;2;257
32;02;02149;62;2;64
32;02;02150;63;0;63
32;02;02151;116;3;119
32;02;02152;89;0;89
32;02;02153;764;20;784
32;02;02154;365;7;372
32;02;02155;166;5;171
32;02;02156;257;1;258
32;02;02157;836;23;859
32;02;02158;273;2;275
32;02;02159;295;2;297
32;02;02160;544;12;556
32;02;02162;291;8;299
32;02;02163;2585;42;2627
32;02;02164;325;7;332
32;02;02165;1654;26;1680
32;02;02166;356;9;365
32;02;02167;890;14;904
32;02;02168;15254;362;15616
32;02;02169;84;0;84
32;02;02170;125;0;125
32;02;02171;88;1;89
32;02;02172;252;9;261
32;02;02173;11653;419;12072
32;02;02174;829;16;845
32;02;02175;161;4;165
32;02;02176;206;3;209
32;02;02177;139;2;141
32;02;02178;106;2;108
32;02;02179;385;8;393
32;02;02180;721;14;735
32;02;02181;79;1;80
32;02;02182;117;3;120
32;02;02183;185;1;186
32;02;02184;351;5;356
32;02;02185;390;15;405
32;02;02186;1351;45;1396
32;02;02187;1134;15;1149
32;02;02188;147;4;151
32;02;02189;350;8;358
32;02;02190;518;12;530
32;02;02191;523;5;528
32;02;02192;371;7;378
32;02;02193;65;1;66
32;02;02194;186;8;194
32;02;02195;910;25;935
32;02;02196;311;7;318
32;02;02197;535;102;637
32;02;02198;228;2;230
32;02;02199;601;8;609
32;02;02200;106;1;107
32;02;02201;441;6;447
32;02;02203;1282;20;1302
32;02;02204;65;2;67
32;02;02205;229;3;232
32;02;02206;76;3;79
32;02;02207;216;3;219
32;02;02208;267;6;273
32;02;02209;708;11;719
32;02;02210;364;6;370
32;02;02211;294;3;297
32;02;02212;708;11;719
32;02;02213;343;2;345
32;02;02214;61;1;62
32;02;02215;841;6;847
32;02;02216;294;4;298
32;02;02217;992;9;1001
32;02;02218;628;12;640
32;02;02219;200;72;272
32;02;02220;436;15;451
32;02;02221;152;4;156
32;02;02222;32;0;32
32;02;02223;301;12;313
32;02;02224;346;4;350
32;02;02225;84;2;86
32;02;02226;1863;30;1893
32;02;02227;120;1;121
32;02;02228;339;6;345
32;02;02229;71;0;71
32;02;02230;186;6;192
32;02;02231;941;9;950
32;02;02232;362;10;372
32;02;02233;145;8;153
32;02;02234;83;1;84
32;02;02235;115;3;118
32;02;02236;330;3;333
32;02;02237;1502;16;1518
32;02;02238;1816;31;1847
32;02;02239;1244;85;1329
32;02;02240;218;3;221
32;02;02241;96;3;99
32;02;02242;641;11;652
32;02;02243;2923;47;2970
32;02;02244;63;3;66
32;02;02245;1805;35;1840
32;02;02246;611;4;615
32;02;02248;156;3;159
32;02;02249;100;0;100
32;02;02250;73;4;77
32;02;02251;27;1;28
32;02;02252;71;2;73
32;02;02253;358;3;361
32;02;02254;129;5;134
32;02;02255;153;2;155
32;02;02256;129;3;132
32;02;02257;437;13;450
32;02;02258;370;13;383
32;02;02259;392;15;407
32;02;02260;650;11;661
32;02;02261;391;9;400
32;02;02262;211;3;214
32;02;02263;112;0;112
32;02;02264;730;16;746
32;02;02265;99;2;101
32;02;02266;46;2;48
32;02;02267;292;10;302
32;02;02268;647;13;660
32;02;02269;155;6;161
32;02;02270;164;3;167
32;02;02271;130;2;132
32;02;02272;78;2;80
32;02;02273;207;0;207
32;02;02274;195;6;201
32;02;02275;319;6;325
32;02;02276;117;5;122
32;02;02277;342;7;349
32;02;02278;28;5;33
32;02;02279;553;25;578
32;02;02280;409;12;421
32;02;02281;256;11;267
32;02;02282;427;8;435
32;02;02283;287;8;295
32;02;02284;102;1;103
32;02;02286;867;11;878
32;02;02287;1048;27;1075
32;02;02288;347;8;355
32;02;02289;411;11;422
32;02;02290;2745;73;2818
32;02;02291;410;8;418
32;02;02292;1305;28;1333
32;02;02293;553;10;563
32;02;02294;207;8;215
32;02;02295;853;7;860
32;02;02296;1197;21;1218
32;02;02297;121;2;123
32;02;02298;1420;9;1429
32;02;02299;546;6;552
32;02;02302;321;12;333
32;02;02303;680;16;696
32;02;02304;2838;135;2973
32;02;02305;3001;55;3056
32;02;02306;510;9;519
32;02;02307;2060;159;2219
32;02;02308;476;8;484
32;02;02309;671;5;676
32;02;02310;248;7;255
32;02;02311;120;2;122
32;02;02312;1100;10;1110
32;02;02313;444;5;449
32;02;02315;1669;34;1703
32;02;02316;128;5;133
32;02;02317;218;4;222
32;02;02318;1381;18;1399
32;02;02319;490;8;498
32;02;02320;237;4;241
32;02;02321;901;189;1090
32;02;02322;386;3;389
32;02;02323;134;3;137
32;02;02324;281;3;284
32;02;02326;470;8;478
32;02;02327;163;1;164
32;02;02328;513;6;519
32;02;02329;425;9;434
32;02;02330;530;7;537
32;02;02331;110;3;113
32;02;02332;265;4;269
32;02;02333;164;0;164
32;02;02334;2958;70;3028
32;02;02335;183;8;191
32;02;02336;983;15;998
32;02;02337;168;4;172
32;02;02338;252;10;262
32;02;02339;690;9;699
32;02;02340;5235;74;5309
32;02;02341;268;1;269
32;02;02342;134;2;136
32;02;02343;81;0;81
32;02;02345;41;1;42
32;02;02346;664;12;676
32;02;02347;444;6;450
32;02;02349;56;0;56
32;02;02350;136;2;138
32;02;02351;113;6;119
32;02;02352;560;10;570
32;02;02353;287;10;297
32;02;02354;80;2;82
32;02;02355;953;26;979
32;02;02356;240;2;242
32;02;02357;71;2;73
32;02;02358;333;3;336
32;02;02359;1301;20;1321
32;02;02360;2751;39;2790
32;02;02361;4645;78;4723
32;02;02362;238;12;250
32;02;02363;390;3;393
32;02;02364;258;5;263
32;02;02366;324;7;331
32;02;02367;130;4;134
32;02;02368;574;7;581
32;02;02369;242;2;244
32;02;02370;610;5;615
32;02;02371;1578;35;1613
32;02;02372;347;10;357
32;02;02373;197;5;202
32;02;02374;861;9;870
32;02;02375;159;3;162
32;02;02376;174;5;179
32;02;02377;135;8;143
32;02;02378;129;5;134
32;02;02379;209;123;332
32;02;02380;24;1;25
32;02;02381;8710;187;8897
32;02;02382;1367;39;1406
32;02;02383;1452;46;1498
32;02;02384;56;2;58
32;02;02385;160;3;163
32;02;02386;225;2;227
32;02;02387;1015;35;1050
32;02;02388;225;6;231
32;02;02389;659;16;675
32;02;02390;264;2;266
32;02;02391;206;0;206
32;02;02392;311;6;317
32;02;02393;141;5;146
32;02;02395;141;6;147
32;02;02396;64;1;65
32;02;02397;1252;20;1272
32;02;02398;284;4;288
32;02;02399;607;5;612
32;02;02400;148;4;152
32;02;02401;194;2;196
32;02;02402;37;2;39
32;02;02403;260;7;267
32;02;02404;190;0;190
32;02;02405;535;5;540
32;02;02406;132;5;137
32;02;02407;199;9;208
32;02;02408;24304;666;24970
32;02;02409;268;4;272
32;02;02410;244;10;254
32;02;02411;203;4;207
32;02;02412;100;1;101
32;02;02413;244;4;248
32;02;02414;201;5;206
32;02;02415;160;4;164
32;02;02416;420;10;430
32;02;02417;116;0;116
32;02;02418;223;4;227
32;02;02419;269;9;278
32;02;02420;829;11;840
32;02;02421;106;1;107
32;02;02422;805;10;815
32;02;02423;422;8;430
32;02;02424;104;0;104
32;02;02425;172;3;175
32;02;02426;540;10;550
32;02;02427;138;1;139
32;02;02428;74;2;76
32;02;02429;122;1;123
32;02;02430;1281;119;1400
32;02;02431;383;9;392
32;02;02432;189;5;194
32;02;02433;221;8;229
32;02;02435;79;0;79
32;02;02438;249;9;258
32;02;02439;1177;20;1197
32;02;02440;138;0;138
32;02;02441;188;3;191
32;02;02442;90;1;91
32;02;02443;203;6;209
32;02;02444;121;0;121
32;02;02445;282;6;288
32;02;02446;118;1;119
32;02;02447;147;5;152
32;02;02448;121;4;125
32;02;02449;66;3;69
32;02;02450;366;4;370
32;02;02451;124;1;125
32;02;02452;236;10;246
32;02;02453;404;8;412
32;02;02454;404;3;407
32;02;02455;204;1;205
32;02;02456;299;4;303
32;02;02457;404;10;414
32;02;02458;820;17;837
32;02;02459;161;8;169
32;02;02460;201;1;202
32;02;02461;383;6;389
32;02;02462;231;2;233
32;02;02463;89;2;91
32;02;02464;365;2;367
32;02;02465;513;7;520
32;02;02466;133;0;133
32;02;02467;51;1;52
32;02;02468;2235;29;2264
32;02;02469;485;13;498
32;02;02470;435;12;447
32;02;02471;135;2;137
32;02;02472;409;7;416
32;02;02473;215;1;216
32;02;02474;392;4;396
32;02;02476;669;14;683
32;02;02477;964;21;985
32;02;02478;261;8;269
32;02;02480;312;3;315
32;02;02481;473;16;489
32;02;02482;54;1;55
32;02;02483;513;10;523
32;02;02484;527;3;530
32;02;02485;94;4;98
32;02;02486;107;1;108
32;02;02487;627;9;636
32;02;02488;156;2;158
32;02;02489;342;7;349
32;02;02490;126;3;129
32;02;02491;324;9;333
32;02;02492;454;8;462
32;02;02493;224;6;230
32;02;02494;127;2;129
32;02;02495;1046;15;1061
32;02;02496;100;1;101
32;02;02497;1154;29;1183
32;02;02498;763;13;776
32;02;02499;43;2;45
32;02;02500;810;19;829
32;02;02501;93;2;95
32;02;02502;1324;9;1333
32;02;02503;831;2;833
32;02;02504;1616;28;1644
32;02;02505;206;5;211
32;02;02506;195;6;201
32;02;02507;31;1;32
32;02;02508;151;6;157
32;02;02509;156;0;156
32;02;02510;151;2;153
32;02;02511;295;4;299
32;02;02512;270;5;275
32;02;02513;138;2;140
32;02;02514;704;15;719
32;02;02515;55;6;61
32;02;02516;67;1;68
32;02;02517;299;5;304
32;02;02518;303;3;306
32;02;02519;186;4;190
32;02;02520;741;7;748
32;02;02521;1364;14;1378
32;02;02522;74;2;76
32;02;02523;72;1;73
32;02;02524;694;15;709
32;02;02525;577;13;590
32;02;02526;99;3;102
32;02;02527;458;9;467
32;02;02528;228;5;233
32;02;02529;178;1;179
32;02;02530;78;1;79
32;02;02531;118;1;119
32;02;02532;986;18;1004
32;02;02533;111;8;119
32;02;02534;48;1;49
32;02;02535;113;5;118
32;02;02536;103;1;104
32;02;02537;202;1;203
32;02;02538;70;0;70
32;02;02539;702;8;710
32;02;02540;1227;36;1263
32;02;02541;421;6;427
32;02;02542;82;2;84
32;02;02543;2066;34;2100
32;02;02544;616;14;630
32;02;02545;187;2;189
32;02;02546;193;4;197
32;02;02547;66;1;67
32;02;02548;377;7;384
32;02;02549;846;25;871
32;02;02550;115;3;118
32;02;02551;115;0;115
32;02;02552;187;9;196
32;02;02553;244;4;248
32;02;02554;1071;22;1093
32;02;02555;2108;46;2154
32;02;02556;81;1;82
32;02;02557;127;0;127
32;02;02558;2557;28;2585
32;02;02559;462;4;466
32;02;02560;246;4;250
32;02;02561;153;4;157
32;02;02562;212;2;214
32;02;02563;164;3;167
32;02;02564;495;5;500
32;02;02565;291;3;294
32;02;02566;1104;23;1127
32;02;02567;279;8;287
32;02;02568;162;4;166
32;02;02569;471;3;474
32;02;02570;177;0;177
32;02;02571;717;75;792
32;02;02572;502;9;511
32;02;02573;60;1;61
32;02;02574;1432;28;1460
32;02;02575;1670;14;1684
32;02;02576;330;8;338
32;02;02577;90;1;91
32;02;02578;86;1;87
32;02;02579;125;9;134
32;02;02580;816;10;826
32;02;02581;323;1;324
32;02;02582;76;2;78
32;02;02583;54;2;56
32;02;02584;121;6;127
32;02;02585;259;7;266
32;02;02586;139;6;145
32;02;02587;355;7;362
32;02;02588;68;2;70
32;02;02589;261;0;261
32;02;02590;169;4;173
32;02;02591;135;1;136
32;02;02592;192;4;196
32;02;02593;1064;21;1085
32;02;02594;132;6;138
32;02;02595;133;0;133
32;02;02596;763;15;778
32;02;02598;669;18;687
32;02;02599;255;3;258
32;02;02600;347;5;352
32;02;02601;197;2;199
32;02;02602;1698;27;1725
32;02;02604;84;1;85
32;02;02605;192;5;197
32;02;02606;70;3;73
32;02;02607;78;3;81
32;02;02608;473;2;475
32;02;02609;20;0;20
32;02;02610;736;11;747
32;02;02612;127;1;128
32;02;02613;605;11;616
32;02;02614;265;7;272
32;02;02615;360;5;365
32;02;02616;211;3;214
32;02;02617;508;4;512
32;02;02618;694;12;706
32;02;02619;658;0;658
32;02;02620;347;9;356
32;02;02621;379;15;394
32;02;02622;54;0;54
32;02;02623;97;3;100
32;02;02624;275;66;341
32;02;02625;142;2;144
32;02;02626;334;7;341
32;02;02627;123;3;126
32;02;02628;217;6;223
32;02;02629;311;12;323
32;02;02631;411;5;416
32;02;02632;57;1;58
32;02;02633;60;0;60
32;02;02634;82;4;86
32;02;02635;146;5;151
32;02;02636;199;5;204
32;02;02637;293;10;303
32;02;02638;237;1;238
32;02;02639;346;7;353
32;02;02640;157;4;161
32;02;02641;111;4;115
32;02;02642;173;3;176
32;02;02643;769;8;777
32;02;02644;346;13;359
32;02;02645;192;9;201
32;02;02647;60;0;60
32;02;02648;1937;38;1975
32;02;02649;307;4;311
32;02;02650;357;6;363
32;02;02651;106;1;107
32;02;02652;104;1;105
32;02;02653;500;13;513
32;02;02654;82;1;83
32;02;02655;135;0;135
32;02;02656;394;10;404
32;02;02657;250;4;254
32;02;02658;236;8;244
32;02;02659;504;13;517
32;02;02660;38;2;40
32;02;02661;254;3;257
32;02;02662;322;9;331
32;02;02663;221;5;226
32;02;02664;123;3;126
32;02;02665;300;5;305
32;02;02666;1002;17;1019
32;02;02667;203;6;209
32;02;02668;1057;21;1078
32;02;02670;151;0;151
32;02;02671;287;5;292
32;02;02672;261;4;265
32;02;02673;444;7;451
32;02;02674;48;0;48
32;02;02675;133;1;134
32;02;02676;1716;40;1756
32;02;02677;240;3;243
32;02;02678;68;0;68
32;02;02679;150;4;154
32;02;02680;2294;37;2331
32;02;02681;279;5;284
32;02;02682;114;3;117
32;02;02683;110;3;113
32;02;02684;3314;57;3371
32;02;02685;120;1;121
32;02;02686;373;4;377
32;02;02687;333;9;342
32;02;02688;48;4;52
32;02;02689;41;1;42
32;02;02690;80;1;81
32;02;02691;53570;1281;54851
32;02;02693;221;3;224
32;02;02694;641;10;651
32;02;02695;81;0;81
32;02;02696;76;3;79
32;02;02697;384;5;389
32;02;02698;101;2;103
32;02;02699;280;3;283
32;02;02701;708;8;716
32;02;02702;602;22;624
32;02;02703;1083;13;1096
32;02;02704;247;4;251
32;02;02705;210;6;216
32;02;02706;566;11;577
32;02;02707;181;0;181
32;02;02708;215;8;223
32;02;02709;407;8;415
32;02;02710;742;18;760
32;02;02711;293;7;300
32;02;02712;142;3;145
32;02;02713;270;4;274
32;02;02714;358;2;360
32;02;02715;45;3;48
32;02;02716;290;5;295
32;02;02717;590;13;603
32;02;02718;121;3;124
32;02;02719;2028;41;2069
32;02;02720;2034;74;2108
32;02;02721;476;2;478
32;02;02722;28712;651;29363
32;02;02723;98;1;99
32;02;02724;61;1;62
32;02;02725;139;6;145
32;02;02726;181;3;184
32;02;02727;221;3;224
32;02;02728;264;4;268
32;02;02729;81;1;82
32;02;02730;267;6;273
32;02;02731;171;2;173
32;02;02732;104;0;104
32;02;02734;274;6;280
32;02;02735;17;0;17
32;02;02736;167;5;172
32;02;02737;552;12;564
32;02;02738;13588;200;13788
32;02;02739;335;7;342
32;02;02740;221;6;227
32;02;02741;539;5;544
32;02;02742;114;0;114
32;02;02743;158;1;159
32;02;02744;72;2;74
32;02;02745;121;1;122
32;02;02746;658;8;666
32;02;02747;83;0;83
32;02;02748;939;24;963
32;02;02749;219;7;226
32;02;02750;583;8;591
32;02;02751;144;2;146
32;02;02752;281;5;286
32;02;02753;328;4;332
32;02;02754;185;3;188
32;02;02755;589;10;599
32;02;02756;684;12;696
32;02;02757;529;8;537
32;02;02758;2012;37;2049
32;02;02759;370;3;373
32;02;02760;142;3;145
32;02;02761;211;4;215
32;02;02762;139;5;144
32;02;02763;219;4;223
32;02;02764;88;3;91
32;02;02765;246;10;256
32;02;02766;235;6;241
32;02;02767;322;3;325
32;02;02768;542;6;548
32;02;02769;898;14;912
32;02;02770;788;20;808
32;02;02772;160;1;161
32;02;02773;39;0;39
32;02;02774;118;1;119
32;02;02775;936;17;953
32;02;02776;558;12;570
32;02;02777;142;7;149
32;02;02778;97;1;98
32;02;02779;219;3;222
32;02;02780;1378;17;1395
32;02;02781;453;16;469
32;02;02782;220;2;222
32;02;02783;138;0;138
32;02;02784;138;0;138
32;02;02785;1100;30;1130
32;02;02786;127;2;129
32;02;02787;258;2;260
32;02;02788;460;7;467
32;02;02789;2587;96;2683
32;02;02790;238;3;241
32;02;02791;259;6;265
32;02;02792;157;7;164
32;02;02793;119;1;120
32;02;02794;188;4;192
32;02;02795;1618;18;1636
32;02;02796;83;0;83
32;02;02797;172;1;173
32;02;02798;1221;19;1240
32;02;02799;407;9;416
32;02;02800;313;5;318
32;02;02801;272;3;275
32;02;02802;209;0;209
32;02;02803;146;5;151
32;02;02804;186;3;189
32;02;02805;2549;44;2593
32;02;02806;294;5;299
32;02;02807;656;24;680
32;02;02808;289;5;294
32;02;02809;69;3;72
32;02;02810;10424;417;10841
32;02;02812;207;6;213
32;02;02813;252;8;260
32;02;02814;162;0;162
32;02;02815;430;17;447
32;02;02816;531;6;537
32;02;02817;82;1;83
32;02;02818;1166;11;1177
32;02;02819;116;1;117
32;02;02820;1688;43;1731
32;02;02821;680;21;701
32;02;02822;391;12;403
32;02;02823;74;0;74
32;02;02824;375;8;383
32;02;02826;356;7;363
32;02;02827;312;5;317
32;02;02828;94;0;94
32;02;02829;42;1;43
32;02;02830;955;16;971
32;02;02831;379;6;385
32;02;02832;189;5;194
32;02;02833;508;7;515
32;02;02834;169;6;175
84;03;03001;2904;60;2964
84;03;03002;309;12;321
84;03;03003;987;27;1014
84;03;03004;253;7;260
84;03;03005;338;3;341
84;03;03006;633;17;650
84;03;03007;357;7;364
84;03;03008;372;14;386
84;03;03009;135;36;171
84;03;03010;424;13;437
84;03;03011;421;9;430
84;03;03012;323;5;328
84;03;03013;3953;96;4049
84;03;03014;136;3;139
84;03;03015;328;11;339
84;03;03016;143;2;145
84;03;03017;189;6;195
84;03;03018;685;14;699
84;03;03019;1640;24;1664
84;03;03020;294;7;301
84;03;03021;224;2;226
84;03;03022;997;17;1014
84;03;03023;8741;231;8972
84;03;03024;237;6;243
84;03;03025;1328;31;1359
84;03;03026;761;18;779
84;03;03027;928;24;952
84;03;03028;364;7;371
84;03;03029;783;12;795
84;03;03030;856;15;871
84;03;03031;291;9;300
84;03;03032;244;2;246
84;03;03033;181;4;185
84;03;03034;496;12;508
84;03;03035;212;4;216
84;03;03036;2572;72;2644
84;03;03037;259;2;261
84;03;03038;521;8;529
84;03;03039;384;7;391
84;03;03040;1126;38;1164
84;03;03041;319;12;331
84;03;03042;530;17;547
84;03;03043;1189;75;1264
84;03;03044;1516;36;1552
84;03;03045;849;18;867
84;03;03046;1026;23;1049
84;03;03047;407;9;416
84;03;03048;1305;24;1329
84;03;03049;428;10;438
84;03;03050;179;10;189
84;03;03051;301;6;307
84;03;03052;1093;29;1122
84;03;03053;1102;25;1127
84;03;03054;237;6;243
84;03;03055;966;17;983
84;03;03056;382;7;389
84;03;03057;201;6;207
84;03;03058;238;6;244
84;03;03059;359;7;366
84;03;03060;1030;17;1047
84;03;03061;394;6;400
84;03;03062;351;17;368
84;03;03063;1028;20;1048
84;03;03064;180;1;181
84;03;03065;544;9;553
84;03;03066;324;5;329
84;03;03067;138;4;142
84;03;03068;104;1;105
84;03;03069;312;6;318
84;03;03070;133;1;134
84;03;03071;248;3;251
84;03;03072;492;12;504
84;03;03073;638;11;649
84;03;03074;656;15;671
84;03;03075;168;2;170
84;03;03076;227;7;234
84;03;03077;128;3;131
84;03;03078;231;8;239
84;03;03079;303;8;311
84;03;03080;691;11;702
84;03;03081;327;12;339
84;03;03082;6132;189;6321
84;03;03083;580;13;593
84;03;03084;2034;31;2065
84;03;03085;646;55;701
84;03;03086;321;8;329
84;03;03087;597;7;604
84;03;03088;320;2;322
84;03;03089;152;1;153
84;03;03090;305;8;313
84;03;03091;438;9;447
84;03;03092;628;13;641
84;03;03093;1185;27;1212
84;03;03094;3297;102;3399
84;03;03095;12474;481;12955
84;03;03096;86;1;87
84;03;03097;360;9;369
84;03;03098;4459;87;4546
84;03;03099;391;11;402
84;03;03100;1381;35;1416
84;03;03101;8729;166;8895
84;03;03102;3032;59;3091
84;03;03103;1065;25;1090
84;03;03104;1169;32;1201
84;03;03105;357;7;364
84;03;03106;1316;105;1421
84;03;03107;1270;27;1297
84;03;03108;376;6;382
84;03;03109;781;32;813
84;03;03110;968;26;994
84;03;03111;1112;24;1136
84;03;03112;668;9;677
84;03;03113;536;16;552
84;03;03114;279;7;286
84;03;03115;341;7;348
84;03;03116;191;5;196
84;03;03117;475;12;487
84;03;03118;5830;197;6027
84;03;03119;413;4;417
84;03;03120;710;12;722
84;03;03121;647;17;664
84;03;03122;236;6;242
84;03;03124;219;3;222
84;03;03125;124;2;126
84;03;03126;1167;13;1180
84;03;03127;620;10;630
84;03;03128;2645;57;2702
84;03;03129;312;13;325
84;03;03130;279;6;285
84;03;03131;550;13;563
84;03;03132;559;15;574
84;03;03133;519;10;529
84;03;03134;193;3;196
84;03;03135;407;9;416
84;03;03136;235;5;240
84;03;03137;271;6;277
84;03;03138;3144;73;3217
84;03;03139;313;11;324
84;03;03140;1154;33;1187
84;03;03141;149;2;151
84;03;03142;242;5;247
84;03;03143;92;3;95
84;03;03144;211;8;219
84;03;03145;736;13;749
84;03;03146;154;35;189
84;03;03147;167;2;169
84;03;03148;349;6;355
84;03;03149;441;16;457
84;03;03150;203;7;210
84;03;03151;159;3;162
84;03;03152;231;7;238
84;03;03154;276;4;280
84;03;03155;1881;42;1923
84;03;03156;1688;54;1742
84;03;03157;1020;23;1043
84;03;03158;871;19;890
84;03;03159;780;15;795
84;03;03160;410;4;414
84;03;03161;900;29;929
84;03;03162;202;6;208
84;03;03163;751;22;773
84;03;03164;273;2;275
84;03;03165;1384;86;1470
84;03;03166;306;5;311
84;03;03167;286;4;290
84;03;03168;906;15;921
84;03;03169;331;6;337
84;03;03170;129;6;135
84;03;03171;249;6;255
84;03;03172;122;2;124
84;03;03173;1142;33;1175
84;03;03174;914;25;939
84;03;03175;278;12;290
84;03;03176;541;10;551
84;03;03177;253;3;256
84;03;03178;298;6;304
84;03;03179;297;10;307
84;03;03180;662;11;673
84;03;03181;296;3;299
84;03;03182;263;1;264
84;03;03183;469;4;473
84;03;03184;505;8;513
84;03;03185;34361;1070;35431
84;03;03186;1524;21;1545
84;03;03187;630;9;639
84;03;03188;219;1;220
84;03;03189;715;24;739
84;03;03190;19246;542;19788
84;03;03191;280;8;288
84;03;03192;150;3;153
84;03;03193;187;4;191
84;03;03194;125;2;127
84;03;03195;2570;94;2664
84;03;03196;221;3;224
84;03;03197;1453;32;1485
84;03;03198;187;0;187
84;03;03200;1520;256;1776
84;03;03201;304;13;317
84;03;03202;603;15;618
84;03;03203;387;9;396
84;03;03204;623;18;641
84;03;03205;440;11;451
84;03;03206;168;6;174
84;03;03207;512;13;525
84;03;03208;423;9;432
84;03;03209;151;3;154
84;03;03210;399;10;409
84;03;03211;2507;49;2556
84;03;03212;1512;25;1537
84;03;03213;252;4;256
84;03;03214;382;3;385
84;03;03215;550;8;558
84;03;03216;172;3;175
84;03;03217;761;35;796
84;03;03218;272;8;280
84;03;03219;215;5;220
84;03;03220;710;15;725
84;03;03221;730;8;738
84;03;03222;90;5;95
84;03;03223;441;14;455
84;03;03224;288;7;295
84;03;03225;444;10;454
84;03;03226;250;5;255
84;03;03227;373;8;381
84;03;03228;38;0;38
84;03;03229;612;18;630
84;03;03230;526;16;542
84;03;03231;188;5;193
84;03;03232;303;9;312
84;03;03233;395;8;403
84;03;03234;373;11;384
84;03;03235;969;10;979
84;03;03236;3654;70;3724
84;03;03237;427;9;436
84;03;03238;529;9;538
84;03;03239;265;9;274
84;03;03240;543;11;554
84;03;03241;368;46;414
84;03;03242;568;14;582
84;03;03243;121;6;127
84;03;03244;128;2;130
84;03;03245;124;1;125
84;03;03246;594;12;606
84;03;03247;1106;33;1139
84;03;03248;165;2;167
84;03;03249;162;2;164
84;03;03250;349;6;355
84;03;03251;376;9;385
84;03;03252;677;15;692
84;03;03253;379;10;389
84;03;03254;5221;118;5339
84;03;03255;143;4;147
84;03;03256;214;5;219
84;03;03257;803;23;826
84;03;03258;1737;26;1763
84;03;03259;338;3;341
84;03;03260;224;5;229
84;03;03261;178;7;185
84;03;03262;2092;38;2130
84;03;03263;194;8;202
84;03;03264;2570;53;2623
84;03;03265;671;78;749
84;03;03266;272;8;280
84;03;03267;664;24;688
84;03;03268;386;3;389
84;03;03269;85;2;87
84;03;03270;143;5;148
84;03;03271;805;32;837
84;03;03272;282;7;289
84;03;03273;492;15;507
84;03;03274;318;6;324
84;03;03275;1747;49;1796
84;03;03276;102;6;108
84;03;03277;254;5;259
84;03;03278;191;4;195
84;03;03279;556;10;566
84;03;03280;182;9;191
84;03;03281;391;3;394
84;03;03282;372;13;385
84;03;03283;1065;18;1083
84;03;03284;290;9;299
84;03;03285;178;8;186
84;03;03286;1138;20;1158
84;03;03287;379;9;388
84;03;03288;384;8;392
84;03;03289;514;12;526
84;03;03290;1630;59;1689
84;03;03291;415;13;428
84;03;03292;879;12;891
84;03;03293;283;10;293
84;03;03294;168;1;169
84;03;03295;76;0;76
84;03;03296;376;12;388
84;03;03297;1538;26;1564
84;03;03298;3618;73;3691
84;03;03299;229;8;237
84;03;03300;537;9;546
84;03;03301;1166;26;1192
84;03;03302;39;1;40
84;03;03303;236;10;246
84;03;03304;2249;59;2308
84;03;03305;593;15;608
84;03;03306;1918;52;1970
84;03;03307;236;3;239
84;03;03308;152;4;156
84;03;03309;454;10;464
84;03;03310;24980;322;25302
84;03;03311;305;7;312
84;03;03312;274;10;284
84;03;03313;275;9;284
84;03;03314;1322;36;1358
84;03;03315;1283;37;1320
84;03;03316;1073;16;1089
84;03;03317;294;8;302
84;03;03319;484;10;494
84;03;03320;776;17;793
84;03;03321;12838;517;13355
93;04;04001;1432;28;1460
93;04;04004;546;30;576
93;04;04005;133;2;135
93;04;04006;824;8;832
93;04;04007;67;0;67
93;04;04008;1031;35;1066
93;04;04009;14;0;14
93;04;04012;95;0;95
93;04;04013;605;15;620
93;04;04016;63;0;63
93;04;04017;99;5;104
93;04;04018;1028;15;1043
93;04;04019;2564;198;2762
93;04;04020;133;2;135
93;04;04021;147;4;151
93;04;04022;417;8;425
93;04;04023;189;4;193
93;04;04024;127;3;130
93;04;04025;386;14;400
93;04;04026;136;6;142
93;04;04027;252;56;308
93;04;04028;122;9;131
93;04;04030;57;0;57
93;04;04031;557;10;567
93;04;04032;127;0;127
93;04;04033;766;19;785
93;04;04034;1124;15;1139
93;04;04035;290;6;296
93;04;04036;960;28;988
93;04;04037;73;2;75
93;04;04039;1470;39;1509
93;04;04040;63;1;64
93;04;04041;299;6;305
93;04;04042;138;1;139
93;04;04043;86;3;89
93;04;04045;1206;21;1227
93;04;04046;687;107;794
93;04;04047;848;20;868
93;04;04049;5089;108;5197
93;04;04050;27;0;27
93;04;04051;72;2;74
93;04;04053;492;20;512
93;04;04054;74;1;75
93;04;04055;188;0;188
93;04;04057;176;3;179
93;04;04058;272;6;278
93;04;04059;220;1;221
93;04;04061;482;5;487
93;04;04062;149;4;153
93;04;04063;1219;32;1251
93;04;04065;633;6;639
93;04;04066;571;12;583
93;04;04067;52;1;53
93;04;04068;836;14;850
93;04;04069;135;3;138
93;04;04070;16482;922;17404
93;04;04072;110;2;112
93;04;04073;388;12;400
93;04;04074;102;2;104
93;04;04075;372;11;383
93;04;04076;816;21;837
93;04;04077;172;3;175
93;04;04079;1371;37;1408
93;04;04081;392;4;396
93;04;04084;493;7;500
93;04;04085;59;2;61
93;04;04086;303;17;320
93;04;04087;133;2;135
93;04;04088;5121;88;5209
93;04;04090;207;4;211
93;04;04091;92;0;92
93;04;04092;118;4;122
93;04;04093;62;1;63
93;04;04094;2639;48;2687
93;04;04095;90;0;90
93;04;04096;1132;26;1158
93;04;04097;385;5;390
93;04;04099;88;5;93
93;04;04101;133;3;136
93;04;04102;179;3;182
93;04;04104;385;11;396
93;04;04106;380;10;390
93;04;04107;4;0;4
93;04;04108;1975;30;2005
93;04;04109;322;4;326
93;04;04110;1011;28;1039
93;04;04111;1347;28;1375
93;04;04112;22528;669;23197
93;04;04113;451;14;465
93;04;04115;121;2;123
93;04;04116;3751;45;3796
93;04;04118;123;1;124
93;04;04120;118;1;119
93;04;04121;639;11;650
93;04;04122;511;10;521
93;04;04123;1121;29;1150
93;04;04124;417;6;423
93;04;04126;406;15;421
93;04;04127;322;3;325
93;04;04128;221;9;230
93;04;04129;59;1;60
93;04;04130;203;2;205
93;04;04132;144;1;145
93;04;04133;237;1;238
93;04;04134;553;20;573
93;04;04135;720;15;735
93;04;04136;313;8;321
93;04;04137;42;0;42
93;04;04138;281;6;287
93;04;04139;523;9;532
93;04;04140;127;3;130
93;04;04141;365;9;374
93;04;04142;54;0;54
93;04;04143;5867;74;5941
93;04;04144;353;1;354
93;04;04145;1448;37;1485
93;04;04148;253;9;262
93;04;04149;2813;43;2856
93;04;04150;202;4;206
93;04;04151;520;13;533
93;04;04152;3905;126;4031
93;04;04154;92;1;93
93;04;04155;179;1;180
93;04;04156;264;1;265
93;04;04157;691;8;699
93;04;04158;407;8;415
93;04;04159;85;5;90
93;04;04160;1680;37;1717
93;04;04161;329;8;337
93;04;04162;258;6;264
93;04;04163;525;11;536
93;04;04164;88;1;89
93;04;04166;1726;39;1765
93;04;04167;288;5;293
93;04;04169;104;3;107
93;04;04170;75;0;75
93;04;04171;121;0;121
93;04;04172;738;10;748
93;04;04173;1010;21;1031
93;04;04174;145;2;147
93;04;04175;91;1;92
93;04;04176;119;4;123
93;04;04177;45;0;45
93;04;04178;1319;35;1354
93;04;04179;105;2;107
93;04;04180;79;4;83
93;04;04181;48;1;49
93;04;04182;215;2;217
93;04;04183;142;3;145
93;04;04184;136;3;139
93;04;04186;99;4;103
93;04;04187;41;1;42
93;04;04188;867;8;875
93;04;04189;627;14;641
93;04;04190;114;3;117
93;04;04191;13;2;15
93;04;04192;1235;24;1259
93;04;04193;180;7;187
93;04;04194;96;2;98
93;04;04195;597;13;610
93;04;04197;3442;78;3520
93;04;04199;177;4;181
93;04;04200;640;21;661
93;04;04201;122;3;125
93;04;04202;132;2;134
93;04;04203;475;9;484
93;04;04204;163;4;167
93;04;04205;1379;27;1406
93;04;04206;425;8;433
93;04;04207;103;4;107
93;04;04208;602;16;618
93;04;04209;7595;239;7834
93;04;04210;89;4;93
93;04;04211;178;3;181
93;04;04214;130;1;131
93;04;04216;234;5;239
93;04;04217;748;19;767
93;04;04218;231;3;234
93;04;04219;244;6;250
93;04;04220;379;11;390
93;04;04222;335;8;343
93;04;04224;100;1;101
93;04;04226;594;14;608
93;04;04227;287;7;294
93;04;04228;39;0;39
93;04;04229;252;5;257
93;04;04230;3173;62;3235
93;04;04231;245;6;251
93;04;04233;268;8;276
93;04;04234;226;2;228
93;04;04235;61;1;62
93;04;04236;108;0;108
93;04;04237;126;3;129
93;04;04240;249;5;254
93;04;04241;192;5;197
93;04;04242;4323;78;4401
93;04;04244;1641;37;1678
93;04;04245;3206;75;3281
93;05;05001;383;6;389
93;05;05003;397;11;408
93;05;05004;917;15;932
93;05;05006;2255;86;2341
93;05;05007;358;8;366
93;05;05008;369;5;374
93;05;05009;99;3;102
93;05;05010;803;12;815
93;05;05011;419;9;428
93;05;05012;620;14;634
93;05;05013;127;5;132
93;05;05014;180;2;182
93;05;05016;256;2;258
93;05;05017;2562;57;2619
93;05;05018;325;10;335
93;05;05019;150;4;154
93;05;05021;142;1;143
93;05;05022;239;3;242
93;05;05023;11339;320;11659
93;05;05024;220;8;228
93;05;05025;215;7;222
93;05;05026;285;3;288
93;05;05027;199;4;203
93;05;05028;155;4;159
93;05;05029;887;25;912
93;05;05031;188;1;189
93;05;05032;136;3;139
93;05;05033;40;0;40
93;05;05035;30;3;33
93;05;05036;1198;34;1232
93;05;05037;506;20;526
93;05;05038;319;17;336
93;05;05039;705;12;717
93;05;05040;3061;80;3141
93;05;05044;127;3;130
93;05;05045;1105;32;1137
93;05;05046;6335;378;6713
93;05;05047;125;4;129
93;05;05048;203;6;209
93;05;05049;57;0;57
93;05;05050;821;9;830
93;05;05051;29;1;30
93;05;05052;805;12;817
93;05;05053;520;11;531
93;05;05054;433;4;437
93;05;05055;328;4;332
93;05;05056;334;11;345
93;05;05057;255;6;261
93;05;05058;217;5;222
93;05;05059;904;19;923
93;05;05060;179;8;187
93;05;05061;40631;1545;42176
93;05;05062;160;1;161
93;05;05063;479;10;489
93;05;05064;105;3;108
93;05;05065;2312;85;2397
93;05;05066;8;0;8
93;05;05068;460;13;473
93;05;05070;3543;51;3594
93;05;05071;338;19;357
93;05;05072;243;7;250
93;05;05073;342;13;355
93;05;05074;191;0;191
93;05;05075;427;7;434
93;05;05076;86;3;89
93;05;05077;297;5;302
93;05;05078;284;10;294
93;05;05079;1060;23;1083
93;05;05080;58;0;58
93;05;05081;52;4;56
93;05;05082;173;2;175
93;05;05084;457;6;463
93;05;05085;454;14;468
93;05;05086;104;2;106
93;05;05087;529;14;543
93;05;05089;84;1;85
93;05;05090;212;8;220
93;05;05091;41;3;44
93;05;05092;763;15;778
93;05;05093;359;10;369
93;05;05094;15;1;16
93;05;05095;301;2;303
93;05;05096;674;18;692
93;05;05097;356;35;391
93;05;05098;543;13;556
93;05;05099;104;1;105
93;05;05100;763;29;792
93;05;05101;1154;40;1194
93;05;05102;93;2;95
93;05;05103;777;21;798
93;05;05104;323;16;339
93;05;05106;299;7;306
93;05;05107;453;23;476
93;05;05108;167;5;172
93;05;05109;524;20;544
93;05;05110;301;5;306
93;05;05111;273;9;282
93;05;05112;87;0;87
93;05;05113;378;17;395
93;05;05114;251;1;252
93;05;05115;453;9;462
93;05;05116;209;2;211
93;05;05117;114;0;114
93;05;05118;1340;28;1368
93;05;05119;655;18;673
93;05;05121;175;4;179
93;05;05122;808;27;835
93;05;05123;1528;38;1566
93;05;05124;474;9;483
93;05;05126;469;9;478
93;05;05127;181;7;188
93;05;05128;692;22;714
93;05;05129;152;2;154
93;05;05130;178;5;183
93;05;05131;81;4;85
93;05;05132;2063;75;2138
93;05;05133;1531;45;1576
93;05;05134;318;5;323
93;05;05135;51;0;51
93;05;05136;737;15;752
93;05;05139;916;27;943
93;05;05140;286;7;293
93;05;05142;443;17;460
93;05;05144;144;2;146
93;05;05145;1075;93;1168
93;05;05146;136;1;137
93;05;05147;365;5;370
93;05;05148;535;18;553
93;05;05149;362;11;373
93;05;05151;1128;37;1165
93;05;05152;126;4;130
93;05;05153;352;13;365
93;05;05154;162;0;162
93;05;05155;30;1;31
93;05;05156;516;11;527
93;05;05157;192;6;198
93;05;05158;117;1;118
93;05;05159;87;3;90
93;05;05160;85;0;85
93;05;05161;935;23;958
93;05;05162;1443;36;1479
93;05;05163;144;4;148
93;05;05164;1076;42;1118
93;05;05165;252;7;259
93;05;05166;1285;27;1312
93;05;05167;87;2;89
93;05;05168;708;21;729
93;05;05169;35;1;36
93;05;05170;2285;52;2337
93;05;05171;214;4;218
93;05;05172;310;5;315
93;05;05173;457;10;467
93;05;05174;615;22;637
93;05;05176;267;4;271
93;05;05177;528;9;537
93;05;05178;584;40;624
93;05;05179;3216;144;3360
93;05;05180;542;14;556
93;05;05181;294;13;307
93;05;05182;42;3;45
93;05;05183;1477;53;1530
93;05;05184;209;8;217
93;06;06001;94;0;94
93;06;06002;54;0;54
93;06;06003;648;5;653
93;06;06004;73438;1085;74523
93;06;06005;175;0;175
93;06;06006;2272;32;2304
93;06;06007;3200;68;3268
93;06;06008;31;2;33
93;06;06009;109;1;110
93;06;06010;2921;63;2984
93;06;06011;3755;28;3783
93;06;06012;13358;130;13488
93;06;06013;690;11;701
93;06;06014;947;6;953
93;06;06015;1240;21;1261
93;06;06016;551;4;555
93;06;06017;254;4;258
93;06;06018;9668;351;10019
93;06;06019;1657;19;1676
93;06;06020;566;11;577
93;06;06021;731;4;735
93;06;06022;554;6;560
93;06;06023;2137;52;2189
93;06;06024;217;2;219
93;06;06025;1414;7;1421
93;06;06026;1380;27;1407
93;06;06027;52178;491;52669
93;06;06028;411;4;415
93;06;06029;74545;802;75347
93;06;06030;41887;359;42246
93;06;06031;1300;11;1311
93;06;06032;4523;68;4591
93;06;06033;12550;136;12686
93;06;06034;1656;15;1671
93;06;06035;1126;9;1135
93;06;06036;400;4;404
93;06;06037;298;3;301
93;06;06038;3664;59;3723
93;06;06039;942;8;950
93;06;06040;63;0;63
93;06;06041;401;6;407
93;06;06042;665;12;677
93;06;06043;822;4;826
93;06;06044;7898;157;8055
93;06;06045;73;2;75
93;06;06046;3482;41;3523
93;06;06047;95;1;96
93;06;06048;7437;81;7518
93;06;06049;110;2;112
93;06;06050;531;6;537
93;06;06051;98;2;100
93;06;06052;179;2;181
93;06;06053;143;1;144
93;06;06054;5117;40;5157
93;06;06055;150;3;153
93;06;06056;142;2;144
93;06;06057;2554;18;2572
93;06;06058;611;15;626
93;06;06059;2256;60;2316
93;06;06060;1994;34;2028
93;06;06061;96;3;99
93;06;06062;317;1;318
93;06;06063;73;0;73
93;06;06064;4173;56;4229
93;06;06065;7010;105;7115
93;06;06066;1599;11;1610
93;06;06067;1493;13;1506
93;06;06068;373;10;383
93;06;06069;48870;922;49792
93;06;06070;570;13;583
93;06;06071;600;7;607
93;06;06072;162;1;163
93;06;06073;653;12;665
93;06;06074;1241;10;1251
93;06;06075;4761;46;4807
93;06;06076;47;3;50
93;06;06077;1294;12;1306
93;06;06078;321;7;328
93;06;06079;21998;283;22281
93;06;06080;106;4;110
93;06;06081;118;2;120
93;06;06082;103;1;104
93;06;06083;30525;456;30981
93;06;06084;9887;282;10169
93;06;06085;19982;439;20421
93;06;06086;251;2;253
93;06;06087;44;0;44
93;06;06088;342669;2859;345528
93;06;06089;2295;74;2369
93;06;06090;7996;89;8085
93;06;06091;2370;18;2388
93;06;06092;1465;13;1478
93;06;06093;206;1;207
93;06;06094;783;9;792
93;06;06095;8192;187;8379
93;06;06096;105;0;105
93;06;06097;335;0;335
93;06;06098;126;1;127
93;06;06099;1840;81;1921
93;06;06100;231;0;231
93;06;06101;184;2;186
93;06;06102;91;5;96
93;06;06103;1833;49;1882
93;06;06104;12839;202;13041
93;06;06105;7183;195;7378
93;06;06106;577;8;585
93;06;06107;68;1;69
93;06;06108;5385;94;5479
93;06;06109;950;4;954
93;06;06110;120;3;123
93;06;06111;119;4;123
93;06;06112;4072;122;4194
93;06;06113;1338;22;1360
93;06;06114;5695;29;5724
93;06;06115;87;0;87
93;06;06116;215;3;218
93;06;06117;1240;9;1249
93;06;06118;3903;100;4003
93;06;06119;108;2;110
93;06;06120;1494;160;1654
93;06;06121;1492;8;1500
93;06;06122;4246;110;4356
93;06;06123;29169;183;29352
93;06;06124;49;0;49
93;06;06125;152;7;159
93;06;06126;3095;19;3114
93;06;06127;1444;12;1456
93;06;06128;3252;70;3322
93;06;06129;306;82;388
93;06;06130;3654;104;3758
93;06;06131;48;2;50
93;06;06132;458;10;468
93;06;06133;71;1;72
93;06;06134;540;8;548
93;06;06135;197;2;199
93;06;06136;3805;85;3890
93;06;06137;1161;24;1185
93;06;06138;1362;14;1376
93;06;06139;110;3;113
93;06;06140;3066;53;3119
93;06;06141;347;1;348
93;06;06142;299;2;301
93;06;06143;664;11;675
93;06;06144;553;4;557
93;06;06145;133;1;134
93;06;06146;155;1;156
93;06;06147;5013;46;5059
93;06;06148;4041;100;4141
93;06;06149;10115;65;10180
93;06;06150;2981;55;3036
93;06;06151;867;1;868
93;06;06152;13486;554;14040
93;06;06153;835;285;1120
93;06;06154;464;8;472
93;06;06155;27364;179;27543
93;06;06156;161;1;162
93;06;06157;18940;302;19242
93;06;06158;776;3;779
93;06;06159;5033;35;5068
93;06;06160;89;2;91
93;06;06161;16285;236;16521
93;06;06162;696;10;706
93;06;06163;2166;49;2215
84;07;07001;376;12;388
84;07;07002;551;18;569
84;07;07003;170;1;171
84;07;07004;81;1;82
84;07;07005;1464;35;1499
84;07;07006;158;6;164
84;07;07007;989;14;1003
84;07;07008;1458;52;1510
84;07;07009;1205;23;1228
84;07;07010;16297;623;16920
84;07;07011;894;18;912
84;07;07012;377;9;386
84;07;07013;1253;22;1275
84;07;07014;326;7;333
84;07;07015;535;23;558
84;07;07017;763;16;779
84;07;07018;44;0;44
84;07;07019;12479;776;13255
84;07;07020;468;11;479
84;07;07022;1254;26;1280
84;07;07023;374;6;380
84;07;07024;661;22;683
84;07;07025;206;2;208
84;07;07026;254;8;262
84;07;07027;1844;30;1874
84;07;07028;516;10;526
84;07;07029;251;3;254
84;07;07030;207;5;212
84;07;07031;761;18;779
84;07;07032;164;1;165
84;07;07033;220;4;224
84;07;07034;251;3;254
84;07;07035;614;19;633
84;07;07036;444;11;455
84;07;07037;146;3;149
84;07;07038;49;0;49
84;07;07039;252;7;259
84;07;07040;259;5;264
84;07;07041;2376;65;2441
84;07;07042;7187;165;7352
84;07;07044;260;8;268
84;07;07045;522;7;529
84;07;07047;84;0;84
84;07;07048;336;7;343
84;07;07049;54;3;57
84;07;07050;941;16;957
84;07;07051;581;20;601
84;07;07052;616;10;626
84;07;07053;523;3;526
84;07;07054;254;9;263
84;07;07055;2979;74;3053
84;07;07056;913;18;931
84;07;07058;1039;35;1074
84;07;07059;240;7;247
84;07;07060;263;5;268
84;07;07061;415;12;427
84;07;07062;150;3;153
84;07;07063;397;9;406
84;07;07064;2877;156;3033
84;07;07065;236;3;239
84;07;07066;3015;173;3188
84;07;07067;318;4;322
84;07;07068;572;6;578
84;07;07069;657;22;679
84;07;07070;2311;49;2360
84;07;07071;790;13;803
84;07;07072;1662;42;1704
84;07;07073;520;11;531
84;07;07074;151;4;155
84;07;07075;149;4;153
84;07;07076;3063;66;3129
84;07;07077;254;2;256
84;07;07078;3168;87;3255
84;07;07079;1162;21;1183
84;07;07080;297;7;304
84;07;07081;58;1;59
84;07;07082;205;12;217
84;07;07083;434;10;444
84;07;07084;1028;37;1065
84;07;07085;619;14;633
84;07;07086;931;19;950
84;07;07087;433;8;441
84;07;07088;97;2;99
84;07;07089;1713;48;1761
84;07;07090;1224;17;1241
84;07;07091;333;12;345
84;07;07092;46;1;47
84;07;07093;275;8;283
84;07;07094;178;3;181
84;07;07095;460;3;463
84;07;07096;371;3;374
84;07;07097;693;18;711
84;07;07098;81;4;85
84;07;07099;633;18;651
84;07;07100;499;19;518
84;07;07101;911;21;932
84;07;07102;10756;221;10977
84;07;07103;310;3;313
84;07;07104;87;2;89
84;07;07105;99;3;102
84;07;07106;132;1;133
84;07;07107;1273;23;1296
84;07;07108;119;8;127
84;07;07109;297;6;303
84;07;07110;1752;28;1780
84;07;07111;169;5;174
84;07;07112;248;7;255
84;07;07113;308;7;315
84;07;07114;201;2;203
84;07;07115;671;11;682
84;07;07116;1358;22;1380
84;07;07117;2206;35;2241
84;07;07118;145;6;151
84;07;07119;255;5;260
84;07;07120;61;0;61
84;07;07121;192;0;192
84;07;07122;1657;46;1703
84;07;07123;165;3;168
84;07;07124;38;1;39
84;07;07126;1171;24;1195
84;07;07127;1118;13;1131
84;07;07128;379;5;384
84;07;07129;2349;44;2393
84;07;07130;205;5;210
84;07;07131;452;42;494
84;07;07132;1587;50;1637
84;07;07133;243;3;246
84;07;07134;1019;27;1046
84;07;07136;104;1;105
84;07;07137;44;0;44
84;07;07138;2226;46;2272
84;07;07139;105;0;105
84;07;07140;797;24;821
84;07;07141;232;7;239
84;07;07142;318;8;326
84;07;07143;773;18;791
84;07;07144;47;2;49
84;07;07145;1160;21;1181
84;07;07146;601;16;617
84;07;07147;242;5;247
84;07;07148;146;8;154
84;07;07149;284;5;289
84;07;07150;556;20;576
84;07;07151;257;11;268
84;07;07152;1183;26;1209
84;07;07153;264;7;271
84;07;07154;121;1;122
84;07;07155;1210;46;1256
84;07;07156;931;29;960
84;07;07157;1345;13;1358
84;07;07158;99;0;99
84;07;07159;715;10;725
84;07;07160;64;1;65
84;07;07161;739;23;762
84;07;07162;581;19;600
84;07;07163;81;7;88
84;07;07165;552;22;574
84;07;07166;250;2;252
84;07;07167;1006;19;1025
84;07;07168;597;17;614
84;07;07169;381;1;382
84;07;07170;243;6;249
84;07;07171;537;8;545
84;07;07172;2276;51;2327
84;07;07173;50;0;50
84;07;07174;482;6;488
84;07;07175;83;1;84
84;07;07176;153;2;155
84;07;07177;847;19;866
84;07;07178;588;12;600
84;07;07179;134;2;136
84;07;07181;2879;39;2918
84;07;07182;1186;31;1217
84;07;07183;473;12;485
84;07;07184;511;13;524
84;07;07185;703;9;712
84;07;07186;8465;282;8747
84;07;07187;135;4;139
84;07;07188;1686;38;1724
84;07;07189;315;7;322
84;07;07190;216;7;223
84;07;07191;2292;52;2344
84;07;07192;242;8;250
84;07;07193;276;4;280
84;07;07194;457;9;466
84;07;07195;62;2;64
84;07;07196;258;4;262
84;07;07197;2746;84;2830
84;07;07198;1126;30;1156
84;07;07199;1249;25;1274
84;07;07200;59;1;60
84;07;07201;2276;29;2305
84;07;07202;177;4;181
84;07;07203;116;3;119
84;07;07204;2377;63;2440
84;07;07205;1419;23;1442
84;07;07206;77;3;80
84;07;07207;1084;17;1101
84;07;07208;123;3;126
84;07;07209;54;2;56
84;07;07210;519;11;530
84;07;07211;461;14;475
84;07;07212;210;3;213
84;07;07213;149;1;150
84;07;07214;206;2;208
84;07;07215;199;6;205
84;07;07216;497;21;518
84;07;07217;833;21;854
84;07;07218;346;10;356
84;07;07219;320;6;326
84;07;07220;107;0;107
84;07;07221;248;9;257
84;07;07222;209;5;214
84;07;07223;139;2;141
84;07;07224;217;13;230
84;07;07225;1187;45;1232
84;07;07226;88;0;88
84;07;07227;1392;47;1439
84;07;07228;844;23;867
84;07;07229;926;25;951
84;07;07230;413;14;427
84;07;07231;2833;83;2916
84;07;07232;413;9;422
84;07;07233;211;4;215
84;07;07234;297;3;300
84;07;07235;216;3;219
84;07;07236;1147;19;1166
84;07;07237;777;13;790
84;07;07238;332;7;339
84;07;07239;110;2;112
84;07;07240;2405;45;2450
84;07;07241;711;17;728
84;07;07242;112;4;116
84;07;07243;290;5;295
84;07;07244;256;5;261
84;07;07245;2508;69;2577
84;07;07247;845;9;854
84;07;07248;247;11;258
84;07;07249;95;2;97
84;07;07250;486;10;496
84;07;07251;173;3;176
84;07;07253;175;3;178
84;07;07254;872;19;891
84;07;07255;1461;38;1499
84;07;07257;114;3;117
84;07;07258;223;2;225
84;07;07259;1688;37;1725
84;07;07260;950;17;967
84;07;07261;1589;35;1624
84;07;07262;172;2;174
84;07;07263;111;3;114
84;07;07264;2380;69;2449
84;07;07265;1384;35;1419
84;07;07266;113;2;115
84;07;07267;267;4;271
84;07;07268;949;12;961
84;07;07269;1096;38;1134
84;07;07270;432;12;444
84;07;07272;313;13;326
84;07;07273;217;3;220
84;07;07274;208;5;213
84;07;07275;103;3;106
84;07;07276;266;20;286
84;07;07277;149;5;154
84;07;07278;389;9;398
84;07;07279;1897;43;1940
84;07;07280;958;21;979
84;07;07281;7580;219;7799
84;07;07282;430;25;455
84;07;07283;63;1;64
84;07;07284;169;4;173
84;07;07285;109;1;110
84;07;07286;526;2;528
84;07;07287;296;15;311
84;07;07288;1280;44;1324
84;07;07289;1688;58;1746
84;07;07290;269;7;276
84;07;07291;858;23;881
84;07;07292;1248;36;1284
84;07;07293;900;18;918
84;07;07294;533;15;548
84;07;07295;1106;24;1130
84;07;07296;1748;48;1796
84;07;07297;508;7;515
84;07;07298;777;31;808
84;07;07299;120;4;124
84;07;07300;461;16;477
84;07;07301;950;15;965
84;07;07302;837;22;859
84;07;07303;254;4;258
84;07;07304;704;12;716
84;07;07305;372;8;380
84;07;07306;232;7;239
84;07;07307;447;9;456
84;07;07308;2228;35;2263
84;07;07309;1503;30;1533
84;07;07310;903;24;927
84;07;07311;146;7;153
84;07;07312;534;16;550
84;07;07313;1137;17;1154
84;07;07314;380;12;392
84;07;07315;372;13;385
84;07;07316;2284;49;2333
84;07;07317;1085;31;1116
84;07;07318;200;5;205
84;07;07319;8832;211;9043
84;07;07321;239;6;245
84;07;07322;1216;25;1241
84;07;07323;1708;53;1761
84;07;07324;10622;515;11137
84;07;07325;2062;72;2134
84;07;07326;117;0;117
84;07;07327;412;12;424
84;07;07328;583;18;601
84;07;07329;417;8;425
84;07;07330;2412;39;2451
84;07;07331;3530;65;3595
84;07;07332;447;13;460
84;07;07333;935;13;948
84;07;07334;2655;58;2713
84;07;07335;207;2;209
84;07;07336;225;7;232
84;07;07337;2614;85;2699
84;07;07338;1962;31;1993
84;07;07339;1990;62;2052
84;07;07340;1514;48;1562
84;07;07341;3001;115;3116
84;07;07342;1184;28;1212
84;07;07343;1401;40;1441
84;07;07344;466;3;469
84;07;07345;944;19;963
84;07;07346;3689;66;3755
84;07;07347;628;2;630
84;07;07348;1097;25;1122
84;07;07349;4848;58;4906
44;08;08001;467;3;470
44;08;08003;1637;35;1672
44;08;08004;236;1;237
44;08;08005;158;2;160
44;08;08006;242;4;246
44;08;08008;711;6;717
44;08;08010;133;5;138
44;08;08011;210;4;214
44;08;08013;390;3;393
44;08;08014;140;6;146
44;08;08015;101;5;106
44;08;08016;205;2;207
44;08;08017;117;3;120
44;08;08018;73;2;75
44;08;08019;61;0;61
44;08;08020;61;0;61
44;08;08021;155;3;158
44;08;08022;320;12;332
44;08;08023;65;1;66
44;08;08024;1088;19;1107
44;08;08025;1119;28;1147
44;08;08026;310;8;318
44;08;08027;97;3;100
44;08;08028;982;20;1002
44;08;08029;87;3;90
44;08;08030;58;0;58
44;08;08031;43;4;47
44;08;08032;218;3;221
44;08;08033;90;4;94
44;08;08034;340;6;346
44;08;08035;59;2;61
44;08;08036;114;8;122
44;08;08037;879;10;889
44;08;08038;328;9;337
44;08;08039;465;13;478
44;08;08040;886;12;898
44;08;08041;206;8;214
44;08;08043;1622;30;1652
44;08;08044;163;1;164
44;08;08045;268;11;279
44;08;08046;159;3;162
44;08;08047;106;0;106
44;08;08048;416;4;420
44;08;08049;128;3;131
44;08;08052;82;5;87
44;08;08053;2423;219;2642
44;08;08055;428;7;435
44;08;08056;45;0;45
44;08;08057;260;24;284
44;08;08058;222;6;228
44;08;08059;30;1;31
44;08;08060;293;1;294
44;08;08061;38;1;39
44;08;08062;126;6;132
44;08;08063;136;1;137
44;08;08064;307;5;312
44;08;08065;46;1;47
44;08;08066;68;1;69
44;08;08067;1121;17;1138
44;08;08069;145;2;147
44;08;08070;369;6;375
44;08;08071;138;2;140
44;08;08073;96;2;98
44;08;08074;56;3;59
44;08;08075;137;3;140
44;08;08076;966;19;985
44;08;08077;51;1;52
44;08;08078;853;15;868
44;08;08080;129;0;129
44;08;08081;5018;74;5092
44;08;08082;81;2;83
44;08;08083;353;7;360
44;08;08084;271;2;273
44;08;08085;226;7;233
44;08;08086;92;7;99
44;08;08087;146;2;148
44;08;08088;134;4;138
44;08;08089;370;9;379
44;08;08090;2879;44;2923
44;08;08092;190;8;198
44;08;08094;57;3;60
44;08;08095;182;6;188
44;08;08096;709;15;724
44;08;08097;444;7;451
44;08;08098;54;2;56
44;08;08099;123;4;127
44;08;08100;72;1;73
44;08;08101;167;5;172
44;08;08102;92;5;97
44;08;08103;222;3;225
44;08;08104;60;1;61
44;08;08105;46436;1090;47526
44;08;08106;73;0;73
44;08;08107;1331;18;1349
44;08;08109;140;3;143
44;08;08110;165;1;166
44;08;08111;782;2;784
44;08;08113;497;11;508
44;08;08115;545;4;549
44;08;08116;1021;17;1038
44;08;08117;159;0;159
44;08;08119;455;7;462
44;08;08120;45;2;47
44;08;08121;138;5;143
44;08;08122;754;15;769
44;08;08123;72;1;73
44;08;08124;345;9;354
44;08;08125;402;9;411
44;08;08126;221;4;225
44;08;08128;65;2;67
44;08;08130;83;3;86
44;08;08131;64;3;67
44;08;08132;189;2;191
44;08;08133;508;5;513
44;08;08134;77;1;78
44;08;08135;151;3;154
44;08;08136;349;8;357
44;08;08137;458;13;471
44;08;08138;255;3;258
44;08;08139;1041;10;1051
44;08;08140;1083;20;1103
44;08;08141;181;4;185
44;08;08142;2018;27;2045
44;08;08143;73;0;73
44;08;08144;102;1;103
44;08;08145;2199;60;2259
44;08;08146;95;2;97
44;08;08147;84;9;93
44;08;08148;279;7;286
44;08;08149;142;5;147
44;08;08150;170;5;175
44;08;08151;306;12;318
44;08;08153;347;5;352
44;08;08154;81;3;84
44;08;08155;101;5;106
44;08;08156;508;3;511
44;08;08158;299;8;307
44;08;08159;110;4;114
44;08;08160;188;4;192
44;08;08161;38;1;39
44;08;08162;350;6;356
44;08;08163;255;4;259
44;08;08164;336;9;345
44;08;08165;58;1;59
44;08;08166;268;2;270
44;08;08167;74;2;76
44;08;08168;174;4;178
44;08;08169;104;8;112
44;08;08170;215;3;218
44;08;08171;95;4;99
44;08;08172;188;1;189
44;08;08173;1722;52;1774
44;08;08174;2313;56;2369
44;08;08175;238;8;246
44;08;08176;53;1;54
44;08;08178;186;5;191
44;08;08179;597;13;610
44;08;08180;1671;41;1712
44;08;08182;54;0;54
44;08;08183;1043;24;1067
44;08;08184;82;2;84
44;08;08185;3280;48;3328
44;08;08186;49;0;49
44;08;08187;311;8;319
44;08;08188;1016;24;1040
44;08;08189;162;2;164
44;08;08190;6476;148;6624
44;08;08191;1052;25;1077
44;08;08192;86;1;87
44;08;08193;271;6;277
44;08;08194;845;13;858
44;08;08195;326;3;329
44;08;08196;104;0;104
44;08;08197;38;2;40
44;08;08198;520;16;536
44;08;08199;796;17;813
44;08;08200;184;6;190
44;08;08201;100;2;102
44;08;08202;517;10;527
44;08;08203;280;6;286
44;08;08204;82;1;83
44;08;08205;73;0;73
44;08;08206;371;5;376
44;08;08207;231;4;235
44;08;08208;137;1;138
44;08;08209;475;5;480
44;08;08210;112;4;116
44;08;08211;721;4;725
44;08;08212;504;10;514
44;08;08214;488;3;491
44;08;08215;43;2;45
44;08;08216;314;13;327
44;08;08217;88;0;88
44;08;08218;1446;24;1470
44;08;08219;117;1;118
44;08;08220;334;8;342
44;08;08222;1847;47;1894
44;08;08223;122;2;124
44;08;08225;205;6;211
44;08;08226;170;4;174
44;08;08228;168;5;173
44;08;08229;131;7;138
44;08;08230;390;6;396
44;08;08232;412;9;421
44;08;08233;46;1;47
44;08;08234;104;0;104
44;08;08235;374;12;386
44;08;08236;297;10;307
44;08;08237;655;20;675
44;08;08238;102;1;103
44;08;08239;1233;30;1263
44;08;08240;171;4;175
44;08;08242;428;8;436
44;08;08243;165;3;168
44;08;08244;72;3;75
44;08;08245;31;2;33
44;08;08246;74;1;75
44;08;08247;131;2;133
44;08;08248;686;9;695
44;08;08249;240;10;250
44;08;08250;188;5;193
44;08;08251;75;2;77
44;08;08252;118;2;120
44;08;08254;616;10;626
44;08;08255;224;3;227
44;08;08256;86;1;87
44;08;08257;155;3;158
44;08;08259;72;2;74
44;08;08260;627;8;635
44;08;08262;572;34;606
44;08;08263;1126;26;1152
44;08;08264;515;11;526
44;08;08268;69;4;73
44;08;08269;79;1;80
44;08;08271;100;6;106
44;08;08272;57;0;57
44;08;08273;72;1;73
44;08;08274;99;1;100
44;08;08275;207;4;211
44;08;08276;740;13;753
44;08;08277;131;4;135
44;08;08278;81;0;81
44;08;08279;58;2;60
44;08;08280;75;2;77
44;08;08281;469;9;478
44;08;08282;1033;72;1105
44;08;08283;127;1;128
44;08;08284;885;23;908
44;08;08286;113;5;118
44;08;08287;133;2;135
44;08;08288;90;1;91
44;08;08289;604;8;612
44;08;08291;245;5;250
44;08;08293;143;5;148
44;08;08294;135;4;139
44;08;08295;185;4;189
44;08;08296;115;7;122
44;08;08297;299;8;307
44;08;08298;1578;45;1623
44;08;08300;15;0;15
44;08;08301;69;4;73
44;08;08302;2237;84;2321
44;08;08303;385;10;395
44;08;08304;81;2;83
44;08;08305;255;5;260
44;08;08306;56;3;59
44;08;08307;82;1;83
44;08;08308;87;0;87
44;08;08309;57;1;58
44;08;08310;69;5;74
44;08;08311;2226;40;2266
44;08;08312;186;7;193
44;08;08313;145;4;149
44;08;08314;800;23;823
44;08;08315;74;2;76
44;08;08316;1006;15;1021
44;08;08317;115;4;119
44;08;08318;357;8;365
44;08;08319;333;8;341
44;08;08320;555;16;571
44;08;08321;168;4;172
44;08;08322;373;14;387
44;08;08323;160;1;161
44;08;08324;114;2;116
44;08;08325;26;1;27
44;08;08326;121;2;123
44;08;08327;2241;37;2278
44;08;08328;5689;109;5798
44;08;08329;497;11;508
44;08;08330;765;9;774
44;08;08331;669;14;683
44;08;08332;44;4;48
44;08;08333;237;9;246
44;08;08334;38;2;40
44;08;08335;81;1;82
44;08;08336;230;3;233
44;08;08338;188;3;191
44;08;08339;307;4;311
44;08;08340;176;4;180
44;08;08341;864;40;904
44;08;08342;245;5;250
44;08;08343;1144;23;1167
44;08;08344;134;2;136
44;08;08346;1350;36;1386
44;08;08347;220;5;225
44;08;08348;113;3;116
44;08;08349;576;6;582
44;08;08350;237;3;240
44;08;08351;84;0;84
44;08;08352;199;4;203
44;08;08353;723;22;745
44;08;08354;824;13;837
44;08;08355;387;7;394
44;08;08356;177;1;178
44;08;08357;784;15;799
44;08;08358;251;4;255
44;08;08360;199;5;204
44;08;08361;1652;58;1710
44;08;08362;7467;297;7764
44;08;08363;5836;124;5960
44;08;08364;132;2;134
44;08;08365;1342;21;1363
44;08;08366;682;11;693
44;08;08367;2283;29;2312
44;08;08368;220;3;223
44;08;08369;131;3;134
44;08;08370;572;6;578
44;08;08372;67;0;67
44;08;08373;293;4;297
44;08;08374;121;0;121
44;08;08375;178;5;183
44;08;08376;251;5;256
44;08;08377;156;2;158
44;08;08378;108;1;109
44;08;08379;243;10;253
44;08;08380;216;4;220
44;08;08381;821;12;833
44;08;08382;99;3;102
44;08;08383;102;4;106
44;08;08384;144;3;147
44;08;08385;1071;171;1242
44;08;08386;344;7;351
44;08;08387;182;6;188
44;08;08388;344;11;355
44;08;08389;335;7;342
44;08;08390;79;4;83
44;08;08391;947;16;963
44;08;08392;197;11;208
44;08;08393;66;1;67
44;08;08394;72;3;75
44;08;08395;136;4;140
44;08;08396;122;0;122
44;08;08397;50;0;50
44;08;08398;89;2;91
44;08;08399;139;3;142
44;08;08400;515;10;525
44;08;08401;231;3;234
44;08;08402;831;9;840
44;08;08403;1916;16;1932
44;08;08404;218;3;221
44;08;08405;235;8;243
44;08;08406;373;12;385
44;08;08407;59;0;59
44;08;08408;561;10;571
44;08;08409;16092;337;16429
44;08;08410;178;15;193
44;08;08411;89;0;89
44;08;08412;159;4;163
44;08;08413;264;3;267
44;08;08415;338;12;350
44;08;08416;170;6;176
44;08;08417;278;8;286
44;08;08418;224;3;227
44;08;08419;1354;28;1382
44;08;08420;1194;22;1216
44;08;08421;94;0;94
44;08;08422;135;4;139
44;08;08424;123;2;125
44;08;08425;43;1;44
44;08;08426;98;0;98
44;08;08427;205;1;206
44;08;08428;146;2;148
44;08;08429;536;14;550
44;08;08430;39;2;41
44;08;08431;100;6;106
44;08;08432;110;4;114
44;08;08433;61;2;63
44;08;08434;52;2;54
44;08;08435;879;13;892
44;08;08436;407;7;414
44;08;08437;174;6;180
44;08;08438;104;2;106
44;08;08439;150;9;159
44;08;08440;130;2;132
44;08;08444;129;4;133
44;08;08445;419;2;421
44;08;08446;79;0;79
44;08;08448;1043;12;1055
44;08;08449;640;15;655
44;08;08450;225;9;234
44;08;08451;378;8;386
44;08;08452;273;0;273
44;08;08453;103;3;106
44;08;08454;86;2;88
44;08;08455;92;1;93
44;08;08456;232;4;236
44;08;08457;1067;27;1094
44;08;08458;180;4;184
44;08;08459;149;3;152
44;08;08460;153;0;153
44;08;08461;206;1;207
44;08;08462;128;4;132
44;08;08463;55;1;56
44;08;08464;80;3;83
44;08;08465;44;3;47
44;08;08466;70;2;72
44;08;08467;108;0;108
44;08;08468;193;0;193
44;08;08469;478;12;490
44;08;08470;66;1;67
44;08;08471;31;2;33
44;08;08472;297;2;299
44;08;08473;305;7;312
44;08;08476;418;7;425
44;08;08477;108;0;108
44;08;08478;237;3;240
44;08;08479;196;2;198
44;08;08480;3568;71;3639
44;08;08481;253;5;258
44;08;08482;105;3;108
44;08;08483;524;13;537
44;08;08484;82;1;83
44;08;08485;204;11;215
44;08;08486;1467;31;1498
44;08;08487;1954;55;2009
44;08;08488;2918;83;3001
44;08;08489;218;3;221
44;08;08490;4320;150;4470
44;08;08491;3572;76;3648
44;08;08492;319;8;327
44;08;08494;459;5;464
44;08;08496;131;1;132
44;08;08497;1197;25;1222
44;08;08498;385;16;401
44;08;08499;321;3;324
44;08;08500;57;1;58
44;08;08501;41;3;44
44;08;08502;93;3;96
44;08;08503;127;1;128
76;09;09001;60;1;61
76;09;09002;645;20;665
76;09;09003;397;9;406
76;09;09004;121;7;128
76;09;09005;131;2;133
76;09;09006;54;0;54
76;09;09007;72;0;72
76;09;09008;122;2;124
76;09;09009;267;13;280
76;09;09011;71;1;72
76;09;09012;27;1;28
76;09;09013;81;2;83
76;09;09014;192;7;199
76;09;09015;692;8;700
76;09;09016;218;8;226
76;09;09017;111;2;113
76;09;09018;90;4;94
76;09;09019;562;10;572
76;09;09020;42;0;42
76;09;09021;121;3;124
76;09;09022;215;0;215
76;09;09023;120;1;121
76;09;09024;207;5;212
76;09;09025;55;3;58
76;09;09026;147;1;148
76;09;09027;79;2;81
76;09;09029;160;6;166
76;09;09030;469;10;479
76;09;09031;42;1;43
76;09;09032;1288;66;1354
76;09;09033;37;1;38
76;09;09034;34;2;36
76;09;09035;196;2;198
76;09;09037;42;0;42
76;09;09038;383;7;390
76;09;09039;340;13;353
76;09;09040;287;7;294
76;09;09041;203;7;210
76;09;09042;980;14;994
76;09;09043;670;13;683
76;09;09044;169;3;172
76;09;09045;199;1;200
76;09;09046;67;3;70
76;09;09047;1072;19;1091
76;09;09048;80;1;81
76;09;09049;179;3;182
76;09;09050;527;7;534
76;09;09051;152;4;156
76;09;09052;162;8;170
76;09;09053;19;3;22
76;09;09054;350;5;355
76;09;09055;93;0;93
76;09;09056;394;10;404
76;09;09057;317;5;322
76;09;09058;192;5;197
76;09;09059;121;4;125
76;09;09060;751;10;761
76;09;09061;505;6;511
76;09;09062;199;5;204
76;09;09063;109;2;111
76;09;09064;39;0;39
76;09;09065;213;1;214
76;09;09066;620;10;630
76;09;09067;214;3;217
76;09;09068;42;0;42
76;09;09069;26;0;26
76;09;09070;337;8;345
76;09;09071;223;8;231
76;09;09072;34;0;34
76;09;09073;194;1;195
76;09;09074;147;1;148
76;09;09075;285;8;293
76;09;09076;204;7;211
76;09;09077;183;1;184
76;09;09078;75;2;77
76;09;09079;796;14;810
76;09;09080;176;2;178
76;09;09081;275;11;286
76;09;09082;453;8;461
76;09;09083;22;0;22
76;09;09084;93;1;94
76;09;09085;401;5;406
76;09;09086;332;5;337
76;09;09087;47;0;47
76;09;09088;15;0;15
76;09;09089;57;2;59
76;09;09090;37;6;43
76;09;09091;204;3;207
76;09;09092;60;3;63
76;09;09093;157;0;157
76;09;09094;137;9;146
76;09;09095;148;1;149
76;09;09096;42;3;45
76;09;09097;115;0;115
76;09;09098;68;2;70
76;09;09099;394;19;413
76;09;09100;90;1;91
76;09;09101;282;3;285
76;09;09102;171;2;173
76;09;09103;864;17;881
76;09;09104;770;19;789
76;09;09105;708;11;719
76;09;09106;358;16;374
76;09;09107;619;15;634
76;09;09108;178;4;182
76;09;09109;171;3;174
76;09;09110;90;4;94
76;09;09111;304;4;308
76;09;09113;562;3;565
76;09;09114;130;2;132
76;09;09115;133;2;135
76;09;09116;386;3;389
76;09;09117;107;6;113
76;09;09118;184;4;188
76;09;09119;546;6;552
76;09;09120;349;4;353
76;09;09121;753;100;853
76;09;09122;9493;325;9818
76;09;09123;113;1;114
76;09;09124;1046;14;1060
76;09;09125;432;5;437
76;09;09126;85;3;88
76;09;09127;125;4;129
76;09;09128;308;10;318
76;09;09129;115;0;115
76;09;09130;726;9;735
76;09;09131;147;0;147
76;09;09132;250;3;253
76;09;09133;22;1;23
76;09;09134;32;1;33
76;09;09136;74;3;77
76;09;09137;202;4;206
76;09;09138;196;26;222
76;09;09139;102;0;102
76;09;09140;119;6;125
76;09;09141;73;0;73
76;09;09142;120;0;120
76;09;09143;33;0;33
76;09;09145;243;9;252
76;09;09146;57;0;57
76;09;09147;176;1;177
76;09;09148;124;5;129
76;09;09149;193;4;197
76;09;09150;201;6;207
76;09;09151;51;1;52
76;09;09152;23;1;24
76;09;09153;120;4;124
76;09;09154;59;2;61
76;09;09155;47;0;47
76;09;09156;20;0;20
76;09;09157;2405;53;2458
76;09;09158;251;7;258
76;09;09159;97;0;97
76;09;09160;6031;165;6196
76;09;09161;610;15;625
76;09;09162;16;0;16
76;09;09163;79;0;79
76;09;09164;493;23;516
76;09;09165;233;1;234
76;09;09166;99;6;105
76;09;09167;2348;40;2388
76;09;09168;185;9;194
76;09;09169;125;3;128
76;09;09170;255;6;261
76;09;09171;70;0;70
76;09;09172;26;0;26
76;09;09173;281;5;286
76;09;09174;355;13;368
76;09;09175;94;4;98
76;09;09176;521;9;530
76;09;09177;241;6;247
76;09;09178;45;4;49
76;09;09179;78;1;79
76;09;09180;120;1;121
76;09;09181;1145;9;1154
76;09;09182;709;10;719
76;09;09183;102;4;106
76;09;09184;45;1;46
76;09;09185;3873;83;3956
76;09;09186;104;0;104
76;09;09187;355;10;365
76;09;09188;1203;24;1227
76;09;09189;168;4;172
76;09;09190;114;1;115
76;09;09192;114;3;117
76;09;09193;61;0;61
76;09;09194;3102;124;3226
76;09;09195;30;0;30
76;09;09196;80;1;81
76;09;09197;17;0;17
76;09;09198;207;4;211
76;09;09199;696;18;714
76;09;09200;99;2;101
76;09;09201;78;1;79
76;09;09202;335;9;344
76;09;09203;156;9;165
76;09;09204;250;10;260
76;09;09205;81;2;83
76;09;09206;534;13;547
76;09;09207;1484;31;1515
76;09;09208;125;0;125
76;09;09209;1034;21;1055
76;09;09210;408;7;415
76;09;09211;117;2;119
76;09;09212;103;1;104
76;09;09213;243;3;246
76;09;09214;757;12;769
76;09;09215;122;4;126
76;09;09216;62;1;63
76;09;09217;154;2;156
76;09;09218;88;1;89
76;09;09219;195;4;199
76;09;09220;164;3;167
76;09;09221;243;3;246
76;09;09222;26;0;26
76;09;09223;555;7;562
76;09;09224;474;8;482
76;09;09225;15659;478;16137
76;09;09226;37;0;37
76;09;09227;199;3;202
76;09;09228;224;5;229
76;09;09229;465;8;473
76;09;09230;60;0;60
76;09;09231;164;1;165
76;09;09232;32;0;32
76;09;09233;47;1;48
76;09;09234;119;3;122
76;09;09235;864;16;880
76;09;09236;368;16;384
76;09;09237;30;1;31
76;09;09238;831;17;848
76;09;09239;136;1;137
76;09;09240;297;3;300
76;09;09241;366;5;371
76;09;09242;53;1;54
76;09;09243;84;3;87
76;09;09244;712;12;724
76;09;09245;1284;35;1319
76;09;09246;529;20;549
76;09;09247;163;9;172
76;09;09249;147;4;151
76;09;09250;93;2;95
76;09;09251;166;8;174
76;09;09252;88;0;88
76;09;09253;384;6;390
76;09;09254;241;6;247
76;09;09255;43;0;43
76;09;09256;58;0;58
76;09;09257;620;16;636
76;09;09258;464;9;473
76;09;09259;152;4;156
76;09;09260;29;0;29
76;09;09261;6418;401;6819
76;09;09262;382;6;388
76;09;09263;22;1;23
76;09;09264;1275;18;1293
76;09;09265;2859;63;2922
76;09;09266;66;2;68
76;09;09267;127;2;129
76;09;09268;1365;31;1396
76;09;09269;363;11;374
76;09;09270;220;5;225
76;09;09271;81;2;83
76;09;09272;1330;27;1357
76;09;09273;665;23;688
76;09;09274;337;6;343
76;09;09275;371;8;379
76;09;09276;220;10;230
76;09;09277;690;11;701
76;09;09279;47;2;49
76;09;09280;641;9;650
76;09;09281;121;2;123
76;09;09282;4828;158;4986
76;09;09283;389;15;404
76;09;09284;187;6;193
76;09;09285;708;14;722
76;09;09287;13;0;13
76;09;09289;1491;35;1526
76;09;09290;155;3;158
76;09;09291;105;3;108
76;09;09292;56;0;56
76;09;09293;680;10;690
76;09;09294;103;1;104
76;09;09295;95;0;95
76;09;09296;152;2;154
76;09;09297;28;0;28
76;09;09298;80;2;82
76;09;09299;426;7;433
76;09;09300;174;7;181
76;09;09301;376;2;378
76;09;09303;322;8;330
76;09;09304;14;1;15
76;09;09305;354;8;362
76;09;09306;3024;32;3056
76;09;09307;158;2;160
76;09;09308;208;8;216
76;09;09309;152;2;154
76;09;09310;47;2;49
76;09;09311;22;0;22
76;09;09312;3218;68;3286
76;09;09313;155;7;162
76;09;09314;274;15;289
76;09;09315;129;0;129
76;09;09316;101;1;102
76;09;09318;125;1;126
76;09;09319;117;4;121
76;09;09320;29;1;30
76;09;09321;317;4;321
76;09;09322;272;10;282
76;09;09323;92;1;93
76;09;09324;3495;55;3550
76;09;09325;29;0;29
76;09;09326;124;1;125
76;09;09327;234;2;236
76;09;09328;216;9;225
76;09;09329;673;21;694
76;09;09330;28;0;28
76;09;09331;718;6;724
76;09;09332;2252;68;2320
76;09;09334;561;64;625
76;09;09335;39;0;39
76;09;09336;965;19;984
76;09;09338;155;4;159
76;09;09339;769;15;784
76;09;09340;156;4;160
76;09;09341;146;0;146
76;09;09342;239;2;241
44;10;10002;237;5;242
44;10;10003;3546;38;3584
44;10;10004;207;2;209
44;10;10005;255;12;267
44;10;10006;2803;81;2884
44;10;10007;104;2;106
44;10;10008;113;1;114
44;10;10009;87;2;89
44;10;10010;47;2;49
44;10;10011;210;1;211
44;10;10012;306;5;311
44;10;10013;145;2;147
44;10;10014;181;1;182
44;10;10015;376;6;382
44;10;10017;130;3;133
44;10;10018;1023;10;1033
44;10;10019;379;5;384
44;10;10020;505;10;515
44;10;10021;157;4;161
44;10;10022;200;12;212
44;10;10023;187;7;194
44;10;10024;169;3;172
44;10;10025;171;4;175
44;10;10026;36;0;36
44;10;10027;60;5;65
44;10;10028;120;0;120
44;10;10029;155;2;157
44;10;10030;1530;30;1560
44;10;10031;471;8;479
44;10;10032;302;9;311
44;10;10033;4787;193;4980
44;10;10034;2961;196;3157
44;10;10035;751;9;760
44;10;10037;447;10;457
44;10;10038;194;2;196
44;10;10039;117;5;122
44;10;10040;164;8;172
44;10;10041;50;1;51
44;10;10042;206;4;210
44;10;10043;127;3;130
44;10;10044;34;0;34
44;10;10045;182;9;191
44;10;10046;114;2;116
44;10;10047;41;1;42
44;10;10048;161;4;165
44;10;10049;531;9;540
44;10;10050;198;3;201
44;10;10051;1087;47;1134
44;10;10052;216;4;220
44;10;10053;594;9;603
44;10;10054;113;1;114
44;10;10055;266;12;278
44;10;10056;240;1;241
44;10;10057;53;1;54
44;10;10058;242;9;251
44;10;10059;112;5;117
44;10;10060;2851;56;2907
44;10;10061;673;12;685
44;10;10062;201;2;203
44;10;10063;411;13;424
44;10;10064;2772;26;2798
44;10;10065;85;1;86
44;10;10066;436;10;446
44;10;10067;1827;28;1855
44;10;10068;125;6;131
44;10;10069;116;0;116
44;10;10070;490;19;509
44;10;10071;51;2;53
44;10;10072;34;0;34
44;10;10073;127;2;129
44;10;10074;507;8;515
44;10;10075;96;6;102
44;10;10076;264;7;271
44;10;10077;110;2;112
44;10;10078;27;0;27
44;10;10079;129;2;131
44;10;10080;1038;10;1048
44;10;10081;11741;92;11833
44;10;10082;245;4;249
44;10;10083;338;6;344
44;10;10084;1019;28;1047
44;10;10085;65;0;65
44;10;10086;264;8;272
44;10;10087;53;1;54
44;10;10089;698;13;711
44;10;10090;232;2;234
44;10;10091;141;4;145
44;10;10092;128;0;128
44;10;10093;103;2;105
44;10;10094;588;12;600
44;10;10095;289;5;294
44;10;10096;433;8;441
44;10;10097;161;4;165
44;10;10098;322;9;331
44;10;10099;519;14;533
44;10;10100;1127;23;1150
44;10;10101;173;3;176
44;10;10102;189;4;193
44;10;10103;153;1;154
44;10;10104;306;3;309
44;10;10105;26;1;27
44;10;10106;136;5;141
44;10;10107;104;0;104
44;10;10108;82;0;82
44;10;10109;232;8;240
44;10;10110;559;11;570
44;10;10111;105;5;110
44;10;10112;177;2;179
44;10;10113;199;6;205
44;10;10114;706;14;720
44;10;10115;1982;34;2016
44;10;10116;316;4;320
44;10;10117;158;7;165
44;10;10118;93;4;97
44;10;10119;174;4;178
44;10;10120;213;2;215
44;10;10121;322;8;330
44;10;10122;225;4;229
44;10;10123;873;16;889
44;10;10124;262;13;275
44;10;10125;307;5;312
44;10;10126;133;4;137
44;10;10127;58;0;58
44;10;10128;73;1;74
44;10;10129;299;9;308
44;10;10130;101;6;107
44;10;10131;360;4;364
44;10;10132;234;5;239
44;10;10133;260;11;271
44;10;10134;88;6;94
44;10;10135;101;3;104
44;10;10136;117;1;118
44;10;10137;33;0;33
44;10;10138;142;2;144
44;10;10139;166;4;170
44;10;10140;1142;9;1151
44;10;10141;721;12;733
44;10;10142;1851;19;1870
44;10;10143;169;5;174
44;10;10144;154;3;157
44;10;10145;212;7;219
44;10;10146;90;3;93
44;10;10147;126;4;130
44;10;10148;410;10;420
44;10;10149;333;4;337
44;10;10150;253;5;258
44;10;10151;877;9;886
44;10;10153;621;14;635
44;10;10154;71;1;72
44;10;10155;190;6;196
44;10;10156;706;8;714
44;10;10157;215;6;221
44;10;10158;535;16;551
44;10;10159;88;1;89
44;10;10160;37;1;38
44;10;10161;49;3;52
44;10;10162;287;6;293
44;10;10163;43;2;45
44;10;10164;735;10;745
44;10;10165;337;6;343
44;10;10166;398;6;404
44;10;10167;91;0;91
44;10;10168;79;1;80
44;10;10169;220;8;228
44;10;10170;490;9;499
44;10;10171;231;9;240
44;10;10172;155;1;156
44;10;10173;462;8;470
44;10;10174;169;3;172
44;10;10175;177;3;180
44;10;10176;164;7;171
44;10;10177;148;7;155
44;10;10178;263;6;269
44;10;10179;472;10;482
44;10;10180;96;4;100
44;10;10181;221;12;233
44;10;10182;119;1;120
44;10;10183;35;1;36
44;10;10184;128;1;129
44;10;10185;209;4;213
44;10;10186;529;16;545
44;10;10187;400;10;410
44;10;10188;215;7;222
44;10;10189;59;0;59
44;10;10190;569;6;575
44;10;10191;910;10;920
44;10;10192;127;1;128
44;10;10193;303;7;310
44;10;10194;95;2;97
44;10;10195;296;4;300
44;10;10196;209;1;210
44;10;10197;180;11;191
44;10;10198;99;3;102
44;10;10199;349;6;355
44;10;10200;91;3;94
44;10;10201;69;0;69
44;10;10202;218;80;298
44;10;10203;390;14;404
44;10;10204;147;3;150
44;10;10205;93;2;95
44;10;10206;126;1;127
44;10;10207;128;1;129
44;10;10208;290;12;302
44;10;10209;2207;54;2261
44;10;10210;455;13;468
44;10;10211;971;15;986
44;10;10212;116;4;120
44;10;10213;160;3;163
44;10;10214;87;1;88
44;10;10215;261;4;265
44;10;10216;1933;25;1958
44;10;10217;32;0;32
44;10;10218;164;1;165
44;10;10219;67;3;70
44;10;10220;1498;43;1541
44;10;10221;162;0;162
44;10;10222;438;7;445
44;10;10223;727;9;736
44;10;10224;1757;33;1790
44;10;10225;234;7;241
44;10;10226;112;2;114
44;10;10227;329;5;334
44;10;10228;198;2;200
44;10;10229;105;2;107
44;10;10230;680;10;690
44;10;10231;621;10;631
44;10;10232;325;5;330
44;10;10233;1511;49;1560
44;10;10234;277;1;278
44;10;10235;47;0;47
44;10;10236;57;1;58
44;10;10237;591;29;620
44;10;10238;458;9;467
44;10;10239;587;24;611
44;10;10240;466;11;477
44;10;10241;64;0;64
44;10;10242;160;3;163
44;10;10243;105;5;110
44;10;10245;809;28;837
44;10;10246;264;16;280
44;10;10247;124;4;128
44;10;10248;388;11;399
44;10;10249;403;7;410
44;10;10250;224;6;230
44;10;10251;253;9;262
44;10;10252;60;2;62
44;10;10253;141;1;142
44;10;10254;328;9;337
44;10;10255;291;5;296
44;10;10256;407;4;411
44;10;10257;30;0;30
44;10;10258;283;7;290
44;10;10259;364;3;367
44;10;10260;643;16;659
44;10;10261;1017;15;1032
44;10;10262;415;8;423
44;10;10263;435;5;440
44;10;10264;117;2;119
44;10;10265;3280;33;3313
44;10;10266;47;3;50
44;10;10267;312;4;316
44;10;10268;5966;118;6084
44;10;10269;150;4;154
44;10;10270;258;6;264
44;10;10271;595;11;606
44;10;10272;180;3;183
44;10;10273;24;0;24
44;10;10274;312;4;316
44;10;10275;594;7;601
44;10;10276;334;6;340
44;10;10278;137;4;141
44;10;10279;53;1;54
44;10;10280;817;9;826
44;10;10281;291;8;299
44;10;10282;1374;19;1393
44;10;10283;130;2;132
44;10;10284;148;3;151
44;10;10285;73;0;73
44;10;10286;206;7;213
44;10;10287;1483;16;1499
44;10;10288;263;4;267
44;10;10289;968;17;985
44;10;10290;235;3;238
44;10;10291;187;7;194
44;10;10293;159;2;161
44;10;10294;62;2;64
44;10;10295;323;6;329
44;10;10296;190;9;199
44;10;10297;5154;92;5246
44;10;10298;1159;20;1179
44;10;10299;522;17;539
44;10;10300;290;2;292
44;10;10301;173;4;177
44;10;10302;87;2;89
44;10;10303;81;2;83
44;10;10304;185;2;187
44;10;10305;86;3;89
44;10;10306;239;6;245
44;10;10307;367;10;377
44;10;10308;211;8;219
44;10;10309;95;2;97
44;10;10310;216;5;221
44;10;10312;168;5;173
44;10;10313;371;2;373
44;10;10314;409;4;413
44;10;10315;45;2;47
44;10;10316;221;4;225
44;10;10317;1212;23;1235
44;10;10318;161;2;163
44;10;10319;325;7;332
44;10;10320;233;5;238
44;10;10321;3591;113;3704
44;10;10323;14480;318;14798
44;10;10324;159;2;161
44;10;10325;4521;347;4868
44;10;10326;171;8;179
44;10;10327;114;1;115
44;10;10328;388;4;392
44;10;10329;513;45;558
44;10;10330;110;1;111
44;10;10331;557;10;567
44;10;10332;497;11;508
44;10;10333;12784;190;12974
44;10;10334;589;8;597
44;10;10335;241;6;247
44;10;10336;395;5;400
44;10;10337;33;1;34
44;10;10338;177;3;180
44;10;10339;291;6;297
44;10;10340;2275;48;2323
44;10;10341;357;9;366
44;10;10342;404;8;412
44;10;10343;6765;145;6910
44;10;10344;902;15;917
44;10;10345;383;11;394
44;10;10346;54;1;55
44;10;10347;208;6;214
44;10;10348;231;4;235
44;10;10349;2885;62;2947
44;10;10350;638;11;649
44;10;10351;366;5;371
44;10;10352;1715;294;2009
44;10;10353;886;10;896
44;10;10354;137;4;141
44;10;10355;67;0;67
44;10;10356;299;8;307
44;10;10357;3167;49;3216
44;10;10358;1043;18;1061
44;10;10359;513;11;524
44;10;10360;953;230;1183
44;10;10361;241;4;245
44;10;10362;10508;388;10896
44;10;10363;550;3;553
44;10;10364;73;2;75
44;10;10365;123;0;123
44;10;10366;65;2;67
44;10;10367;689;9;698
44;10;10368;999;11;1010
44;10;10369;193;6;199
44;10;10370;246;6;252
44;10;10371;308;5;313
44;10;10372;417;6;423
44;10;10373;379;20;399
44;10;10374;161;1;162
44;10;10375;332;10;342
44;10;10376;154;3;157
44;10;10377;112;9;121
44;10;10378;69;3;72
44;10;10379;456;9;465
44;10;10380;80;5;85
44;10;10381;988;18;1006
44;10;10382;1047;13;1060
44;10;10383;185;3;188
44;10;10384;217;7;224
44;10;10386;224;7;231
44;10;10387;61957;1130;63087
44;10;10388;44;1;45
44;10;10389;116;4;120
44;10;10390;122;2;124
44;10;10391;294;1;295
44;10;10392;400;9;409
44;10;10393;177;3;180
44;10;10394;165;1;166
44;10;10395;295;4;299
44;10;10396;500;5;505
44;10;10397;164;2;166
44;10;10398;76;4;80
44;10;10399;720;8;728
44;10;10400;117;5;122
44;10;10401;2315;39;2354
44;10;10402;245;5;250
44;10;10403;54;1;55
44;10;10404;109;2;111
44;10;10405;56;0;56
44;10;10406;1858;37;1895
44;10;10408;132;5;137
44;10;10409;602;4;606
44;10;10410;107;4;111
44;10;10411;27;0;27
44;10;10412;942;20;962
44;10;10414;124;5;129
44;10;10416;245;9;254
44;10;10417;204;6;210
44;10;10418;201;9;210
44;10;10419;753;13;766
44;10;10420;2726;30;2756
44;10;10421;148;4;152
44;10;10422;184;2;186
44;10;10423;417;15;432
44;10;10424;63;2;65
44;10;10425;272;3;275
44;10;10426;960;12;972
44;10;10427;204;7;211
44;10;10428;100;5;105
44;10;10429;248;3;251
44;10;10430;85;2;87
44;10;10431;101;1;102
44;10;10432;71;1;72
44;10;10433;251;8;259
44;10;10434;56;1;57
44;10;10435;186;4;190
44;10;10436;170;7;177
44;10;10437;605;10;615
44;10;10438;221;5;226
44;10;10439;125;3;128
44;10;10440;146;6;152
44;10;10441;232;2;234
44;10;10442;686;9;695
44;10;10443;45;1;46
44;10;10444;227;3;230
44;10;10445;54;9;63
76;11;11001;563;11;574
76;11;11002;168;2;170
76;11;11003;196;3;199
76;11;11004;333;5;338
76;11;11005;1313;33;1346
76;11;11006;79;2;81
76;11;11007;121;4;125
76;11;11008;386;3;389
76;11;11009;1582;22;1604
76;11;11010;258;7;265
76;11;11011;456;14;470
76;11;11012;2189;32;2221
76;11;11013;355;6;361
76;11;11014;1513;30;1543
76;11;11015;262;3;265
76;11;11016;80;3;83
76;11;11017;74;1;75
76;11;11018;1220;33;1253
76;11;11019;64;0;64
76;11;11020;38;0;38
76;11;11021;535;11;546
76;11;11022;1113;23;1136
76;11;11023;760;14;774
76;11;11024;784;15;799
76;11;11025;306;3;309
76;11;11026;175;3;178
76;11;11027;777;20;797
76;11;11028;382;7;389
76;11;11029;60;3;63
76;11;11030;118;6;124
76;11;11031;23;2;25
76;11;11032;245;2;247
76;11;11033;1317;27;1344
76;11;11034;857;7;864
76;11;11035;243;6;249
76;11;11036;162;2;164
76;11;11037;966;10;976
76;11;11038;46;0;46
76;11;11039;47;1;48
76;11;11040;1746;28;1774
76;11;11041;1225;15;1240
76;11;11042;228;6;234
76;11;11043;223;6;229
76;11;11044;105;0;105
76;11;11045;141;1;142
76;11;11046;55;0;55
76;11;11047;47;1;48
76;11;11048;727;16;743
76;11;11049;3208;81;3289
76;11;11051;181;4;185
76;11;11052;343;5;348
76;11;11053;283;5;288
76;11;11054;271;11;282
76;11;11055;240;4;244
76;11;11056;171;4;175
76;11;11057;29;0;29
76;11;11058;256;8;264
76;11;11059;138;1;139
76;11;11060;49;1;50
76;11;11061;303;4;307
76;11;11062;19;0;19
76;11;11063;603;5;608
76;11;11064;371;4;375
76;11;11065;53;1;54
76;11;11066;102;0;102
76;11;11067;1826;18;1844
76;11;11068;1473;41;1514
76;11;11069;46825;1291;48116
76;11;11070;337;5;342
76;11;11071;224;7;231
76;11;11072;165;8;173
76;11;11073;59;0;59
76;11;11074;302;2;304
76;11;11075;133;2;135
76;11;11076;12187;507;12694
76;11;11077;503;9;512
76;11;11078;207;7;214
76;11;11079;206;3;209
76;11;11080;170;2;172
76;11;11081;1621;30;1651
76;11;11082;8;0;8
76;11;11083;52;0;52
76;11;11084;1003;23;1026
76;11;11085;954;39;993
76;11;11086;906;13;919
76;11;11087;93;1;94
76;11;11088;1652;50;1702
76;11;11089;407;7;414
76;11;11090;623;17;640
76;11;11091;1132;12;1144
76;11;11092;87;1;88
76;11;11093;28;2;30
76;11;11094;26;0;26
76;11;11095;303;8;311
76;11;11096;36;2;38
76;11;11098;905;19;924
76;11;11099;2581;55;2636
76;11;11100;26;1;27
76;11;11101;52;1;53
76;11;11102;587;8;595
76;11;11103;1118;21;1139
76;11;11104;50;0;50
76;11;11105;726;10;736
76;11;11106;5825;96;5921
76;11;11107;76;1;77
76;11;11108;46;1;47
76;11;11109;52;1;53
76;11;11110;118;0;118
76;11;11111;933;9;942
76;11;11112;84;1;85
76;11;11113;116;5;121
76;11;11114;39;0;39
76;11;11115;897;24;921
76;11;11116;4033;71;4104
76;11;11117;115;2;117
76;11;11118;44;1;45
76;11;11119;295;7;302
76;11;11120;530;13;543
76;11;11121;110;1;111
76;11;11122;765;12;777
76;11;11123;146;3;149
76;11;11124;654;11;665
76;11;11125;153;0;153
76;11;11126;477;4;481
76;11;11127;71;3;74
76;11;11128;148;2;150
76;11;11129;1729;32;1761
76;11;11130;227;5;232
76;11;11131;573;13;586
76;11;11132;1256;16;1272
76;11;11133;42;0;42
76;11;11134;50;4;54
76;11;11135;12;1;13
76;11;11136;849;89;938
76;11;11137;127;5;132
76;11;11138;526;16;542
76;11;11139;79;0;79
76;11;11140;1235;21;1256
76;11;11141;120;1;121
76;11;11142;198;5;203
76;11;11143;110;0;110
76;11;11144;1069;12;1081
76;11;11145;3758;62;3820
76;11;11146;406;8;414
76;11;11147;5;0;5
76;11;11148;552;10;562
76;11;11149;79;1;80
76;11;11150;450;50;500
76;11;11151;514;11;525
76;11;11152;127;4;131
76;11;11153;241;7;248
76;11;11154;49;0;49
76;11;11155;78;1;79
76;11;11156;105;2;107
76;11;11157;213;5;218
76;11;11158;291;11;302
76;11;11159;138;2;140
76;11;11160;36;0;36
76;11;11161;127;3;130
76;11;11162;58;1;59
76;11;11163;46;0;46
76;11;11164;1499;21;1520
76;11;11165;303;9;312
76;11;11166;81;0;81
76;11;11167;124;2;126
76;11;11168;95;0;95
76;11;11169;86;5;91
76;11;11170;5087;80;5167
76;11;11172;594;11;605
76;11;11173;132;3;135
76;11;11174;55;0;55
76;11;11175;476;9;485
76;11;11176;59;2;61
76;11;11177;32;0;32
76;11;11178;1284;15;1299
76;11;11179;91;2;93
76;11;11180;64;0;64
76;11;11181;399;8;407
76;11;11182;175;3;178
76;11;11183;267;9;276
76;11;11184;92;3;95
76;11;11185;540;9;549
76;11;11186;55;2;57
76;11;11187;57;1;58
76;11;11188;1704;31;1735
76;11;11189;106;1;107
76;11;11190;1227;20;1247
76;11;11191;151;7;158
76;11;11192;788;30;818
76;11;11193;278;3;281
76;11;11194;157;3;160
76;11;11195;402;9;411
76;11;11196;180;8;188
76;11;11197;604;16;620
76;11;11198;1022;15;1037
76;11;11199;1513;26;1539
76;11;11200;134;7;141
76;11;11201;865;15;880
76;11;11202;4612;58;4670
76;11;11203;11317;220;11537
76;11;11204;48;0;48
76;11;11205;134;2;136
76;11;11206;10012;509;10521
76;11;11207;239;5;244
76;11;11208;80;3;83
76;11;11209;246;7;253
76;11;11210;1138;10;1148
76;11;11211;534;5;539
76;11;11212;574;12;586
76;11;11213;47;0;47
76;11;11214;422;12;434
76;11;11215;864;26;890
76;11;11216;368;12;380
76;11;11217;1314;27;1341
76;11;11218;83;0;83
76;11;11219;19;0;19
76;11;11220;703;13;716
76;11;11221;299;5;304
76;11;11222;178;5;183
76;11;11223;25;1;26
76;11;11224;27;1;28
76;11;11225;927;22;949
76;11;11226;81;1;82
76;11;11227;38;1;39
76;11;11228;151;4;155
76;11;11229;25;1;26
76;11;11230;32;0;32
76;11;11231;97;3;100
76;11;11232;46;0;46
76;11;11233;758;13;771
76;11;11234;185;5;190
76;11;11235;60;2;62
76;11;11236;242;2;244
76;11;11238;138;6;144
76;11;11239;83;2;85
76;11;11240;556;9;565
76;11;11241;329;1;330
76;11;11242;173;0;173
76;11;11243;602;10;612
76;11;11244;90;3;93
76;11;11245;38;0;38
76;11;11246;46;0;46
76;11;11247;38;0;38
76;11;11248;69;1;70
76;11;11249;82;1;83
76;11;11250;36;1;37
76;11;11251;741;10;751
76;11;11252;304;9;313
76;11;11253;836;14;850
76;11;11254;1900;173;2073
76;11;11255;1485;15;1500
76;11;11256;614;12;626
76;11;11257;230;3;233
76;11;11258;2030;48;2078
76;11;11259;1005;30;1035
76;11;11260;106;3;109
76;11;11261;701;8;709
76;11;11262;55516;1184;56700
76;11;11263;260;5;265
76;11;11264;1289;32;1321
76;11;11265;38;1;39
76;11;11266;5795;68;5863
76;11;11267;1127;25;1152
76;11;11268;113;0;113
76;11;11269;2564;50;2614
76;11;11270;137;1;138
76;11;11271;33;0;33
76;11;11272;2398;101;2499
76;11;11273;673;12;685
76;11;11274;369;15;384
76;11;11275;205;3;208
76;11;11276;526;17;543
76;11;11277;28;2;30
76;11;11278;74;1;75
76;11;11279;2634;60;2694
76;11;11280;1087;30;1117
76;11;11281;1230;19;1249
76;11;11282;52;2;54
76;11;11283;77;5;82
76;11;11284;476;16;492
76;11;11285;1132;23;1155
76;11;11286;1166;20;1186
76;11;11287;87;2;89
76;11;11288;1577;155;1732
76;11;11289;967;17;984
76;11;11290;116;1;117
76;11;11291;108;4;112
76;11;11292;165;1;166
76;11;11293;899;23;922
76;11;11294;58;1;59
76;11;11295;1339;19;1358
76;11;11296;565;9;574
76;11;11297;142;1;143
76;11;11299;623;14;637
76;11;11300;154;0;154
76;11;11301;1184;17;1201
76;11;11302;265;9;274
76;11;11303;441;15;456
76;11;11304;3212;108;3320
76;11;11305;50;0;50
76;11;11306;52;2;54
76;11;11307;262;5;267
76;11;11308;451;9;460
76;11;11309;93;4;97
76;11;11310;201;1;202
76;11;11311;270;4;274
76;11;11312;111;5;116
76;11;11313;302;7;309
76;11;11314;85;7;92
76;11;11315;1949;26;1975
76;11;11316;210;3;213
76;11;11317;113;1;114
76;11;11318;136;6;142
76;11;11319;80;1;81
76;11;11320;294;4;298
76;11;11321;83;0;83
76;11;11322;990;18;1008
76;11;11323;275;2;277
76;11;11324;505;13;518
76;11;11325;452;11;463
76;11;11326;80;1;81
76;11;11327;472;13;485
76;11;11328;241;3;244
76;11;11330;506;12;518
76;11;11331;61;3;64
76;11;11332;1369;16;1385
76;11;11333;107;3;110
76;11;11334;117;2;119
76;11;11335;45;0;45
76;11;11336;436;7;443
76;11;11337;387;4;391
76;11;11338;41;1;42
76;11;11339;504;12;516
76;11;11340;525;10;535
76;11;11341;112;2;114
76;11;11342;242;4;246
76;11;11343;120;2;122
76;11;11344;713;16;729
76;11;11345;262;0;262
76;11;11346;127;3;130
76;11;11347;104;2;106
76;11;11348;88;1;89
76;11;11350;51;3;54
76;11;11351;724;26;750
76;11;11352;51;2;53
76;11;11353;2020;46;2066
76;11;11354;27;0;27
76;11;11355;361;8;369
76;11;11356;1121;20;1141
76;11;11357;217;7;224
76;11;11358;24;2;26
76;11;11359;475;6;481
76;11;11360;2069;35;2104
76;11;11361;883;20;903
76;11;11362;201;4;205
76;11;11363;182;5;187
76;11;11364;143;2;145
76;11;11365;41;2;43
76;11;11366;537;10;547
76;11;11367;922;23;945
76;11;11368;119;3;122
76;11;11369;3024;43;3067
76;11;11370;3254;76;3330
76;11;11371;707;13;720
76;11;11372;379;5;384
76;11;11373;72;1;73
76;11;11374;16;0;16
76;11;11375;30;1;31
76;11;11376;95;4;99
76;11;11377;76;0;76
76;11;11378;203;6;209
76;11;11379;5533;96;5629
76;11;11380;130;3;133
76;11;11381;122;7;129
76;11;11382;362;58;420
76;11;11383;324;10;334
76;11;11384;126;0;126
76;11;11385;236;7;243
76;11;11386;483;7;490
76;11;11387;111;1;112
76;11;11388;47;0;47
76;11;11389;16;0;16
76;11;11390;556;10;566
76;11;11391;24;2;26
76;11;11392;270;4;274
76;11;11393;487;7;494
76;11;11394;131;0;131
76;11;11395;30;0;30
76;11;11396;597;3;600
76;11;11397;5502;128;5630
76;11;11398;255;5;260
76;11;11399;106;5;111
76;11;11400;103;1;104
76;11;11401;793;11;804
76;11;11402;23;0;23
76;11;11404;956;33;989
76;11;11405;574;10;584
76;11;11406;33;2;35
76;11;11407;280;6;286
76;11;11408;504;8;512
76;11;11409;105;1;106
76;11;11410;986;17;1003
76;11;11411;135;1;136
76;11;11412;55;0;55
76;11;11413;503;11;514
76;11;11414;24;1;25
76;11;11415;124;0;124
76;11;11416;249;5;254
76;11;11417;98;0;98
76;11;11418;1211;39;1250
76;11;11419;63;0;63
76;11;11420;135;3;138
76;11;11421;534;8;542
76;11;11422;348;15;363
76;11;11423;159;4;163
76;11;11424;85;1;86
76;11;11425;1684;54;1738
76;11;11426;1177;23;1200
76;11;11427;302;8;310
76;11;11428;252;7;259
76;11;11429;4469;80;4549
76;11;11430;1359;42;1401
76;11;11431;248;7;255
76;11;11432;322;10;332
76;11;11433;976;17;993
76;11;11434;1276;25;1301
76;11;11435;154;6;160
76;11;11436;370;2;372
76;11;11437;911;17;928
76;11;11438;388;6;394
76;11;11439;400;8;408
76;11;11440;35;3;38
76;11;11441;2658;53;2711
76;12;12001;1069;32;1101
76;12;12002;869;29;898
76;12;12003;343;7;350
76;12;12004;445;20;465
76;12;12006;351;11;362
76;12;12007;176;8;184
76;12;12008;885;19;904
76;12;12009;36;1;37
76;12;12010;153;2;155
76;12;12011;775;28;803
76;12;12012;746;9;755
76;12;12013;3741;113;3854
76;12;12015;228;3;231
76;12;12016;824;26;850
76;12;12017;216;5;221
76;12;12018;181;7;188
76;12;12019;89;4;93
76;12;12021;1558;55;1613
76;12;12022;109;0;109
76;12;12023;106;1;107
76;12;12024;195;3;198
76;12;12025;972;12;984
76;12;12026;1054;20;1074
76;12;12027;202;10;212
76;12;12028;518;9;527
76;12;12029;201;4;205
76;12;12030;379;15;394
76;12;12031;356;5;361
76;12;12032;595;14;609
76;12;12033;2923;66;2989
76;12;12034;303;7;310
76;12;12035;172;8;180
76;12;12036;637;8;645
76;12;12037;608;16;624
76;12;12038;164;4;168
76;12;12039;264;5;269
76;12;12041;264;6;270
76;12;12042;208;11;219
76;12;12043;2166;76;2242
76;12;12044;1028;32;1060
76;12;12045;388;12;400
76;12;12046;573;16;589
76;12;12047;451;6;457
76;12;12048;345;9;354
76;12;12049;451;10;461
76;12;12050;442;12;454
76;12;12051;310;2;312
76;12;12052;4419;115;4534
76;12;12053;327;6;333
76;12;12054;351;8;359
76;12;12055;83;0;83
76;12;12056;3150;84;3234
76;12;12057;925;34;959
76;12;12058;106;5;111
76;12;12059;517;24;541
76;12;12060;114;4;118
76;12;12061;575;11;586
76;12;12062;343;3;346
76;12;12063;1939;29;1968
76;12;12064;268;6;274
76;12;12065;461;14;475
76;12;12066;1148;28;1176
76;12;12067;76;0;76
76;12;12068;878;26;904
76;12;12069;265;7;272
76;12;12070;522;26;548
76;12;12071;334;7;341
76;12;12072;232;7;239
76;12;12073;625;19;644
76;12;12074;295;14;309
76;12;12075;106;2;108
76;12;12076;1615;57;1672
76;12;12077;513;12;525
76;12;12078;185;2;187
76;12;12079;491;18;509
76;12;12080;373;9;382
76;12;12082;189;2;191
76;12;12083;1473;52;1525
76;12;12084;1569;57;1626
76;12;12085;315;0;315
76;12;12086;324;16;340
76;12;12088;228;4;232
76;12;12089;5323;206;5529
76;12;12090;3205;94;3299
76;12;12091;455;11;466
76;12;12092;523;10;533
76;12;12093;176;1;177
76;12;12094;985;17;1002
76;12;12095;240;6;246
76;12;12096;4601;149;4750
76;12;12097;248;3;251
76;12;12098;461;21;482
76;12;12099;241;4;245
76;12;12100;2372;67;2439
76;12;12101;1072;35;1107
76;12;12102;2359;51;2410
76;12;12103;282;8;290
76;12;12104;488;10;498
76;12;12105;1108;25;1133
76;12;12106;534;11;545
76;12;12107;318;5;323
76;12;12108;375;5;380
76;12;12109;99;2;101
76;12;12110;325;16;341
76;12;12111;495;18;513
76;12;12113;506;7;513
76;12;12115;290;3;293
76;12;12116;266;8;274
76;12;12118;522;13;535
76;12;12119;1234;28;1262
76;12;12120;2147;104;2251
76;12;12121;723;16;739
76;12;12122;124;8;132
76;12;12124;306;9;315
76;12;12125;278;4;282
76;12;12127;636;20;656
76;12;12128;220;6;226
76;12;12129;463;14;477
76;12;12130;1127;32;1159
76;12;12131;1512;47;1559
76;12;12133;6005;166;6171
76;12;12134;347;10;357
76;12;12135;441;14;455
76;12;12136;938;17;955
76;12;12137;838;11;849
76;12;12138;1729;50;1779
76;12;12139;139;1;140
76;12;12140;988;24;1012
76;12;12141;222;7;229
76;12;12142;637;15;652
76;12;12143;62;0;62
76;12;12144;125;2;127
76;12;12145;21979;680;22659
76;12;12146;2284;77;2361
76;12;12147;138;1;139
76;12;12148;1407;39;1446
76;12;12149;154;5;159
76;12;12150;502;89;591
76;12;12151;214;8;222
76;12;12152;127;2;129
76;12;12153;421;7;428
76;12;12154;619;26;645
76;12;12155;334;9;343
76;12;12156;532;13;545
76;12;12157;1693;49;1742
76;12;12158;327;8;335
76;12;12159;561;24;585
76;12;12160;317;5;322
76;12;12161;545;15;560
76;12;12162;1080;28;1108
76;12;12163;210;4;214
76;12;12164;701;14;715
76;12;12165;363;16;379
76;12;12166;115;1;116
76;12;12167;699;22;721
76;12;12168;998;18;1016
76;12;12169;2007;146;2153
76;12;12170;370;8;378
76;12;12171;584;19;603
76;12;12172;530;12;542
76;12;12174;3439;99;3538
76;12;12175;178;2;180
76;12;12176;11665;594;12259
76;12;12177;1017;15;1032
76;12;12178;373;9;382
76;12;12179;84;1;85
76;12;12180;73;2;75
76;12;12181;214;5;219
76;12;12182;279;5;284
76;12;12183;218;6;224
76;12;12184;120;6;126
76;12;12185;1639;68;1707
76;12;12186;211;2;213
76;12;12187;354;4;358
76;12;12188;316;10;326
76;12;12189;354;6;360
76;12;12190;295;9;304
76;12;12191;322;9;331
76;12;12192;185;4;189
76;12;12193;286;13;299
76;12;12194;848;21;869
76;12;12195;274;3;277
76;12;12197;1983;78;2061
76;12;12198;1949;72;2021
76;12;12199;1991;142;2133
76;12;12200;1039;27;1066
76;12;12201;1067;45;1112
76;12;12202;24475;1935;26410
76;12;12203;554;15;569
76;12;12204;178;4;182
76;12;12205;775;16;791
76;12;12206;637;15;652
76;12;12207;345;14;359
76;12;12208;8023;635;8658
76;12;12209;749;13;762
76;12;12210;454;5;459
76;12;12211;134;1;135
76;12;12212;88;7;95
76;12;12213;616;15;631
76;12;12214;521;13;534
76;12;12215;1160;48;1208
76;12;12216;1400;37;1437
76;12;12217;745;18;763
76;12;12219;376;9;385
76;12;12220;288;2;290
76;12;12221;339;10;349
76;12;12222;195;4;199
76;12;12223;1600;38;1638
76;12;12224;2211;40;2251
76;12;12225;1617;44;1661
76;12;12226;427;13;440
76;12;12227;182;5;187
76;12;12228;303;8;311
76;12;12229;254;7;261
76;12;12230;403;16;419
76;12;12231;715;8;723
76;12;12232;279;8;287
76;12;12233;293;3;296
76;12;12234;613;8;621
76;12;12235;206;7;213
76;12;12236;154;5;159
76;12;12237;645;81;726
76;12;12238;416;14;430
76;12;12239;315;13;328
76;12;12240;403;10;413
76;12;12241;1751;65;1816
76;12;12242;306;15;321
76;12;12243;948;13;961
76;12;12244;883;10;893
76;12;12246;538;15;553
76;12;12247;284;7;291
76;12;12248;611;104;715
76;12;12249;194;8;202
76;12;12250;205;2;207
76;12;12251;336;7;343
76;12;12252;418;9;427
76;12;12253;1013;30;1043
76;12;12254;2265;75;2340
76;12;12255;766;28;794
76;12;12256;371;10;381
76;12;12257;788;18;806
76;12;12258;982;15;997
76;12;12259;648;17;665
76;12;12260;171;2;173
76;12;12261;122;4;126
76;12;12262;711;14;725
76;12;12263;732;23;755
76;12;12264;3256;92;3348
76;12;12265;521;14;535
76;12;12266;548;5;553
76;12;12267;627;12;639
76;12;12268;421;18;439
76;12;12269;126;3;129
76;12;12270;4069;122;4191
76;12;12272;519;13;532
76;12;12273;291;8;299
76;12;12274;112;2;114
76;12;12275;36;1;37
76;12;12276;362;13;375
76;12;12277;530;4;534
76;12;12278;183;2;185
76;12;12280;407;6;413
76;12;12281;740;22;762
76;12;12282;425;8;433
76;12;12283;485;15;500
76;12;12284;345;1;346
76;12;12286;1206;31;1237
76;12;12287;636;22;658
76;12;12288;1593;38;1631
76;12;12289;206;8;214
76;12;12290;489;10;499
76;12;12291;403;9;412
76;12;12292;417;14;431
76;12;12293;137;1;138
76;12;12294;656;18;674
76;12;12295;98;2;100
76;12;12296;529;13;542
76;12;12297;510;19;529
76;12;12298;415;8;423
76;12;12299;692;26;718
76;12;12300;11602;551;12153
76;12;12301;1988;46;2034
76;12;12303;249;5;254
76;12;12305;1243;22;1265
76;12;12307;295;15;310
93;13;13001;145133;3203;148336
93;13;13002;21372;225;21597
93;13;13003;2626;54;2680
93;13;13004;50454;789;51243
93;13;13005;47535;451;47986
93;13;13006;1545;26;1571
93;13;13007;12922;162;13084
93;13;13008;563;16;579
93;13;13009;828;33;861
93;13;13010;4192;162;4354
93;13;13011;342;7;349
93;13;13012;593;55;648
93;13;13013;1916;35;1951
93;13;13014;13660;77;13737
93;13;13015;14838;305;15143
93;13;13016;6270;83;6353
93;13;13017;1509;18;1527
93;13;13018;4439;59;4498
93;13;13019;9918;324;10242
93;13;13020;2168;44;2212
93;13;13021;5690;127;5817
93;13;13022;6905;108;7013
93;13;13023;4729;109;4838
93;13;13024;2669;36;2705
93;13;13025;2380;76;2456
93;13;13026;17606;61;17667
93;13;13027;16063;252;16315
93;13;13028;35993;381;36374
93;13;13029;1437;23;1460
93;13;13030;5244;55;5299
93;13;13031;3768;44;3812
93;13;13032;8030;143;8173
93;13;13033;5783;99;5882
93;13;13034;1740;28;1768
93;13;13035;6844;161;7005
93;13;13036;4496;128;4624
93;13;13037;8744;104;8848
93;13;13038;3544;71;3615
93;13;13039;15687;183;15870
93;13;13040;10161;188;10349
93;13;13041;21521;338;21859
93;13;13042;6635;128;6763
93;13;13043;9887;90;9977
93;13;13044;5196;84;5280
93;13;13045;4856;73;4929
93;13;13046;4271;78;4349
93;13;13047;43626;657;44283
93;13;13048;4406;98;4504
93;13;13049;2037;41;2078
93;13;13050;9909;266;10175
93;13;13051;8941;120;9061
93;13;13052;2667;33;2700
93;13;13053;6134;156;6290
93;13;13054;32384;228;32612
93;13;13056;48574;516;49090
93;13;13057;517;11;528
93;13;13058;2362;50;2412
93;13;13059;3855;53;3908
93;13;13060;5821;91;5912
93;13;13061;215;5;220
93;13;13062;4213;74;4287
93;13;13063;26428;400;26828
93;13;13064;2656;29;2685
93;13;13065;3410;49;3459
93;13;13066;5847;68;5915
93;13;13067;2821;34;2855
93;13;13068;2110;36;2146
93;13;13069;10487;267;10754
93;13;13070;6519;61;6580
93;13;13071;21623;287;21910
93;13;13072;3540;94;3634
93;13;13073;5598;78;5676
93;13;13074;5134;89;5223
93;13;13075;11649;103;11752
93;13;13076;3515;49;3564
93;13;13077;16651;127;16778
93;13;13078;8424;80;8504
93;13;13079;1783;103;1886
93;13;13080;5882;90;5972
93;13;13081;12086;123;12209
93;13;13082;4637;126;4763
93;13;13083;4058;58;4116
93;13;13084;5426;120;5546
93;13;13085;6015;74;6089
93;13;13086;8713;124;8837
93;13;13087;4918;140;5058
93;13;13088;5145;48;5193
93;13;13089;3346;51;3397
93;13;13090;123;4;127
93;13;13091;5638;114;5752
93;13;13092;8591;129;8720
93;13;13093;379;8;387
93;13;13094;2497;45;2542
93;13;13095;1236;68;1304
93;13;13096;2144;21;2165
93;13;13097;13413;299;13712
93;13;13098;5820;110;5930
93;13;13099;885;13;898
93;13;13100;9769;223;9992
93;13;13101;3443;59;3502
93;13;13102;6631;52;6683
93;13;13103;45386;584;45970
93;13;13104;7581;144;7725
93;13;13105;6894;86;6980
93;13;13106;11196;95;11291
93;13;13107;5808;122;5930
93;13;13108;15811;142;15953
93;13;13109;2271;56;2327
93;13;13110;10303;150;10453
93;13;13111;1007;20;1027
93;13;13112;8582;151;8733
93;13;13113;8400;184;8584
93;13;13114;5407;137;5544
93;13;13115;2028;40;2068
93;13;13116;819;17;836
93;13;13117;33333;368;33701
93;13;13118;3702;52;3754
93;13;13119;6498;84;6582
93;13;13201;39893;200;40093
93;13;13202;25217;58;25275
93;13;13203;51792;194;51986
93;13;13204;49296;303;49599
93;13;13205;46152;279;46431
93;13;13206;42135;406;42541
93;13;13207;34697;313;35010
93;13;13208;81436;1254;82690
93;13;13209;76633;654;77287
93;13;13210;58491;340;58831
93;13;13211;57278;443;57721
93;13;13212;61406;552;61958
93;13;13213;91358;717;92075
93;13;13214;61702;252;61954
93;13;13215;77243;299;77542
93;13;13216;16002;100;16102
28;14;14001;1212;45;1257
28;14;14003;304;7;311
28;14;14005;1723;38;1761
28;14;14006;1046;21;1067
28;14;14007;231;4;235
28;14;14009;1356;19;1375
28;14;14011;1894;38;1932
28;14;14012;192;1;193
28;14;14014;1206;34;1240
28;14;14015;738;22;760
28;14;14016;484;14;498
28;14;14019;219;3;222
28;14;14020;3795;30;3825
28;14;14021;473;11;484
28;14;14022;584;8;592
28;14;14023;68;1;69
28;14;14024;591;12;603
28;14;14025;308;3;311
28;14;14026;1109;20;1129
28;14;14027;4595;67;4662
28;14;14030;1696;49;1745
28;14;14032;275;11;286
28;14;14033;216;2;218
28;14;14034;569;2;571
28;14;14035;1374;57;1431
28;14;14036;172;1;173
28;14;14037;565;13;578
28;14;14038;789;9;798
28;14;14039;824;18;842
28;14;14040;189;3;192
28;14;14041;124;2;126
28;14;14042;975;21;996
28;14;14043;70;0;70
28;14;14044;1073;18;1091
28;14;14045;252;2;254
28;14;14046;1923;14;1937
28;14;14047;12682;329;13011
28;14;14049;139;2;141
28;14;14050;181;2;183
28;14;14053;172;3;175
28;14;14054;200;3;203
28;14;14055;405;9;414
28;14;14057;1477;8;1485
28;14;14059;414;32;446
28;14;14060;2042;26;2068
28;14;14061;8950;157;9107
28;14;14062;447;7;454
28;14;14063;214;1;215
28;14;14064;224;7;231
28;14;14066;2274;35;2309
28;14;14068;3561;85;3646
28;14;14069;1338;27;1365
28;14;14070;194;2;196
28;14;14076;5855;73;5928
28;14;14077;719;55;774
28;14;14078;370;4;374
28;14;14079;1553;35;1588
28;14;14080;124;5;129
28;14;14082;189;9;198
28;14;14083;666;15;681
28;14;14084;403;9;412
28;14;14085;795;21;816
28;14;14086;325;13;338
28;14;14087;125;1;126
28;14;14088;406;7;413
28;14;14089;394;9;403
28;14;14090;736;6;742
28;14;14091;102;1;103
28;14;14092;2186;24;2210
28;14;14093;198;5;203
28;14;14096;226;6;232
28;14;14097;305;4;309
28;14;14098;6120;100;6220
28;14;14100;1913;24;1937
28;14;14101;4005;72;4077
28;14;14102;1012;23;1035
28;14;14103;408;7;415
28;14;14104;166;4;170
28;14;14106;660;6;666
28;14;14107;164;0;164
28;14;14110;125;2;127
28;14;14111;438;6;444
28;14;14116;109;5;114
28;14;14117;3558;31;3589
28;14;14118;106230;2174;108404
28;14;14119;1966;21;1987
28;14;14120;1396;23;1419
28;14;14121;252;1;253
28;14;14122;158;1;159
28;14;14123;2021;48;2069
28;14;14124;546;10;556
28;14;14125;1753;49;1802
28;14;14126;1334;36;1370
28;14;14127;548;4;552
28;14;14130;186;1;187
28;14;14131;228;4;232
28;14;14132;204;0;204
28;14;14134;186;5;191
28;14;14135;281;2;283
28;14;14136;101;0;101
28;14;14137;2886;25;2911
28;14;14138;292;6;298
28;14;14140;349;6;355
28;14;14141;163;2;165
28;14;14143;2372;25;2397
28;14;14145;525;4;529
28;14;14146;169;4;173
28;14;14147;140;1;141
28;14;14149;422;13;435
28;14;14150;1338;27;1365
28;14;14159;220;13;233
28;14;14160;188;6;194
28;14;14161;342;16;358
28;14;14162;1305;15;1320
28;14;14163;382;3;385
28;14;14165;174;4;178
28;14;14166;2555;44;2599
28;14;14167;6976;52;7028
28;14;14168;207;5;212
28;14;14169;159;0;159
28;14;14171;144;1;145
28;14;14172;432;10;442
28;14;14173;440;14;454
28;14;14174;6452;274;6726
28;14;14175;292;5;297
28;14;14177;848;17;865
28;14;14179;164;5;169
28;14;14180;156;3;159
28;14;14181;4957;45;5002
28;14;14182;404;6;410
28;14;14183;103;1;104
28;14;14184;229;0;229
28;14;14190;128;5;133
28;14;14191;4196;54;4250
28;14;14193;655;20;675
28;14;14194;648;10;658
28;14;14195;261;1;262
28;14;14196;208;6;214
28;14;14197;1116;27;1143
28;14;14198;255;9;264
28;14;14200;2261;79;2340
28;14;14202;267;6;273
28;14;14203;192;7;199
28;14;14204;179;2;181
28;14;14205;217;6;223
28;14;14206;298;0;298
28;14;14207;646;9;655
28;14;14209;512;10;522
28;14;14211;360;4;364
28;14;14214;190;2;192
28;14;14215;2259;34;2293
28;14;14216;238;3;241
28;14;14218;403;6;409
28;14;14220;3565;60;3625
28;14;14221;3117;45;3162
28;14;14223;87;2;89
28;14;14224;49;2;51
28;14;14225;5276;169;5445
28;14;14226;299;2;301
28;14;14227;210;6;216
28;14;14228;4973;204;5177
28;14;14229;2293;22;2315
28;14;14230;116;1;117
28;14;14231;446;12;458
28;14;14232;168;3;171
28;14;14236;585;7;592
28;14;14237;618;7;625
28;14;14238;109;2;111
28;14;14239;107;0;107
28;14;14240;511;12;523
28;14;14241;621;15;636
28;14;14242;1623;24;1647
28;14;14243;1587;6;1593
28;14;14244;312;11;323
28;14;14245;320;11;331
28;14;14246;807;6;813
28;14;14248;250;5;255
28;14;14249;1431;10;1441
28;14;14250;283;6;289
28;14;14251;539;6;545
28;14;14252;260;3;263
28;14;14254;1653;27;1680
28;14;14256;336;5;341
28;14;14257;2013;27;2040
28;14;14258;7968;250;8218
28;14;14260;245;7;252
28;14;14261;338;7;345
28;14;14266;1439;23;1462
28;14;14269;226;4;230
28;14;14270;398;16;414
28;14;14271;4938;69;5007
28;14;14272;96;2;98
28;14;14273;136;1;137
28;14;14274;2617;64;2681
28;14;14275;464;6;470
28;14;14276;355;4;359
28;14;14277;1941;13;1954
28;14;14278;1199;18;1217
28;14;14280;256;9;265
28;14;14281;735;14;749
28;14;14282;208;6;214
28;14;14283;224;7;231
28;14;14284;156;4;160
28;14;14285;71;2;73
28;14;14286;484;20;504
28;14;14287;1970;14;1984
28;14;14288;933;24;957
28;14;14289;584;13;597
28;14;14290;812;8;820
28;14;14291;289;4;293
28;14;14293;274;6;280
28;14;14297;584;7;591
28;14;14298;135;3;138
28;14;14299;835;18;853
28;14;14300;52;0;52
28;14;14301;4916;47;4963
28;14;14302;166;14;180
28;14;14303;919;20;939
28;14;14304;882;35;917
28;14;14305;678;13;691
28;14;14306;390;5;395
28;14;14308;268;0;268
28;14;14309;840;4;844
28;14;14310;706;7;713
28;14;14311;1045;9;1054
28;14;14312;1536;24;1560
28;14;14316;265;3;268
28;14;14318;728;7;735
28;14;14319;973;8;981
28;14;14320;283;7;290
28;14;14322;245;5;250
28;14;14325;3110;42;3152
28;14;14326;808;39;847
28;14;14327;22555;275;22830
28;14;14328;1345;9;1354
28;14;14329;109;4;113
28;14;14332;667;11;678
28;14;14333;6733;200;6933
28;14;14334;316;6;322
28;14;14335;300;3;303
28;14;14336;476;5;481
28;14;14337;329;10;339
28;14;14338;1711;37;1748
28;14;14341;11696;193;11889
28;14;14342;3610;43;3653
28;14;14343;66;0;66
28;14;14344;379;9;388
28;14;14345;301;2;303
28;14;14346;679;14;693
28;14;14347;1041;12;1053
28;14;14348;81;1;82
28;14;14349;2116;21;2137
28;14;14352;841;20;861
28;14;14353;451;5;456
28;14;14354;1934;48;1982
28;14;14355;1191;20;1211
28;14;14357;910;22;932
28;14;14358;89;2;91
28;14;14360;216;2;218
28;14;14362;160;0;160
28;14;14364;465;13;478
28;14;14365;2536;40;2576
28;14;14366;20038;654;20692
28;14;14367;437;5;442
28;14;14368;262;11;273
28;14;14369;288;3;291
28;14;14370;3016;39;3055
28;14;14371;6220;110;6330
28;14;14374;142;2;144
28;14;14375;166;3;169
28;14;14377;592;9;601
28;14;14378;274;9;283
28;14;14379;364;5;369
28;14;14380;186;5;191
28;14;14381;61;2;63
28;14;14383;2683;38;2721
28;14;14384;3213;52;3265
28;14;14385;164;9;173
28;14;14389;263;9;272
28;14;14390;189;4;193
28;14;14391;393;4;397
28;14;14393;366;7;373
28;14;14394;428;14;442
28;14;14396;1024;15;1039
28;14;14397;335;6;341
28;14;14398;547;16;563
28;14;14399;275;11;286
28;14;14400;217;3;220
28;14;14401;132;6;138
28;14;14402;109;2;111
28;14;14403;745;21;766
28;14;14404;120;2;122
28;14;14405;325;7;332
28;14;14406;1116;27;1143
28;14;14407;2286;56;2342
28;14;14408;2014;14;2028
28;14;14409;2186;35;2221
28;14;14410;1080;7;1087
28;14;14411;309;6;315
28;14;14412;83;2;85
28;14;14419;257;9;266
28;14;14421;607;6;613
28;14;14424;190;3;193
28;14;14425;164;6;170
28;14;14426;160;7;167
28;14;14427;294;3;297
28;14;14430;137;3;140
28;14;14431;9586;113;9699
28;14;14435;198;3;201
28;14;14436;558;5;563
28;14;14437;9973;244;10217
28;14;14438;545;10;555
28;14;14439;90;2;92
28;14;14445;95;2;97
28;14;14446;98;2;100
28;14;14448;64;0;64
28;14;14449;408;5;413
28;14;14452;626;10;636
28;14;14453;352;7;359
28;14;14454;1626;22;1648
28;14;14455;285;2;287
28;14;14456;3273;45;3318
28;14;14457;128;1;129
28;14;14458;533;58;591
28;14;14460;1353;31;1384
28;14;14461;470;2;472
28;14;14465;501;13;514
28;14;14466;342;9;351
28;14;14467;320;7;327
28;14;14468;363;6;369
28;14;14469;91;3;94
28;14;14473;112;3;115
28;14;14474;201;3;204
28;14;14475;2352;43;2395
28;14;14476;178;3;181
28;14;14478;1967;50;2017
28;14;14480;521;7;528
28;14;14482;238;2;240
28;14;14483;191;3;194
28;14;14484;245;4;249
28;14;14486;570;9;579
28;14;14487;774;23;797
28;14;14488;9344;118;9462
28;14;14491;196;11;207
28;14;14492;313;7;320
28;14;14494;129;7;136
28;14;14495;548;11;559
28;14;14496;57;4;61
28;14;14497;333;7;340
28;14;14498;240;4;244
28;14;14499;534;5;539
28;14;14500;159;6;165
28;14;14501;247;5;252
28;14;14502;89;1;90
28;14;14504;813;21;834
28;14;14506;246;3;249
28;14;14509;212;5;217
28;14;14510;55;3;58
28;14;14511;67;0;67
28;14;14512;73;0;73
28;14;14514;4627;70;4697
28;14;14515;1938;17;1955
28;14;14516;2079;19;2098
28;14;14519;126;0;126
28;14;14520;867;23;890
28;14;14522;391;7;398
28;14;14524;294;5;299
28;14;14527;538;8;546
28;14;14528;391;5;396
28;14;14529;262;3;265
28;14;14530;1909;27;1936
28;14;14531;48;0;48
28;14;14533;96;4;100
28;14;14534;391;6;397
28;14;14535;554;12;566
28;14;14536;2547;43;2590
28;14;14538;1650;31;1681
28;14;14540;289;14;303
28;14;14541;121;1;122
28;14;14542;535;11;546
28;14;14543;2448;71;2519
28;14;14546;222;2;224
28;14;14547;158;3;161
28;14;14550;94;1;95
28;14;14552;505;14;519
28;14;14554;1659;10;1669
28;14;14555;452;6;458
28;14;14556;1822;23;1845
28;14;14557;1132;12;1144
28;14;14558;1093;15;1108
28;14;14559;229;1;230
28;14;14562;2237;41;2278
28;14;14563;430;9;439
28;14;14565;259;4;263
28;14;14566;2525;52;2577
28;14;14569;236;6;242
28;14;14570;2507;44;2551
28;14;14571;305;5;310
28;14;14572;788;7;795
28;14;14574;1751;88;1839
28;14;14575;389;25;414
28;14;14576;524;13;537
28;14;14578;1352;30;1382
28;14;14579;1321;24;1345
28;14;14582;735;24;759
28;14;14586;164;6;170
28;14;14587;2298;42;2340
28;14;14588;330;3;333
28;14;14589;950;9;959
28;14;14590;133;1;134
28;14;14591;732;10;742
28;14;14592;1340;22;1362
28;14;14593;688;10;698
28;14;14595;237;5;242
28;14;14598;230;4;234
28;14;14601;168;5;173
28;14;14602;270;3;273
28;14;14603;508;8;516
28;14;14605;265;8;273
28;14;14606;211;2;213
28;14;14607;145;1;146
28;14;14609;545;9;554
28;14;14610;1955;115;2070
28;14;14613;94;1;95
28;14;14614;779;13;792
28;14;14619;124;2;126
28;14;14620;422;9;431
28;14;14621;436;7;443
28;14;14622;127;6;133
28;14;14623;2523;19;2542
28;14;14625;772;14;786
28;14;14626;930;21;951
28;14;14627;398;8;406
28;14;14630;705;18;723
28;14;14635;187;2;189
28;14;14637;204;3;207
28;14;14639;257;9;266
28;14;14640;237;1;238
28;14;14643;831;14;845
28;14;14644;654;14;668
28;14;14645;163;9;172
28;14;14646;439;9;448
28;14;14648;453;19;472
28;14;14649;475;10;485
28;14;14650;190;4;194
28;14;14651;261;2;263
28;14;14652;79;2;81
28;14;14654;7329;340;7669
28;14;14656;988;16;1004
28;14;14657;313;4;317
28;14;14658;4357;97;4454
28;14;14659;1428;24;1452
28;14;14660;94;3;97
28;14;14661;154;1;155
28;14;14663;2490;52;2542
28;14;14664;311;4;315
28;14;14665;294;4;298
28;14;14666;1906;27;1933
28;14;14667;222;4;226
28;14;14668;318;3;321
28;14;14669;207;2;209
28;14;14672;874;15;889
28;14;14674;128;3;131
28;14;14675;2036;25;2061
28;14;14676;993;23;1016
28;14;14677;254;6;260
28;14;14678;562;8;570
28;14;14679;666;21;687
28;14;14680;153;6;159
28;14;14681;151;4;155
28;14;14682;452;13;465
28;14;14684;253;3;256
28;14;14685;1726;33;1759
28;14;14687;192;3;195
28;14;14689;3629;48;3677
28;14;14692;1744;21;1765
28;14;14694;510;19;529
28;14;14698;391;1;392
28;14;14699;3731;67;3798
28;14;14700;664;9;673
28;14;14701;782;19;801
28;14;14705;152;1;153
28;14;14706;240;11;251
28;14;14707;1118;14;1132
28;14;14708;297;7;304
28;14;14709;346;7;353
28;14;14710;105;0;105
28;14;14711;917;10;927
28;14;14712;3459;91;3550
28;14;14713;577;11;588
28;14;14714;785;10;795
28;14;14715;4603;89;4692
28;14;14716;210;3;213
28;14;14719;700;7;707
28;14;14720;857;28;885
28;14;14721;648;9;657
28;14;14723;270;4;274
28;14;14724;997;12;1009
28;14;14726;5755;117;5872
28;14;14728;563;7;570
28;14;14731;188;13;201
28;14;14732;307;11;318
28;14;14733;312;9;321
28;14;14734;333;8;341
28;14;14735;800;11;811
28;14;14737;500;8;508
28;14;14738;3636;54;3690
28;14;14739;1645;36;1681
28;14;14740;1181;18;1199
28;14;14741;121;3;124
28;14;14742;72;0;72
28;14;14743;88;3;91
28;14;14744;299;4;303
28;14;14745;230;4;234
28;14;14747;678;8;686
28;14;14748;74;1;75
28;14;14751;295;9;304
28;14;14752;3160;37;3197
28;14;14753;740;22;762
28;14;14754;2543;58;2601
28;14;14755;593;13;606
28;14;14756;231;3;234
28;14;14758;777;25;802
28;14;14759;269;10;279
28;14;14760;742;6;748
28;14;14761;817;15;832
28;14;14762;16590;891;17481
28;14;14764;975;16;991
84;15;15001;799;9;808
84;15;15002;223;4;227
84;15;15003;599;12;611
84;15;15004;472;9;481
84;15;15005;350;16;366
84;15;15006;731;28;759
84;15;15007;121;7;128
84;15;15008;285;1;286
84;15;15009;186;6;192
84;15;15010;190;3;193
84;15;15011;182;3;185
84;15;15012;6279;192;6471
84;15;15013;147;0;147
84;15;15014;25593;1283;26876
84;15;15015;167;4;171
84;15;15016;629;14;643
84;15;15017;145;6;151
84;15;15018;132;1;133
84;15;15019;235;4;239
84;15;15020;97;4;101
84;15;15021;634;16;650
84;15;15022;163;6;169
84;15;15024;76;0;76
84;15;15025;240;7;247
84;15;15026;183;1;184
84;15;15027;745;14;759
84;15;15028;356;9;365
84;15;15029;507;16;523
84;15;15030;294;7;301
84;15;15032;60;3;63
84;15;15033;215;4;219
84;15;15034;145;6;151
84;15;15036;470;8;478
84;15;15037;1056;24;1080
84;15;15038;1030;25;1055
84;15;15040;98;7;105
84;15;15041;252;5;257
84;15;15042;254;4;258
84;15;15043;87;2;89
84;15;15045;841;11;852
84;15;15046;218;3;221
84;15;15048;31;1;32
84;15;15049;221;5;226
84;15;15050;170;2;172
84;15;15051;209;5;214
84;15;15052;156;12;168
84;15;15053;439;10;449
84;15;15054;989;24;1013
84;15;15055;442;12;454
84;15;15056;856;20;876
84;15;15057;189;4;193
84;15;15058;147;0;147
84;15;15059;121;7;128
84;15;15060;51;1;52
84;15;15061;272;4;276
84;15;15063;332;14;346
84;15;15064;83;1;84
84;15;15065;79;1;80
84;15;15066;117;2;119
84;15;15067;28;1;29
84;15;15069;248;2;250
84;15;15070;200;3;203
84;15;15072;222;6;228
84;15;15073;92;2;94
84;15;15074;763;21;784
84;15;15075;74;4;78
84;15;15076;171;4;175
84;15;15077;61;0;61
84;15;15078;155;2;157
84;15;15079;372;9;381
84;15;15080;147;4;151
84;15;15081;98;2;100
84;15;15082;297;11;308
84;15;15083;2022;67;2089
84;15;15084;291;9;300
84;15;15085;496;12;508
84;15;15086;58;2;60
84;15;15087;360;10;370
84;15;15088;512;15;527
84;15;15089;449;8;457
84;15;15090;591;15;606
84;15;15091;90;5;95
84;15;15092;1405;41;1446
84;15;15093;99;3;102
84;15;15094;829;16;845
84;15;15095;355;3;358
84;15;15096;286;7;293
84;15;15097;111;5;116
84;15;15098;93;0;93
84;15;15100;131;2;133
84;15;15101;517;14;531
84;15;15102;107;0;107
84;15;15103;237;6;243
84;15;15104;345;9;354
84;15;15105;35;3;38
84;15;15106;156;2;158
84;15;15107;171;4;175
84;15;15108;990;23;1013
84;15;15110;130;6;136
84;15;15111;208;7;215
84;15;15112;92;4;96
84;15;15113;183;4;187
84;15;15114;517;7;524
84;15;15116;154;11;165
84;15;15117;593;68;661
84;15;15118;726;31;757
84;15;15119;1797;66;1863
84;15;15120;3498;218;3716
84;15;15121;108;1;109
84;15;15122;2111;60;2171
84;15;15123;164;2;166
84;15;15124;532;23;555
84;15;15125;128;3;131
84;15;15126;81;2;83
84;15;15127;281;3;284
84;15;15128;120;3;123
84;15;15129;174;6;180
84;15;15130;140;4;144
84;15;15131;286;12;298
84;15;15132;45;0;45
84;15;15133;135;1;136
84;15;15134;815;12;827
84;15;15135;115;6;121
84;15;15137;267;7;274
84;15;15138;1845;99;1944
84;15;15139;68;0;68
84;15;15140;2113;58;2171
84;15;15141;1804;30;1834
84;15;15142;1735;40;1775
84;15;15143;102;1;103
84;15;15144;330;10;340
84;15;15146;126;5;131
84;15;15147;450;9;459
84;15;15148;432;11;443
84;15;15149;257;3;260
84;15;15151;151;0;151
84;15;15152;898;18;916
84;15;15153;1463;36;1499
84;15;15154;1188;24;1212
84;15;15155;87;2;89
84;15;15156;685;15;700
84;15;15157;351;43;394
84;15;15158;103;2;105
84;15;15159;269;8;277
84;15;15160;1094;22;1116
84;15;15161;108;2;110
84;15;15162;2479;62;2541
84;15;15163;1098;31;1129
84;15;15164;627;18;645
84;15;15165;203;3;206
84;15;15166;314;10;324
84;15;15167;117;8;125
84;15;15168;712;25;737
84;15;15169;820;16;836
84;15;15170;231;4;235
84;15;15172;93;1;94
84;15;15173;115;5;120
84;15;15174;271;6;277
84;15;15175;1070;27;1097
84;15;15176;242;9;251
84;15;15178;142;7;149
84;15;15179;249;4;253
84;15;15180;75;3;78
84;15;15181;577;11;588
84;15;15182;133;3;136
84;15;15183;135;0;135
84;15;15184;785;19;804
84;15;15185;243;11;254
84;15;15186;229;3;232
84;15;15187;6458;542;7000
84;15;15188;1198;31;1229
84;15;15189;222;7;229
84;15;15190;104;3;107
84;15;15191;644;9;653
84;15;15192;293;4;297
84;15;15194;105;6;111
84;15;15196;1548;53;1601
84;15;15198;108;1;109
84;15;15199;75;0;75
84;15;15200;146;3;149
84;15;15201;226;3;229
84;15;15202;717;17;734
84;15;15203;174;3;177
84;15;15204;1539;42;1581
84;15;15205;105;5;110
84;15;15206;142;2;144
84;15;15207;362;12;374
84;15;15208;135;4;139
84;15;15209;124;5;129
84;15;15211;298;5;303
84;15;15212;359;15;374
84;15;15213;203;4;207
84;15;15214;178;5;183
84;15;15215;1121;37;1158
84;15;15216;402;14;416
84;15;15217;106;3;109
84;15;15218;68;2;70
84;15;15219;325;5;330
84;15;15220;145;2;147
84;15;15221;1368;34;1402
84;15;15222;217;10;227
84;15;15223;214;6;220
84;15;15224;132;13;145
84;15;15225;212;4;216
84;15;15226;204;4;208
84;15;15228;462;10;472
84;15;15229;81;2;83
84;15;15230;197;9;206
84;15;15231;596;20;616
84;15;15232;228;7;235
84;15;15233;301;5;306
84;15;15234;330;6;336
84;15;15235;573;23;596
84;15;15236;602;14;616
84;15;15237;172;6;178
84;15;15238;128;3;131
84;15;15240;173;7;180
84;15;15241;48;3;51
84;15;15242;101;3;104
84;15;15243;503;9;512
84;15;15244;473;10;483
84;15;15245;252;4;256
84;15;15246;235;2;237
84;15;15247;23;0;23
84;15;15248;564;12;576
84;15;15249;64;2;66
84;15;15250;509;18;527
84;15;15251;141;6;147
84;15;15252;413;18;431
84;15;15253;65;1;66
84;15;15254;119;2;121
84;15;15255;1249;35;1284
84;15;15256;52;5;57
84;15;15257;125;4;129
84;15;15258;1838;36;1874
84;15;15259;244;3;247
84;15;15260;108;4;112
84;15;15261;825;21;846
84;15;15262;562;11;573
84;15;15263;124;5;129
84;15;15264;269;6;275
84;15;15265;1644;28;1672
84;15;15266;551;10;561
84;15;15267;4335;106;4441
84;15;15268;1233;26;1259
84;15;15269;130;3;133
75;16;16001;503;1;504
75;16;16002;523;8;531
75;16;16003;857;10;867
75;16;16005;1579;39;1618
75;16;16007;463;11;474
75;16;16008;310;2;312
75;16;16009;380;6;386
75;16;16010;167;4;171
75;16;16011;568;21;589
75;16;16012;503;9;512
75;16;16013;319;8;327
75;16;16014;128;0;128
75;16;16015;41603;1687;43290
75;16;16016;827;23;850
75;16;16018;709;18;727
75;16;16019;1248;23;1271
75;16;16020;347;4;351
75;16;16023;590;11;601
75;16;16024;515;9;524
75;16;16025;1237;31;1268
75;16;16026;1359;27;1386
75;16;16027;126;3;129
75;16;16028;4714;177;4891
75;16;16029;226;5;231
75;16;16030;1052;22;1074
75;16;16031;410;11;421
75;16;16032;517;7;524
75;16;16034;144;2;146
75;16;16035;199;5;204
75;16;16036;291;9;300
75;16;16037;141;5;146
75;16;16038;310;8;318
75;16;16039;474;12;486
75;16;16040;305;6;311
75;16;16041;111;1;112
75;16;16042;110;7;117
75;16;16044;215;7;222
75;16;16045;366;6;372
75;16;16046;1003;12;1015
75;16;16047;295;6;301
75;16;16048;129;0;129
75;16;16049;375;8;383
75;16;16050;251;8;259
75;16;16052;246;3;249
75;16;16053;119;1;120
75;16;16054;175;1;176
75;16;16055;892;11;903
75;16;16056;891;18;909
75;16;16057;320;6;326
75;16;16058;1410;51;1461
75;16;16059;176;5;181
75;16;16060;454;12;466
75;16;16061;4233;82;4315
75;16;16062;137;1;138
75;16;16063;159;0;159
75;16;16064;1115;17;1132
75;16;16065;621;6;627
75;16;16066;464;8;472
75;16;16067;465;10;475
75;16;16068;565;6;571
75;16;16069;388;3;391
75;16;16070;1568;32;1600
75;16;16071;591;16;607
75;16;16072;511;10;521
75;16;16073;1776;31;1807
75;16;16074;333;8;341
75;16;16075;244;3;247
75;16;16076;878;9;887
75;16;16077;491;9;500
75;16;16078;5149;118;5267
75;16;16079;347;3;350
75;16;16081;215;5;220
75;16;16082;673;12;685
75;16;16083;340;6;346
75;16;16084;334;3;337
75;16;16085;3083;272;3355
75;16;16086;864;17;881
75;16;16087;142;2;144
75;16;16088;1105;38;1143
75;16;16089;3746;66;3812
75;16;16090;3537;64;3601
75;16;16091;172;2;174
75;16;16093;1587;26;1613
75;16;16095;130;4;134
75;16;16096;418;3;421
75;16;16097;2299;100;2399
75;16;16098;141;2;143
75;16;16099;221;1;222
75;16;16100;767;14;781
75;16;16101;1052;18;1070
75;16;16102;18670;434;19104
75;16;16103;123;5;128
75;16;16104;470;9;479
75;16;16105;620;5;625
75;16;16106;2712;154;2866
75;16;16107;534;6;540
75;16;16108;131;1;132
75;16;16109;763;8;771
75;16;16110;777;21;798
75;16;16111;178;3;181
75;16;16112;57;2;59
75;16;16113;7764;260;8024
75;16;16114;165;3;168
75;16;16116;390;9;399
75;16;16117;120;3;123
75;16;16118;138;0;138
75;16;16119;1355;15;1370
75;16;16120;1520;21;1541
75;16;16121;440;13;453
75;16;16122;140;4;144
75;16;16123;488;10;498
75;16;16124;569;10;579
75;16;16125;263;3;266
75;16;16127;95;3;98
75;16;16128;174;6;180
75;16;16130;186;7;193
75;16;16131;497;7;504
75;16;16132;990;9;999
75;16;16133;198;3;201
75;16;16134;1014;27;1041
75;16;16135;314;4;318
75;16;16136;572;12;584
75;16;16137;312;6;318
75;16;16138;3818;105;3923
75;16;16139;239;2;241
75;16;16140;438;15;453
75;16;16141;321;12;333
75;16;16142;200;4;204
75;16;16143;704;13;717
75;16;16144;421;6;427
75;16;16145;639;19;658
75;16;16146;2108;35;2143
75;16;16147;264;6;270
75;16;16148;1011;14;1025
75;16;16150;1594;43;1637
75;16;16151;886;21;907
75;16;16152;719;20;739
75;16;16153;1168;22;1190
75;16;16154;6119;115;6234
75;16;16155;110;1;111
75;16;16157;162;3;165
75;16;16158;308;5;313
75;16;16160;482;7;489
75;16;16161;165;3;168
75;16;16162;182;0;182
75;16;16163;1145;21;1166
75;16;16164;243;2;245
75;16;16165;367;4;371
75;16;16166;5626;153;5779
75;16;16167;4434;134;4568
75;16;16168;813;8;821
75;16;16169;563;8;571
75;16;16170;399;2;401
75;16;16171;651;13;664
75;16;16173;180;4;184
75;16;16174;511;11;522
75;16;16175;1390;34;1424
75;16;16176;305;7;312
75;16;16177;118;2;120
75;16;16178;186;5;191
75;16;16180;247;6;253
75;16;16181;523;11;534
75;16;16182;453;13;466
75;16;16183;178;4;182
75;16;16184;87;1;88
75;16;16185;157;2;159
75;16;16186;552;17;569
75;16;16187;2092;47;2139
75;16;16188;341;4;345
75;16;16189;254;6;260
75;16;16190;186;6;192
75;16;16191;181;1;182
75;16;16192;3900;107;4007
75;16;16193;991;17;1008
75;16;16194;104;1;105
75;16;16195;294;8;302
75;16;16196;723;9;732
75;16;16197;110;7;117
75;16;16198;445;5;450
75;16;16199;3223;69;3292
75;16;16200;482;4;486
75;16;16203;115;0;115
75;16;16204;1298;35;1333
75;16;16205;540;5;545
75;16;16206;1692;17;1709
75;16;16207;492;9;501
75;16;16208;398;4;402
75;16;16209;824;9;833
75;16;16210;817;10;827
75;16;16211;561;7;568
75;16;16212;391;6;397
75;16;16213;295;5;300
75;16;16215;155;5;160
75;16;16216;843;14;857
75;16;16217;1101;24;1125
75;16;16218;409;12;421
75;16;16220;716;15;731
75;16;16221;238;4;242
75;16;16222;328;7;335
75;16;16223;2009;28;2037
75;16;16224;714;18;732
75;16;16225;650;31;681
75;16;16226;717;9;726
75;16;16227;139;0;139
75;16;16229;242;4;246
75;16;16230;2564;100;2664
75;16;16231;321;2;323
75;16;16232;2151;50;2201
75;16;16233;1004;17;1021
75;16;16234;731;8;739
75;16;16236;2397;73;2470
75;16;16237;223;0;223
75;16;16238;117;0;117
75;16;16239;134;2;136
75;16;16240;99;0;99
75;16;16241;207;4;211
75;16;16242;1382;17;1399
75;16;16243;1047;21;1068
75;16;16244;2348;54;2402
75;16;16245;932;23;955
75;16;16246;266;8;274
75;16;16248;152;1;153
75;16;16249;403;3;406
75;16;16250;220;2;222
75;16;16251;253;6;259
75;16;16252;152;3;155
75;16;16253;362;3;365
75;16;16254;221;8;229
75;16;16255;141;5;146
75;16;16256;240;11;251
75;16;16258;483;9;492
75;16;16260;271;7;278
75;16;16261;467;17;484
75;16;16263;400;5;405
75;16;16264;323;6;329
75;16;16267;89;1;90
75;16;16268;209;2;211
75;16;16269;898;10;908
75;16;16270;344;5;349
75;16;16271;2369;146;2515
75;16;16272;543;9;552
75;16;16273;124;6;130
75;16;16275;175;2;177
75;16;16276;761;17;778
75;16;16277;595;11;606
75;16;16279;225;3;228
75;16;16280;1996;31;2027
75;16;16281;3977;159;4136
75;16;16282;534;11;545
75;16;16283;570;7;577
75;16;16284;120;1;121
75;16;16285;406;5;411
75;16;16286;2964;49;3013
75;16;16287;4277;69;4346
75;16;16289;294;2;296
75;16;16290;242;4;246
75;16;16291;7305;200;7505
75;16;16292;3372;150;3522
75;16;16293;492;7;499
75;16;16295;1333;24;1357
75;16;16297;329;12;341
75;16;16298;373;5;378
75;16;16300;1308;16;1324
75;16;16301;229;3;232
75;16;16302;216;2;218
75;16;16303;406;12;418
75;16;16304;963;35;998
75;16;16306;317;8;325
75;16;16307;333;14;347
75;16;16308;1053;24;1077
75;16;16310;216;2;218
75;16;16312;823;13;836
75;16;16315;107;1;108
75;16;16316;385;6;391
75;16;16317;439;5;444
75;16;16318;366;2;368
75;16;16320;896;17;913
75;16;16321;46;0;46
75;16;16323;471;11;482
75;16;16325;132;3;135
75;16;16326;135;0;135
75;16;16329;782;15;797
75;16;16330;826;28;854
75;16;16331;89;3;92
75;16;16334;126;3;129
75;16;16335;124;3;127
75;16;16336;343;3;346
75;16;16337;895;30;925
75;16;16338;319;5;324
75;16;16339;802;19;821
75;16;16340;1032;28;1060
75;16;16341;3218;39;3257
75;16;16342;299;7;306
75;16;16343;296;9;305
75;16;16345;218;2;220
75;16;16346;248;8;256
75;16;16347;508;12;520
75;16;16348;1296;32;1328
75;16;16349;513;11;524
75;16;16350;796;10;806
75;16;16352;216;8;224
75;16;16353;787;16;803
75;16;16354;121;3;124
75;16;16355;1192;16;1208
75;16;16356;31;0;31
75;16;16357;136;2;138
75;16;16358;7381;246;7627
75;16;16359;1011;27;1038
75;16;16360;403;85;488
75;16;16361;313;6;319
75;16;16362;326;12;338
75;16;16363;524;10;534
75;16;16364;64;2;66
75;16;16365;106;0;106
75;16;16366;2074;77;2151
75;16;16368;888;21;909
75;16;16369;982;20;1002
75;16;16370;1160;41;1201
75;16;16372;127;2;129
75;16;16373;196;6;202
75;16;16374;9761;312;10073
75;16;16375;386;6;392
75;16;16377;116;0;116
75;16;16378;573;15;588
75;16;16379;1486;27;1513
75;16;16380;410;3;413
75;16;16381;164;2;166
75;16;16382;721;31;752
75;16;16383;758;10;768
75;16;16384;581;7;588
75;16;16385;1165;26;1191
75;16;16387;466;63;529
75;16;16388;940;22;962
75;16;16389;87;2;89
75;16;16390;222;7;229
75;16;16392;189;6;195
75;16;16393;2168;33;2201
75;16;16394;83;2;85
75;16;16395;297;4;301
75;16;16396;124;0;124
75;16;16397;374;7;381
75;16;16398;99;5;104
75;16;16399;346;9;355
75;16;16400;620;11;631
75;16;16401;146;2;148
75;16;16402;283;5;288
75;16;16403;127;3;130
75;16;16404;109;2;111
75;16;16405;165;9;174
75;16;16406;770;15;785
75;16;16408;717;19;736
75;16;16409;982;11;993
75;16;16412;338;1;339
75;16;16413;136;2;138
75;16;16414;312;4;316
75;16;16415;1099;20;1119
75;16;16416;506;8;514
75;16;16418;1547;28;1575
75;16;16419;328;2;330
75;16;16420;242;4;246
75;16;16421;411;6;417
75;16;16422;811;8;819
75;16;16423;254;4;258
75;16;16424;525;8;533
75;16;16425;557;11;568
75;17;17002;133;4;137
75;17;17003;4143;74;4217
75;17;17004;207;5;212
75;17;17005;196;1;197
75;17;17006;252;4;256
75;17;17007;313;7;320
75;17;17008;2272;33;2305
75;17;17009;1147;9;1156
75;17;17010;4050;101;4151
75;17;17011;394;4;398
75;17;17012;155;5;160
75;17;17013;340;8;348
75;17;17015;760;9;769
75;17;17016;782;12;794
75;17;17017;670;13;683
75;17;17018;855;13;868
75;17;17019;1302;24;1326
75;17;17020;349;4;353
75;17;17021;3566;84;3650
75;17;17022;1006;23;1029
75;17;17023;373;7;380
75;17;17024;1333;25;1358
75;17;17025;704;29;733
75;17;17026;385;5;390
75;17;17027;471;7;478
75;17;17028;9247;167;9414
75;17;17029;209;1;210
75;17;17030;545;5;550
75;17;17031;195;2;197
75;17;17032;804;17;821
75;17;17033;496;5;501
75;17;17034;463;7;470
75;17;17035;112;2;114
75;17;17036;780;14;794
75;17;17037;650;9;659
75;17;17038;692;6;698
75;17;17039;211;1;212
75;17;17041;1679;16;1695
75;17;17042;443;9;452
75;17;17043;746;13;759
75;17;17044;1149;22;1171
75;17;17045;1030;18;1048
75;17;17046;387;8;395
75;17;17047;237;1;238
75;17;17048;321;4;325
75;17;17049;79;5;84
75;17;17050;517;144;661
75;17;17051;2272;30;2302
75;17;17052;693;9;702
75;17;17053;1322;27;1349
75;17;17054;204;9;213
75;17;17055;361;4;365
75;17;17056;600;14;614
75;17;17057;916;16;932
75;17;17058;3506;126;3632
75;17;17059;1375;25;1400
75;17;17060;228;5;233
75;17;17061;137;2;139
75;17;17062;216;3;219
75;17;17063;453;7;460
75;17;17064;3010;63;3073
75;17;17065;1777;53;1830
75;17;17066;235;2;237
75;17;17067;173;4;177
75;17;17068;243;3;246
75;17;17069;232;6;238
75;17;17070;934;14;948
75;17;17071;511;9;520
75;17;17072;1303;26;1329
75;17;17073;1277;44;1321
75;17;17074;1053;15;1068
75;17;17075;1386;23;1409
75;17;17076;321;3;324
75;17;17077;1235;20;1255
75;17;17078;511;7;518
75;17;17079;1610;33;1643
75;17;17080;961;12;973
75;17;17081;372;7;379
75;17;17082;527;8;535
75;17;17083;619;12;631
75;17;17084;678;8;686
75;17;17085;408;6;414
75;17;17086;3587;83;3670
75;17;17087;205;2;207
75;17;17089;1004;26;1030
75;17;17091;2001;27;2028
75;17;17092;160;4;164
75;17;17093;4270;79;4349
75;17;17094;5900;93;5993
75;17;17095;215;6;221
75;17;17096;77;2;79
75;17;17097;778;15;793
75;17;17098;598;13;611
75;17;17099;635;10;645
75;17;17100;1118;17;1135
75;17;17101;331;1;332
75;17;17102;1263;35;1298
75;17;17104;1090;108;1198
75;17;17105;316;1;317
75;17;17106;313;5;318
75;17;17107;1455;24;1479
75;17;17108;407;15;422
75;17;17109;1438;20;1458
75;17;17110;977;15;992
75;17;17111;820;12;832
75;17;17112;713;16;729
75;17;17113;717;7;724
75;17;17114;212;2;214
75;17;17115;309;7;316
75;17;17116;225;5;230
75;17;17117;140;0;140
75;17;17118;348;10;358
75;17;17119;1127;20;1147
75;17;17120;1878;39;1917
75;17;17121;1137;19;1156
75;17;17122;234;4;238
75;17;17124;426;5;431
75;17;17125;462;10;472
75;17;17126;299;6;305
75;17;17127;1776;30;1806
75;17;17128;694;12;706
75;17;17129;419;6;425
75;17;17130;473;13;486
75;17;17131;2150;43;2193
75;17;17132;650;18;668
75;17;17133;896;75;971
75;17;17134;432;9;441
75;17;17135;229;2;231
75;17;17136;1284;28;1312
75;17;17137;223;3;226
75;17;17138;282;3;285
75;17;17139;336;7;343
75;17;17140;3144;62;3206
75;17;17141;470;9;479
75;17;17142;5638;143;5781
75;17;17143;703;13;716
75;17;17145;485;8;493
75;17;17146;3547;70;3617
75;17;17147;1376;22;1398
75;17;17148;459;10;469
75;17;17149;59;2;61
75;17;17150;521;7;528
75;17;17151;876;23;899
75;17;17152;874;8;882
75;17;17153;2076;32;2108
75;17;17154;712;8;720
75;17;17155;2618;43;2661
75;17;17156;129;3;132
75;17;17157;163;2;165
75;17;17158;1066;8;1074
75;17;17159;365;7;372
75;17;17160;413;13;426
75;17;17161;2785;40;2825
75;17;17162;198;1;199
75;17;17163;514;10;524
75;17;17164;2326;54;2380
75;17;17165;392;13;405
75;17;17166;1316;14;1330
75;17;17167;771;11;782
75;17;17168;3934;75;4009
75;17;17171;767;18;785
75;17;17172;2906;30;2936
75;17;17173;234;6;240
75;17;17174;909;9;918
75;17;17175;645;7;652
75;17;17176;107;4;111
75;17;17177;118;0;118
75;17;17178;70;1;71
75;17;17179;1772;85;1857
75;17;17180;89;3;92
75;17;17181;310;6;316
75;17;17182;553;11;564
75;17;17183;938;13;951
75;17;17184;587;12;599
75;17;17185;2100;32;2132
75;17;17186;963;11;974
75;17;17187;513;17;530
75;17;17188;455;9;464
75;17;17190;2865;56;2921
75;17;17191;427;9;436
75;17;17192;835;18;853
75;17;17193;2541;54;2595
75;17;17194;3336;75;3411
75;17;17195;274;5;279
75;17;17196;545;6;551
75;17;17197;3519;223;3742
75;17;17198;301;0;301
75;17;17199;158;2;160
75;17;17200;7098;155;7253
75;17;17201;480;6;486
75;17;17202;587;13;600
75;17;17203;729;9;738
75;17;17204;306;8;314
75;17;17205;395;9;404
75;17;17206;283;3;286
75;17;17207;734;17;751
75;17;17208;1051;15;1066
75;17;17209;269;4;273
75;17;17210;505;4;509
75;17;17211;751;9;760
75;17;17212;165;2;167
75;17;17213;134;4;138
75;17;17214;536;12;548
75;17;17215;47;0;47
75;17;17216;1012;14;1026
75;17;17217;291;7;298
75;17;17218;4505;64;4569
75;17;17219;6234;103;6337
75;17;17220;415;17;432
75;17;17221;930;21;951
75;17;17222;3130;93;3223
75;17;17223;181;2;183
75;17;17224;2160;80;2240
75;17;17225;2110;32;2142
75;17;17226;973;14;987
75;17;17227;221;3;224
75;17;17228;2992;72;3064
75;17;17229;219;3;222
75;17;17230;3123;72;3195
75;17;17231;106;5;111
75;17;17232;1530;21;1551
75;17;17233;325;1;326
75;17;17234;344;5;349
75;17;17235;721;14;735
75;17;17236;1500;29;1529
75;17;17237;585;4;589
75;17;17239;442;8;450
75;17;17240;3226;51;3277
75;17;17241;1565;19;1584
75;17;17242;869;13;882
75;17;17243;1229;10;1239
75;17;17244;690;8;698
75;17;17245;911;13;924
75;17;17246;517;7;524
75;17;17247;855;12;867
75;17;17248;916;20;936
75;17;17249;175;1;176
75;17;17250;476;5;481
75;17;17252;304;7;311
75;17;17253;1349;16;1365
75;17;17254;187;4;191
75;17;17255;798;12;810
75;17;17256;324;12;336
75;17;17257;683;6;689
75;17;17258;302;5;307
75;17;17259;153;2;155
75;17;17260;466;5;471
75;17;17261;312;6;318
75;17;17262;1262;22;1284
75;17;17263;585;11;596
75;17;17264;5859;148;6007
75;17;17265;1208;20;1228
75;17;17266;719;7;726
75;17;17267;1165;15;1180
75;17;17268;191;7;198
75;17;17269;687;7;694
75;17;17270;619;14;633
75;17;17271;322;6;328
75;17;17273;1017;13;1030
75;17;17274;8684;188;8872
75;17;17275;774;26;800
75;17;17276;75;1;76
75;17;17277;1092;86;1178
75;17;17278;761;9;770
75;17;17279;626;13;639
75;17;17280;731;16;747
75;17;17281;159;3;162
75;17;17282;213;2;215
75;17;17283;4203;249;4452
75;17;17284;1776;290;2066
75;17;17285;1147;27;1174
75;17;17286;594;10;604
75;17;17287;249;0;249
75;17;17288;315;6;321
75;17;17289;445;17;462
75;17;17290;294;9;303
75;17;17291;6556;124;6680
75;17;17292;512;5;517
75;17;17293;695;11;706
75;17;17294;201;0;201
75;17;17295;794;16;810
75;17;17296;1059;19;1078
75;17;17297;2305;43;2348
75;17;17298;986;18;1004
75;17;17299;23584;682;24266
75;17;17300;77205;2128;79333
75;17;17301;70;1;71
75;17;17302;593;9;602
75;17;17303;1031;17;1048
75;17;17304;478;5;483
75;17;17305;414;9;423
75;17;17306;18419;527;18946
75;17;17307;1391;32;1423
75;17;17308;2700;61;2761
75;17;17309;1895;39;1934
75;17;17310;1119;14;1133
75;17;17311;1381;24;1405
75;17;17312;826;14;840
75;17;17313;381;9;390
75;17;17314;894;16;910
75;17;17315;1362;28;1390
75;17;17316;397;11;408
75;17;17317;559;5;564
75;17;17318;682;11;693
75;17;17319;107;1;108
75;17;17320;413;6;419
75;17;17321;361;3;364
75;17;17322;678;4;682
75;17;17323;1283;22;1305
75;17;17324;111;0;111
75;17;17325;538;3;541
75;17;17326;286;5;291
75;17;17327;311;3;314
75;17;17328;902;11;913
75;17;17329;357;2;359
75;17;17330;1340;15;1355
75;17;17331;1250;50;1300
75;17;17332;390;6;396
75;17;17333;5342;116;5458
75;17;17334;223;4;227
75;17;17335;288;3;291
75;17;17336;2741;58;2799
75;17;17337;3742;54;3796
75;17;17338;1765;33;1798
75;17;17339;1278;123;1401
75;17;17340;1536;84;1620
75;17;17341;181;2;183
75;17;17342;421;9;430
75;17;17343;146;3;149
75;17;17344;1319;15;1334
75;17;17345;309;15;324
75;17;17346;1455;26;1481
75;17;17347;6796;434;7230
75;17;17348;691;7;698
75;17;17349;2975;43;3018
75;17;17350;873;16;889
75;17;17351;2026;33;2059
75;17;17353;2214;60;2274
75;17;17354;645;12;657
75;17;17355;503;11;514
75;17;17356;306;4;310
75;17;17357;534;8;542
75;17;17358;311;6;317
75;17;17359;1206;20;1226
75;17;17360;3363;106;3469
75;17;17361;113;5;118
75;17;17362;297;7;304
75;17;17363;545;14;559
75;17;17364;437;14;451
75;17;17365;467;9;476
75;17;17366;487;4;491
75;17;17367;157;4;161
75;17;17369;2215;20;2235
75;17;17372;78;1;79
75;17;17373;2302;43;2345
75;17;17374;243;2;245
75;17;17375;1201;25;1226
75;17;17376;1897;32;1929
75;17;17377;125;6;131
75;17;17378;434;6;440
75;17;17379;207;3;210
75;17;17380;3907;85;3992
75;17;17381;228;3;231
75;17;17382;535;6;541
75;17;17383;348;4;352
75;17;17384;259;4;263
75;17;17385;6634;98;6732
75;17;17386;353;9;362
75;17;17387;1896;30;1926
75;17;17388;256;7;263
75;17;17389;579;9;588
75;17;17390;116;1;117
75;17;17391;2352;49;2401
75;17;17393;1733;27;1760
75;17;17394;906;18;924
75;17;17395;481;8;489
75;17;17396;1732;29;1761
75;17;17397;2446;106;2552
75;17;17398;168;7;175
75;17;17400;630;13;643
75;17;17401;95;7;102
75;17;17402;155;3;158
75;17;17403;747;13;760
75;17;17404;659;19;678
75;17;17405;199;2;201
75;17;17406;413;3;416
75;17;17407;4846;99;4945
75;17;17408;886;10;896
75;17;17409;3309;65;3374
75;17;17410;575;9;584
75;17;17411;1145;21;1166
75;17;17412;675;8;683
75;17;17413;1359;21;1380
75;17;17414;5091;163;5254
75;17;17415;25287;1407;26694
75;17;17416;59;2;61
75;17;17417;165;1;166
75;17;17418;605;16;621
75;17;17420;2263;62;2325
75;17;17421;7180;117;7297
75;17;17422;72;0;72
75;17;17423;74;1;75
75;17;17424;382;3;385
75;17;17425;2405;45;2450
75;17;17426;252;4;256
75;17;17427;216;5;221
75;17;17428;493;10;503
75;17;17429;3047;30;3077
75;17;17430;401;7;408
75;17;17431;708;6;714
75;17;17432;365;6;371
75;17;17433;213;7;220
75;17;17434;6786;170;6956
75;17;17435;176;1;177
75;17;17436;756;23;779
75;17;17437;98;1;99
75;17;17438;303;7;310
75;17;17439;784;14;798
75;17;17440;374;8;382
75;17;17441;1125;24;1149
75;17;17442;382;3;385
75;17;17443;1723;44;1767
75;17;17444;1675;257;1932
75;17;17445;330;8;338
75;17;17446;464;6;470
75;17;17447;1987;31;2018
75;17;17448;1170;14;1184
75;17;17449;8097;139;8236
75;17;17450;230;3;233
75;17;17451;550;10;560
75;17;17452;4322;63;4385
75;17;17453;1470;33;1503
75;17;17454;375;6;381
75;17;17455;670;11;681
75;17;17457;1191;18;1209
75;17;17458;170;0;170
75;17;17459;561;10;571
75;17;17460;833;17;850
75;17;17461;3926;81;4007
75;17;17462;766;15;781
75;17;17463;1258;22;1280
75;17;17464;151;6;157
75;17;17465;590;8;598
75;17;17466;2296;32;2328
75;17;17467;235;2;237
75;17;17468;150;3;153
75;17;17469;575;12;587
75;17;17470;232;9;241
75;17;17471;210;3;213
75;17;17472;2278;17;2295
75;17;17473;117;0;117
75;17;17474;739;15;754
75;17;17476;272;3;275
75;17;17477;110;1;111
75;17;17478;58;1;59
75;17;17479;294;4;298
75;17;17480;766;10;776
75;17;17481;164;3;167
75;17;17482;644;11;655
75;17;17483;1490;26;1516
75;17;17484;1768;15;1783
75;17;17485;1070;13;1083
75;17;17486;684;6;690
24;18;18001;380;8;388
24;18;18002;191;4;195
24;18;18003;1889;28;1917
24;18;18004;1070;19;1089
24;18;18005;1068;21;1089
24;18;18006;237;2;239
24;18;18007;70;3;73
24;18;18008;500;10;510
24;18;18009;283;11;294
24;18;18010;199;7;206
24;18;18011;2063;40;2103
24;18;18012;440;5;445
24;18;18013;304;5;309
24;18;18014;148;7;155
24;18;18015;5502;128;5630
24;18;18016;400;3;403
24;18;18017;288;3;291
24;18;18018;2740;36;2776
24;18;18019;445;7;452
24;18;18020;858;13;871
24;18;18021;273;4;277
24;18;18022;345;8;353
24;18;18023;1665;54;1719
24;18;18024;99;3;102
24;18;18025;617;12;629
24;18;18026;1010;27;1037
24;18;18027;657;67;724
24;18;18028;1183;37;1220
24;18;18029;301;4;305
24;18;18030;1018;22;1040
24;18;18031;568;5;573
24;18;18032;1396;36;1432
24;18;18033;64541;2065;66606
24;18;18034;309;9;318
24;18;18035;1043;24;1067
24;18;18036;523;7;530
24;18;18037;974;14;988
24;18;18038;567;4;571
24;18;18039;318;8;326
24;18;18040;362;3;365
24;18;18041;192;2;194
24;18;18042;353;2;355
24;18;18043;195;0;195
24;18;18044;416;4;420
24;18;18045;418;8;426
24;18;18046;169;3;172
24;18;18047;613;8;621
24;18;18048;381;5;386
24;18;18049;468;8;476
24;18;18050;3663;77;3740
24;18;18051;136;3;139
24;18;18052;1023;21;1044
24;18;18053;293;8;301
24;18;18054;246;3;249
24;18;18055;941;22;963
24;18;18056;239;5;244
24;18;18057;1751;20;1771
24;18;18058;1457;19;1476
24;18;18059;943;12;955
24;18;18060;50;2;52
24;18;18061;90;0;90
24;18;18062;268;2;270
24;18;18063;162;6;168
24;18;18064;216;7;223
24;18;18065;823;12;835
24;18;18066;906;15;921
24;18;18067;710;9;719
24;18;18068;34;2;36
24;18;18069;417;15;432
24;18;18070;202;2;204
24;18;18071;33;0;33
24;18;18072;266;4;270
24;18;18073;203;8;211
24;18;18074;200;4;204
24;18;18075;1013;26;1039
24;18;18076;442;8;450
24;18;18077;363;9;372
24;18;18078;59;1;60
24;18;18079;454;6;460
24;18;18080;152;2;154
24;18;18081;401;3;404
24;18;18082;1032;30;1062
24;18;18083;750;7;757
24;18;18084;203;4;207
24;18;18085;240;6;246
24;18;18086;549;17;566
24;18;18087;3655;76;3731
24;18;18088;212;7;219
24;18;18089;434;10;444
24;18;18090;427;10;437
24;18;18091;249;6;255
24;18;18092;999;24;1023
24;18;18093;139;3;142
24;18;18094;337;8;345
24;18;18095;180;4;184
24;18;18096;2099;25;2124
24;18;18097;1964;32;1996
24;18;18098;129;4;133
24;18;18099;223;3;226
24;18;18100;676;16;692
24;18;18101;296;10;306
24;18;18102;301;2;303
24;18;18103;1432;14;1446
24;18;18104;133;2;135
24;18;18105;458;17;475
24;18;18106;266;3;269
24;18;18107;124;8;132
24;18;18108;3177;35;3212
24;18;18109;1729;21;1750
24;18;18110;967;24;991
24;18;18111;182;1;183
24;18;18112;286;1;287
24;18;18113;181;3;184
24;18;18114;226;4;230
24;18;18115;790;8;798
24;18;18116;277;2;279
24;18;18117;503;5;508
24;18;18118;1322;35;1357
24;18;18119;203;5;208
24;18;18120;593;13;606
24;18;18121;92;2;94
24;18;18122;215;2;217
24;18;18124;312;3;315
24;18;18125;1082;23;1105
24;18;18126;1379;42;1421
24;18;18127;1358;27;1385
24;18;18128;165;0;165
24;18;18129;229;6;235
24;18;18130;299;6;305
24;18;18131;34;0;34
24;18;18132;137;1;138
24;18;18133;1585;15;1600
24;18;18134;659;16;675
24;18;18135;240;5;245
24;18;18136;296;5;301
24;18;18137;505;10;515
24;18;18138;1922;57;1979
24;18;18139;655;9;664
24;18;18140;1365;24;1389
24;18;18141;6555;128;6683
24;18;18142;686;17;703
24;18;18143;379;7;386
24;18;18144;467;10;477
24;18;18145;1612;40;1652
24;18;18146;316;13;329
24;18;18147;204;3;207
24;18;18148;2606;62;2668
24;18;18149;575;13;588
24;18;18150;694;15;709
24;18;18151;352;12;364
24;18;18152;109;2;111
24;18;18153;332;3;335
24;18;18154;175;4;179
24;18;18155;430;9;439
24;18;18156;436;9;445
24;18;18157;763;24;787
24;18;18158;847;19;866
24;18;18159;820;29;849
24;18;18160;1466;30;1496
24;18;18161;219;2;221
24;18;18162;255;1;256
24;18;18163;271;5;276
24;18;18164;132;3;135
24;18;18165;1108;30;1138
24;18;18166;574;10;584
24;18;18167;300;2;302
24;18;18168;217;2;219
24;18;18169;213;7;220
24;18;18170;668;14;682
24;18;18171;252;4;256
24;18;18172;1798;44;1842
24;18;18173;246;2;248
24;18;18174;263;3;266
24;18;18175;614;3;617
24;18;18176;405;5;410
24;18;18177;57;0;57
24;18;18178;198;3;201
24;18;18179;1005;20;1025
24;18;18180;2069;68;2137
24;18;18181;539;8;547
24;18;18182;218;5;223
24;18;18183;148;3;151
24;18;18184;348;1;349
24;18;18185;234;1;235
24;18;18186;422;8;430
24;18;18187;512;9;521
24;18;18188;249;5;254
24;18;18189;479;4;483
24;18;18190;859;18;877
24;18;18191;179;2;181
24;18;18192;237;3;240
24;18;18193;204;5;209
24;18;18194;971;19;990
24;18;18195;191;5;196
24;18;18196;82;2;84
24;18;18197;9488;282;9770
24;18;18198;371;16;387
24;18;18199;252;4;256
24;18;18200;311;15;326
24;18;18201;771;15;786
24;18;18202;13;0;13
24;18;18203;97;1;98
24;18;18204;290;8;298
24;18;18205;9607;239;9846
24;18;18206;1549;53;1602
24;18;18207;6442;101;6543
24;18;18208;411;7;418
24;18;18209;447;15;462
24;18;18210;607;10;617
24;18;18211;681;12;693
24;18;18212;637;15;652
24;18;18213;5041;116;5157
24;18;18214;594;2;596
24;18;18215;154;2;156
24;18;18216;486;13;499
24;18;18217;147;4;151
24;18;18218;657;5;662
24;18;18219;508;11;519
24;18;18220;349;4;353
24;18;18221;299;2;301
24;18;18223;2447;39;2486
24;18;18224;297;9;306
24;18;18225;277;9;286
24;18;18226;451;15;466
24;18;18227;172;3;175
24;18;18228;218;3;221
24;18;18229;611;19;630
24;18;18230;283;11;294
24;18;18231;742;18;760
24;18;18232;241;3;244
24;18;18233;1400;48;1448
24;18;18234;426;8;434
24;18;18235;1126;18;1144
24;18;18236;133;2;135
24;18;18237;478;4;482
24;18;18238;128;3;131
24;18;18240;644;7;651
24;18;18241;1349;30;1379
24;18;18242;2984;33;3017
24;18;18243;400;8;408
24;18;18244;79;0;79
24;18;18245;487;9;496
24;18;18246;1107;22;1129
24;18;18247;725;15;740
24;18;18248;468;6;474
24;18;18249;402;14;416
24;18;18250;68;2;70
24;18;18251;58;2;60
24;18;18252;295;5;300
24;18;18253;476;13;489
24;18;18254;602;16;618
24;18;18255;1012;204;1216
24;18;18256;337;7;344
24;18;18257;680;14;694
24;18;18258;695;16;711
24;18;18259;278;3;281
24;18;18260;88;2;90
24;18;18261;410;7;417
24;18;18262;327;8;335
24;18;18263;663;3;666
24;18;18264;79;2;81
24;18;18265;793;13;806
24;18;18266;239;6;245
24;18;18267;3953;116;4069
24;18;18268;404;10;414
24;18;18269;652;13;665
24;18;18270;717;20;737
24;18;18271;1501;34;1535
24;18;18272;632;22;654
24;18;18273;817;16;833
24;18;18274;306;3;309
24;18;18275;142;7;149
24;18;18276;189;1;190
24;18;18277;35;0;35
24;18;18278;554;10;564
24;18;18279;25464;522;25986
24;18;18280;717;21;738
24;18;18281;2126;38;2164
24;18;18282;581;12;593
24;18;18283;84;0;84
24;18;18284;214;4;218
24;18;18285;420;6;426
24;18;18286;464;9;473
24;18;18287;292;9;301
24;18;18288;243;7;250
24;18;18289;591;17;608
24;18;18290;587;10;597
75;19;19001;359;14;373
75;19;19002;396;8;404
75;19;19003;239;9;248
75;19;19004;737;10;747
75;19;19005;3968;102;4070
75;19;19006;104;0;104
75;19;19007;840;24;864
75;19;19008;208;4;212
75;19;19009;122;2;124
75;19;19010;2896;112;3008
75;19;19011;1136;12;1148
75;19;19012;219;5;224
75;19;19013;887;21;908
75;19;19014;225;5;230
75;19;19015;701;7;708
75;19;19016;304;9;313
75;19;19017;87;1;88
75;19;19018;158;4;162
75;19;19019;1284;20;1304
75;19;19020;110;8;118
75;19;19021;91;3;94
75;19;19022;223;5;228
75;19;19023;1250;20;1270
75;19;19024;598;23;621
75;19;19025;359;4;363
75;19;19026;250;4;254
75;19;19027;115;0;115
75;19;19028;2648;100;2748
75;19;19029;279;5;284
75;19;19030;962;17;979
75;19;19031;46330;1285;47615
75;19;19033;793;12;805
75;19;19034;220;11;231
75;19;19035;547;19;566
75;19;19036;1388;15;1403
75;19;19037;1182;28;1210
75;19;19038;1521;54;1575
75;19;19039;227;7;234
75;19;19040;155;5;160
75;19;19041;436;18;454
75;19;19042;625;13;638
75;19;19043;442;9;451
75;19;19044;279;10;289
75;19;19045;197;6;203
75;19;19046;113;1;114
75;19;19047;364;6;370
75;19;19048;356;12;368
75;19;19049;743;20;763
75;19;19050;411;10;421
75;19;19051;163;4;167
75;19;19052;50;1;51
75;19;19053;258;4;262
75;19;19054;209;4;213
75;19;19055;292;12;304
75;19;19056;405;12;417
75;19;19057;483;19;502
75;19;19058;341;16;357
75;19;19059;392;9;401
75;19;19060;688;12;700
75;19;19061;1308;12;1320
75;19;19062;1140;48;1188
75;19;19063;2974;79;3053
75;19;19064;72;2;74
75;19;19065;71;0;71
75;19;19066;1736;36;1772
75;19;19067;208;9;217
75;19;19068;710;6;716
75;19;19069;140;3;143
75;19;19070;336;12;348
75;19;19071;200;3;203
75;19;19072;2678;72;2750
75;19;19073;4295;731;5026
75;19;19074;54;0;54
75;19;19075;381;14;395
75;19;19076;420;9;429
75;19;19077;130;2;132
75;19;19078;419;8;427
75;19;19079;493;10;503
75;19;19080;688;12;700
75;19;19081;506;15;521
75;19;19082;1097;22;1119
75;19;19083;134;2;136
75;19;19084;265;12;277
75;19;19085;789;16;805
75;19;19086;333;6;339
75;19;19087;94;3;97
75;19;19088;52;1;53
75;19;19089;187;3;190
75;19;19090;94;7;101
75;19;19091;317;13;330
75;19;19092;77;1;78
75;19;19093;964;34;998
75;19;19094;1114;26;1140
75;19;19095;136;1;137
75;19;19096;408;11;419
75;19;19097;134;1;135
75;19;19098;971;21;992
75;19;19099;220;10;230
75;19;19100;1097;23;1120
75;19;19101;1542;47;1589
75;19;19102;297;2;299
75;19;19103;67;2;69
75;19;19104;115;1;116
75;19;19105;487;14;501
75;19;19106;373;2;375
75;19;19107;1617;45;1662
75;19;19108;60;2;62
75;19;19109;222;7;229
75;19;19110;132;0;132
75;19;19111;99;0;99
75;19;19112;109;0;109
75;19;19113;644;38;682
75;19;19114;164;10;174
75;19;19115;301;8;309
75;19;19116;253;5;258
75;19;19117;698;21;719
75;19;19118;810;10;820
75;19;19119;147;1;148
75;19;19120;239;1;240
75;19;19121;2236;43;2279
75;19;19122;192;10;202
75;19;19123;7984;165;8149
75;19;19124;1449;22;1471
75;19;19125;784;17;801
75;19;19126;172;0;172
75;19;19128;307;6;313
75;19;19129;664;8;672
75;19;19130;442;10;452
75;19;19131;538;23;561
75;19;19132;130;1;131
75;19;19133;242;1;243
75;19;19134;705;21;726
75;19;19135;348;6;354
75;19;19136;2308;202;2510
75;19;19137;63;0;63
75;19;19138;1264;52;1316
75;19;19139;76;1;77
75;19;19140;635;19;654
75;19;19141;284;6;290
75;19;19142;98;3;101
75;19;19143;597;14;611
75;19;19144;235;5;240
75;19;19145;445;77;522
75;19;19146;2336;213;2549
75;19;19147;635;14;649
75;19;19148;1659;252;1911
75;19;19149;200;4;204
75;19;19150;363;16;379
75;19;19151;935;18;953
75;19;19152;436;8;444
75;19;19153;3624;94;3718
75;19;19154;318;9;327
75;19;19155;264;5;269
75;19;19156;161;2;163
75;19;19157;222;2;224
75;19;19158;167;4;171
75;19;19159;89;1;90
75;19;19160;192;2;194
75;19;19161;464;6;470
75;19;19162;1219;17;1236
75;19;19163;292;7;299
75;19;19164;830;11;841
75;19;19165;122;3;125
75;19;19166;93;0;93
75;19;19167;43;0;43
75;19;19168;84;4;88
75;19;19169;290;4;294
75;19;19170;210;9;219
75;19;19171;188;3;191
75;19;19172;113;5;118
75;19;19173;305;11;316
75;19;19174;131;1;132
75;19;19175;94;0;94
75;19;19176;1086;34;1120
75;19;19177;176;4;180
75;19;19178;966;23;989
75;19;19179;200;6;206
75;19;19180;704;18;722
75;19;19181;420;7;427
75;19;19182;763;23;786
75;19;19184;128;4;132
75;19;19186;213;4;217
75;19;19187;402;5;407
75;19;19188;413;6;419
75;19;19189;43;1;44
75;19;19190;190;5;195
75;19;19191;646;12;658
75;19;19192;499;6;505
75;19;19193;174;5;179
75;19;19194;1322;36;1358
75;19;19195;379;6;385
75;19;19196;481;19;500
75;19;19198;104;0;104
75;19;19199;240;5;245
75;19;19200;89;8;97
75;19;19201;594;13;607
75;19;19202;2007;44;2051
75;19;19203;1779;92;1871
75;19;19204;274;3;277
75;19;19205;88;2;90
75;19;19206;88;2;90
75;19;19207;1129;32;1161
75;19;19208;185;3;188
75;19;19209;165;2;167
75;19;19210;66;0;66
75;19;19211;1004;20;1024
75;19;19212;104;6;110
75;19;19213;624;17;641
75;19;19214;452;3;455
75;19;19215;122;2;124
75;19;19216;247;3;250
75;19;19217;154;5;159
75;19;19219;55;1;56
75;19;19220;481;10;491
75;19;19221;87;2;89
75;19;19222;340;12;352
75;19;19223;268;2;270
75;19;19225;171;2;173
75;19;19226;129;3;132
75;19;19227;1319;35;1354
75;19;19228;67;1;68
75;19;19229;4751;92;4843
75;19;19230;399;8;407
75;19;19231;177;2;179
75;19;19232;77;2;79
75;19;19233;295;14;309
75;19;19234;480;6;486
75;19;19235;234;6;240
75;19;19236;482;10;492
75;19;19237;1056;22;1078
75;19;19238;222;8;230
75;19;19239;295;7;302
75;19;19240;290;14;304
75;19;19241;285;6;291
75;19;19242;458;17;475
75;19;19243;851;17;868
75;19;19244;85;1;86
75;19;19245;133;5;138
75;19;19246;1877;42;1919
75;19;19247;194;8;202
75;19;19248;701;13;714
75;19;19249;342;9;351
75;19;19250;670;6;676
75;19;19251;275;7;282
75;19;19252;845;16;861
75;19;19253;223;2;225
75;19;19254;193;1;194
75;19;19255;1778;37;1815
75;19;19256;346;6;352
75;19;19257;272;7;279
75;19;19258;608;10;618
75;19;19259;234;4;238
75;19;19260;217;7;224
75;19;19261;746;15;761
75;19;19262;155;16;171
75;19;19263;294;11;305
75;19;19264;506;4;510
75;19;19265;344;8;352
75;19;19266;98;4;102
75;19;19268;38;0;38
75;19;19269;1297;80;1377
75;19;19270;551;6;557
75;19;19271;241;3;244
75;19;19272;14812;663;15475
75;19;19273;811;20;831
75;19;19274;4215;115;4330
75;19;19275;9358;368;9726
75;19;19276;2794;59;2853
75;19;19277;143;5;148
75;19;19278;2457;43;2500
75;19;19279;387;10;397
75;19;19280;180;4;184
75;19;19281;72;7;79
75;19;19283;75;1;76
75;19;19284;87;3;90
75;19;19285;1255;29;1284
75;19;19286;535;9;544
75;19;19287;270;6;276
75;19;19288;1242;164;1406
75;19;19289;668;8;676
27;21;21001;462;52;514
27;21;21002;266;3;269
27;21;21003;1464;27;1491
27;21;21004;269;7;276
27;21;21005;1470;17;1487
27;21;21006;172;1;173
27;21;21007;226;30;256
27;21;21008;572;7;579
27;21;21009;175;1;176
27;21;21010;136;6;142
27;21;21011;82;0;82
27;21;21012;344;13;357
27;21;21013;450;7;457
27;21;21014;62;0;62
27;21;21015;92;0;92
27;21;21016;966;19;985
27;21;21017;507;18;525
27;21;21018;54;1;55
27;21;21020;224;8;232
27;21;21021;2629;49;2678
27;21;21022;536;13;549
27;21;21023;1384;31;1415
27;21;21024;111;0;111
27;21;21025;67;2;69
27;21;21026;189;9;198
27;21;21027;1312;26;1338
27;21;21028;781;10;791
27;21;21029;76;1;77
27;21;21030;88;3;91
27;21;21031;529;5;534
27;21;21032;167;5;172
27;21;21033;151;5;156
27;21;21034;131;2;133
27;21;21035;331;4;335
27;21;21036;78;3;81
27;21;21037;297;12;309
27;21;21038;7614;85;7699
27;21;21039;37;0;37
27;21;21040;95;5;100
27;21;21041;184;2;186
27;21;21042;161;4;165
27;21;21043;223;19;242
27;21;21044;99;1;100
27;21;21045;211;8;219
27;21;21046;70;2;72
27;21;21047;69;1;70
27;21;21048;651;10;661
27;21;21049;42;2;44
27;21;21050;207;6;213
27;21;21051;85;3;88
27;21;21052;25;4;29
27;21;21053;202;4;206
27;21;21054;20551;759;21310
27;21;21055;15;0;15
27;21;21056;875;10;885
27;21;21057;352;5;357
27;21;21058;248;5;253
27;21;21059;885;24;909
27;21;21060;1618;18;1636
27;21;21061;67;2;69
27;21;21062;220;9;229
27;21;21063;90;5;95
27;21;21064;112;0;112
27;21;21065;127;4;131
27;21;21066;53;1;54
27;21;21067;689;9;698
27;21;21068;104;7;111
27;21;21069;121;1;122
27;21;21070;139;4;143
27;21;21071;701;20;721
27;21;21072;193;4;197
27;21;21074;255;4;259
27;21;21075;68;1;69
27;21;21076;827;8;835
27;21;21077;127;2;129
27;21;21078;76;2;78
27;21;21079;130;0;130
27;21;21080;647;13;660
27;21;21081;128;1;129
27;21;21082;64;2;66
27;21;21083;124;1;125
27;21;21084;63;4;67
27;21;21085;140;3;143
27;21;21086;1239;29;1268
27;21;21087;811;11;822
27;21;21088;281;7;288
27;21;21089;437;6;443
27;21;21090;61;3;64
27;21;21091;44;0;44
27;21;21092;222;5;227
27;21;21093;152;4;156
27;21;21094;411;4;415
27;21;21095;47;1;48
27;21;21096;107;1;108
27;21;21097;38;2;40
27;21;21098;125;2;127
27;21;21099;311;6;317
27;21;21100;34;0;34
27;21;21101;166;4;170
27;21;21102;142;3;145
27;21;21103;2357;43;2400
27;21;21104;44;0;44
27;21;21105;1127;12;1139
27;21;21106;929;12;941
27;21;21107;904;24;928
27;21;21108;114;1;115
27;21;21109;223;7;230
27;21;21110;652;131;783
27;21;21111;317;3;320
27;21;21112;415;9;424
27;21;21113;198;1;199
27;21;21114;159;1;160
27;21;21115;369;7;376
27;21;21116;134;0;134
27;21;21117;48;2;50
27;21;21118;21;3;24
27;21;21119;43;0;43
27;21;21120;160;2;162
27;21;21121;78;1;79
27;21;21122;315;8;323
27;21;21123;32;5;37
27;21;21124;175;6;181
27;21;21125;222;8;230
27;21;21126;617;7;624
27;21;21127;524;8;532
27;21;21128;242;11;253
27;21;21129;22;0;22
27;21;21130;392;4;396
27;21;21131;464;63;527
27;21;21132;392;6;398
27;21;21133;293;7;300
27;21;21134;242;9;251
27;21;21135;311;8;319
27;21;21136;26;0;26
27;21;21137;99;1;100
27;21;21138;597;8;605
27;21;21139;224;5;229
27;21;21140;75;1;76
27;21;21141;35;1;36
27;21;21142;213;4;217
27;21;21143;63;3;66
27;21;21144;37;0;37
27;21;21145;37;1;38
27;21;21146;127;3;130
27;21;21147;35;1;36
27;21;21148;346;1;347
27;21;21149;140;4;144
27;21;21150;300;11;311
27;21;21151;87;5;92
27;21;21152;79;2;81
27;21;21153;155;6;161
27;21;21154;5347;350;5697
27;21;21155;41;6;47
27;21;21156;49;0;49
27;21;21157;16;0;16
27;21;21158;179;5;184
27;21;21159;99;4;103
27;21;21160;99;1;100
27;21;21161;79;5;84
27;21;21162;483;8;491
27;21;21163;192;5;197
27;21;21164;143;3;146
27;21;21165;74;4;78
27;21;21166;14025;191;14216
27;21;21167;123;4;127
27;21;21168;40;0;40
27;21;21169;161;4;165
27;21;21170;378;5;383
27;21;21171;11123;210;11333
27;21;21172;304;6;310
27;21;21173;639;15;654
27;21;21175;193;1;194
27;21;21176;123;2;125
27;21;21177;180;1;181
27;21;21178;306;10;316
27;21;21179;898;10;908
27;21;21180;153;4;157
27;21;21181;141;2;143
27;21;21182;95;1;96
27;21;21183;1055;13;1068
27;21;21184;70;0;70
27;21;21185;529;20;549
27;21;21186;616;17;633
27;21;21187;123;4;127
27;21;21189;436;9;445
27;21;21190;442;19;461
27;21;21191;811;24;835
27;21;21192;625;10;635
27;21;21193;366;16;382
27;21;21194;936;12;948
27;21;21195;219;4;223
27;21;21196;977;16;993
27;21;21197;32;0;32
27;21;21198;255;3;258
27;21;21199;160;2;162
27;21;21200;1110;25;1135
27;21;21201;247;5;252
27;21;21202;148;1;149
27;21;21203;122;2;124
27;21;21204;86;1;87
27;21;21205;240;6;246
27;21;21207;79;4;83
27;21;21208;166;4;170
27;21;21209;1912;41;1953
27;21;21210;526;5;531
27;21;21211;131;2;133
27;21;21212;322;4;326
27;21;21214;170;4;174
27;21;21215;185;0;185
27;21;21216;105;2;107
27;21;21217;133;4;137
27;21;21218;116;0;116
27;21;21219;141;0;141
27;21;21220;144;3;147
27;21;21221;40;2;42
27;21;21222;118;3;121
27;21;21223;1537;36;1573
27;21;21224;65;4;69
27;21;21225;131;2;133
27;21;21226;343;11;354
27;21;21227;505;7;512
27;21;21228;143;0;143
27;21;21229;91;2;93
27;21;21230;377;8;385
27;21;21231;158002;3378;161380
27;21;21232;203;5;208
27;21;21233;200;1;201
27;21;21234;61;3;64
27;21;21235;53;1;54
27;21;21236;253;6;259
27;21;21237;95;3;98
27;21;21238;132;2;134
27;21;21239;781;11;792
27;21;21240;313;2;315
27;21;21241;292;16;308
27;21;21242;298;4;302
27;21;21243;73;4;77
27;21;21244;67;0;67
27;21;21245;318;3;321
27;21;21246;182;3;185
27;21;21247;798;13;811
27;21;21248;61;1;62
27;21;21249;677;20;697
27;21;21250;86;2;88
27;21;21251;280;27;307
27;21;21252;79;4;83
27;21;21253;138;4;142
27;21;21254;208;10;218
27;21;21255;325;3;328
27;21;21256;314;7;321
27;21;21257;68;2;70
27;21;21258;225;3;228
27;21;21259;287;10;297
27;21;21260;152;4;156
27;21;21261;619;11;630
27;21;21262;30;0;30
27;21;21263;1660;41;1701
27;21;21264;43;0;43
27;21;21265;750;21;771
27;21;21266;192;1;193
27;21;21267;495;13;508
27;21;21268;190;3;193
27;21;21269;445;9;454
27;21;21270;206;7;213
27;21;21271;283;3;286
27;21;21272;267;4;271
27;21;21273;1402;18;1420
27;21;21274;165;3;168
27;21;21275;133;3;136
27;21;21276;118;4;122
27;21;21277;886;19;905
27;21;21278;8800;204;9004
27;21;21279;25;0;25
27;21;21280;133;6;139
27;21;21281;170;2;172
27;21;21282;101;2;103
27;21;21283;65;1;66
27;21;21284;292;4;296
27;21;21285;497;5;502
27;21;21286;88;1;89
27;21;21287;159;7;166
27;21;21288;162;1;163
27;21;21289;118;8;126
27;21;21290;901;13;914
27;21;21291;365;10;375
27;21;21292;5231;44;5275
27;21;21293;118;0;118
27;21;21294;433;5;438
27;21;21295;3048;41;3089
27;21;21296;177;1;178
27;21;21297;720;6;726
27;21;21298;108;3;111
27;21;21299;88;1;89
27;21;21300;354;9;363
27;21;21301;267;2;269
27;21;21302;124;2;126
27;21;21303;9;0;9
27;21;21304;255;9;264
27;21;21305;196;2;198
27;21;21306;210;3;213
27;21;21307;142;2;144
27;21;21308;203;12;215
27;21;21309;83;3;86
27;21;21310;113;2;115
27;21;21311;73;1;74
27;21;21312;26;3;29
27;21;21313;46;0;46
27;21;21314;79;2;81
27;21;21315;1227;16;1243
27;21;21316;327;5;332
27;21;21317;4405;57;4462
27;21;21319;894;13;907
27;21;21320;790;14;804
27;21;21321;77;2;79
27;21;21322;313;14;327
27;21;21323;138;4;142
27;21;21324;51;1;52
27;21;21325;183;2;185
27;21;21326;73;4;77
27;21;21327;255;4;259
27;21;21328;47;0;47
27;21;21329;42;2;44
27;21;21330;373;3;376
27;21;21331;330;4;334
27;21;21332;996;22;1018
27;21;21333;228;5;233
27;21;21334;512;12;524
27;21;21335;115;3;118
27;21;21336;673;13;686
27;21;21337;1350;13;1363
27;21;21338;163;3;166
27;21;21339;511;19;530
27;21;21340;250;5;255
27;21;21341;105;4;109
27;21;21342;437;9;446
27;21;21343;95;1;96
27;21;21344;216;5;221
27;21;21345;188;3;191
27;21;21346;299;3;302
27;21;21347;337;17;354
27;21;21348;102;1;103
27;21;21349;491;8;499
27;21;21350;54;1;55
27;21;21351;1164;120;1284
27;21;21352;1137;16;1153
27;21;21353;1237;27;1264
27;21;21354;53;0;53
27;21;21355;8545;127;8672
27;21;21356;1596;36;1632
27;21;21357;113;3;116
27;21;21358;183;4;187
27;21;21359;58;3;61
27;21;21360;116;3;119
27;21;21361;516;12;528
27;21;21362;132;3;135
27;21;21363;318;6;324
27;21;21364;83;3;86
27;21;21365;79;0;79
27;21;21366;214;3;217
27;21;21367;260;2;262
27;21;21368;244;13;257
27;21;21369;316;4;320
27;21;21370;902;18;920
27;21;21371;808;19;827
27;21;21372;83;5;88
27;21;21373;783;15;798
27;21;21374;191;6;197
27;21;21375;187;5;192
27;21;21376;104;1;105
27;21;21377;47;0;47
27;21;21378;93;2;95
27;21;21379;160;1;161
27;21;21380;56;2;58
27;21;21381;92;4;96
27;21;21382;192;3;195
27;21;21383;1688;21;1709
27;21;21384;56;5;61
27;21;21385;325;8;333
27;21;21386;323;12;335
27;21;21387;220;5;225
27;21;21388;596;11;607
27;21;21389;207;1;208
27;21;21390;5311;76;5387
27;21;21391;843;10;853
27;21;21392;60;1;61
27;21;21393;153;8;161
27;21;21394;158;4;162
27;21;21395;91;1;92
27;21;21396;69;2;71
27;21;21397;179;3;182
27;21;21398;361;8;369
27;21;21399;213;2;215
27;21;21400;48;0;48
27;21;21401;320;5;325
27;21;21402;9;0;9
27;21;21403;86;1;87
27;21;21404;420;16;436
27;21;21405;807;22;829
27;21;21406;248;2;250
27;21;21407;236;11;247
27;21;21408;1690;29;1719
27;21;21409;462;13;475
27;21;21410;30;2;32
27;21;21411;567;18;585
27;21;21412;1408;45;1453
27;21;21413;397;15;412
27;21;21414;315;9;324
27;21;21415;178;5;183
27;21;21416;2008;37;2045
27;21;21417;108;0;108
27;21;21418;59;4;63
27;21;21419;264;5;269
27;21;21420;161;3;164
27;21;21421;233;3;236
27;21;21422;130;4;134
27;21;21423;747;23;770
27;21;21424;111;2;113
27;21;21425;4848;132;4980
27;21;21426;206;3;209
27;21;21427;188;5;193
27;21;21428;166;4;170
27;21;21429;296;6;302
27;21;21430;85;5;90
27;21;21431;147;5;152
27;21;21432;253;4;257
27;21;21433;386;7;393
27;21;21434;192;1;193
27;21;21435;301;6;307
27;21;21436;156;3;159
27;21;21437;243;5;248
27;21;21438;74;3;77
27;21;21439;88;0;88
27;21;21440;194;5;199
27;21;21441;239;7;246
27;21;21442;664;11;675
27;21;21444;69;0;69
27;21;21445;144;2;146
27;21;21446;261;5;266
27;21;21447;81;0;81
27;21;21448;87;1;88
27;21;21449;182;3;185
27;21;21450;166;5;171
27;21;21451;76;3;79
27;21;21452;3036;34;3070
27;21;21454;111;0;111
27;21;21455;199;8;207
27;21;21456;153;8;161
27;21;21457;73;5;78
27;21;21458;1153;16;1169
27;21;21459;233;5;238
27;21;21460;65;1;66
27;21;21461;1435;22;1457
27;21;21462;948;18;966
27;21;21463;56;1;57
27;21;21464;5362;91;5453
27;21;21465;77;1;78
27;21;21466;40;4;44
27;21;21467;128;4;132
27;21;21468;88;1;89
27;21;21469;459;13;472
27;21;21470;51;3;54
27;21;21471;15;0;15
27;21;21472;170;1;171
27;21;21473;1604;11;1615
27;21;21474;415;11;426
27;21;21475;506;10;516
27;21;21476;163;5;168
27;21;21477;83;2;85
27;21;21478;285;5;290
27;21;21479;90;1;91
27;21;21480;236;9;245
27;21;21481;2138;33;2171
27;21;21482;635;15;650
27;21;21483;294;5;299
27;21;21484;65;5;70
27;21;21485;2542;46;2588
27;21;21487;411;3;414
27;21;21488;192;2;194
27;21;21489;55;4;59
27;21;21490;157;7;164
27;21;21491;69;1;70
27;21;21492;454;12;466
27;21;21493;571;7;578
27;21;21494;83;0;83
27;21;21495;155;1;156
27;21;21496;1301;20;1321
27;21;21497;173;15;188
27;21;21498;49;2;51
27;21;21499;203;4;207
27;21;21500;551;9;560
27;21;21501;1537;119;1656
27;21;21502;602;7;609
27;21;21503;132;4;136
27;21;21504;91;3;94
27;21;21505;710;10;720
27;21;21506;373;5;378
27;21;21508;446;8;454
27;21;21510;155;1;156
27;21;21511;128;4;132
27;21;21512;383;10;393
27;21;21514;102;3;105
27;21;21515;9099;381;9480
27;21;21516;77;4;81
27;21;21517;507;12;519
27;21;21518;204;2;206
27;21;21519;351;8;359
27;21;21520;151;0;151
27;21;21521;892;11;903
27;21;21522;447;5;452
27;21;21523;150;2;152
27;21;21524;92;0;92
27;21;21525;889;14;903
27;21;21526;41;0;41
27;21;21527;285;9;294
27;21;21528;141;2;143
27;21;21529;49;1;50
27;21;21530;149;1;150
27;21;21531;484;5;489
27;21;21532;1155;11;1166
27;21;21533;87;3;90
27;21;21534;731;42;773
27;21;21535;1328;10;1338
27;21;21536;291;11;302
27;21;21537;115;2;117
27;21;21538;118;4;122
27;21;21539;56;1;57
27;21;21540;7546;101;7647
27;21;21541;221;8;229
27;21;21542;450;0;450
27;21;21543;193;8;201
27;21;21544;58;6;64
27;21;21545;929;15;944
27;21;21546;207;4;211
27;21;21547;199;3;202
27;21;21548;182;3;185
27;21;21549;82;4;86
27;21;21550;131;5;136
27;21;21552;36;1;37
27;21;21553;109;3;112
27;21;21554;1063;7;1070
27;21;21555;1500;21;1521
27;21;21556;243;3;246
27;21;21557;109;3;112
27;21;21558;900;31;931
27;21;21559;692;11;703
27;21;21560;300;2;302
27;21;21561;453;1;454
27;21;21562;198;6;204
27;21;21563;121;2;123
27;21;21564;407;9;416
27;21;21565;508;8;516
27;21;21566;142;3;145
27;21;21567;215;5;220
27;21;21568;691;11;702
27;21;21569;220;6;226
27;21;21570;169;16;185
27;21;21571;238;2;240
27;21;21572;399;5;404
27;21;21573;372;3;375
27;21;21574;386;9;395
27;21;21575;344;4;348
27;21;21576;161;4;165
27;21;21577;1344;25;1369
27;21;21578;322;4;326
27;21;21579;208;6;214
27;21;21580;135;2;137
27;21;21581;145;2;147
27;21;21582;908;12;920
27;21;21583;55;2;57
27;21;21584;2372;109;2481
27;21;21585;969;14;983
27;21;21586;718;10;728
27;21;21587;246;4;250
27;21;21588;68;1;69
27;21;21589;102;1;103
27;21;21590;1288;41;1329
27;21;21591;861;14;875
27;21;21592;228;11;239
27;21;21593;79;1;80
27;21;21594;193;3;196
27;21;21595;163;4;167
27;21;21596;385;6;391
27;21;21597;53;1;54
27;21;21598;174;2;176
27;21;21599;2407;34;2441
27;21;21600;124;4;128
27;21;21601;96;4;100
27;21;21602;26;0;26
27;21;21603;4120;353;4473
27;21;21604;140;4;144
27;21;21605;1966;52;2018
27;21;21606;1809;46;1855
27;21;21607;2310;22;2332
27;21;21608;98;4;102
27;21;21609;497;7;504
27;21;21610;362;7;369
27;21;21611;915;13;928
27;21;21612;87;1;88
27;21;21613;157;8;165
27;21;21614;399;4;403
27;21;21615;241;8;249
27;21;21616;190;7;197
27;21;21617;11713;226;11939
27;21;21618;579;8;587
27;21;21619;218;6;224
27;21;21620;159;5;164
27;21;21622;255;4;259
27;21;21623;1578;34;1612
27;21;21624;141;1;142
27;21;21625;81;3;84
27;21;21626;60;2;62
27;21;21627;95;9;104
27;21;21628;65;0;65
27;21;21629;305;5;310
27;21;21630;213;8;221
27;21;21631;54;0;54
27;21;21632;1040;31;1071
27;21;21633;188;1;189
27;21;21634;137;0;137
27;21;21635;104;6;110
27;21;21636;254;8;262
27;21;21637;213;3;216
27;21;21638;1138;7;1145
27;21;21639;746;14;760
27;21;21640;215;5;220
27;21;21641;457;12;469
27;21;21642;423;8;431
27;21;21643;445;8;453
27;21;21644;170;4;174
27;21;21645;598;16;614
27;21;21646;123;3;126
27;21;21647;119;1;120
27;21;21648;175;1;176
27;21;21649;53;0;53
27;21;21650;149;4;153
27;21;21651;202;4;206
27;21;21652;297;7;304
27;21;21653;51;2;53
27;21;21655;232;10;242
27;21;21656;697;11;708
27;21;21657;1944;49;1993
27;21;21659;168;10;178
27;21;21660;49;1;50
27;21;21661;1744;26;1770
27;21;21662;33;0;33
27;21;21663;2846;37;2883
27;21;21664;82;4;86
27;21;21665;170;0;170
27;21;21666;94;3;97
27;21;21667;399;7;406
27;21;21669;81;0;81
27;21;21670;281;4;285
27;21;21671;52;1;53
27;21;21672;28;1;29
27;21;21673;215;2;217
27;21;21674;201;3;204
27;21;21675;39;1;40
27;21;21676;215;5;220
27;21;21677;116;1;117
27;21;21678;185;3;188
27;21;21679;129;2;131
27;21;21680;504;7;511
27;21;21681;86;1;87
27;21;21682;269;1;270
27;21;21683;356;3;359
27;21;21684;951;49;1000
27;21;21685;252;6;258
27;21;21686;144;2;146
27;21;21687;139;5;144
27;21;21688;113;4;117
27;21;21689;168;7;175
27;21;21690;92;2;94
27;21;21691;396;7;403
27;21;21692;252;4;256
27;21;21693;69;1;70
27;21;21694;26;0;26
27;21;21695;60;1;61
27;21;21696;96;2;98
27;21;21698;385;9;394
27;21;21699;1167;13;1180
27;21;21700;86;3;89
27;21;21701;126;5;131
27;21;21702;266;7;273
27;21;21703;48;0;48
27;21;21704;100;0;100
27;21;21705;77;1;78
27;21;21706;104;1;105
27;21;21707;217;4;221
27;21;21708;331;12;343
27;21;21709;178;2;180
27;21;21710;1064;18;1082
27;21;21711;102;4;106
27;21;21712;233;15;248
27;21;21713;342;5;347
27;21;21714;339;9;348
27;21;21715;192;1;193
27;21;21716;171;5;176
27;21;21717;276;11;287
53;22;22001;599;18;617
53;22;22002;1144;36;1180
53;22;22003;928;77;1005
53;22;22004;4809;92;4901
53;22;22005;1026;16;1042
53;22;22006;268;9;277
53;22;22008;1125;40;1165
53;22;22009;160;1;161
53;22;22011;1062;27;1089
53;22;22012;881;17;898
53;22;22013;2122;44;2166
53;22;22014;1165;29;1194
53;22;22015;1680;30;1710
53;22;22016;352;6;358
53;22;22018;295;5;300
53;22;22019;488;13;501
53;22;22020;2902;68;2970
53;22;22021;1176;25;1201
53;22;22023;421;1;422
53;22;22024;227;1;228
53;22;22025;2229;33;2262
53;22;22026;744;8;752
53;22;22027;417;12;429
53;22;22028;841;25;866
53;22;22029;348;13;361
53;22;22030;889;21;910
53;22;22031;653;9;662
53;22;22032;2495;144;2639
53;22;22033;359;11;370
53;22;22034;1532;58;1590
53;22;22035;1036;15;1051
53;22;22036;210;4;214
53;22;22037;386;4;390
53;22;22039;554;27;581
53;22;22040;582;9;591
53;22;22041;263;3;266
53;22;22042;495;15;510
53;22;22043;211;5;216
53;22;22044;1781;50;1831
53;22;22045;345;7;352
53;22;22046;6396;115;6511
53;22;22047;934;18;952
53;22;22048;2197;47;2244
53;22;22049;1629;44;1673
53;22;22050;14407;587;14994
53;22;22052;370;7;377
53;22;22053;682;13;695
53;22;22054;3922;92;4014
53;22;22055;6934;215;7149
53;22;22056;1757;26;1783
53;22;22057;399;12;411
53;22;22059;1412;40;1452
53;22;22060;605;19;624
53;22;22061;1363;40;1403
53;22;22062;544;10;554
53;22;22063;555;9;564
53;22;22064;948;30;978
53;22;22065;1729;36;1765
53;22;22067;2545;59;2604
53;22;22068;430;8;438
53;22;22069;217;5;222
53;22;22070;7069;553;7622
53;22;22071;714;9;723
53;22;22072;407;9;416
53;22;22073;375;16;391
53;22;22074;644;17;661
53;22;22075;720;7;727
53;22;22076;1325;36;1361
53;22;22077;1195;15;1210
53;22;22079;2268;36;2304
53;22;22081;4183;97;4280
53;22;22082;906;32;938
53;22;22083;679;12;691
53;22;22084;2520;51;2571
53;22;22085;289;8;297
53;22;22086;658;12;670
53;22;22087;653;25;678
53;22;22088;253;3;256
53;22;22090;1067;20;1087
53;22;22091;442;9;451
53;22;22092;269;3;272
53;22;22093;16688;470;17158
53;22;22094;1558;63;1621
53;22;22095;180;10;190
53;22;22096;459;3;462
53;22;22097;726;18;744
53;22;22098;1425;34;1459
53;22;22099;1098;17;1115
53;22;22101;1133;25;1158
53;22;22103;958;39;997
53;22;22104;526;28;554
53;22;22105;1146;23;1169
53;22;22106;7801;263;8064
53;22;22107;1256;39;1295
53;22;22108;122;2;124
53;22;22109;210;5;215
53;22;22110;601;12;613
53;22;22111;404;7;411
53;22;22112;437;5;442
53;22;22113;20210;936;21146
53;22;22114;847;17;864
53;22;22115;441;16;457
53;22;22116;1351;23;1374
53;22;22117;1716;33;1749
53;22;22118;4195;96;4291
53;22;22119;591;10;601
53;22;22121;1780;29;1809
53;22;22122;735;12;747
53;22;22124;218;8;226
53;22;22126;158;1;159
53;22;22127;1480;38;1518
53;22;22128;410;15;425
53;22;22129;67;3;70
53;22;22131;813;13;826
53;22;22132;252;4;256
53;22;22133;626;15;641
53;22;22134;3077;117;3194
53;22;22135;2329;45;2374
53;22;22136;9605;384;9989
53;22;22137;1469;30;1499
53;22;22138;360;5;365
53;22;22139;89;1;90
53;22;22140;598;16;614
53;22;22141;237;6;243
53;22;22143;1697;23;1720
53;22;22144;1326;34;1360
53;22;22145;836;11;847
53;22;22146;391;17;408
53;22;22147;2937;230;3167
53;22;22148;234;4;238
53;22;22149;431;17;448
53;22;22150;947;27;974
53;22;22152;1262;41;1303
53;22;22153;790;17;807
53;22;22155;2141;32;2173
53;22;22156;649;15;664
53;22;22157;670;17;687
53;22;22158;2439;64;2503
53;22;22160;946;18;964
53;22;22161;2748;107;2855
53;22;22162;7179;335;7514
53;22;22163;691;20;711
53;22;22164;1839;26;1865
53;22;22165;607;19;626
53;22;22166;2494;63;2557
53;22;22168;7089;196;7285
53;22;22169;173;4;177
53;22;22170;1633;34;1667
53;22;22171;4441;91;4532
53;22;22172;2981;54;3035
53;22;22174;869;5;874
53;22;22175;1464;20;1484
53;22;22176;6839;111;6950
53;22;22177;1353;29;1382
53;22;22178;1325;34;1359
53;22;22179;1602;27;1629
53;22;22180;1901;31;1932
53;22;22181;629;27;656
53;22;22182;3242;75;3317
53;22;22183;3697;126;3823
53;22;22184;1587;30;1617
53;22;22185;2429;73;2502
53;22;22186;4083;129;4212
53;22;22187;14309;487;14796
53;22;22188;1090;10;1100
53;22;22189;580;10;590
53;22;22190;3775;76;3851
53;22;22193;1617;25;1642
53;22;22194;3620;98;3718
53;22;22195;2298;42;2340
53;22;22196;936;21;957
53;22;22197;2968;80;3048
53;22;22198;3857;165;4022
53;22;22199;1197;19;1216
53;22;22200;593;11;604
53;22;22201;754;13;767
53;22;22202;754;15;769
53;22;22203;4103;77;4180
53;22;22204;1232;20;1252
53;22;22205;417;3;420
53;22;22206;3916;55;3971
53;22;22207;2176;45;2221
53;22;22208;1711;33;1744
53;22;22209;3757;63;3820
53;22;22210;3039;125;3164
53;22;22211;3687;117;3804
53;22;22212;1140;33;1173
53;22;22213;3551;108;3659
53;22;22214;3140;56;3196
53;22;22215;11383;356;11739
53;22;22216;731;12;743
53;22;22217;408;14;422
53;22;22218;1166;36;1202
53;22;22219;2448;59;2507
53;22;22220;1643;53;1696
53;22;22221;1733;37;1770
53;22;22222;4541;88;4629
53;22;22223;1989;268;2257
53;22;22224;1579;57;1636
53;22;22225;5409;113;5522
53;22;22226;2464;57;2521
53;22;22227;776;11;787
53;22;22228;1462;29;1491
53;22;22229;1071;25;1096
53;22;22231;317;4;321
53;22;22232;1991;39;2030
53;22;22233;2263;55;2318
53;22;22234;1160;22;1182
53;22;22235;237;4;241
53;22;22236;715;7;722
53;22;22237;2188;65;2253
53;22;22238;531;12;543
53;22;22239;1333;37;1370
53;22;22240;1077;15;1092
53;22;22241;1024;30;1054
53;22;22242;1559;23;1582
53;22;22243;539;17;556
53;22;22244;484;18;502
53;22;22245;966;14;980
53;22;22246;2103;32;2135
53;22;22248;1807;37;1844
53;22;22249;611;10;621
53;22;22250;1009;25;1034
53;22;22251;7300;208;7508
53;22;22254;1117;22;1139
53;22;22255;879;21;900
53;22;22256;1078;26;1104
53;22;22257;381;8;389
53;22;22258;3856;225;4081
53;22;22259;3976;111;4087
53;22;22260;556;7;563
53;22;22261;362;11;373
53;22;22262;2867;200;3067
53;22;22263;333;3;336
53;22;22264;2713;576;3289
53;22;22265;1763;56;1819
53;22;22266;3056;324;3380
53;22;22267;392;3;395
53;22;22268;600;10;610
53;22;22269;250;6;256
53;22;22271;353;7;360
53;22;22272;2289;53;2342
53;22;22273;2176;32;2208
53;22;22274;372;6;378
53;22;22275;1238;25;1263
53;22;22276;269;0;269
53;22;22277;2309;49;2358
53;22;22278;43605;1494;45099
53;22;22279;1119;37;1156
53;22;22280;1051;36;1087
53;22;22281;1519;25;1544
53;22;22282;3308;77;3385
53;22;22283;877;26;903
53;22;22284;290;9;299
53;22;22285;258;8;266
53;22;22286;474;14;488
53;22;22287;1453;36;1489
53;22;22288;351;6;357
53;22;22289;213;1;214
53;22;22291;251;8;259
53;22;22293;408;13;421
53;22;22294;305;6;311
53;22;22295;358;8;366
53;22;22296;646;11;657
53;22;22299;1512;43;1555
53;22;22300;392;9;401
53;22;22302;911;19;930
53;22;22304;650;9;659
53;22;22305;495;5;500
53;22;22306;555;14;569
53;22;22307;2029;50;2079
53;22;22308;646;18;664
53;22;22309;195;4;199
53;22;22310;468;15;483
53;22;22311;874;35;909
53;22;22312;226;8;234
53;22;22313;306;11;317
53;22;22314;403;7;410
53;22;22315;284;11;295
53;22;22316;469;11;480
53;22;22317;265;2;267
53;22;22318;307;8;315
53;22;22319;456;13;469
53;22;22320;168;3;171
53;22;22321;1594;45;1639
53;22;22322;387;8;395
53;22;22323;815;13;828
53;22;22324;1290;55;1345
53;22;22325;3121;222;3343
53;22;22326;546;5;551
53;22;22327;1637;27;1664
53;22;22328;408;6;414
53;22;22330;395;12;407
53;22;22331;185;2;187
53;22;22332;521;9;530
53;22;22333;761;29;790
53;22;22334;127;7;134
53;22;22335;236;0;236
53;22;22337;1107;25;1132
53;22;22338;760;26;786
53;22;22339;2524;76;2600
53;22;22340;1196;27;1223
53;22;22341;692;10;702
53;22;22342;427;9;436
53;22;22343;3641;126;3767
53;22;22344;748;16;764
53;22;22345;784;15;799
53;22;22346;900;24;924
53;22;22347;1060;19;1079
53;22;22348;495;9;504
53;22;22349;1449;39;1488
53;22;22350;195;3;198
53;22;22351;544;13;557
53;22;22352;274;2;276
53;22;22353;2535;74;2609
53;22;22354;1074;23;1097
53;22;22356;943;24;967
53;22;22358;578;7;585
53;22;22359;416;6;422
53;22;22360;8459;166;8625
53;22;22361;627;12;639
53;22;22362;2416;267;2683
53;22;22363;1243;32;1275
53;22;22364;2862;82;2944
53;22;22365;187;14;201
53;22;22366;405;5;410
53;22;22368;711;28;739
53;22;22369;783;17;800
53;22;22370;348;8;356
53;22;22371;1142;20;1162
53;22;22372;2148;36;2184
53;22;22373;102;4;106
53;22;22375;695;11;706
53;22;22376;1692;31;1723
53;22;22377;797;21;818
53;22;22378;216;7;223
53;22;22379;1483;41;1524
53;22;22380;685;14;699
53;22;22381;351;8;359
53;22;22383;224;6;230
53;22;22384;1053;25;1078
53;22;22385;1092;24;1116
53;22;22386;776;20;796
53;22;22387;1285;30;1315
53;22;22388;1239;21;1260
53;22;22389;4990;104;5094
53;22;22390;777;18;795
53;22;22391;1129;16;1145
75;23;23001;1410;230;1640
75;23;23002;1075;15;1090
75;23;23003;139;0;139
75;23;23004;555;9;564
75;23;23005;198;4;202
75;23;23006;212;2;214
75;23;23007;236;10;246
75;23;23008;3248;183;3431
75;23;23009;93;0;93
75;23;23010;118;2;120
75;23;23011;160;4;164
75;23;23012;109;2;111
75;23;23013;1208;25;1233
75;23;23014;121;3;124
75;23;23015;813;16;829
75;23;23016;182;2;184
75;23;23017;164;2;166
75;23;23018;247;11;258
75;23;23019;25;0;25
75;23;23020;410;7;417
75;23;23021;765;11;776
75;23;23022;373;7;380
75;23;23023;105;1;106
75;23;23024;532;12;544
75;23;23025;1342;24;1366
75;23;23026;351;10;361
75;23;23027;235;7;242
75;23;23028;107;2;109
75;23;23029;219;2;221
75;23;23030;2478;213;2691
75;23;23031;1249;18;1267
75;23;23032;695;11;706
75;23;23033;445;8;453
75;23;23034;28;0;28
75;23;23035;707;10;717
75;23;23036;1030;14;1044
75;23;23037;79;3;82
75;23;23038;253;3;256
75;23;23039;541;24;565
75;23;23040;154;1;155
75;23;23041;243;4;247
75;23;23042;125;1;126
75;23;23043;96;0;96
75;23;23044;80;1;81
75;23;23045;868;12;880
75;23;23046;81;4;85
75;23;23047;241;3;244
75;23;23048;471;10;481
75;23;23049;249;6;255
75;23;23050;128;1;129
75;23;23051;78;1;79
75;23;23052;431;10;441
75;23;23053;205;2;207
75;23;23054;230;9;239
75;23;23055;30;0;30
75;23;23056;294;6;300
75;23;23057;551;12;563
75;23;23058;105;2;107
75;23;23059;101;6;107
75;23;23060;143;3;146
75;23;23061;755;12;767
75;23;23062;559;9;568
75;23;23063;155;1;156
75;23;23064;650;3;653
75;23;23065;274;9;283
75;23;23066;194;11;205
75;23;23067;788;9;797
75;23;23068;528;7;535
75;23;23069;412;6;418
75;23;23070;439;14;453
75;23;23071;191;6;197
75;23;23072;231;3;234
75;23;23073;425;5;430
75;23;23074;186;5;191
75;23;23075;1094;24;1118
75;23;23076;1328;32;1360
75;23;23077;439;11;450
75;23;23078;189;4;193
75;23;23079;1550;186;1736
75;23;23080;94;0;94
75;23;23081;300;4;304
75;23;23082;316;6;322
75;23;23083;247;1;248
75;23;23084;146;1;147
75;23;23086;244;3;247
75;23;23087;488;11;499
75;23;23088;121;0;121
75;23;23089;728;11;739
75;23;23090;378;6;384
75;23;23091;161;3;164
75;23;23092;680;12;692
75;23;23093;1567;22;1589
75;23;23095;1220;43;1263
75;23;23096;12734;637;13371
75;23;23097;298;3;301
75;23;23098;90;3;93
75;23;23099;318;5;323
75;23;23100;439;10;449
75;23;23101;387;13;400
75;23;23102;346;3;349
75;23;23103;323;14;337
75;23;23104;239;1;240
75;23;23105;635;2;637
75;23;23106;366;4;370
75;23;23107;129;5;134
75;23;23108;142;1;143
75;23;23109;211;5;216
75;23;23110;60;1;61
75;23;23111;251;1;252
75;23;23112;746;11;757
75;23;23113;299;6;305
75;23;23114;410;7;417
75;23;23115;247;2;249
75;23;23116;543;11;554
75;23;23117;302;7;309
75;23;23118;180;6;186
75;23;23119;43;0;43
75;23;23120;187;3;190
75;23;23122;70;4;74
75;23;23123;187;2;189
75;23;23124;652;17;669
75;23;23125;99;1;100
75;23;23127;198;6;204
75;23;23128;126;6;132
75;23;23129;65;1;66
75;23;23130;530;6;536
75;23;23131;693;13;706
75;23;23132;411;6;417
75;23;23133;345;12;357
75;23;23134;200;47;247
75;23;23136;277;9;286
75;23;23137;516;12;528
75;23;23138;169;1;170
75;23;23139;542;6;548
75;23;23140;419;9;428
75;23;23141;630;16;646
75;23;23142;287;3;290
75;23;23143;491;13;504
75;23;23144;240;3;243
75;23;23145;279;7;286
75;23;23146;241;7;248
75;23;23147;96;2;98
75;23;23148;245;2;247
75;23;23149;709;14;723
75;23;23150;156;2;158
75;23;23151;431;8;439
75;23;23152;70;0;70
75;23;23154;737;11;748
75;23;23155;364;6;370
75;23;23156;83;1;84
75;23;23157;96;0;96
75;23;23158;158;0;158
75;23;23159;150;3;153
75;23;23160;276;1;277
75;23;23162;369;3;372
75;23;23164;484;11;495
75;23;23165;577;5;582
75;23;23166;192;7;199
75;23;23167;334;8;342
75;23;23168;769;18;787
75;23;23169;632;13;645
75;23;23170;213;11;224
75;23;23171;116;1;117
75;23;23172;122;1;123
75;23;23173;139;3;142
75;23;23174;584;7;591
75;23;23175;114;1;115
75;23;23176;4982;231;5213
75;23;23177;1088;29;1117
75;23;23178;175;0;175
75;23;23179;279;4;283
75;23;23180;486;3;489
75;23;23181;158;2;160
75;23;23182;173;2;175
75;23;23183;77;2;79
75;23;23184;99;3;102
75;23;23185;284;3;287
75;23;23186;154;6;160
75;23;23187;195;2;197
75;23;23188;196;2;198
75;23;23189;1133;25;1158
75;23;23190;167;1;168
75;23;23191;195;7;202
75;23;23192;1466;21;1487
75;23;23193;2482;59;2541
75;23;23194;123;3;126
75;23;23195;1049;26;1075
75;23;23196;255;5;260
75;23;23197;369;2;371
75;23;23198;143;1;144
75;23;23199;386;8;394
75;23;23200;165;8;173
75;23;23201;212;5;217
75;23;23202;229;7;236
75;23;23203;219;7;226
75;23;23204;142;3;145
75;23;23205;143;1;144
75;23;23206;689;13;702
75;23;23207;195;3;198
75;23;23208;415;9;424
75;23;23209;184;1;185
75;23;23210;253;2;255
75;23;23211;426;9;435
75;23;23212;129;1;130
75;23;23213;181;2;183
75;23;23214;272;5;277
75;23;23215;139;4;143
75;23;23216;146;5;151
75;23;23217;343;5;348
75;23;23218;98;1;99
75;23;23219;1222;28;1250
75;23;23220;566;12;578
75;23;23221;193;5;198
75;23;23222;161;3;164
75;23;23223;215;0;215
75;23;23224;72;0;72
75;23;23225;104;1;105
75;23;23226;169;6;175
75;23;23227;201;8;209
75;23;23228;197;5;202
75;23;23229;284;2;286
75;23;23230;166;5;171
75;23;23232;209;1;210
75;23;23233;126;7;133
75;23;23234;155;1;156
75;23;23235;777;13;790
75;23;23236;257;8;265
75;23;23237;55;0;55
75;23;23238;385;7;392
75;23;23239;632;11;643
75;23;23240;405;5;410
75;23;23241;215;3;218
75;23;23242;226;3;229
75;23;23243;154;2;156
75;23;23244;587;14;601
75;23;23245;1935;57;1992
75;23;23246;350;9;359
75;23;23247;1738;114;1852
75;23;23248;359;8;367
75;23;23249;221;7;228
75;23;23250;289;3;292
75;23;23251;126;2;128
75;23;23252;156;3;159
75;23;23253;175;6;181
75;23;23254;254;2;256
75;23;23255;122;0;122
75;23;23257;715;18;733
75;23;23258;306;9;315
75;23;23259;120;1;121
75;23;23260;180;0;180
75;23;23261;288;5;293
75;23;23262;164;2;166
75;23;23263;374;5;379
75;23;23264;47;1;48
75;23;23265;54;0;54
75;23;23266;171;1;172
75;24;24001;622;7;629
75;24;24002;1772;23;1795
75;24;24004;296;3;299
75;24;24005;385;9;394
75;24;24006;196;10;206
75;24;24007;500;13;513
75;24;24008;588;10;598
75;24;24009;268;8;276
75;24;24010;1419;49;1468
75;24;24011;1297;19;1316
75;24;24012;380;9;389
75;24;24014;622;20;642
75;24;24015;268;4;272
75;24;24016;821;20;841
75;24;24018;399;10;409
75;24;24019;436;7;443
75;24;24020;894;20;914
75;24;24021;391;8;399
75;24;24022;210;5;215
75;24;24023;328;11;339
75;24;24024;48;0;48
75;24;24025;239;7;246
75;24;24026;4410;82;4492
75;24;24027;360;1;361
75;24;24028;1842;42;1884
75;24;24029;525;7;532
75;24;24030;684;16;700
75;24;24031;255;5;260
75;24;24032;371;10;381
75;24;24034;273;7;280
75;24;24035;1350;36;1386
75;24;24036;177;3;180
75;24;24037;26693;715;27408
75;24;24038;432;12;444
75;24;24039;161;4;165
75;24;24040;544;9;553
75;24;24042;670;7;677
75;24;24043;144;10;154
75;24;24045;246;4;250
75;24;24046;120;1;121
75;24;24048;322;7;329
75;24;24050;341;12;353
75;24;24051;213;6;219
75;24;24052;127;0;127
75;24;24053;10737;341;11078
75;24;24054;609;20;629
75;24;24055;765;16;781
75;24;24056;227;4;231
75;24;24057;67;0;67
75;24;24058;218;3;221
75;24;24059;349;6;355
75;24;24060;71;1;72
75;24;24061;124;6;130
75;24;24062;175;3;178
75;24;24063;150;3;153
75;24;24064;3670;56;3726
75;24;24066;213;5;218
75;24;24067;2588;42;2630
75;24;24068;1927;60;1987
75;24;24069;395;2;397
75;24;24070;506;9;515
75;24;24071;374;2;376
75;24;24073;378;12;390
75;24;24074;510;21;531
75;24;24075;319;8;327
75;24;24076;403;14;417
75;24;24077;394;8;402
75;24;24080;476;12;488
75;24;24081;634;10;644
75;24;24082;1529;28;1557
75;24;24083;185;4;189
75;24;24084;104;4;108
75;24;24085;154;1;155
75;24;24086;448;7;455
75;24;24087;815;19;834
75;24;24088;347;7;354
75;24;24089;450;13;463
75;24;24090;589;11;600
75;24;24091;1204;32;1236
75;24;24094;439;9;448
75;24;24095;405;9;414
75;24;24096;789;14;803
75;24;24097;354;10;364
75;24;24098;2965;90;3055
75;24;24100;453;3;456
75;24;24101;282;8;290
75;24;24102;4378;82;4460
75;24;24104;617;7;624
75;24;24105;135;1;136
75;24;24106;533;23;556
75;24;24107;395;6;401
75;24;24108;1074;16;1090
75;24;24109;104;2;106
75;24;24110;61;4;65
75;24;24111;72;1;73
75;24;24113;91;1;92
75;24;24114;68;2;70
75;24;24115;2148;31;2179
75;24;24116;187;1;188
75;24;24117;572;18;590
75;24;24119;250;4;254
75;24;24120;554;12;566
75;24;24121;59;2;61
75;24;24122;110;1;111
75;24;24123;119;1;120
75;24;24124;235;5;240
75;24;24126;266;12;278
75;24;24128;166;3;169
75;24;24129;478;8;486
75;24;24130;880;16;896
75;24;24131;71;0;71
75;24;24132;258;4;262
75;24;24133;1276;18;1294
75;24;24134;838;13;851
75;24;24135;683;12;695
75;24;24136;118;6;124
75;24;24137;726;77;803
75;24;24138;7387;296;7683
75;24;24139;2211;48;2259
75;24;24140;1563;34;1597
75;24;24141;182;1;183
75;24;24142;1219;42;1261
75;24;24143;725;8;733
75;24;24144;95;0;95
75;24;24145;1749;30;1779
75;24;24146;255;9;264
75;24;24147;1090;10;1100
75;24;24148;285;5;290
75;24;24150;529;19;548
75;24;24151;103;2;105
75;24;24152;909;22;931
75;24;24153;398;11;409
75;24;24154;354;10;364
75;24;24155;465;11;476
75;24;24156;1165;16;1181
75;24;24157;792;11;803
75;24;24158;399;4;403
75;24;24159;392;7;399
75;24;24160;563;2;565
75;24;24161;129;1;130
75;24;24162;408;9;417
75;24;24163;159;1;160
75;24;24164;1171;40;1211
75;24;24165;415;7;422
75;24;24167;2564;40;2604
75;24;24168;431;13;444
75;24;24171;557;8;565
75;24;24172;1097;16;1113
75;24;24174;138;1;139
75;24;24175;316;17;333
75;24;24176;36;0;36
75;24;24177;644;10;654
75;24;24179;770;28;798
75;24;24180;317;9;326
75;24;24182;1488;53;1541
75;24;24183;281;3;284
75;24;24184;147;2;149
75;24;24186;332;2;334
75;24;24188;537;13;550
75;24;24189;447;16;463
75;24;24190;263;8;271
75;24;24191;173;1;174
75;24;24192;91;3;94
75;24;24193;477;9;486
75;24;24194;1600;25;1625
75;24;24195;109;1;110
75;24;24196;490;4;494
75;24;24197;721;14;735
75;24;24199;370;7;377
75;24;24200;543;11;554
75;24;24202;146;4;150
75;24;24205;670;5;675
75;24;24206;109;4;113
75;24;24207;652;16;668
75;24;24208;242;4;246
75;24;24209;139;1;140
75;24;24210;859;20;879
75;24;24211;435;3;438
75;24;24212;740;10;750
75;24;24213;171;2;173
75;24;24214;835;10;845
75;24;24215;178;3;181
75;24;24216;153;3;156
75;24;24217;451;8;459
75;24;24218;1175;44;1219
75;24;24220;674;8;682
75;24;24221;158;3;161
75;24;24222;2653;96;2749
75;24;24223;2770;37;2807
75;24;24224;694;12;706
75;24;24225;2609;35;2644
75;24;24226;1377;21;1398
75;24;24227;981;24;1005
75;24;24228;496;13;509
75;24;24229;1688;38;1726
75;24;24230;148;1;149
75;24;24231;94;1;95
75;24;24232;70;2;72
75;24;24234;370;2;372
75;24;24236;994;15;1009
75;24;24237;1208;24;1232
75;24;24238;137;5;142
75;24;24240;334;7;341
75;24;24241;443;10;453
75;24;24242;256;1;257
75;24;24243;836;11;847
75;24;24244;193;2;195
75;24;24245;261;3;264
75;24;24246;411;5;416
75;24;24247;167;3;170
75;24;24248;283;7;290
75;24;24251;568;9;577
75;24;24252;815;20;835
75;24;24253;2280;47;2327
75;24;24254;186;1;187
75;24;24255;584;9;593
75;24;24256;3142;75;3217
75;24;24257;233;5;238
75;24;24259;1572;31;1603
75;24;24260;868;9;877
75;24;24261;289;10;299
75;24;24262;346;7;353
75;24;24263;303;13;316
75;24;24264;1850;15;1865
75;24;24266;1524;27;1551
75;24;24267;178;1;179
75;24;24268;660;13;673
75;24;24269;628;7;635
75;24;24271;492;13;505
75;24;24272;468;5;473
75;24;24273;335;10;345
75;24;24274;804;88;892
75;24;24276;404;4;408
75;24;24277;290;4;294
75;24;24278;83;1;84
75;24;24279;63;1;64
75;24;24280;459;8;467
75;24;24281;193;7;200
75;24;24282;145;7;152
75;24;24284;137;5;142
75;24;24285;410;13;423
75;24;24286;496;10;506
75;24;24287;125;2;127
75;24;24288;285;4;289
75;24;24289;1476;21;1497
75;24;24290;156;5;161
75;24;24291;2753;55;2808
75;24;24292;458;7;465
75;24;24293;300;4;304
75;24;24294;5704;69;5773
75;24;24295;1214;20;1234
75;24;24296;1139;15;1154
75;24;24297;942;13;955
75;24;24299;2762;50;2812
75;24;24300;369;10;379
75;24;24301;384;4;388
75;24;24302;308;2;310
75;24;24303;231;3;234
75;24;24304;974;23;997
75;24;24305;237;2;239
75;24;24306;126;4;130
75;24;24307;265;5;270
75;24;24308;797;10;807
75;24;24309;3611;67;3678
75;24;24311;3055;111;3166
75;24;24312;4604;101;4705
75;24;24313;53;0;53
75;24;24314;109;9;118
75;24;24316;789;16;805
75;24;24317;254;8;262
75;24;24318;312;8;320
75;24;24319;474;7;481
75;24;24320;974;17;991
75;24;24321;893;13;906
75;24;24322;29896;1580;31476
75;24;24323;183;5;188
75;24;24324;570;9;579
75;24;24325;206;4;210
75;24;24326;187;2;189
75;24;24327;127;3;130
75;24;24328;1179;20;1199
75;24;24329;1325;19;1344
75;24;24330;688;27;715
75;24;24331;721;23;744
75;24;24334;188;5;193
75;24;24335;2478;46;2524
75;24;24336;529;19;548
75;24;24337;147;2;149
75;24;24338;426;11;437
75;24;24339;148;0;148
75;24;24340;4143;80;4223
75;24;24341;1043;20;1063
75;24;24345;467;15;482
75;24;24346;377;9;386
75;24;24347;145;0;145
75;24;24348;305;1;306
75;24;24349;339;10;349
75;24;24350;2392;41;2433
75;24;24351;310;6;316
75;24;24352;3844;148;3992
75;24;24353;331;9;340
75;24;24354;3022;52;3074
75;24;24355;427;4;431
75;24;24356;1628;35;1663
75;24;24357;301;6;307
75;24;24359;122;0;122
75;24;24360;319;5;324
75;24;24361;445;8;453
75;24;24362;1588;26;1614
75;24;24364;567;20;587
75;24;24365;240;8;248
75;24;24366;856;20;876
75;24;24367;179;2;181
75;24;24370;1860;39;1899
75;24;24371;468;3;471
75;24;24372;5352;94;5446
75;24;24373;341;8;349
75;24;24374;353;4;357
75;24;24375;148;3;151
75;24;24376;1426;19;1445
75;24;24377;158;7;165
75;24;24378;81;1;82
75;24;24379;418;4;422
75;24;24380;484;2;486
75;24;24381;213;8;221
75;24;24382;526;9;535
75;24;24383;164;2;166
75;24;24384;37;1;38
75;24;24385;225;2;227
75;24;24386;215;10;225
75;24;24388;493;15;508
75;24;24390;342;9;351
75;24;24392;519;10;529
75;24;24393;88;0;88
75;24;24394;155;7;162
75;24;24395;368;6;374
75;24;24396;1548;34;1582
75;24;24397;236;7;243
75;24;24398;599;7;606
75;24;24399;105;4;109
75;24;24401;294;4;298
75;24;24403;65;0;65
75;24;24404;176;5;181
75;24;24405;327;9;336
75;24;24406;140;2;142
75;24;24407;240;7;247
75;24;24408;258;4;262
75;24;24409;1188;16;1204
75;24;24410;497;8;505
75;24;24411;162;2;164
75;24;24412;914;26;940
75;24;24413;269;0;269
75;24;24414;287;5;292
75;24;24415;251;2;253
75;24;24416;172;9;181
75;24;24417;471;8;479
75;24;24418;946;7;953
75;24;24419;864;19;883
75;24;24420;243;2;245
75;24;24421;197;6;203
75;24;24422;116;2;118
75;24;24423;310;3;313
75;24;24424;133;3;136
75;24;24425;364;6;370
75;24;24426;166;6;172
75;24;24428;601;38;639
75;24;24429;236;8;244
75;24;24432;637;17;654
75;24;24434;144;2;146
75;24;24436;1024;18;1042
75;24;24437;918;14;932
75;24;24438;236;9;245
75;24;24441;136;3;139
75;24;24442;2031;23;2054
75;24;24443;416;11;427
75;24;24444;304;7;311
75;24;24445;146;5;151
75;24;24446;50;3;53
75;24;24448;474;9;483
75;24;24449;941;7;948
75;24;24450;575;4;579
75;24;24451;796;18;814
75;24;24452;189;2;191
75;24;24453;362;6;368
75;24;24454;655;7;662
75;24;24455;734;10;744
75;24;24456;193;8;201
75;24;24457;138;1;139
75;24;24458;267;7;274
75;24;24459;284;9;293
75;24;24460;497;6;503
75;24;24461;822;17;839
75;24;24462;1706;24;1730
75;24;24463;547;15;562
75;24;24464;325;6;331
75;24;24465;236;6;242
75;24;24466;326;5;331
75;24;24468;305;6;311
75;24;24470;258;5;263
75;24;24471;625;12;637
75;24;24472;986;18;1004
75;24;24473;353;6;359
75;24;24474;168;1;169
75;24;24476;159;3;162
75;24;24477;193;5;198
75;24;24478;191;0;191
75;24;24479;1168;13;1181
75;24;24480;304;8;312
75;24;24481;519;0;519
75;24;24482;277;3;280
75;24;24483;140;7;147
75;24;24484;885;17;902
75;24;24485;420;2;422
75;24;24486;404;3;407
75;24;24487;1811;15;1826
75;24;24488;352;5;357
75;24;24489;380;5;385
75;24;24490;1115;14;1129
75;24;24491;579;9;588
75;24;24492;61;1;62
75;24;24493;93;2;95
75;24;24494;508;4;512
75;24;24495;113;3;116
75;24;24496;328;4;332
75;24;24498;827;22;849
75;24;24499;859;21;880
75;24;24500;149;7;156
75;24;24501;494;8;502
75;24;24502;90;0;90
75;24;24504;283;1;284
75;24;24505;352;3;355
75;24;24507;110;2;112
75;24;24508;210;5;215
75;24;24509;673;12;685
75;24;24510;361;12;373
75;24;24511;253;3;256
75;24;24512;287;10;297
75;24;24513;310;3;313
75;24;24514;245;2;247
75;24;24515;729;4;733
75;24;24516;1177;54;1231
75;24;24517;72;2;74
75;24;24518;280;4;284
75;24;24519;435;0;435
75;24;24520;8816;409;9225
75;24;24521;1027;19;1046
75;24;24522;368;11;379
75;24;24523;426;13;439
75;24;24524;179;5;184
75;24;24525;194;2;196
75;24;24526;713;9;722
75;24;24527;934;16;950
75;24;24528;127;2;129
75;24;24529;201;2;203
75;24;24531;212;3;215
75;24;24532;248;3;251
75;24;24533;80;4;84
75;24;24534;1202;240;1442
75;24;24535;254;3;257
75;24;24536;297;5;302
75;24;24537;249;4;253
75;24;24538;1059;11;1070
75;24;24540;1590;28;1618
75;24;24541;88;0;88
75;24;24542;80;3;83
75;24;24543;1107;14;1121
75;24;24544;386;10;396
75;24;24545;99;1;100
75;24;24546;38;0;38
75;24;24547;6266;106;6372
75;24;24548;274;5;279
75;24;24549;499;10;509
75;24;24550;1257;16;1273
75;24;24551;2871;185;3056
75;24;24552;250;4;254
75;24;24553;1742;37;1779
75;24;24554;574;13;587
75;24;24555;641;10;651
75;24;24557;7006;201;7207
75;24;24558;637;5;642
75;24;24559;332;10;342
75;24;24560;116;7;123
75;24;24562;270;11;281
75;24;24563;277;7;284
75;24;24564;690;106;796
75;24;24565;372;8;380
75;24;24566;472;4;476
75;24;24567;252;3;255
75;24;24568;1059;11;1070
75;24;24569;127;2;129
75;24;24570;42;1;43
75;24;24571;1693;14;1707
75;24;24572;191;5;196
75;24;24573;590;14;604
75;24;24574;343;8;351
75;24;24575;231;22;253
75;24;24576;242;10;252
75;24;24577;524;10;534
75;24;24580;265;2;267
75;24;24581;906;19;925
75;24;24582;454;9;463
75;24;24584;972;18;990
75;24;24585;676;12;688
75;24;24586;921;22;943
75;24;24587;817;21;838
27;25;25001;252;6;258
27;25;25002;305;5;310
27;25;25003;323;6;329
27;25;25004;1059;20;1079
27;25;25005;90;1;91
27;25;25006;88;2;90
27;25;25007;105;3;108
27;25;25008;467;4;471
27;25;25009;163;3;166
27;25;25011;740;16;756
27;25;25012;166;5;171
27;25;25013;260;3;263
27;25;25014;929;11;940
27;25;25015;704;21;725
27;25;25016;164;4;168
27;25;25017;92;3;95
27;25;25018;624;23;647
27;25;25019;381;11;392
27;25;25020;910;9;919
27;25;25021;1619;30;1649
27;25;25022;1468;39;1507
27;25;25024;900;30;930
27;25;25025;707;14;721
27;25;25026;214;5;219
27;25;25029;244;3;247
27;25;25030;430;11;441
27;25;25031;13341;208;13549
27;25;25032;425;10;435
27;25;25033;518;10;528
27;25;25035;2515;46;2561
27;25;25036;2227;31;2258
27;25;25038;161;4;165
27;25;25039;914;16;930
27;25;25040;810;14;824
27;25;25041;366;10;376
27;25;25042;228;8;236
27;25;25043;1951;53;2004
27;25;25044;59;0;59
27;25;25045;48;1;49
27;25;25046;74;2;76
27;25;25047;4989;162;5151
27;25;25048;3616;75;3691
27;25;25049;137;5;142
27;25;25050;500;5;505
27;25;25051;623;14;637
27;25;25052;67;0;67
27;25;25053;96;6;102
27;25;25054;524;13;537
27;25;25055;350;8;358
27;25;25056;117912;3232;121144
27;25;25057;5441;72;5513
27;25;25058;1345;11;1356
27;25;25059;270;5;275
27;25;25060;698;24;722
27;25;25061;116;1;117
27;25;25062;301;11;312
27;25;25063;1210;26;1236
27;25;25065;55;4;59
27;25;25066;84;1;85
27;25;25067;191;3;194
27;25;25070;373;15;388
27;25;25071;475;11;486
27;25;25072;21;1;22
27;25;25073;830;6;836
27;25;25074;978;21;999
27;25;25075;398;11;409
27;25;25077;72;0;72
27;25;25078;1064;24;1088
27;25;25079;438;11;449
27;25;25082;894;23;917
27;25;25083;191;1;192
27;25;25084;1166;17;1183
27;25;25085;388;8;396
27;25;25086;210;2;212
27;25;25087;179;3;182
27;25;25088;88;5;93
27;25;25089;94;2;96
27;25;25090;67;0;67
27;25;25091;471;8;479
27;25;25092;70;2;72
27;25;25093;76;0;76
27;25;25094;116;0;116
27;25;25095;278;3;281
27;25;25096;143;2;145
27;25;25097;478;12;490
27;25;25098;181;4;185
27;25;25099;225;6;231
27;25;25100;472;7;479
27;25;25101;571;12;583
27;25;25102;48;2;50
27;25;25103;636;14;650
27;25;25104;85;1;86
27;25;25105;588;6;594
27;25;25106;69;0;69
27;25;25107;192;0;192
27;25;25108;309;9;318
27;25;25109;326;10;336
27;25;25110;1020;19;1039
27;25;25111;362;12;374
27;25;25112;1312;26;1338
27;25;25113;142;3;145
27;25;25114;386;6;392
27;25;25115;279;3;282
27;25;25116;246;6;252
27;25;25117;91;0;91
27;25;25119;325;10;335
27;25;25120;398;10;408
27;25;25121;255;16;271
27;25;25122;525;7;532
27;25;25124;269;7;276
27;25;25125;324;5;329
27;25;25126;476;8;484
27;25;25127;2741;50;2791
27;25;25129;111;3;114
27;25;25130;11;0;11
27;25;25131;110;5;115
27;25;25132;138;4;142
27;25;25133;2023;56;2079
27;25;25134;8;0;8
27;25;25136;502;13;515
27;25;25138;125;5;130
27;25;25139;602;10;612
27;25;25141;122;6;128
27;25;25142;327;3;330
27;25;25143;207;11;218
27;25;25145;120;1;121
27;25;25147;2021;39;2060
27;25;25148;502;5;507
27;25;25149;506;11;517
27;25;25150;291;3;294
27;25;25151;133;5;138
27;25;25152;158;0;158
27;25;25153;132;1;133
27;25;25154;266;8;274
27;25;25155;299;13;312
27;25;25156;1169;22;1191
27;25;25157;1299;28;1327
27;25;25159;1220;24;1244
27;25;25160;750;27;777
27;25;25161;30;5;35
27;25;25162;208;6;214
27;25;25163;107;1;108
27;25;25164;144;2;146
27;25;25166;84;6;90
27;25;25170;1356;41;1397
27;25;25171;105;2;107
27;25;25172;232;3;235
27;25;25173;148;1;149
27;25;25174;244;3;247
27;25;25175;89;1;90
27;25;25176;315;5;320
27;25;25177;150;5;155
27;25;25178;124;3;127
27;25;25179;60;2;62
27;25;25180;115;6;121
27;25;25181;146;6;152
27;25;25182;92;0;92
27;25;25183;74;2;76
27;25;25184;281;12;293
27;25;25185;62;3;65
27;25;25186;1044;24;1068
27;25;25187;502;6;508
27;25;25188;750;26;776
27;25;25189;189;6;195
27;25;25190;1598;27;1625
27;25;25191;452;10;462
27;25;25192;170;4;174
27;25;25193;1856;46;1902
27;25;25194;112;0;112
27;25;25195;1522;290;1812
27;25;25196;1392;26;1418
27;25;25197;616;5;621
27;25;25198;726;21;747
27;25;25199;344;12;356
27;25;25200;1379;36;1415
27;25;25201;737;15;752
27;25;25202;314;5;319
27;25;25203;189;4;193
27;25;25204;3198;95;3293
27;25;25207;624;17;641
27;25;25208;178;4;182
27;25;25209;131;4;135
27;25;25210;159;4;163
27;25;25211;88;1;89
27;25;25212;2633;49;2682
27;25;25213;736;22;758
27;25;25214;491;10;501
27;25;25215;89;0;89
27;25;25216;265;10;275
27;25;25217;597;10;607
27;25;25218;160;7;167
27;25;25219;635;14;649
27;25;25220;594;15;609
27;25;25221;65;0;65
27;25;25222;1595;36;1631
27;25;25223;327;8;335
27;25;25224;835;13;848
27;25;25225;188;1;189
27;25;25226;218;4;222
27;25;25227;281;0;281
27;25;25228;3724;64;3788
27;25;25229;389;4;393
27;25;25230;3237;54;3291
27;25;25231;119;2;121
27;25;25232;100;2;102
27;25;25233;289;8;297
27;25;25234;175;7;182
27;25;25235;317;3;320
27;25;25236;288;3;291
27;25;25237;2172;34;2206
27;25;25238;157;2;159
27;25;25239;177;1;178
27;25;25240;3202;151;3353
27;25;25241;147;6;153
27;25;25242;119;0;119
27;25;25243;788;19;807
27;25;25244;84;3;87
27;25;25245;1251;22;1273
27;25;25246;280;10;290
27;25;25247;87;3;90
27;25;25248;549;112;661
27;25;25249;61;2;63
27;25;25251;174;8;182
27;25;25252;115;0;115
27;25;25253;393;4;397
27;25;25254;1405;31;1436
27;25;25255;349;13;362
27;25;25256;906;14;920
27;25;25257;268;4;272
27;25;25258;2295;39;2334
27;25;25259;1926;37;1963
27;25;25261;80;1;81
27;25;25262;466;24;490
27;25;25263;250;2;252
27;25;25264;84;2;86
27;25;25265;1317;20;1337
27;25;25266;116;3;119
27;25;25267;682;20;702
27;25;25268;115;2;117
27;25;25269;61;1;62
27;25;25270;121;6;127
27;25;25271;1691;38;1729
27;25;25273;207;4;211
27;25;25274;339;2;341
27;25;25275;201;4;205
27;25;25276;171;2;173
27;25;25277;73;0;73
27;25;25278;558;13;571
27;25;25279;119;1;120
27;25;25280;157;4;161
27;25;25281;282;0;282
27;25;25282;763;13;776
27;25;25283;64;1;65
27;25;25284;5786;73;5859
27;25;25285;1484;26;1510
27;25;25286;125;5;130
27;25;25287;1771;42;1813
27;25;25288;719;19;738
27;25;25289;73;3;76
27;25;25290;95;3;98
27;25;25293;1267;51;1318
27;25;25295;298;5;303
27;25;25296;788;28;816
27;25;25297;169;3;172
27;25;25298;242;8;250
27;25;25299;110;1;111
27;25;25300;297;5;302
27;25;25301;860;26;886
27;25;25303;226;6;232
27;25;25304;3662;62;3724
27;25;25305;593;17;610
27;25;25306;124;5;129
27;25;25307;913;11;924
27;25;25308;463;6;469
27;25;25309;1128;36;1164
27;25;25310;98;1;99
27;25;25311;207;4;211
27;25;25312;67;1;68
27;25;25313;195;3;198
27;25;25314;268;2;270
27;25;25315;2865;70;2935
27;25;25316;235;12;247
27;25;25317;265;5;270
27;25;25318;1801;33;1834
27;25;25320;1221;34;1255
27;25;25321;5188;116;5304
27;25;25322;406;10;416
27;25;25323;445;6;451
27;25;25324;162;8;170
27;25;25325;232;8;240
27;25;25326;529;13;542
27;25;25327;70;0;70
27;25;25328;786;11;797
27;25;25329;36;1;37
27;25;25330;181;3;184
27;25;25331;242;5;247
27;25;25332;575;10;585
27;25;25333;343;15;358
27;25;25334;2236;243;2479
27;25;25335;152;5;157
27;25;25336;543;5;548
27;25;25338;97;1;98
27;25;25339;223;2;225
27;25;25340;188;4;192
27;25;25341;178;6;184
27;25;25342;79;3;82
27;25;25343;165;3;168
27;25;25344;45;0;45
27;25;25345;670;14;684
27;25;25346;180;3;183
27;25;25347;823;21;844
27;25;25348;609;16;625
27;25;25349;564;15;579
27;25;25350;736;22;758
27;25;25351;234;1;235
27;25;25354;159;0;159
27;25;25355;62;0;62
27;25;25356;4266;103;4369
27;25;25357;852;8;860
27;25;25359;160;5;165
27;25;25360;171;4;175
27;25;25361;844;25;869
27;25;25362;284;12;296
27;25;25364;1795;18;1813
27;25;25365;305;5;310
27;25;25366;193;6;199
27;25;25367;4795;150;4945
27;25;25368;1479;21;1500
27;25;25369;162;3;165
27;25;25370;2152;37;2189
27;25;25371;211;7;218
27;25;25372;275;12;287
27;25;25373;46;2;48
27;25;25374;555;16;571
27;25;25375;442;10;452
27;25;25376;154;5;159
27;25;25377;231;6;237
27;25;25378;346;8;354
27;25;25379;71;4;75
27;25;25380;1339;36;1375
27;25;25381;2555;37;2592
27;25;25382;609;6;615
27;25;25383;276;6;282
27;25;25384;97;1;98
27;25;25385;128;3;131
27;25;25386;126;3;129
27;25;25387;385;9;394
27;25;25388;25806;559;26365
27;25;25389;113;4;117
27;25;25390;399;12;411
27;25;25391;179;6;185
27;25;25392;192;5;197
27;25;25393;549;7;556
27;25;25394;1472;43;1515
27;25;25395;1570;49;1619
27;25;25397;2180;42;2222
27;25;25398;115;4;119
27;25;25400;472;9;481
27;25;25401;26;0;26
27;25;25402;24;1;25
27;25;25403;2129;71;2200
27;25;25404;91;2;93
27;25;25405;899;41;940
27;25;25406;566;14;580
27;25;25408;56;1;57
27;25;25410;1342;62;1404
27;25;25411;6853;336;7189
27;25;25413;1047;36;1083
27;25;25414;123;2;125
27;25;25415;341;5;346
27;25;25416;183;4;187
27;25;25417;804;20;824
27;25;25418;1259;29;1288
27;25;25419;94;4;98
27;25;25420;166;4;170
27;25;25421;72;4;76
27;25;25422;178;4;182
27;25;25424;1544;32;1576
27;25;25425;455;16;471
27;25;25426;335;6;341
27;25;25427;394;5;399
27;25;25428;1619;38;1657
27;25;25429;1497;41;1538
27;25;25430;39;0;39
27;25;25431;339;13;352
27;25;25432;2149;58;2207
27;25;25433;41;1;42
27;25;25434;4423;104;4527
27;25;25435;163;4;167
27;25;25436;57;2;59
27;25;25437;345;3;348
27;25;25438;956;15;971
27;25;25439;254;2;256
27;25;25440;376;8;384
27;25;25441;65;1;66
27;25;25442;728;12;740
27;25;25443;78;1;79
27;25;25444;141;4;145
27;25;25445;124;2;126
27;25;25446;191;10;201
27;25;25447;344;5;349
27;25;25448;1526;29;1555
27;25;25449;138;1;139
27;25;25450;86;3;89
27;25;25451;142;3;145
27;25;25452;470;12;482
27;25;25453;1396;39;1435
27;25;25454;2127;42;2169
27;25;25455;198;4;202
27;25;25456;268;9;277
27;25;25457;109;0;109
27;25;25458;214;5;219
27;25;25459;314;10;324
27;25;25460;242;24;266
27;25;25461;304;2;306
27;25;25462;17542;898;18440
27;25;25463;4124;74;4198
27;25;25464;132;4;136
27;25;25465;203;3;206
27;25;25466;828;18;846
27;25;25467;1982;42;2024
27;25;25468;846;19;865
27;25;25469;458;12;470
27;25;25470;157;5;162
27;25;25471;138;3;141
27;25;25472;31;3;34
27;25;25473;731;21;752
27;25;25474;113;3;116
27;25;25475;1441;14;1455
27;25;25476;125;0;125
27;25;25477;396;6;402
27;25;25478;122;2;124
27;25;25479;401;4;405
27;25;25481;334;5;339
27;25;25482;667;3;670
27;25;25483;39;3;42
27;25;25485;233;4;237
27;25;25486;425;11;436
27;25;25487;46;3;49
27;25;25488;109;6;115
27;25;25489;284;27;311
27;25;25490;375;19;394
27;25;25491;116;3;119
27;25;25492;94;3;97
27;25;25493;920;26;946
27;25;25494;711;24;735
27;25;25495;2157;26;2183
27;25;25496;101;0;101
27;25;25497;617;14;631
27;25;25498;48;0;48
27;25;25499;124;2;126
27;25;25500;87;1;88
27;25;25501;37;1;38
27;25;25502;546;4;550
27;25;25503;116;4;120
27;25;25504;80;2;82
27;25;25505;1035;27;1062
27;25;25506;92;0;92
27;25;25507;75;2;77
27;25;25508;1130;23;1153
27;25;25510;361;9;370
27;25;25511;348;6;354
27;25;25512;2408;52;2460
27;25;25513;47;0;47
27;25;25514;341;17;358
27;25;25515;428;8;436
27;25;25516;124;6;130
27;25;25517;284;4;288
27;25;25518;157;9;166
27;25;25519;887;13;900
27;25;25520;176;3;179
27;25;25521;163;5;168
27;25;25522;187;3;190
27;25;25523;680;15;695
27;25;25524;903;26;929
27;25;25525;292;12;304
27;25;25526;1455;41;1496
27;25;25527;4922;73;4995
27;25;25528;74;0;74
27;25;25529;1308;27;1335
27;25;25532;3231;69;3300
27;25;25533;15;0;15
27;25;25534;193;4;197
27;25;25535;229;6;235
27;25;25536;187;2;189
27;25;25537;284;9;293
27;25;25538;116;4;120
27;25;25539;5726;143;5869
27;25;25540;307;6;313
27;25;25541;371;8;379
27;25;25542;1764;30;1794
27;25;25544;208;9;217
27;25;25545;144;2;146
27;25;25546;60;1;61
27;25;25547;3829;41;3870
27;25;25548;139;7;146
27;25;25549;632;7;639
27;25;25550;242;7;249
27;25;25551;131;1;132
27;25;25552;117;2;119
27;25;25553;399;9;408
27;25;25554;116;3;119
27;25;25555;1098;25;1123
27;25;25556;47;3;50
27;25;25557;425;8;433
27;25;25558;1528;24;1552
27;25;25559;257;6;263
27;25;25560;3020;42;3062
27;25;25561;348;9;357
27;25;25562;213;6;219
27;25;25563;122;2;124
27;25;25564;1019;16;1035
27;25;25565;275;13;288
27;25;25566;300;4;304
27;25;25567;117;3;120
27;25;25569;540;11;551
27;25;25570;26;1;27
27;25;25571;498;11;509
27;25;25572;105;5;110
27;25;25573;13;0;13
27;25;25574;175;1;176
27;25;25575;807;10;817
27;25;25578;5748;101;5849
27;25;25579;206;3;209
27;25;25580;11272;169;11441
27;25;25582;142;2;144
27;25;25583;251;5;256
27;25;25584;125;4;129
27;25;25586;815;31;846
27;25;25588;120;30;150
27;25;25589;84;1;85
27;25;25590;84;2;86
27;25;25591;157;0;157
27;25;25592;624;14;638
27;25;25594;352;4;356
27;25;25595;93;0;93
27;25;25596;71;1;72
27;25;25597;236;3;239
27;25;25598;522;7;529
27;25;25599;256;8;264
27;25;25600;205;4;209
27;25;25601;1664;83;1747
27;25;25602;115;5;120
27;25;25604;126;4;130
27;25;25605;471;11;482
27;25;25607;60;1;61
27;25;25608;175;2;177
27;25;25609;476;11;487
27;25;25611;478;7;485
27;25;25612;692;20;712
27;25;25613;94;2;96
27;25;25614;2793;54;2847
27;25;25615;441;6;447
27;25;25616;280;3;283
27;25;25617;353;6;359
27;25;25618;347;8;355
27;25;25619;202;3;205
27;25;25620;336;7;343
27;25;25621;227;36;263
27;25;25622;259;1;260
27;25;25623;126;1;127
27;25;25624;148;3;151
27;25;25625;52;1;53
27;25;25626;221;8;229
27;25;25627;304;5;309
27;25;25628;210;3;213
27;25;25629;204;6;210
27;25;25630;80;0;80
27;25;25631;601;11;612
27;25;25632;3148;85;3233
27;25;25633;735;13;748
27;25;25634;637;23;660
27;25;25635;188;3;191
84;26;26001;428;8;436
84;26;26002;1985;37;2022
84;26;26003;50;0;50
84;26;26004;2546;77;2623
84;26;26005;1791;50;1841
84;26;26006;2495;77;2572
84;26;26007;104;7;111
84;26;26008;1370;28;1398
84;26;26009;1337;35;1372
84;26;26010;4063;97;4160
84;26;26011;2580;42;2622
84;26;26012;21;3;24
84;26;26013;77;3;80
84;26;26014;594;8;602
84;26;26015;77;4;81
84;26;26016;418;16;434
84;26;26017;16;0;16
84;26;26018;12;1;13
84;26;26019;244;3;247
84;26;26020;242;6;248
84;26;26021;124;4;128
84;26;26022;88;3;91
84;26;26023;1105;19;1124
84;26;26024;354;10;364
84;26;26025;201;10;211
84;26;26026;66;0;66
84;26;26027;139;2;141
84;26;26028;235;13;248
84;26;26030;2;0;2
84;26;26031;1029;27;1056
84;26;26032;452;9;461
84;26;26033;926;17;943
84;26;26034;576;9;585
84;26;26035;477;8;485
84;26;26036;105;4;109
84;26;26037;3984;85;4069
84;26;26038;1324;33;1357
84;26;26039;874;13;887
84;26;26040;69;2;71
84;26;26041;1427;26;1453
84;26;26042;1599;26;1625
84;26;26043;144;5;149
84;26;26045;1654;47;1701
84;26;26046;68;3;71
84;26;26047;92;0;92
84;26;26048;72;1;73
84;26;26049;1250;37;1287
84;26;26050;86;2;88
84;26;26051;67;2;69
84;26;26052;481;12;493
84;26;26054;1544;22;1566
84;26;26055;153;2;155
84;26;26056;679;15;694
84;26;26057;9957;145;10102
84;26;26058;19792;566;20358
84;26;26059;212;3;215
84;26;26060;147;6;153
84;26;26061;595;10;605
84;26;26062;36;3;39
84;26;26063;2325;95;2420
84;26;26064;6814;179;6993
84;26;26065;751;8;759
84;26;26066;41;0;41
84;26;26067;58;1;59
84;26;26068;211;6;217
84;26;26069;129;3;132
84;26;26070;527;11;538
84;26;26071;1084;33;1117
84;26;26072;1292;20;1312
84;26;26073;242;3;245
84;26;26074;720;132;852
84;26;26075;28;1;29
84;26;26076;27;0;27
84;26;26077;887;22;909
84;26;26078;935;14;949
84;26;26079;1500;38;1538
84;26;26080;43;0;43
84;26;26081;576;24;600
84;26;26082;102;1;103
84;26;26083;1831;580;2411
84;26;26084;3945;147;4092
84;26;26085;2724;52;2776
84;26;26086;666;12;678
84;26;26087;1316;45;1361
84;26;26088;5934;136;6070
84;26;26089;61;1;62
84;26;26090;33;0;33
84;26;26091;42;0;42
84;26;26092;735;11;746
84;26;26093;531;13;544
84;26;26094;862;24;886
84;26;26095;922;32;954
84;26;26096;2061;37;2098
84;26;26097;616;16;632
84;26;26098;167;5;172
84;26;26099;556;12;568
84;26;26100;449;15;464
84;26;26101;143;10;153
84;26;26102;136;7;143
84;26;26103;499;4;503
84;26;26104;89;0;89
84;26;26105;72;1;73
84;26;26106;1157;22;1179
84;26;26107;542;15;557
84;26;26108;8680;274;8954
84;26;26110;659;10;669
84;26;26111;100;1;101
84;26;26112;197;8;205
84;26;26113;4718;240;4958
84;26;26114;3239;136;3375
84;26;26115;663;70;733
84;26;26116;5921;102;6023
84;26;26117;56;4;60
84;26;26118;1510;22;1532
84;26;26119;806;7;813
84;26;26121;1103;41;1144
84;26;26122;179;2;181
84;26;26123;25;0;25
84;26;26124;5520;127;5647
84;26;26125;1387;33;1420
84;26;26126;91;0;91
84;26;26127;115;2;117
84;26;26128;74;0;74
84;26;26129;1026;22;1048
84;26;26130;24;0;24
84;26;26131;150;1;151
84;26;26133;163;4;167
84;26;26134;83;1;84
84;26;26135;124;2;126
84;26;26136;51;0;51
84;26;26137;191;2;193
84;26;26138;1115;34;1149
84;26;26139;2392;57;2449
84;26;26140;717;28;745
84;26;26141;210;5;215
84;26;26142;118;1;119
84;26;26143;906;51;957
84;26;26144;1961;51;2012
84;26;26145;664;20;684
84;26;26146;1577;44;1621
84;26;26147;19;1;20
84;26;26148;1894;57;1951
84;26;26149;991;8;999
84;26;26150;11;0;11
84;26;26152;27;0;27
84;26;26153;98;1;99
84;26;26154;240;4;244
84;26;26155;1221;18;1239
84;26;26156;1057;43;1100
84;26;26157;748;17;765
84;26;26159;116;2;118
84;26;26160;1232;17;1249
84;26;26161;49;0;49
84;26;26162;891;29;920
84;26;26163;51;0;51
84;26;26164;56;1;57
84;26;26165;9202;152;9354
84;26;26166;6616;94;6710
84;26;26167;538;1;539
84;26;26168;535;14;549
84;26;26169;2182;42;2224
84;26;26170;3207;97;3304
84;26;26171;191;9;200
84;26;26172;664;10;674
84;26;26173;876;20;896
84;26;26174;1116;32;1148
84;26;26175;224;9;233
84;26;26176;1301;42;1343
84;26;26177;700;22;722
84;26;26178;534;7;541
84;26;26179;2732;56;2788
84;26;26180;220;6;226
84;26;26181;235;7;242
84;26;26182;1550;35;1585
84;26;26183;1170;30;1200
84;26;26185;587;14;601
84;26;26186;53;1;54
84;26;26188;1064;24;1088
84;26;26189;119;2;121
84;26;26190;85;2;87
84;26;26191;2400;60;2460
84;26;26192;275;11;286
84;26;26193;442;9;451
84;26;26194;581;16;597
84;26;26195;191;3;194
84;26;26196;1796;140;1936
84;26;26197;4271;118;4389
84;26;26198;39818;1234;41052
84;26;26199;28;0;28
84;26;26200;75;1;76
84;26;26201;48;6;54
84;26;26202;332;11;343
84;26;26203;281;6;287
84;26;26204;143;5;148
84;26;26205;85;0;85
84;26;26206;2942;101;3043
84;26;26207;696;18;714
84;26;26208;1937;36;1973
84;26;26209;24;0;24
84;26;26210;1025;24;1049
84;26;26211;1348;27;1375
84;26;26212;1200;30;1230
84;26;26213;681;15;696
84;26;26214;75;0;75
84;26;26215;416;22;438
84;26;26216;795;15;810
84;26;26217;193;3;196
84;26;26218;3229;56;3285
84;26;26219;473;8;481
84;26;26220;6772;186;6958
84;26;26221;71;2;73
84;26;26222;39;0;39
84;26;26223;523;6;529
84;26;26224;267;8;275
84;26;26225;699;21;720
84;26;26226;368;6;374
84;26;26227;27;0;27
84;26;26228;40;0;40
84;26;26229;95;1;96
84;26;26231;2629;69;2698
84;26;26232;592;8;600
84;26;26233;242;9;251
84;26;26234;873;17;890
84;26;26235;13510;259;13769
84;26;26236;214;4;218
84;26;26238;240;2;242
84;26;26239;206;4;210
84;26;26240;147;3;150
84;26;26241;132;2;134
84;26;26242;17;0;17
84;26;26243;968;39;1007
84;26;26244;134;1;135
84;26;26245;6;0;6
84;26;26246;126;4;130
84;26;26247;531;8;539
84;26;26248;175;5;180
84;26;26249;672;17;689
84;26;26250;3573;49;3622
84;26;26251;412;12;424
84;26;26252;10680;151;10831
84;26;26253;72;1;73
84;26;26254;18;0;18
84;26;26255;23;0;23
84;26;26256;141;2;143
84;26;26257;453;21;474
84;26;26258;887;29;916
84;26;26259;266;12;278
84;26;26261;396;11;407
84;26;26262;260;7;267
84;26;26263;146;2;148
84;26;26264;329;7;336
84;26;26266;24;0;24
84;26;26267;25;1;26
84;26;26268;122;0;122
84;26;26269;56;0;56
84;26;26270;125;2;127
84;26;26271;3395;64;3459
84;26;26272;361;9;370
84;26;26273;1023;20;1043
84;26;26274;1;0;1
84;26;26275;1640;46;1686
84;26;26276;464;14;478
84;26;26277;164;4;168
84;26;26278;283;10;293
84;26;26279;60;2;62
84;26;26281;33098;680;33778
84;26;26282;187;8;195
84;26;26283;23;0;23
84;26;26284;382;8;390
84;26;26285;280;9;289
84;26;26286;24;1;25
84;26;26287;485;15;500
84;26;26288;308;6;314
84;26;26289;1364;21;1385
84;26;26290;362;10;372
84;26;26291;84;2;86
84;26;26292;212;4;216
84;26;26293;324;8;332
84;26;26294;603;18;621
84;26;26295;1858;30;1888
84;26;26296;31;1;32
84;26;26298;419;5;424
84;26;26299;105;4;109
84;26;26300;48;1;49
84;26;26301;4248;90;4338
84;26;26302;547;11;558
84;26;26303;73;4;77
84;26;26304;275;3;278
84;26;26305;1083;22;1105
84;26;26306;316;5;321
84;26;26307;2809;66;2875
84;26;26308;150;0;150
84;26;26309;231;5;236
84;26;26310;157;4;161
84;26;26311;1419;50;1469
84;26;26312;1289;46;1335
84;26;26313;6289;128;6417
84;26;26314;382;16;398
84;26;26315;352;13;365
84;26;26316;204;7;211
84;26;26317;792;13;805
84;26;26318;35;1;36
84;26;26319;566;11;577
84;26;26320;814;10;824
84;26;26321;209;9;218
84;26;26322;420;22;442
84;26;26323;1829;48;1877
84;26;26324;8736;436;9172
84;26;26325;6758;66;6824
84;26;26326;1443;47;1490
84;26;26327;215;3;218
84;26;26328;54;1;55
84;26;26329;180;6;186
84;26;26330;2254;44;2298
84;26;26331;608;14;622
84;26;26332;2062;20;2082
84;26;26333;3960;152;4112
84;26;26334;139;2;141
84;26;26335;195;3;198
84;26;26336;567;23;590
84;26;26337;1844;30;1874
84;26;26338;1823;58;1881
84;26;26339;1487;42;1529
84;26;26340;258;4;262
84;26;26341;726;12;738
84;26;26342;318;7;325
84;26;26343;103;2;105
84;26;26344;392;7;399
84;26;26345;2155;55;2210
84;26;26346;231;5;236
84;26;26347;6106;206;6312
84;26;26348;1650;28;1678
84;26;26349;368;5;373
84;26;26350;75;1;76
84;26;26351;30;0;30
84;26;26352;258;7;265
84;26;26353;1032;18;1050
84;26;26355;602;8;610
84;26;26356;119;4;123
84;26;26357;2012;40;2052
84;26;26358;1519;43;1562
84;26;26359;36;0;36
84;26;26360;660;26;686
84;26;26361;140;3;143
84;26;26362;64749;1400;66149
84;26;26363;38;0;38
84;26;26364;326;8;334
84;26;26365;585;11;596
84;26;26367;692;20;712
84;26;26368;464;6;470
84;26;26369;58;1;59
84;26;26370;138;5;143
84;26;26371;47;2;49
84;26;26372;39;1;40
84;26;26373;245;8;253
84;26;26374;15;0;15
84;26;26375;17;1;18
84;26;26376;107;1;108
84;26;26377;1031;24;1055
84;26;26378;33;0;33
84;26;26379;908;10;918
84;26;26380;550;10;560
84;26;26381;904;12;916
84;26;26382;568;7;575
28;27;27001;327;9;336
28;27;27002;464;8;472
28;27;27003;1619;33;1652
28;27;27004;425;8;433
28;27;27005;1171;18;1189
28;27;27006;148;3;151
28;27;27008;1592;16;1608
28;27;27009;566;11;577
28;27;27010;170;7;177
28;27;27011;1196;14;1210
28;27;27012;447;16;463
28;27;27013;486;11;497
28;27;27014;848;23;871
28;27;27015;1303;31;1334
28;27;27016;8070;140;8210
28;27;27017;1363;37;1400
28;27;27018;992;11;1003
28;27;27019;163;7;170
28;27;27020;1676;43;1719
28;27;27021;340;9;349
28;27;27022;5350;109;5459
28;27;27023;708;20;728
28;27;27025;956;19;975
28;27;27026;432;9;441
28;27;27027;286;7;293
28;27;27028;336;4;340
28;27;27031;1101;39;1140
28;27;27032;1390;31;1421
28;27;27033;306;7;313
28;27;27034;632;9;641
28;27;27035;102;1;103
28;27;27036;550;21;571
28;27;27037;1178;22;1200
28;27;27038;279;6;285
28;27;27039;517;36;553
28;27;27040;448;5;453
28;27;27042;78;0;78
28;27;27043;676;21;697
28;27;27044;820;37;857
28;27;27045;772;12;784
28;27;27046;149;1;150
28;27;27047;330;8;338
28;27;27048;187;3;190
28;27;27049;4554;118;4672
28;27;27050;641;15;656
28;27;27051;2794;38;2832
28;27;27052;396;3;399
28;27;27053;219;5;224
28;27;27054;582;8;590
28;27;27055;331;6;337
28;27;27056;9848;311;10159
28;27;27057;285;6;291
28;27;27058;1769;43;1812
28;27;27059;306;3;309
28;27;27061;327;5;332
28;27;27062;1567;47;1614
28;27;27063;255;1;256
28;27;27064;676;9;685
28;27;27065;4666;58;4724
28;27;27066;328;6;334
28;27;27067;1549;28;1577
28;27;27068;174;2;176
28;27;27069;695;16;711
28;27;27070;1726;35;1761
28;27;27071;215;2;217
28;27;27072;748;22;770
28;27;27073;1214;18;1232
28;27;27074;277;8;285
28;27;27075;340;4;344
28;27;27076;493;9;502
28;27;27077;856;10;866
28;27;27078;266;11;277
28;27;27079;362;5;367
28;27;27081;183;7;190
28;27;27082;2075;49;2124
28;27;27083;261;4;265
28;27;27085;1517;22;1539
28;27;27089;1009;17;1026
28;27;27090;3649;65;3714
28;27;27091;737;5;742
28;27;27094;126;1;127
28;27;27095;665;11;676
28;27;27096;346;11;357
28;27;27097;661;12;673
28;27;27098;83;3;86
28;27;27099;798;10;808
28;27;27100;1185;24;1209
28;27;27101;523;10;533
28;27;27102;1033;22;1055
28;27;27103;3942;73;4015
28;27;27104;702;10;712
28;27;27105;3957;79;4036
28;27;27106;478;5;483
28;27;27107;1324;25;1349
28;27;27108;1204;33;1237
28;27;27109;398;7;405
28;27;27110;627;8;635
28;27;27111;202;5;207
28;27;27112;4331;125;4456
28;27;27113;139;2;141
28;27;27114;1216;23;1239
28;27;27115;338;7;345
28;27;27116;4199;152;4351
28;27;27117;1024;20;1044
28;27;27118;646;10;656
28;27;27119;1615;29;1644
28;27;27120;404;5;409
28;27;27123;491;12;503
28;27;27124;214;1;215
28;27;27125;660;10;670
28;27;27126;1134;22;1156
28;27;27127;699;22;721
28;27;27129;594;15;609
28;27;27130;419;11;430
28;27;27132;860;24;884
28;27;27133;1062;10;1072
28;27;27134;215;0;215
28;27;27135;459;11;470
28;27;27136;276;4;280
28;27;27137;201;5;206
28;27;27138;396;10;406
28;27;27139;172;6;178
28;27;27140;412;11;423
28;27;27141;63;0;63
28;27;27142;281;7;288
28;27;27144;278;5;283
28;27;27146;375;5;380
28;27;27147;688;11;699
28;27;27148;408;10;418
28;27;27149;113;3;116
28;27;27151;1734;22;1756
28;27;27152;556;9;565
28;27;27153;367;6;373
28;27;27154;598;16;614
28;27;27155;107;2;109
28;27;27156;472;17;489
28;27;27157;1326;20;1346
28;27;27158;768;28;796
28;27;27161;1083;21;1104
28;27;27162;243;5;248
28;27;27163;207;1;208
28;27;27164;819;8;827
28;27;27165;4995;65;5060
28;27;27167;657;6;663
28;27;27168;180;7;187
28;27;27169;1010;12;1022
28;27;27170;1193;21;1214
28;27;27171;385;10;395
28;27;27173;122;3;125
28;27;27174;1370;26;1396
28;27;27176;218;5;223
28;27;27177;549;13;562
28;27;27179;716;16;732
28;27;27180;2098;38;2136
28;27;27181;603;12;615
28;27;27182;157;3;160
28;27;27183;2308;43;2351
28;27;27184;124;3;127
28;27;27185;594;6;600
28;27;27187;330;6;336
28;27;27188;1489;14;1503
28;27;27189;432;7;439
28;27;27190;207;4;211
28;27;27191;2500;64;2564
28;27;27192;608;11;619
28;27;27193;1377;16;1393
28;27;27194;250;2;252
28;27;27196;1371;8;1379
28;27;27198;6126;254;6380
28;27;27199;571;12;583
28;27;27200;149;7;156
28;27;27201;235;6;241
28;27;27202;464;8;472
28;27;27203;478;17;495
28;27;27204;284;7;291
28;27;27205;452;4;456
28;27;27206;451;3;454
28;27;27207;591;7;598
28;27;27208;151;2;153
28;27;27209;601;11;612
28;27;27210;474;12;486
28;27;27212;109;2;111
28;27;27213;5952;136;6088
28;27;27214;816;14;830
28;27;27215;391;10;401
28;27;27216;493;25;518
28;27;27217;556;9;565
28;27;27218;1580;23;1603
28;27;27219;549;7;556
28;27;27220;349;8;357
28;27;27222;198;4;202
28;27;27224;460;10;470
28;27;27226;3730;82;3812
28;27;27227;665;11;676
28;27;27228;300;3;303
28;27;27229;46349;1225;47574
28;27;27230;3702;55;3757
28;27;27231;447;7;454
28;27;27232;344;7;351
28;27;27233;727;11;738
28;27;27234;348;6;354
28;27;27235;171;3;174
28;27;27237;166;2;168
28;27;27238;1162;29;1191
28;27;27239;419;7;426
28;27;27240;221;4;225
28;27;27241;175;5;180
28;27;27242;1017;14;1031
28;27;27243;739;10;749
28;27;27245;259;8;267
28;27;27246;1834;19;1853
28;27;27247;324;3;327
28;27;27248;197;3;200
28;27;27249;1155;21;1176
28;27;27251;549;8;557
28;27;27252;328;7;335
28;27;27254;846;23;869
28;27;27256;624;9;633
28;27;27258;522;7;529
28;27;27259;90;4;94
28;27;27260;663;8;671
28;27;27261;448;12;460
28;27;27263;1244;13;1257
28;27;27266;317;2;319
28;27;27267;350;4;354
28;27;27269;194;3;197
28;27;27271;329;13;342
28;27;27273;381;7;388
28;27;27275;6860;98;6958
28;27;27276;285;8;293
28;27;27277;737;15;752
28;27;27278;1945;38;1983
28;27;27279;3058;52;3110
28;27;27280;837;7;844
28;27;27281;226;8;234
28;27;27282;606;13;619
28;27;27284;11696;166;11862
28;27;27285;494;13;507
28;27;27286;409;5;414
28;27;27287;865;17;882
28;27;27288;599;14;613
28;27;27289;168;3;171
28;27;27290;1256;16;1272
28;27;27291;126;11;137
28;27;27294;991;16;1007
28;27;27295;478;15;493
28;27;27298;315;6;321
28;27;27299;3994;81;4075
28;27;27300;527;4;531
28;27;27301;1334;28;1362
28;27;27302;1305;13;1318
28;27;27304;166;4;170
28;27;27306;2954;60;3014
28;27;27307;466;7;473
28;27;27309;504;7;511
28;27;27310;426;8;434
28;27;27311;1086;5;1091
28;27;27312;273;13;286
28;27;27313;609;5;614
28;27;27315;269;8;277
28;27;27316;1278;27;1305
28;27;27317;458;10;468
28;27;27318;259;3;262
28;27;27319;307;5;312
28;27;27320;304;0;304
28;27;27321;134;5;139
28;27;27322;1392;19;1411
28;27;27323;281;3;284
28;27;27324;617;14;631
28;27;27325;187;3;190
28;27;27326;318;13;331
28;27;27327;212;8;220
28;27;27329;771;22;793
28;27;27330;133;4;137
28;27;27331;456;10;466
28;27;27332;782;12;794
28;27;27333;718;7;725
28;27;27334;109;1;110
28;27;27335;1077;32;1109
28;27;27336;431;4;435
28;27;27337;356;6;362
28;27;27338;674;8;682
28;27;27339;790;15;805
28;27;27340;710;8;718
28;27;27341;67;3;70
28;27;27342;202;6;208
28;27;27343;1280;55;1335
28;27;27345;209;2;211
28;27;27346;234;4;238
28;27;27347;785;26;811
28;27;27348;1756;20;1776
28;27;27349;867;13;880
28;27;27350;999;17;1016
28;27;27351;1423;24;1447
28;27;27353;470;8;478
28;27;27354;426;4;430
28;27;27355;2665;30;2695
28;27;27358;591;13;604
28;27;27359;226;1;227
28;27;27360;329;7;336
28;27;27361;386;5;391
28;27;27363;221;7;228
28;27;27364;195;3;198
28;27;27365;2028;38;2066
28;27;27366;207;3;210
28;27;27367;1487;15;1502
28;27;27368;335;9;344
28;27;27369;79;2;81
28;27;27370;329;9;338
28;27;27371;159;1;160
28;27;27372;682;5;687
28;27;27373;118;2;120
28;27;27374;530;14;544
28;27;27375;18518;403;18921
28;27;27376;223;5;228
28;27;27377;712;6;718
28;27;27378;1143;24;1167
28;27;27379;444;8;452
28;27;27380;265;4;269
28;27;27381;162;0;162
28;27;27382;319;9;328
28;27;27383;376;11;387
28;27;27384;498;11;509
28;27;27385;1497;41;1538
28;27;27386;1329;7;1336
28;27;27388;487;9;496
28;27;27389;462;17;479
28;27;27390;1121;16;1137
28;27;27391;1599;21;1620
28;27;27392;150;4;154
28;27;27393;503;2;505
28;27;27394;492;11;503
28;27;27395;88;1;89
28;27;27396;467;9;476
28;27;27397;1737;42;1779
28;27;27398;1476;105;1581
28;27;27399;52;1;53
28;27;27400;342;4;346
28;27;27401;177;3;180
28;27;27403;236;12;248
28;27;27404;91;1;92
28;27;27405;102;5;107
28;27;27406;889;24;913
28;27;27407;325;9;334
28;27;27408;603;19;622
28;27;27410;643;7;650
28;27;27411;232;2;234
28;27;27412;1491;35;1526
28;27;27413;777;12;789
28;27;27414;843;10;853
28;27;27415;369;7;376
28;27;27417;669;12;681
28;27;27418;105;0;105
28;27;27419;760;17;777
28;27;27420;164;7;171
28;27;27421;640;13;653
28;27;27422;876;22;898
28;27;27423;772;18;790
28;27;27424;326;8;334
28;27;27425;2406;46;2452
28;27;27426;1318;7;1325
28;27;27427;420;8;428
28;27;27428;4241;221;4462
28;27;27429;183;0;183
28;27;27430;343;3;346
28;27;27431;578;6;584
28;27;27432;697;7;704
28;27;27433;191;2;193
28;27;27434;55;0;55
28;27;27435;285;3;288
28;27;27436;440;6;446
28;27;27437;340;6;346
28;27;27438;2275;40;2315
28;27;27439;1133;37;1170
28;27;27440;659;22;681
28;27;27441;74;1;75
28;27;27442;198;7;205
28;27;27444;230;2;232
28;27;27445;253;4;257
28;27;27446;479;3;482
28;27;27447;898;56;954
28;27;27448;5056;127;5183
28;27;27451;292;6;298
28;27;27453;1802;20;1822
28;27;27454;465;7;472
28;27;27455;165;3;168
28;27;27456;760;18;778
28;27;27457;696;12;708
28;27;27458;2648;27;2675
28;27;27459;73;2;75
28;27;27460;205;5;210
28;27;27462;161;1;162
28;27;27463;721;8;729
28;27;27464;911;19;930
28;27;27465;402;13;415
28;27;27466;336;5;341
28;27;27467;9982;272;10254
28;27;27468;602;8;610
28;27;27469;4146;58;4204
28;27;27470;1134;22;1156
28;27;27471;205;7;212
28;27;27472;276;3;279
28;27;27473;909;26;935
28;27;27474;1158;22;1180
28;27;27475;164;1;165
28;27;27476;388;8;396
28;27;27477;697;26;723
28;27;27478;949;25;974
28;27;27480;652;7;659
28;27;27481;403;54;457
28;27;27482;169;4;173
28;27;27483;435;6;441
28;27;27485;833;8;841
28;27;27486;654;18;672
28;27;27487;662;2;664
28;27;27488;194;4;198
28;27;27489;521;13;534
28;27;27490;267;4;271
28;27;27492;317;10;327
28;27;27493;3288;52;3340
28;27;27495;237;2;239
28;27;27496;516;6;522
28;27;27497;1045;17;1062
28;27;27498;367;4;371
28;27;27500;1679;56;1735
28;27;27501;259;6;265
28;27;27502;2214;28;2242
28;27;27504;1288;38;1326
28;27;27505;165;1;166
28;27;27507;4031;66;4097
28;27;27508;198;2;200
28;27;27511;721;11;732
28;27;27512;336;7;343
28;27;27514;380;2;382
28;27;27516;1412;34;1446
28;27;27517;2093;47;2140
28;27;27518;749;13;762
28;27;27520;142;1;143
28;27;27521;138;6;144
28;27;27522;436;4;440
28;27;27524;868;6;874
28;27;27525;298;18;316
28;27;27527;205;7;212
28;27;27528;3681;82;3763
28;27;27529;435;9;444
28;27;27530;82;3;85
28;27;27531;206;4;210
28;27;27533;494;20;514
28;27;27534;886;10;896
28;27;27535;438;9;447
28;27;27536;538;15;553
28;27;27537;876;14;890
28;27;27538;547;9;556
28;27;27539;385;13;398
28;27;27540;670;15;685
28;27;27541;220;6;226
28;27;27542;887;15;902
28;27;27543;887;11;898
28;27;27544;204;5;209
28;27;27545;123;5;128
28;27;27546;168;2;170
28;27;27547;871;21;892
28;27;27548;1174;25;1199
28;27;27550;307;7;314
28;27;27552;249;5;254
28;27;27553;422;2;424
28;27;27554;3338;105;3443
28;27;27555;246;5;251
28;27;27556;65;0;65
28;27;27557;464;6;470
28;27;27558;179;6;185
28;27;27560;251;12;263
28;27;27561;652;11;663
28;27;27562;4425;136;4561
28;27;27563;825;23;848
28;27;27564;333;6;339
28;27;27565;681;9;690
28;27;27567;280;6;286
28;27;27568;495;8;503
28;27;27569;245;10;255
28;27;27570;100;2;102
28;27;27571;336;10;346
28;27;27572;289;4;293
28;27;27576;650;15;665
28;27;27577;435;11;446
28;27;27578;596;16;612
28;27;27579;99;2;101
28;27;27580;2426;31;2457
28;27;27582;1696;16;1712
28;27;27584;282;9;291
28;27;27586;173;1;174
28;27;27587;789;6;795
28;27;27589;968;32;1000
28;27;27590;236;3;239
28;27;27591;595;12;607
28;27;27592;246;3;249
28;27;27593;1614;22;1636
28;27;27594;276;1;277
28;27;27595;1012;13;1025
28;27;27597;585;1;586
28;27;27598;1249;26;1275
28;27;27599;911;10;921
28;27;27601;433;10;443
28;27;27602;5594;169;5763
28;27;27603;313;6;319
28;27;27604;157;2;159
28;27;27605;237;5;242
28;27;27606;488;1;489
28;27;27608;446;9;455
28;27;27609;333;6;339
28;27;27610;56;1;57
28;27;27611;321;10;331
28;27;27612;333;6;339
28;27;27613;379;4;383
28;27;27614;167;2;169
28;27;27615;192;3;195
28;27;27616;1890;52;1942
28;27;27617;530;9;539
28;27;27618;470;11;481
28;27;27620;465;2;467
28;27;27621;170;5;175
28;27;27622;1852;55;1907
28;27;27623;492;9;501
28;27;27624;883;24;907
28;27;27625;359;2;361
28;27;27627;245;12;257
28;27;27629;1789;16;1805
28;27;27630;318;40;358
28;27;27631;372;4;376
28;27;27632;579;8;587
28;27;27633;495;4;499
28;27;27635;141;1;142
28;27;27638;3700;52;3752
28;27;27640;192;4;196
28;27;27641;260;5;265
28;27;27643;1069;23;1092
28;27;27644;558;41;599
28;27;27645;155;4;159
28;27;27646;446;5;451
28;27;27649;353;7;360
28;27;27650;468;8;476
28;27;27652;310;8;318
28;27;27654;1121;12;1133
28;27;27655;730;160;890
28;27;27656;1311;31;1342
28;27;27658;362;6;368
28;27;27659;123;6;129
28;27;27660;237;2;239
28;27;27661;425;9;434
28;27;27662;330;11;341
28;27;27663;167;4;171
28;27;27664;513;7;520
28;27;27665;762;13;775
28;27;27666;565;19;584
28;27;27667;384;9;393
28;27;27668;701;11;712
28;27;27669;441;6;447
28;27;27670;961;18;979
28;27;27671;164;7;171
28;27;27672;357;1;358
28;27;27673;178;4;182
28;27;27674;267;7;274
28;27;27677;413;8;421
28;27;27678;1040;24;1064
28;27;27679;7614;364;7978
28;27;27680;193;6;199
28;27;27681;23727;677;24404
28;27;27682;657;16;673
28;27;27683;232;3;235
28;27;27684;831;14;845
28;27;27685;659;18;677
28;27;27686;48;0;48
28;27;27689;348;16;364
28;27;27690;311;1;312
28;27;27691;863;19;882
28;27;27692;161;6;167
28;27;27693;1296;32;1328
28;27;27694;314;15;329
28;27;27695;281;6;287
28;27;27696;932;17;949
28;27;27697;330;17;347
28;27;27698;559;13;572
28;27;27699;119;3;122
28;27;27700;728;5;733
28;27;27701;12910;287;13197
24;28;28001;2390;56;2446
24;28;28003;139;4;143
24;28;28004;316;3;319
24;28;28005;747;90;837
24;28;28006;1825;47;1872
24;28;28007;2697;103;2800
24;28;28008;206;2;208
24;28;28009;72;1;73
24;28;28010;325;8;333
24;28;28012;3653;63;3716
24;28;28013;1549;25;1574
24;28;28014;668;7;675
24;28;28015;6090;87;6177
24;28;28016;131;6;137
24;28;28018;1501;16;1517
24;28;28019;208;4;212
24;28;28021;1581;30;1611
24;28;28022;1139;31;1170
24;28;28023;1376;26;1402
24;28;28024;1722;60;1782
24;28;28025;107;2;109
24;28;28026;246;0;246
24;28;28027;1224;20;1244
24;28;28028;260;5;265
24;28;28029;318;7;325
24;28;28030;275;8;283
24;28;28031;390;111;501
24;28;28032;339;4;343
24;28;28033;799;32;831
24;28;28034;888;12;900
24;28;28035;979;23;1002
24;28;28036;847;20;867
24;28;28037;334;5;339
24;28;28038;112;5;117
24;28;28039;1671;31;1702
24;28;28040;324;9;333
24;28;28041;276;2;278
24;28;28045;224;6;230
24;28;28046;485;9;494
24;28;28047;724;15;739
24;28;28048;742;14;756
24;28;28049;244;5;249
24;28;28050;267;6;273
24;28;28051;4846;100;4946
24;28;28052;752;15;767
24;28;28053;250;3;253
24;28;28054;504;11;515
24;28;28055;560;9;569
24;28;28056;1699;46;1745
24;28;28057;592;9;601
24;28;28058;358;4;362
24;28;28059;1823;28;1851
24;28;28060;263;5;268
24;28;28061;3311;36;3347
24;28;28062;899;15;914
24;28;28064;2007;51;2058
24;28;28065;108;5;113
24;28;28067;90;2;92
24;28;28068;433;10;443
24;28;28070;3715;109;3824
24;28;28071;688;3;691
24;28;28072;413;0;413
24;28;28073;343;1;344
24;28;28074;256;4;260
24;28;28075;1016;181;1197
24;28;28076;194;3;197
24;28;28077;176;3;179
24;28;28078;184;4;188
24;28;28079;300;4;304
24;28;28080;254;3;257
24;28;28081;306;5;311
24;28;28082;634;14;648
24;28;28084;711;9;720
24;28;28085;38534;1164;39698
24;28;28086;327;8;335
24;28;28087;239;4;243
24;28;28088;13096;336;13432
24;28;28089;2596;32;2628
24;28;28090;104;3;107
24;28;28091;145;3;148
24;28;28092;232;6;238
24;28;28094;1670;27;1697
24;28;28095;275;6;281
24;28;28096;1226;18;1244
24;28;28098;1841;49;1890
24;28;28099;1106;22;1128
24;28;28100;447;6;453
24;28;28102;722;9;731
24;28;28103;5618;124;5742
24;28;28104;898;28;926
24;28;28105;555;6;561
24;28;28106;406;11;417
24;28;28107;363;9;372
24;28;28108;232;8;240
24;28;28109;318;5;323
24;28;28110;4078;118;4196
24;28;28111;358;13;371
24;28;28113;1343;32;1375
24;28;28114;136;0;136
24;28;28116;2831;61;2892
24;28;28117;267;9;276
24;28;28118;427;15;442
24;28;28119;153;2;155
24;28;28120;455;2;457
24;28;28121;108;0;108
24;28;28122;1504;23;1527
24;28;28123;451;8;459
24;28;28124;738;20;758
24;28;28126;200;4;204
24;28;28127;1259;27;1286
24;28;28128;432;5;437
24;28;28129;758;19;777
24;28;28130;996;13;1009
24;28;28132;659;16;675
24;28;28134;30646;519;31165
24;28;28135;1222;57;1279
24;28;28136;166;5;171
24;28;28137;838;17;855
24;28;28139;191;2;193
24;28;28140;5634;67;5701
24;28;28141;317;11;328
24;28;28142;184;2;186
24;28;28143;245;3;248
24;28;28144;212;7;219
24;28;28146;855;12;867
24;28;28147;600;10;610
24;28;28148;368;11;379
24;28;28149;621;18;639
24;28;28151;176;5;181
24;28;28153;208;7;215
24;28;28154;1696;33;1729
24;28;28155;205;2;207
24;28;28156;900;16;916
24;28;28157;121;4;125
24;28;28158;1070;27;1097
24;28;28159;341;4;345
24;28;28160;834;8;842
24;28;28161;502;7;509
24;28;28162;305;5;310
24;28;28163;213;3;216
24;28;28164;735;10;745
24;28;28166;253;2;255
24;28;28167;386;6;392
24;28;28168;3693;57;3750
24;28;28169;223;7;230
24;28;28170;281;6;287
24;28;28171;921;22;943
24;28;28172;797;15;812
24;28;28173;1494;34;1528
24;28;28175;169;4;173
24;28;28176;679;13;692
24;28;28177;666;12;678
24;28;28178;313;6;319
24;28;28180;501;13;514
24;28;28182;315;2;317
24;28;28183;690;3;693
24;28;28184;342;4;346
24;28;28185;1302;22;1324
24;28;28187;656;13;669
24;28;28188;947;16;963
24;28;28189;178;4;182
24;28;28190;458;12;470
24;28;28191;2682;57;2739
24;28;28192;316;3;319
24;28;28193;135;3;138
24;28;28194;411;16;427
24;28;28195;748;22;770
24;28;28196;3266;50;3316
24;28;28197;148;3;151
24;28;28198;801;31;832
24;28;28199;2571;50;2621
24;28;28200;422;5;427
24;28;28201;1961;41;2002
24;28;28202;325;6;331
24;28;28203;638;7;645
24;28;28206;679;12;691
24;28;28207;230;4;234
24;28;28208;382;14;396
24;28;28209;5686;160;5846
24;28;28210;220;2;222
24;28;28211;578;7;585
24;28;28212;196;8;204
24;28;28213;665;10;675
24;28;28214;3329;81;3410
24;28;28215;253;6;259
24;28;28216;203;1;204
24;28;28217;180;2;182
24;28;28218;15403;215;15618
24;28;28219;389;10;399
24;28;28220;6689;320;7009
24;28;28221;140;8;148
24;28;28222;385;6;391
24;28;28223;1542;22;1564
24;28;28225;649;11;660
24;28;28226;906;16;922
24;28;28227;4457;82;4539
24;28;28229;11127;258;11385
24;28;28230;383;7;390
24;28;28231;178;3;181
24;28;28232;592;30;622
24;28;28233;1152;26;1178
24;28;28234;461;11;472
24;28;28235;369;3;372
24;28;28236;2181;60;2241
24;28;28237;207;4;211
24;28;28239;983;25;1008
24;28;28240;513;8;521
24;28;28242;98;3;101
24;28;28243;214;6;220
24;28;28245;360;9;369
24;28;28246;530;9;539
24;28;28247;568;15;583
24;28;28248;329;6;335
24;28;28249;614;18;632
24;28;28251;1061;27;1088
24;28;28252;189;3;192
24;28;28253;1067;84;1151
24;28;28254;795;13;808
24;28;28255;170;0;170
24;28;28256;449;14;463
24;28;28257;87;2;89
24;28;28259;330;5;335
24;28;28260;99;5;104
24;28;28261;599;12;611
24;28;28263;252;7;259
24;28;28264;139;5;144
24;28;28265;252;2;254
24;28;28267;508;5;513
24;28;28268;17;2;19
24;28;28269;1899;41;1940
24;28;28270;223;4;227
24;28;28271;140;4;144
24;28;28272;159;3;162
24;28;28273;139;2;141
24;28;28274;242;6;248
24;28;28275;659;15;674
24;28;28276;208;8;216
24;28;28277;306;13;319
24;28;28278;1480;34;1514
24;28;28279;3981;65;4046
24;28;28280;9491;450;9941
24;28;28281;518;9;527
24;28;28282;431;11;442
24;28;28283;289;5;294
24;28;28284;277;9;286
24;28;28285;349;9;358
24;28;28286;622;15;637
24;28;28287;1012;15;1027
24;28;28289;220;6;226
24;28;28290;287;9;296
24;28;28291;526;16;542
24;28;28292;734;16;750
24;28;28293;1197;28;1225
24;28;28294;524;13;537
24;28;28296;269;4;273
24;28;28298;2756;57;2813
24;28;28299;171;6;177
24;28;28300;154;6;160
24;28;28301;444;6;450
24;28;28302;1099;319;1418
24;28;28303;101;3;104
24;28;28304;433;6;439
24;28;28305;299;5;304
24;28;28306;204;6;210
24;28;28308;259;11;270
24;28;28309;1071;16;1087
24;28;28310;264;6;270
24;28;28312;130;2;132
24;28;28313;194;1;195
24;28;28314;116;8;124
24;28;28315;22;1;23
24;28;28316;126;3;129
24;28;28317;564;5;569
24;28;28319;373;13;386
24;28;28321;838;14;852
24;28;28322;498;9;507
24;28;28323;285;1;286
24;28;28324;886;23;909
24;28;28325;1055;27;1082
24;28;28326;360;2;362
24;28;28327;189;2;191
24;28;28329;159;2;161
24;28;28330;1375;32;1407
24;28;28331;973;19;992
24;28;28332;1090;21;1111
24;28;28333;140;3;143
24;28;28334;2195;54;2249
24;28;28335;853;24;877
24;28;28336;107;1;108
24;28;28337;2817;67;2884
24;28;28339;355;11;366
24;28;28341;249;5;254
24;28;28342;263;5;268
24;28;28343;444;11;455
24;28;28344;264;10;274
24;28;28346;57;3;60
24;28;28347;933;29;962
24;28;28348;4019;71;4090
24;28;28349;257;8;265
24;28;28350;934;21;955
24;28;28351;408;8;416
24;28;28352;1569;41;1610
24;28;28353;403;5;408
24;28;28354;419;69;488
24;28;28355;296;9;305
24;28;28357;1059;30;1089
24;28;28358;2072;67;2139
24;28;28359;4041;46;4087
24;28;28360;920;17;937
24;28;28362;503;12;515
24;28;28363;1024;13;1037
24;28;28364;766;13;779
24;28;28365;409;9;418
24;28;28366;320;3;323
24;28;28367;330;6;336
24;28;28368;197;3;200
24;28;28369;758;10;768
24;28;28370;505;11;516
24;28;28371;1101;20;1121
24;28;28372;568;12;580
24;28;28373;3032;47;3079
24;28;28374;538;3;541
24;28;28375;369;6;375
24;28;28377;1761;44;1805
24;28;28378;524;11;535
24;28;28379;467;10;477
24;28;28380;1998;171;2169
24;28;28382;889;15;904
24;28;28383;706;6;712
24;28;28385;452;34;486
24;28;28386;1245;21;1266
24;28;28387;982;11;993
24;28;28388;1044;32;1076
24;28;28389;341;8;349
24;28;28390;312;6;318
24;28;28391;2595;32;2627
24;28;28392;164;2;166
24;28;28393;2243;66;2309
24;28;28394;1422;28;1450
24;28;28395;433;14;447
24;28;28396;310;4;314
24;28;28397;407;13;420
24;28;28398;1167;22;1189
24;28;28400;194;8;202
24;28;28401;454;8;462
24;28;28403;770;21;791
24;28;28404;12472;150;12622
24;28;28405;1070;21;1091
24;28;28406;1247;19;1266
24;28;28407;295;8;303
24;28;28408;121;3;124
24;28;28409;455;15;470
24;28;28410;303;4;307
24;28;28411;172;2;174
24;28;28414;65;5;70
24;28;28415;1688;31;1719
24;28;28417;1335;28;1363
24;28;28418;163;5;168
24;28;28419;344;8;352
24;28;28421;275;5;280
24;28;28422;3914;61;3975
24;28;28423;598;14;612
24;28;28424;1616;39;1655
24;28;28425;575;11;586
24;28;28426;498;9;507
53;29;29001;998;19;1017
53;29;29002;1376;33;1409
53;29;29003;3692;66;3758
53;29;29004;5668;157;5825
53;29;29005;1239;31;1270
53;29;29006;3616;63;3679
53;29;29007;892;31;923
53;29;29008;1000;21;1021
53;29;29010;1645;34;1679
53;29;29011;3530;86;3616
53;29;29012;188;2;190
53;29;29013;218;6;224
53;29;29014;430;9;439
53;29;29015;3553;63;3616
53;29;29016;1028;11;1039
53;29;29017;861;27;888
53;29;29018;438;5;443
53;29;29019;139926;2629;142555
53;29;29020;5675;114;5789
53;29;29021;1912;49;1961
53;29;29022;2466;55;2521
53;29;29023;3189;103;3292
53;29;29024;7155;613;7768
53;29;29025;1538;45;1583
53;29;29026;5164;422;5586
53;29;29027;3650;100;3750
53;29;29028;921;20;941
53;29;29029;1145;18;1163
53;29;29030;3683;115;3798
53;29;29031;4528;114;4642
53;29;29032;2080;50;2130
53;29;29033;524;10;534
53;29;29034;658;6;664
53;29;29035;1114;19;1133
53;29;29036;608;7;615
53;29;29037;4187;125;4312
53;29;29038;998;26;1024
53;29;29039;19816;856;20672
53;29;29040;2750;76;2826
53;29;29041;1890;31;1921
53;29;29042;7386;219;7605
53;29;29043;1817;46;1863
53;29;29044;1967;39;2006
53;29;29045;2215;66;2281
53;29;29046;14000;365;14365
53;29;29047;1877;35;1912
53;29;29048;2251;43;2294
53;29;29049;3320;141;3461
53;29;29051;8434;203;8637
53;29;29053;1744;41;1785
53;29;29054;642;15;657
53;29;29055;3215;78;3293
53;29;29056;1947;31;1978
53;29;29057;3438;122;3560
53;29;29058;9864;484;10348
53;29;29059;1050;32;1082
53;29;29060;2786;79;2865
53;29;29061;6215;135;6350
53;29;29062;1098;35;1133
53;29;29063;433;7;440
53;29;29064;447;4;451
53;29;29065;908;15;923
53;29;29066;1828;30;1858
53;29;29067;1298;41;1339
53;29;29068;2502;52;2554
53;29;29069;8061;160;8221
53;29;29070;526;10;536
53;29;29071;783;3;786
53;29;29072;2681;48;2729
53;29;29073;939;34;973
53;29;29074;1008;17;1025
53;29;29075;15050;357;15407
53;29;29076;4550;65;4615
53;29;29077;1991;47;2038
53;29;29078;2036;47;2083
53;29;29079;1267;43;1310
53;29;29080;2232;69;2301
53;29;29081;1406;27;1433
53;29;29082;452;13;465
53;29;29083;260;2;262
53;29;29084;160;6;166
53;29;29085;733;18;751
53;29;29086;1453;22;1475
53;29;29087;725;16;741
53;29;29089;857;23;880
53;29;29090;782;25;807
53;29;29091;2097;39;2136
53;29;29093;1422;31;1453
53;29;29094;665;14;679
53;29;29095;1495;26;1521
53;29;29097;2028;52;2080
53;29;29098;2145;53;2198
53;29;29099;821;22;843
53;29;29100;414;12;426
53;29;29101;3576;112;3688
53;29;29102;959;12;971
53;29;29103;15918;614;16532
53;29;29104;345;6;351
53;29;29105;9151;320;9471
53;29;29106;1850;41;1891
53;29;29107;884;13;897
53;29;29108;1479;40;1519
53;29;29109;1486;36;1522
53;29;29110;861;14;875
53;29;29111;1314;25;1339
53;29;29112;957;18;975
53;29;29113;2362;39;2401
53;29;29114;351;7;358
53;29;29115;290;4;294
53;29;29116;154;2;156
53;29;29117;5672;118;5790
53;29;29119;1460;37;1497
53;29;29120;1970;65;2035
53;29;29122;676;16;692
53;29;29123;784;20;804
53;29;29124;7322;229;7551
53;29;29125;826;17;843
53;29;29126;207;6;213
53;29;29128;406;6;412
53;29;29130;5092;131;5223
53;29;29131;474;14;488
53;29;29132;795;31;826
53;29;29133;1513;43;1556
53;29;29134;795;26;821
53;29;29135;4013;107;4120
53;29;29136;1158;23;1181
53;29;29137;2133;53;2186
53;29;29139;874;141;1015
53;29;29140;3910;86;3996
53;29;29141;348;4;352
53;29;29142;460;4;464
53;29;29143;968;21;989
53;29;29144;759;9;768
53;29;29145;873;28;901
53;29;29146;3408;50;3458
53;29;29147;3242;79;3321
53;29;29148;943;30;973
53;29;29150;6742;133;6875
53;29;29151;14845;457;15302
53;29;29152;701;15;716
53;29;29153;2686;52;2738
53;29;29155;833;19;852
53;29;29156;2049;43;2092
53;29;29158;5149;100;5249
53;29;29159;844;17;861
53;29;29160;8515;164;8679
53;29;29161;3188;82;3270
53;29;29162;3640;265;3905
53;29;29163;3184;77;3261
53;29;29165;3568;84;3652
53;29;29166;507;19;526
53;29;29167;1985;44;2029
53;29;29168;1230;20;1250
53;29;29169;3178;76;3254
53;29;29170;4191;163;4354
53;29;29171;3828;75;3903
53;29;29172;2245;68;2313
53;29;29173;2471;55;2526
53;29;29174;6223;187;6410
53;29;29175;2108;51;2159
53;29;29176;1784;44;1828
53;29;29177;3854;91;3945
53;29;29178;6312;128;6440
53;29;29179;3737;117;3854
53;29;29180;913;22;935
53;29;29181;2944;71;3015
53;29;29182;1063;22;1085
53;29;29183;714;9;723
53;29;29184;2535;57;2592
53;29;29185;3497;93;3590
53;29;29186;1610;61;1671
53;29;29187;791;28;819
53;29;29188;2737;124;2861
53;29;29189;13161;365;13526
53;29;29190;4183;105;4288
53;29;29191;3454;94;3548
53;29;29192;1761;45;1806
53;29;29193;1430;29;1459
53;29;29195;6640;130;6770
53;29;29196;2166;42;2208
53;29;29197;3951;109;4060
53;29;29198;1838;46;1884
53;29;29199;5086;171;5257
53;29;29201;2119;38;2157
53;29;29202;1279;36;1315
53;29;29204;2084;35;2119
53;29;29205;1174;26;1200
53;29;29206;2294;96;2390
53;29;29207;4517;291;4808
53;29;29208;1245;29;1274
53;29;29209;3832;104;3936
53;29;29210;2862;72;2934
53;29;29211;659;18;677
53;29;29212;13496;245;13741
53;29;29213;1760;40;1800
53;29;29214;681;26;707
53;29;29215;2948;74;3022
53;29;29216;4179;103;4282
53;29;29217;2821;58;2879
53;29;29218;1567;31;1598
53;29;29220;8369;395;8764
53;29;29221;1779;53;1832
53;29;29222;398;7;405
53;29;29224;1213;26;1239
53;29;29225;2165;45;2210
53;29;29226;1507;96;1603
53;29;29227;1480;32;1512
53;29;29228;657;16;673
53;29;29229;1114;34;1148
53;29;29230;1689;33;1722
53;29;29232;63283;2478;65761
53;29;29233;12220;458;12678
53;29;29234;2917;62;2979
53;29;29235;11717;234;11951
53;29;29236;4180;118;4298
53;29;29237;1814;44;1858
53;29;29238;836;29;865
53;29;29239;3489;85;3574
53;29;29240;959;26;985
53;29;29241;7614;162;7776
53;29;29243;456;10;466
53;29;29244;821;13;834
53;29;29245;1557;21;1578
53;29;29246;212;5;217
53;29;29247;3503;113;3616
53;29;29248;846;8;854
53;29;29249;712;10;722
53;29;29250;755;17;772
53;29;29251;655;12;667
53;29;29252;933;25;958
53;29;29254;4621;146;4767
53;29;29255;926;20;946
53;29;29256;760;20;780
53;29;29257;2069;62;2131
53;29;29259;6709;244;6953
53;29;29260;8163;195;8358
53;29;29261;211;3;214
53;29;29262;786;10;796
53;29;29263;1117;17;1134
53;29;29264;777;11;788
53;29;29265;1044;31;1075
53;29;29266;3044;78;3122
53;29;29267;720;18;738
53;29;29268;1899;36;1935
53;29;29269;1038;15;1053
53;29;29270;1646;35;1681
53;29;29271;893;32;925
53;29;29272;3249;68;3317
53;29;29273;2393;77;2470
53;29;29274;5295;111;5406
53;29;29275;736;20;756
53;29;29276;1196;29;1225
53;29;29277;2289;78;2367
53;29;29278;1758;43;1801
53;29;29279;2898;77;2975
53;29;29280;2098;60;2158
53;29;29281;997;27;1024
53;29;29282;360;10;370
53;29;29284;2406;99;2505
53;29;29285;521;7;528
53;29;29286;242;9;251
53;29;29287;973;21;994
53;29;29288;611;7;618
53;29;29289;114;6;120
53;29;29290;684;15;699
53;29;29291;957;18;975
53;29;29292;316;6;322
53;29;29293;7064;224;7288
53;29;29294;648;14;662
53;29;29295;532;22;554
53;29;29296;1347;40;1387
53;29;29297;2321;44;2365
53;29;29298;575;11;586
53;29;29299;333;3;336
53;29;29300;1597;51;1648
53;29;29301;392;2;394
53;29;29302;3639;136;3775
94;2A;2A001;3229;57;3286
94;2A;2A004;71361;867;72228
94;2A;2A006;3456;69;3525
94;2A;2A008;1771;26;1797
94;2A;2A011;53;2;55
94;2A;2A014;72;1;73
94;2A;2A017;1813;37;1850
94;2A;2A018;160;2;162
94;2A;2A019;55;0;55
94;2A;2A021;77;1;78
94;2A;2A022;80;0;80
94;2A;2A024;187;1;188
94;2A;2A026;187;3;190
94;2A;2A027;54;0;54
94;2A;2A028;145;6;151
94;2A;2A031;520;6;526
94;2A;2A032;4124;109;4233
94;2A;2A035;161;2;163
94;2A;2A038;50;1;51
94;2A;2A040;374;7;381
94;2A;2A041;3192;55;3247
94;2A;2A048;499;5;504
94;2A;2A056;105;5;110
94;2A;2A060;71;1;72
94;2A;2A061;112;1;113
94;2A;2A062;381;9;390
94;2A;2A064;32;2;34
94;2A;2A065;1297;22;1319
94;2A;2A066;58;0;58
94;2A;2A070;389;6;395
94;2A;2A071;214;5;219
94;2A;2A085;1493;37;1530
94;2A;2A089;133;0;133
94;2A;2A090;679;18;697
94;2A;2A091;171;1;172
94;2A;2A092;1145;20;1165
94;2A;2A094;71;2;73
94;2A;2A098;713;9;722
94;2A;2A099;276;0;276
94;2A;2A100;68;0;68
94;2A;2A103;2017;33;2050
94;2A;2A104;1295;36;1331
94;2A;2A108;214;5;219
94;2A;2A114;1466;29;1495
94;2A;2A115;150;7;157
94;2A;2A117;81;0;81
94;2A;2A118;205;5;210
94;2A;2A119;137;3;140
94;2A;2A127;89;2;91
94;2A;2A128;94;0;94
94;2A;2A129;43;1;44
94;2A;2A130;3402;55;3457
94;2A;2A131;160;2;162
94;2A;2A132;148;1;149
94;2A;2A133;151;3;154
94;2A;2A139;1838;31;1869
94;2A;2A141;127;1;128
94;2A;2A142;669;13;682
94;2A;2A144;103;3;106
94;2A;2A146;52;1;53
94;2A;2A154;107;6;113
94;2A;2A158;29;1;30
94;2A;2A160;257;2;259
94;2A;2A163;549;15;564
94;2A;2A174;100;3;103
94;2A;2A181;629;17;646
94;2A;2A186;221;1;222
94;2A;2A189;1218;30;1248
94;2A;2A191;121;3;124
94;2A;2A196;51;1;52
94;2A;2A197;99;0;99
94;2A;2A198;539;11;550
94;2A;2A200;143;3;146
94;2A;2A203;97;0;97
94;2A;2A204;96;1;97
94;2A;2A209;2015;33;2048
94;2A;2A211;563;17;580
94;2A;2A212;468;9;477
94;2A;2A215;910;7;917
94;2A;2A228;1859;19;1878
94;2A;2A232;280;3;283
94;2A;2A240;113;0;113
94;2A;2A247;11132;180;11312
94;2A;2A249;3699;40;3739
94;2A;2A253;51;0;51
94;2A;2A254;200;4;204
94;2A;2A258;60;4;64
94;2A;2A259;62;1;63
94;2A;2A262;49;3;52
94;2A;2A266;89;4;93
94;2A;2A268;80;0;80
94;2A;2A269;1392;32;1424
94;2A;2A270;344;3;347
94;2A;2A271;3289;52;3341
94;2A;2A272;3248;124;3372
94;2A;2A276;489;12;501
94;2A;2A278;83;3;86
94;2A;2A279;122;0;122
94;2A;2A282;148;4;152
94;2A;2A284;374;5;379
94;2A;2A285;76;0;76
94;2A;2A288;1401;24;1425
94;2A;2A295;116;0;116
94;2A;2A300;1088;21;1109
94;2A;2A308;383;7;390
94;2A;2A310;102;0;102
94;2A;2A312;404;9;413
94;2A;2A322;95;0;95
94;2A;2A323;402;7;409
94;2A;2A324;399;4;403
94;2A;2A326;122;0;122
94;2A;2A330;501;2;503
94;2A;2A331;61;0;61
94;2A;2A336;512;11;523
94;2A;2A345;598;4;602
94;2A;2A348;889;14;903
94;2A;2A349;846;18;864
94;2A;2A351;389;5;394
94;2A;2A357;50;3;53
94;2A;2A358;54;1;55
94;2A;2A359;225;2;227
94;2A;2A360;129;5;134
94;2A;2A362;2759;35;2794
94;2A;2A363;62;0;62
94;2B;2B002;240;4;244
94;2B;2B003;25;0;25
94;2B;2B005;29;2;31
94;2B;2B007;206;3;209
94;2B;2B009;2185;26;2211
94;2B;2B010;354;6;360
94;2B;2B012;50;0;50
94;2B;2B013;25;0;25
94;2B;2B015;25;0;25
94;2B;2B016;551;0;551
94;2B;2B020;598;15;613
94;2B;2B023;115;2;117
94;2B;2B025;84;2;86
94;2B;2B029;294;3;297
94;2B;2B030;132;4;136
94;2B;2B033;48503;695;49198
94;2B;2B034;671;9;680
94;2B;2B036;88;0;88
94;2B;2B037;7810;126;7936
94;2B;2B039;225;2;227
94;2B;2B042;8832;141;8973
94;2B;2B043;1624;40;1664
94;2B;2B045;66;0;66
94;2B;2B046;155;3;158
94;2B;2B047;272;3;275
94;2B;2B049;2461;29;2490
94;2B;2B050;5774;82;5856
94;2B;2B051;73;0;73
94;2B;2B052;20;0;20
94;2B;2B053;19;2;21
94;2B;2B054;188;4;192
94;2B;2B055;121;1;122
94;2B;2B057;317;10;327
94;2B;2B058;318;1;319
94;2B;2B059;108;1;109
94;2B;2B063;30;1;31
94;2B;2B067;34;0;34
94;2B;2B068;26;0;26
94;2B;2B069;105;1;106
94;2B;2B072;54;1;55
94;2B;2B073;107;0;107
94;2B;2B074;404;6;410
94;2B;2B075;70;2;72
94;2B;2B077;696;5;701
94;2B;2B078;28;1;29
94;2B;2B079;490;1;491
94;2B;2B080;142;1;143
94;2B;2B081;42;0;42
94;2B;2B082;40;1;41
94;2B;2B083;159;2;161
94;2B;2B084;234;1;235
94;2B;2B086;189;1;190
94;2B;2B087;2199;26;2225
94;2B;2B088;209;5;214
94;2B;2B093;895;32;927
94;2B;2B095;128;3;131
94;2B;2B096;7485;117;7602
94;2B;2B097;55;1;56
94;2B;2B101;80;3;83
94;2B;2B102;77;0;77
94;2B;2B105;116;0;116
94;2B;2B106;12;0;12
94;2B;2B107;155;1;156
94;2B;2B109;235;2;237
94;2B;2B110;70;1;71
94;2B;2B111;51;0;51
94;2B;2B112;232;4;236
94;2B;2B113;56;1;57
94;2B;2B116;28;1;29
94;2B;2B120;5608;127;5735
94;2B;2B121;361;5;366
94;2B;2B122;57;0;57
94;2B;2B123;4219;55;4274
94;2B;2B124;210;6;216
94;2B;2B125;54;0;54
94;2B;2B126;69;0;69
94;2B;2B134;3163;72;3235
94;2B;2B135;307;2;309
94;2B;2B136;146;2;148
94;2B;2B137;23;0;23
94;2B;2B138;149;2;151
94;2B;2B140;102;0;102
94;2B;2B143;1104;8;1112
94;2B;2B145;209;6;215
94;2B;2B147;113;2;115
94;2B;2B148;6007;51;6058
94;2B;2B149;82;1;83
94;2B;2B150;1260;38;1298
94;2B;2B152;848;9;857
94;2B;2B153;117;2;119
94;2B;2B155;47;0;47
94;2B;2B156;23;0;23
94;2B;2B157;29;0;29
94;2B;2B159;81;1;82
94;2B;2B161;65;0;65
94;2B;2B162;703;11;714
94;2B;2B164;23;0;23
94;2B;2B165;332;6;338
94;2B;2B166;632;5;637
94;2B;2B167;425;14;439
94;2B;2B168;1972;42;2014
94;2B;2B169;981;10;991
94;2B;2B170;109;2;111
94;2B;2B171;34;1;35
94;2B;2B172;577;7;584
94;2B;2B173;253;3;256
94;2B;2B175;108;2;110
94;2B;2B176;73;2;75
94;2B;2B177;59;2;61
94;2B;2B178;75;2;77
94;2B;2B179;64;0;64
94;2B;2B180;78;1;79
94;2B;2B182;256;2;258
94;2B;2B183;94;2;96
94;2B;2B184;89;1;90
94;2B;2B185;1781;14;1795
94;2B;2B187;133;1;134
94;2B;2B188;533;9;542
94;2B;2B190;183;5;188
94;2B;2B192;151;1;152
94;2B;2B193;601;3;604
94;2B;2B194;26;0;26
94;2B;2B195;124;1;125
94;2B;2B199;184;5;189
94;2B;2B201;197;1;198
94;2B;2B202;23;0;23
94;2B;2B205;876;12;888
94;2B;2B206;37;0;37
94;2B;2B207;3370;40;3410
94;2B;2B208;108;0;108
94;2B;2B210;117;0;117
94;2B;2B213;63;0;63
94;2B;2B214;22;0;22
94;2B;2B216;19;0;19
94;2B;2B217;41;3;44
94;2B;2B218;98;3;101
94;2B;2B219;82;1;83
94;2B;2B220;133;3;136
94;2B;2B221;16;0;16
94;2B;2B222;38;0;38
94;2B;2B223;502;3;505
94;2B;2B224;654;11;665
94;2B;2B225;100;2;102
94;2B;2B226;59;1;60
94;2B;2B227;34;1;35
94;2B;2B229;350;0;350
94;2B;2B230;109;5;114
94;2B;2B231;105;6;111
94;2B;2B233;167;2;169
94;2B;2B234;18;0;18
94;2B;2B235;84;0;84
94;2B;2B236;181;3;184
94;2B;2B238;210;8;218
94;2B;2B239;214;11;225
94;2B;2B241;31;1;32
94;2B;2B242;697;13;710
94;2B;2B243;42;0;42
94;2B;2B244;42;0;42
94;2B;2B245;42;1;43
94;2B;2B246;191;1;192
94;2B;2B248;42;1;43
94;2B;2B250;150;0;150
94;2B;2B251;3667;40;3707
94;2B;2B252;183;2;185
94;2B;2B255;42;0;42
94;2B;2B256;26;0;26
94;2B;2B257;158;0;158
94;2B;2B260;156;3;159
94;2B;2B261;538;11;549
94;2B;2B263;69;5;74
94;2B;2B264;62;1;63
94;2B;2B265;360;6;366
94;2B;2B267;45;3;48
94;2B;2B273;44;5;49
94;2B;2B274;93;1;94
94;2B;2B275;71;2;73
94;2B;2B277;337;3;340
94;2B;2B280;114;0;114
94;2B;2B281;1157;9;1166
94;2B;2B283;722;13;735
94;2B;2B286;873;8;881
94;2B;2B287;142;0;142
94;2B;2B289;117;0;117
94;2B;2B290;285;4;289
94;2B;2B291;34;1;35
94;2B;2B292;71;2;73
94;2B;2B293;210;2;212
94;2B;2B296;134;5;139
94;2B;2B297;57;0;57
94;2B;2B298;1681;19;1700
94;2B;2B299;105;1;106
94;2B;2B301;57;1;58
94;2B;2B302;91;2;93
94;2B;2B303;755;6;761
94;2B;2B304;143;0;143
94;2B;2B305;2913;42;2955
94;2B;2B306;119;0;119
94;2B;2B307;1490;29;1519
94;2B;2B309;1888;86;1974
94;2B;2B311;781;11;792
94;2B;2B313;2027;22;2049
94;2B;2B314;346;1;347
94;2B;2B315;281;5;286
94;2B;2B316;990;15;1005
94;2B;2B317;60;0;60
94;2B;2B318;583;12;595
94;2B;2B319;796;7;803
94;2B;2B320;282;2;284
94;2B;2B321;16;0;16
94;2B;2B327;188;3;191
94;2B;2B328;96;0;96
94;2B;2B329;110;1;111
94;2B;2B332;231;3;234
94;2B;2B333;138;3;141
94;2B;2B334;107;1;108
94;2B;2B335;353;7;360
94;2B;2B337;128;0;128
94;2B;2B338;29;0;29
94;2B;2B339;28;0;28
94;2B;2B340;123;0;123
94;2B;2B341;713;17;730
94;2B;2B342;2512;46;2558
94;2B;2B343;1795;14;1809
94;2B;2B344;42;2;44
94;2B;2B346;2851;32;2883
94;2B;2B347;266;0;266
94;2B;2B350;195;4;199
94;2B;2B352;209;5;214
94;2B;2B353;3328;87;3415
94;2B;2B354;428;5;433
94;2B;2B355;358;7;365
94;2B;2B356;144;1;145
94;2B;2B361;289;5;294
94;2B;2B364;34;0;34
94;2B;2B365;104;2;106
94;2B;2B366;102;2;104
76;30;30001;518;13;531
76;30;30002;777;15;792
76;30;30003;8560;80;8640
76;30;30004;3338;62;3400
76;30;30005;215;3;218
76;30;30006;5717;53;5770
76;30;30007;41837;615;42452
76;30;30008;953;17;970
76;30;30009;172;3;175
76;30;30010;3327;41;3368
76;30;30011;8476;205;8681
76;30;30012;4219;76;4295
76;30;30013;456;21;477
76;30;30014;1022;27;1049
76;30;30015;152;5;157
76;30;30016;288;10;298
76;30;30017;210;2;212
76;30;30018;514;13;527
76;30;30019;2895;60;2955
76;30;30020;2363;43;2406
76;30;30021;321;4;325
76;30;30022;179;7;186
76;30;30023;787;16;803
76;30;30024;456;7;463
76;30;30025;230;3;233
76;30;30026;1075;33;1108
76;30;30027;2556;59;2615
76;30;30028;18091;358;18449
76;30;30029;1620;26;1646
76;30;30030;368;4;372
76;30;30031;200;2;202
76;30;30032;15906;139;16045
76;30;30033;5104;55;5159
76;30;30034;7353;85;7438
76;30;30035;239;1;240
76;30;30036;3421;27;3448
76;30;30037;2835;34;2869
76;30;30038;328;11;339
76;30;30039;2304;31;2335
76;30;30040;129;2;131
76;30;30041;1237;21;1258
76;30;30042;2552;44;2596
76;30;30043;581;11;592
76;30;30044;90;0;90
76;30;30045;390;4;394
76;30;30046;981;14;995
76;30;30047;6272;135;6407
76;30;30048;175;3;178
76;30;30049;374;17;391
76;30;30050;170;1;171
76;30;30051;1338;30;1368
76;30;30052;643;18;661
76;30;30053;787;12;799
76;30;30054;301;4;305
76;30;30055;671;12;683
76;30;30056;331;7;338
76;30;30057;1698;29;1727
76;30;30058;212;10;222
76;30;30059;2418;28;2446
76;30;30060;4150;81;4231
76;30;30061;2363;27;2390
76;30;30062;5898;99;5997
76;30;30064;122;2;124
76;30;30065;466;4;470
76;30;30066;533;12;545
76;30;30067;412;6;418
76;30;30068;900;22;922
76;30;30069;504;12;516
76;30;30070;750;24;774
76;30;30071;395;2;397
76;30;30072;465;10;475
76;30;30073;1672;87;1759
76;30;30074;24;0;24
76;30;30075;4308;112;4420
76;30;30076;854;29;883
76;30;30077;1715;34;1749
76;30;30079;261;6;267
76;30;30080;876;5;881
76;30;30081;964;29;993
76;30;30082;4209;96;4305
76;30;30083;2418;38;2456
76;30;30084;618;11;629
76;30;30085;1065;15;1080
76;30;30086;634;10;644
76;30;30087;228;6;234
76;30;30088;635;15;650
76;30;30089;1756;31;1787
76;30;30090;262;4;266
76;30;30091;1667;34;1701
76;30;30092;1692;49;1741
76;30;30093;95;2;97
76;30;30094;146;1;147
76;30;30095;587;12;599
76;30;30096;949;21;970
76;30;30097;279;5;284
76;30;30098;435;4;439
76;30;30099;241;8;249
76;30;30100;700;9;709
76;30;30101;651;16;667
76;30;30102;543;9;552
76;30;30103;939;11;950
76;30;30104;743;18;761
76;30;30105;139;5;144
76;30;30106;728;17;745
76;30;30107;601;12;613
76;30;30108;157;5;162
76;30;30109;466;7;473
76;30;30110;379;9;388
76;30;30111;438;9;447
76;30;30112;1593;15;1608
76;30;30113;237;3;240
76;30;30114;685;10;695
76;30;30115;252;8;260
76;30;30116;1077;12;1089
76;30;30117;2796;56;2852
76;30;30119;157;5;162
76;30;30120;1084;15;1099
76;30;30121;250;4;254
76;30;30122;705;13;718
76;30;30123;3632;102;3734
76;30;30124;214;2;216
76;30;30125;4940;50;4990
76;30;30126;731;18;749
76;30;30127;1079;26;1105
76;30;30128;4071;68;4139
76;30;30129;694;20;714
76;30;30130;826;20;846
76;30;30131;1106;33;1139
76;30;30132;4998;96;5094
76;30;30133;8419;73;8492
76;30;30134;309;4;313
76;30;30135;3850;39;3889
76;30;30136;1129;17;1146
76;30;30137;137;3;140
76;30;30138;2222;55;2277
76;30;30139;350;23;373
76;30;30140;1106;11;1117
76;30;30141;6331;118;6449
76;30;30142;1133;22;1155
76;30;30143;213;5;218
76;30;30144;462;9;471
76;30;30145;1620;25;1645
76;30;30146;1481;24;1505
76;30;30147;1512;27;1539
76;30;30148;323;7;330
76;30;30149;927;20;947
76;30;30150;264;6;270
76;30;30151;503;7;510
76;30;30152;2044;34;2078
76;30;30153;125;0;125
76;30;30154;399;7;406
76;30;30155;6943;97;7040
76;30;30156;8656;164;8820
76;30;30158;432;9;441
76;30;30159;741;5;746
76;30;30160;261;4;265
76;30;30161;201;6;207
76;30;30162;667;15;682
76;30;30163;170;6;176
76;30;30164;716;14;730
76;30;30165;1195;35;1230
76;30;30166;2503;151;2654
76;30;30167;794;16;810
76;30;30168;619;17;636
76;30;30169;5721;134;5855
76;30;30170;924;31;955
76;30;30171;1219;12;1231
76;30;30172;758;8;766
76;30;30173;1725;32;1757
76;30;30174;1403;37;1440
76;30;30175;194;1;195
76;30;30176;195;3;198
76;30;30177;656;10;666
76;30;30178;1521;38;1559
76;30;30179;3163;52;3215
76;30;30180;578;9;587
76;30;30181;458;5;463
76;30;30182;1367;22;1389
76;30;30183;665;4;669
76;30;30184;1523;12;1535
76;30;30185;1431;19;1450
76;30;30186;1921;51;1972
76;30;30187;305;8;313
76;30;30188;710;13;723
76;30;30189;148561;2225;150786
76;30;30191;1186;28;1214
76;30;30192;429;12;441
76;30;30193;694;6;700
76;30;30194;280;2;282
76;30;30195;34;3;37
76;30;30196;454;11;465
76;30;30197;273;8;281
76;30;30198;259;6;265
76;30;30199;55;1;56
76;30;30200;957;14;971
76;30;30201;369;6;375
76;30;30202;10369;192;10561
76;30;30203;334;8;342
76;30;30204;363;5;368
76;30;30205;249;4;253
76;30;30206;4131;121;4252
76;30;30207;733;6;739
76;30;30208;45;0;45
76;30;30209;3921;131;4052
76;30;30210;3299;33;3332
76;30;30211;4097;58;4155
76;30;30212;2259;43;2302
76;30;30213;20;0;20
76;30;30214;2113;48;2161
76;30;30215;391;3;394
76;30;30216;823;15;838
76;30;30217;7629;185;7814
76;30;30218;257;3;260
76;30;30219;106;2;108
76;30;30220;260;6;266
76;30;30221;5545;66;5611
76;30;30222;179;7;186
76;30;30223;4251;114;4365
76;30;30224;607;15;622
76;30;30225;1628;53;1681
76;30;30226;1242;26;1268
76;30;30227;3351;40;3391
76;30;30228;1722;33;1755
76;30;30229;599;9;608
76;30;30230;589;9;598
76;30;30231;364;11;375
76;30;30232;435;14;449
76;30;30233;656;10;666
76;30;30234;284;7;291
76;30;30235;853;12;865
76;30;30236;117;3;120
76;30;30237;651;12;663
76;30;30238;62;0;62
76;30;30239;594;3;597
76;30;30240;386;4;390
76;30;30241;1915;30;1945
76;30;30242;162;2;164
76;30;30243;7055;182;7237
76;30;30244;359;6;365
76;30;30245;804;14;818
76;30;30246;109;7;116
76;30;30247;288;9;297
76;30;30248;462;4;466
76;30;30249;1070;13;1083
76;30;30250;405;12;417
76;30;30251;548;12;560
76;30;30252;227;7;234
76;30;30253;1169;16;1185
76;30;30254;1997;39;2036
76;30;30255;3052;32;3084
76;30;30256;761;16;777
76;30;30257;1999;27;2026
76;30;30258;13931;108;14039
76;30;30259;4503;79;4582
76;30;30260;1080;22;1102
76;30;30261;233;4;237
76;30;30262;255;12;267
76;30;30263;3804;138;3942
76;30;30264;170;1;171
76;30;30265;241;2;243
76;30;30266;852;11;863
76;30;30267;524;11;535
76;30;30268;626;15;641
76;30;30269;2437;171;2608
76;30;30270;1517;39;1556
76;30;30271;721;15;736
76;30;30272;143;6;149
76;30;30273;1442;27;1469
76;30;30274;3401;62;3463
76;30;30275;315;5;320
76;30;30276;3536;45;3581
76;30;30277;500;9;509
76;30;30278;3000;68;3068
76;30;30279;658;11;669
76;30;30280;360;11;371
76;30;30281;1652;23;1675
76;30;30282;861;17;878
76;30;30283;183;3;186
76;30;30284;4497;62;4559
76;30;30285;754;8;762
76;30;30286;770;18;788
76;30;30287;657;11;668
76;30;30288;1262;19;1281
76;30;30289;86;2;88
76;30;30290;1830;59;1889
76;30;30291;291;5;296
76;30;30292;454;10;464
76;30;30293;349;5;354
76;30;30294;5275;128;5403
76;30;30295;3064;63;3127
76;30;30296;151;14;165
76;30;30297;224;11;235
76;30;30298;503;19;522
76;30;30299;1097;48;1145
76;30;30300;538;12;550
76;30;30301;310;4;314
76;30;30302;2135;46;2181
76;30;30303;839;21;860
76;30;30304;189;3;192
76;30;30305;3571;39;3610
76;30;30306;554;8;562
76;30;30307;2600;26;2626
76;30;30308;774;51;825
76;30;30309;337;1;338
76;30;30310;281;6;287
76;30;30311;1903;22;1925
76;30;30312;2061;47;2108
76;30;30313;758;7;765
76;30;30314;235;4;239
76;30;30315;2119;39;2158
76;30;30316;241;7;248
76;30;30317;1765;16;1781
76;30;30318;208;4;212
76;30;30319;618;23;641
76;30;30320;159;2;161
76;30;30321;5050;63;5113
76;30;30322;267;6;273
76;30;30323;122;2;124
76;30;30324;877;15;892
76;30;30325;1388;34;1422
76;30;30326;2029;37;2066
76;30;30327;56;2;58
76;30;30328;1039;19;1058
76;30;30329;438;16;454
76;30;30330;935;25;960
76;30;30331;1806;50;1856
76;30;30332;113;1;114
76;30;30333;4424;43;4467
76;30;30334;8387;329;8716
76;30;30335;134;4;138
76;30;30336;1388;20;1408
76;30;30337;422;6;428
76;30;30338;142;4;146
76;30;30339;1415;21;1436
76;30;30340;591;11;602
76;30;30341;11492;118;11610
76;30;30342;1270;42;1312
76;30;30343;604;8;612
76;30;30344;5308;76;5384
76;30;30345;343;1;344
76;30;30346;1794;33;1827
76;30;30347;1379;21;1400
76;30;30348;1816;102;1918
76;30;30349;546;3;549
76;30;30350;3772;118;3890
76;30;30351;12216;401;12617
76;30;30352;1791;35;1826
76;30;30353;67;1;68
76;30;30354;200;4;204
76;30;30355;1029;21;1050
76;30;30356;2851;172;3023
76;31;31001;122;3;125
76;31;31002;241;6;247
76;31;31003;1272;29;1301
76;31;31004;2679;50;2729
76;31;31005;293;8;301
76;31;31006;221;6;227
76;31;31007;64;0;64
76;31;31008;253;4;257
76;31;31009;186;3;189
76;31;31010;99;3;102
76;31;31011;268;6;274
76;31;31012;99;2;101
76;31;31013;358;11;369
76;31;31014;81;4;85
76;31;31015;22;1;23
76;31;31017;101;2;103
76;31;31018;227;4;231
76;31;31019;32;1;33
76;31;31020;874;72;946
76;31;31021;128;5;133
76;31;31022;8968;94;9062
76;31;31023;310;5;315
76;31;31024;421;5;426
76;31;31025;921;15;936
76;31;31026;1055;21;1076
76;31;31027;200;5;205
76;31;31028;1243;70;1313
76;31;31029;335;6;341
76;31;31030;78;1;79
76;31;31031;590;20;610
76;31;31032;7209;80;7289
76;31;31033;9923;95;10018
76;31;31034;231;9;240
76;31;31035;4088;247;4335
76;31;31036;1578;48;1626
76;31;31037;1602;12;1614
76;31;31038;664;11;675
76;31;31039;81;2;83
76;31;31040;35;1;36
76;31;31041;113;2;115
76;31;31042;2285;143;2428
76;31;31043;140;6;146
76;31;31044;16625;287;16912
76;31;31045;496;10;506
76;31;31046;12;0;12
76;31;31047;92;1;93
76;31;31048;3395;58;3453
76;31;31049;579;14;593
76;31;31050;643;9;652
76;31;31051;467;5;472
76;31;31052;1587;32;1619
76;31;31053;1340;28;1368
76;31;31054;184;1;185
76;31;31055;173;3;176
76;31;31056;6973;83;7056
76;31;31057;1505;51;1556
76;31;31058;128;1;129
76;31;31059;114;6;120
76;31;31060;111;5;116
76;31;31061;191;12;203
76;31;31062;107;4;111
76;31;31063;166;2;168
76;31;31064;27;0;27
76;31;31065;3034;59;3093
76;31;31066;4127;62;4189
76;31;31067;42;0;42
76;31;31068;27;0;27
76;31;31069;25525;489;26014
76;31;31070;451;8;459
76;31;31071;441;3;444
76;31;31072;68;2;70
76;31;31073;659;21;680
76;31;31074;289;7;296
76;31;31075;1225;22;1247
76;31;31076;471;12;483
76;31;31077;593;15;608
76;31;31078;147;2;149
76;31;31079;4723;89;4812
76;31;31080;1648;34;1682
76;31;31081;5;0;5
76;31;31082;1111;21;1132
76;31;31083;233;2;235
76;31;31084;1061;24;1085
76;31;31085;249;3;252
76;31;31086;88;4;92
76;31;31087;323;2;325
76;31;31088;2862;95;2957
76;31;31089;679;6;685
76;31;31090;374;5;379
76;31;31091;5947;105;6052
76;31;31092;120;0;120
76;31;31093;957;11;968
76;31;31094;2870;51;2921
76;31;31095;128;1;129
76;31;31096;180;1;181
76;31;31097;462;12;474
76;31;31098;1089;19;1108
76;31;31099;399;4;403
76;31;31100;2371;31;2402
76;31;31101;467;4;471
76;31;31102;220;3;223
76;31;31103;59;0;59
76;31;31104;677;13;690
76;31;31105;228;5;233
76;31;31106;2544;47;2591
76;31;31107;5791;111;5902
76;31;31108;269;2;271
76;31;31109;467;3;470
76;31;31110;644;13;657
76;31;31111;279;4;283
76;31;31112;190;5;195
76;31;31113;14213;249;14462
76;31;31114;241;3;244
76;31;31115;59;1;60
76;31;31116;10682;117;10799
76;31;31117;4359;99;4458
76;31;31118;6579;103;6682
76;31;31119;208;5;213
76;31;31120;718;18;736
76;31;31121;63;1;64
76;31;31122;113;2;115
76;31;31123;74;1;75
76;31;31124;387;9;396
76;31;31125;36;0;36
76;31;31126;396;10;406
76;31;31127;4;1;5
76;31;31128;850;22;872
76;31;31129;17;4;21
76;31;31130;84;3;87
76;31;31131;70;1;71
76;31;31132;64;1;65
76;31;31133;99;4;103
76;31;31134;83;0;83
76;31;31135;4799;72;4871
76;31;31136;2171;26;2197
76;31;31137;155;0;155
76;31;31138;250;6;256
76;31;31139;195;4;199
76;31;31140;177;7;184
76;31;31141;218;2;220
76;31;31142;239;7;246
76;31;31143;277;8;285
76;31;31144;730;12;742
76;31;31145;2914;65;2979
76;31;31146;14;0;14
76;31;31147;658;12;670
76;31;31148;507;17;524
76;31;31149;39968;561;40529
76;31;31150;7372;106;7478
76;31;31151;859;23;882
76;31;31152;94;5;99
76;31;31153;416;12;428
76;31;31155;231;2;233
76;31;31156;358;12;370
76;31;31157;19344;253;19597
76;31;31158;178;7;185
76;31;31159;472;5;477
76;31;31160;2432;28;2460
76;31;31161;1236;22;1258
76;31;31162;1080;86;1166
76;31;31163;2649;65;2714
76;31;31164;202;6;208
76;31;31165;6349;98;6447
76;31;31166;279;4;283
76;31;31167;700;14;714
76;31;31168;130;0;130
76;31;31169;6967;162;7129
76;31;31170;246;10;256
76;31;31171;302;9;311
76;31;31172;47;1;48
76;31;31173;266;3;269
76;31;31174;538;4;542
76;31;31175;608;10;618
76;31;31176;191;5;196
76;31;31177;136;2;138
76;31;31178;200;3;203
76;31;31179;322;20;342
76;31;31180;139;6;145
76;31;31181;2089;28;2117
76;31;31182;5307;59;5366
76;31;31183;317;9;326
76;31;31184;2056;38;2094
76;31;31185;117;1;118
76;31;31186;3011;30;3041
76;31;31187;12170;329;12499
76;31;31188;5893;161;6054
76;31;31189;220;4;224
76;31;31190;233;0;233
76;31;31191;96;2;98
76;31;31192;776;21;797
76;31;31193;1904;30;1934
76;31;31194;169;2;171
76;31;31195;32;0;32
76;31;31196;244;3;247
76;31;31197;327;8;335
76;31;31198;101;3;104
76;31;31199;200;7;207
76;31;31200;79;4;83
76;31;31201;73;0;73
76;31;31202;6271;149;6420
76;31;31203;9292;162;9454
76;31;31204;82;3;85
76;31;31205;3130;27;3157
76;31;31206;1311;15;1326
76;31;31207;78;6;84
76;31;31208;327;5;332
76;31;31209;147;4;151
76;31;31210;1283;24;1307
76;31;31211;702;8;710
76;31;31212;1928;14;1942
76;31;31213;155;3;158
76;31;31215;467;15;482
76;31;31216;269;10;279
76;31;31217;68;1;69
76;31;31218;115;4;119
76;31;31219;447;2;449
76;31;31220;376;5;381
76;31;31221;69;0;69
76;31;31222;46;0;46
76;31;31223;43;1;44
76;31;31224;1203;186;1389
76;31;31225;186;3;189
76;31;31226;81;6;87
76;31;31227;843;36;879
76;31;31228;1974;43;2017
76;31;31229;696;17;713
76;31;31230;4387;79;4466
76;31;31231;691;8;699
76;31;31232;8844;166;9010
76;31;31233;997;33;1030
76;31;31234;440;8;448
76;31;31235;44;1;45
76;31;31236;73;1;74
76;31;31237;232;30;262
76;31;31238;482;11;493
76;31;31239;1634;28;1662
76;31;31240;601;10;611
76;31;31241;295;5;300
76;31;31242;18;2;20
76;31;31243;69;4;73
76;31;31244;381;17;398
76;31;31245;188;5;193
76;31;31246;866;15;881
76;31;31247;1303;28;1331
76;31;31248;6271;105;6376
76;31;31249;1259;26;1285
76;31;31250;675;17;692
76;31;31251;145;1;146
76;31;31252;1955;25;1980
76;31;31253;2938;37;2975
76;31;31254;4008;142;4150
76;31;31255;319;10;329
76;31;31256;290;6;296
76;31;31258;241;6;247
76;31;31259;2081;49;2130
76;31;31260;96;1;97
76;31;31261;1224;19;1243
76;31;31262;421;11;432
76;31;31263;3169;57;3226
76;31;31264;557;7;564
76;31;31265;242;4;246
76;31;31266;199;1;200
76;31;31267;66;0;66
76;31;31268;135;3;138
76;31;31269;1510;15;1525
76;31;31270;1013;35;1048
76;31;31271;2155;42;2197
76;31;31272;65;3;68
76;31;31273;2886;69;2955
76;31;31274;182;5;187
76;31;31275;160;5;165
76;31;31276;287;5;292
76;31;31277;1543;42;1585
76;31;31278;317;5;322
76;31;31279;77;1;78
76;31;31280;372;13;385
76;31;31281;1336;32;1368
76;31;31282;9050;112;9162
76;31;31283;267;1;268
76;31;31284;1654;55;1709
76;31;31285;759;13;772
76;31;31286;614;8;622
76;31;31287;3255;83;3338
76;31;31288;311;9;320
76;31;31289;280;3;283
76;31;31290;36;1;37
76;31;31291;9359;253;9612
76;31;31292;73;1;74
76;31;31293;2828;23;2851
76;31;31294;91;1;92
76;31;31295;83;0;83
76;31;31296;437;11;448
76;31;31297;2139;42;2181
76;31;31299;3777;82;3859
76;31;31300;127;3;130
76;31;31301;131;1;132
76;31;31302;291;7;298
76;31;31303;3160;34;3194
76;31;31304;451;10;461
76;31;31305;197;6;203
76;31;31306;92;0;92
76;31;31308;48;0;48
76;31;31309;229;2;231
76;31;31310;339;5;344
76;31;31311;1181;21;1202
76;31;31312;35;1;36
76;31;31313;110;2;112
76;31;31314;384;5;389
76;31;31315;956;46;1002
76;31;31316;490;8;498
76;31;31317;469;9;478
76;31;31318;206;5;211
76;31;31319;138;1;139
76;31;31320;956;41;997
76;31;31321;125;8;133
76;31;31322;66;2;68
76;31;31323;351;13;364
76;31;31324;2414;44;2458
76;31;31325;187;12;199
76;31;31326;93;0;93
76;31;31327;214;1;215
76;31;31328;317;10;327
76;31;31329;208;2;210
76;31;31330;506;11;517
76;31;31331;307;12;319
76;31;31332;217;4;221
76;31;31333;89;3;92
76;31;31334;1301;23;1324
76;31;31335;25;2;27
76;31;31336;628;12;640
76;31;31337;92;1;93
76;31;31338;781;23;804
76;31;31339;490;6;496
76;31;31340;291;9;300
76;31;31341;6054;103;6157
76;31;31342;173;0;173
76;31;31343;61;0;61
76;31;31344;766;12;778
76;31;31345;2623;36;2659
76;31;31346;1104;14;1118
76;31;31347;167;4;171
76;31;31348;37;0;37
76;31;31349;905;18;923
76;31;31350;81;1;82
76;31;31351;5166;93;5259
76;31;31352;224;11;235
76;31;31353;88;0;88
76;31;31354;54;0;54
76;31;31355;1758;53;1811
76;31;31356;1839;46;1885
76;31;31357;305;2;307
76;31;31358;3576;101;3677
76;31;31359;70;2;72
76;31;31360;503;7;510
76;31;31361;516;5;521
76;31;31362;203;5;208
76;31;31363;217;5;222
76;31;31364;3088;66;3154
76;31;31365;470;11;481
76;31;31366;654;21;675
76;31;31367;76;5;81
76;31;31368;242;13;255
76;31;31369;42;2;44
76;31;31370;143;1;144
76;31;31371;423;15;438
76;31;31372;459;7;466
76;31;31373;179;2;181
76;31;31374;1009;13;1022
76;31;31375;3111;68;3179
76;31;31376;104;3;107
76;31;31377;711;9;720
76;31;31378;82;2;84
76;31;31379;178;2;180
76;31;31380;507;8;515
76;31;31381;2530;59;2589
76;31;31382;112;1;113
76;31;31383;1304;26;1330
76;31;31384;1769;36;1805
76;31;31385;201;4;205
76;31;31386;214;6;220
76;31;31387;129;0;129
76;31;31388;387;12;399
76;31;31389;4111;78;4189
76;31;31390;2751;33;2784
76;31;31391;453;31;484
76;31;31392;78;4;82
76;31;31393;167;5;172
76;31;31394;129;3;132
76;31;31395;24797;564;25361
76;31;31396;3928;64;3992
76;31;31397;56;1;57
76;31;31398;96;1;97
76;31;31399;2912;64;2976
76;31;31400;90;0;90
76;31;31401;393;6;399
76;31;31402;906;32;938
76;31;31403;767;133;900
76;31;31404;101;4;105
76;31;31405;114;3;117
76;31;31406;814;11;825
76;31;31407;1239;29;1268
76;31;31408;88;3;91
76;31;31409;2352;54;2406
76;31;31410;4544;89;4633
76;31;31411;947;22;969
76;31;31412;267;8;275
76;31;31413;509;12;521
76;31;31414;80;2;82
76;31;31415;82;2;84
76;31;31416;585;7;592
76;31;31417;8578;255;8833
76;31;31418;938;33;971
76;31;31419;173;4;177
76;31;31420;2840;37;2877
76;31;31421;4318;69;4387
76;31;31422;93;0;93
76;31;31423;306;3;309
76;31;31424;19402;411;19813
76;31;31425;442;7;449
76;31;31426;854;11;865
76;31;31427;941;15;956
76;31;31428;53;2;55
76;31;31429;2307;38;2345
76;31;31430;596;14;610
76;31;31431;61;1;62
76;31;31432;38;4;42
76;31;31433;9812;124;9936
76;31;31434;80;4;84
76;31;31435;935;14;949
76;31;31436;412;10;422
76;31;31437;85;4;89
76;31;31439;720;15;735
76;31;31440;71;1;72
76;31;31441;148;2;150
76;31;31442;552;9;561
76;31;31443;291;5;296
76;31;31444;139;4;143
76;31;31445;5896;118;6014
76;31;31446;14600;317;14917
76;31;31447;35;1;36
76;31;31448;472;25;497
76;31;31449;139;4;143
76;31;31450;545;13;558
76;31;31451;9637;297;9934
76;31;31452;56;0;56
76;31;31453;137;2;139
76;31;31454;3578;86;3664
76;31;31455;2611;56;2667
76;31;31456;51;1;52
76;31;31457;794;13;807
76;31;31458;4757;54;4811
76;31;31459;756;19;775
76;31;31460;4212;68;4280
76;31;31461;289;3;292
76;31;31462;1931;41;1972
76;31;31463;247;4;251
76;31;31464;323;9;332
76;31;31465;19;0;19
76;31;31466;809;22;831
76;31;31467;6217;50;6267
76;31;31468;233;8;241
76;31;31469;137;3;140
76;31;31470;64;3;67
76;31;31471;383;8;391
76;31;31472;240;6;246
76;31;31473;434;1;435
76;31;31474;239;4;243
76;31;31475;1410;27;1437
76;31;31476;919;21;940
76;31;31477;42;0;42
76;31;31478;1266;34;1300
76;31;31479;60;1;61
76;31;31480;2174;66;2240
76;31;31481;2093;46;2139
76;31;31482;213;4;217
76;31;31483;11773;564;12337
76;31;31484;2522;65;2587
76;31;31485;116;2;118
76;31;31486;1373;22;1395
76;31;31487;228;5;233
76;31;31488;11017;138;11155
76;31;31489;395;12;407
76;31;31490;6383;68;6451
76;31;31491;413;11;424
76;31;31492;552;5;557
76;31;31493;132;6;138
76;31;31494;178;1;179
76;31;31495;1293;13;1306
76;31;31496;258;13;271
76;31;31497;2221;46;2267
76;31;31498;37;0;37
76;31;31499;9521;183;9704
76;31;31500;555;19;574
76;31;31501;436;7;443
76;31;31502;361;9;370
76;31;31503;997;11;1008
76;31;31504;223;16;239
76;31;31505;318;6;324
76;31;31506;12696;229;12925
76;31;31507;1622;25;1647
76;31;31508;34;0;34
76;31;31509;155;1;156
76;31;31510;141;0;141
76;31;31511;234;8;242
76;31;31512;892;27;919
76;31;31513;392;6;398
76;31;31514;59;2;61
76;31;31515;436;9;445
76;31;31516;1791;16;1807
76;31;31517;2325;61;2386
76;31;31518;576;15;591
76;31;31519;200;8;208
76;31;31520;122;3;125
76;31;31521;339;8;347
76;31;31522;59;2;61
76;31;31523;1763;106;1869
76;31;31524;129;2;131
76;31;31525;588;14;602
76;31;31526;8474;194;8668
76;31;31527;150;3;153
76;31;31528;123;4;127
76;31;31529;112;2;114
76;31;31530;249;5;254
76;31;31531;78;0;78
76;31;31532;93;0;93
76;31;31533;2297;51;2348
76;31;31534;208;0;208
76;31;31535;682;17;699
76;31;31536;252;8;260
76;31;31537;180;5;185
76;31;31538;220;4;224
76;31;31539;62;3;65
76;31;31540;320;8;328
76;31;31541;3284;73;3357
76;31;31542;210;3;213
76;31;31543;113;2;115
76;31;31544;215;2;217
76;31;31545;210;4;214
76;31;31546;130;2;132
76;31;31547;9481;124;9605
76;31;31548;51;0;51
76;31;31549;19;0;19
76;31;31550;523;15;538
76;31;31551;539;17;556
76;31;31552;138;4;142
76;31;31553;1146;25;1171
76;31;31554;238;1;239
76;31;31555;493465;5131;498596
76;31;31556;377;9;386
76;31;31557;28117;615;28732
76;31;31558;388;5;393
76;31;31559;7;0;7
76;31;31560;475;8;483
76;31;31561;11798;164;11962
76;31;31562;120;1;121
76;31;31563;1339;37;1376
76;31;31564;142;1;143
76;31;31565;878;15;893
76;31;31566;519;4;523
76;31;31567;435;6;441
76;31;31568;272;5;277
76;31;31569;384;10;394
76;31;31570;305;5;310
76;31;31571;285;4;289
76;31;31572;2702;86;2788
76;31;31573;3658;71;3729
76;31;31574;3059;35;3094
76;31;31575;1168;37;1205
76;31;31576;354;7;361
76;31;31577;144;0;144
76;31;31578;931;31;962
76;31;31579;790;13;803
76;31;31580;1007;21;1028
76;31;31581;1578;32;1610
76;31;31582;4806;65;4871
76;31;31583;1083;25;1108
76;31;31584;6034;88;6122
76;31;31585;1790;42;1832
76;31;31586;561;3;564
76;31;31587;1627;12;1639
76;31;31588;10050;126;10176
76;31;31589;1431;19;1450
76;31;31590;45;0;45
76;31;31591;79;1;80
76;31;31592;2046;32;2078
76;31;31593;86;0;86
76;32;32001;726;54;780
76;32;32002;79;5;84
76;32;32003;46;2;48
76;32;32004;136;2;138
76;32;32005;322;5;327
76;32;32007;223;5;228
76;32;32008;74;0;74
76;32;32009;90;1;91
76;32;32010;96;0;96
76;32;32012;1107;29;1136
76;32;32013;22173;1103;23276
76;32;32014;115;5;120
76;32;32015;89;1;90
76;32;32016;672;16;688
76;32;32017;133;5;138
76;32;32018;213;3;216
76;32;32019;516;17;533
76;32;32020;275;9;284
76;32;32021;74;1;75
76;32;32022;165;6;171
76;32;32023;112;3;115
76;32;32024;162;3;165
76;32;32025;160;2;162
76;32;32026;111;0;111
76;32;32027;1368;38;1406
76;32;32028;105;3;108
76;32;32029;664;20;684
76;32;32030;123;3;126
76;32;32031;169;2;171
76;32;32032;319;4;323
76;32;32033;107;0;107
76;32;32034;53;3;56
76;32;32035;241;4;245
76;32;32036;661;40;701
76;32;32037;129;7;136
76;32;32038;206;8;214
76;32;32039;119;4;123
76;32;32040;136;1;137
76;32;32041;173;4;177
76;32;32042;130;4;134
76;32;32043;150;4;154
76;32;32044;311;9;320
76;32;32045;418;19;437
76;32;32046;205;1;206
76;32;32047;111;1;112
76;32;32048;88;0;88
76;32;32049;76;3;79
76;32;32050;97;4;101
76;32;32051;129;2;131
76;32;32052;137;4;141
76;32;32053;193;3;196
76;32;32054;384;9;393
76;32;32055;134;2;136
76;32;32056;49;3;52
76;32;32057;131;3;134
76;32;32058;41;2;43
76;32;32059;135;2;137
76;32;32060;221;4;225
76;32;32061;186;3;189
76;32;32062;162;2;164
76;32;32063;174;8;182
76;32;32064;403;12;415
76;32;32065;249;3;252
76;32;32066;253;12;265
76;32;32067;51;4;55
76;32;32068;138;3;141
76;32;32069;66;3;69
76;32;32070;211;3;214
76;32;32071;185;9;194
76;32;32072;49;1;50
76;32;32073;215;3;218
76;32;32075;228;4;232
76;32;32076;546;10;556
76;32;32077;87;2;89
76;32;32078;231;9;240
76;32;32079;1215;22;1237
76;32;32080;143;6;149
76;32;32081;131;2;133
76;32;32082;353;6;359
76;32;32083;1006;24;1030
76;32;32084;52;2;54
76;32;32085;173;7;180
76;32;32086;78;2;80
76;32;32087;121;4;125
76;32;32088;324;0;324
76;32;32089;247;6;253
76;32;32090;341;8;349
76;32;32091;358;17;375
76;32;32092;92;4;96
76;32;32093;103;7;110
76;32;32094;429;16;445
76;32;32095;601;12;613
76;32;32096;1654;36;1690
76;32;32097;116;2;118
76;32;32098;323;5;328
76;32;32099;72;2;74
76;32;32100;163;4;167
76;32;32101;227;3;230
76;32;32102;228;2;230
76;32;32103;166;8;174
76;32;32104;162;3;165
76;32;32105;397;11;408
76;32;32106;927;70;997
76;32;32107;6493;206;6699
76;32;32108;153;10;163
76;32;32109;194;5;199
76;32;32110;399;5;404
76;32;32111;51;0;51
76;32;32112;252;12;264
76;32;32113;90;1;91
76;32;32114;123;5;128
76;32;32115;328;3;331
76;32;32116;149;4;153
76;32;32117;853;28;881
76;32;32118;138;5;143
76;32;32119;3975;71;4046
76;32;32120;425;9;434
76;32;32121;506;16;522
76;32;32122;345;10;355
76;32;32123;566;13;579
76;32;32124;187;0;187
76;32;32125;125;1;126
76;32;32126;161;1;162
76;32;32127;656;15;671
76;32;32128;204;12;216
76;32;32129;149;0;149
76;32;32130;217;1;218
76;32;32131;157;2;159
76;32;32132;5924;111;6035
76;32;32133;261;2;263
76;32;32134;344;6;350
76;32;32135;134;5;139
76;32;32136;174;5;179
76;32;32138;154;4;158
76;32;32139;112;1;113
76;32;32140;70;0;70
76;32;32141;115;0;115
76;32;32142;139;2;141
76;32;32143;273;11;284
76;32;32144;73;0;73
76;32;32145;47;2;49
76;32;32146;272;4;276
76;32;32147;3016;69;3085
76;32;32148;103;0;103
76;32;32149;1201;35;1236
76;32;32150;213;6;219
76;32;32151;63;0;63
76;32;32152;335;11;346
76;32;32153;168;1;169
76;32;32154;111;1;112
76;32;32155;1161;51;1212
76;32;32156;216;4;220
76;32;32157;190;3;193
76;32;32158;241;10;251
76;32;32159;550;14;564
76;32;32160;9072;222;9294
76;32;32161;91;4;95
76;32;32162;1147;50;1197
76;32;32163;295;9;304
76;32;32164;115;2;117
76;32;32165;219;6;225
76;32;32166;121;1;122
76;32;32167;308;5;313
76;32;32169;147;4;151
76;32;32170;141;3;144
76;32;32171;179;1;180
76;32;32172;295;15;310
76;32;32173;213;8;221
76;32;32174;222;4;226
76;32;32175;220;7;227
76;32;32176;122;5;127
76;32;32177;168;5;173
76;32;32178;77;3;80
76;32;32180;562;9;571
76;32;32181;245;2;247
76;32;32182;180;6;186
76;32;32183;232;11;243
76;32;32184;131;3;134
76;32;32185;153;4;157
76;32;32186;80;0;80
76;32;32187;119;7;126
76;32;32188;78;3;81
76;32;32189;106;3;109
76;32;32190;507;6;513
76;32;32191;145;1;146
76;32;32192;234;7;241
76;32;32193;233;3;236
76;32;32194;208;7;215
76;32;32195;45;2;47
76;32;32196;165;0;165
76;32;32197;223;6;229
76;32;32198;193;4;197
76;32;32199;190;9;199
76;32;32200;372;11;383
76;32;32201;339;7;346
76;32;32202;280;15;295
76;32;32203;253;3;256
76;32;32204;369;11;380
76;32;32205;107;1;108
76;32;32206;213;3;216
76;32;32207;342;17;359
76;32;32208;3672;355;4027
76;32;32209;283;3;286
76;32;32210;736;15;751
76;32;32211;195;7;202
76;32;32212;215;4;219
76;32;32213;2156;36;2192
76;32;32214;101;3;104
76;32;32215;146;10;156
76;32;32216;166;1;167
76;32;32217;61;2;63
76;32;32218;63;0;63
76;32;32219;307;11;318
76;32;32220;142;3;145
76;32;32221;236;3;239
76;32;32222;234;3;237
76;32;32223;60;31;91
76;32;32224;234;2;236
76;32;32225;104;5;109
76;32;32226;82;5;87
76;32;32227;804;27;831
76;32;32228;92;1;93
76;32;32229;71;8;79
76;32;32230;46;4;50
76;32;32231;437;14;451
76;32;32232;41;0;41
76;32;32233;1208;85;1293
76;32;32234;330;7;337
76;32;32235;161;8;169
76;32;32236;65;3;68
76;32;32237;483;11;494
76;32;32238;86;3;89
76;32;32239;448;11;459
76;32;32240;63;4;67
76;32;32241;170;6;176
76;32;32242;1498;397;1895
76;32;32243;269;3;272
76;32;32244;164;4;168
76;32;32245;147;7;154
76;32;32246;201;3;204
76;32;32247;309;7;316
76;32;32248;144;4;148
76;32;32249;2218;50;2268
76;32;32250;77;1;78
76;32;32251;69;0;69
76;32;32252;1111;20;1131
76;32;32253;525;12;537
76;32;32254;345;14;359
76;32;32255;155;5;160
76;32;32256;3450;301;3751
76;32;32257;61;4;65
76;32;32258;230;5;235
76;32;32260;76;4;80
76;32;32261;370;7;377
76;32;32262;394;14;408
76;32;32263;127;3;130
76;32;32264;211;3;214
76;32;32265;108;2;110
76;32;32266;145;1;146
76;32;32267;113;2;115
76;32;32268;811;29;840
76;32;32269;496;4;500
76;32;32270;84;1;85
76;32;32271;298;8;306
76;32;32272;167;3;170
76;32;32273;179;11;190
76;32;32274;205;3;208
76;32;32275;45;1;46
76;32;32276;71;1;72
76;32;32277;121;3;124
76;32;32278;118;7;125
76;32;32279;710;19;729
76;32;32280;94;2;96
76;32;32281;107;5;112
76;32;32282;677;12;689
76;32;32283;284;7;291
76;32;32284;63;1;64
76;32;32285;572;18;590
76;32;32286;701;11;712
76;32;32287;79;1;80
76;32;32288;145;3;148
76;32;32289;239;4;243
76;32;32290;1171;34;1205
76;32;32291;120;2;122
76;32;32292;397;13;410
76;32;32293;74;2;76
76;32;32294;75;3;78
76;32;32295;138;8;146
76;32;32296;2027;165;2192
76;32;32297;378;11;389
76;32;32298;372;12;384
76;32;32299;101;0;101
76;32;32300;294;3;297
76;32;32301;895;24;919
76;32;32302;226;11;237
76;32;32303;62;2;64
76;32;32304;290;9;299
76;32;32305;412;8;420
76;32;32306;615;48;663
76;32;32307;2501;119;2620
76;32;32308;108;2;110
76;32;32309;114;5;119
76;32;32310;123;1;124
76;32;32311;325;6;331
76;32;32312;672;14;686
76;32;32313;139;4;143
76;32;32314;75;5;80
76;32;32315;156;2;158
76;32;32316;106;3;109
76;32;32317;67;1;68
76;32;32318;111;2;113
76;32;32319;1429;26;1455
76;32;32320;150;7;157
76;32;32321;273;5;278
76;32;32322;203;3;206
76;32;32323;108;5;113
76;32;32324;80;3;83
76;32;32325;130;3;133
76;32;32326;145;4;149
76;32;32327;85;1;86
76;32;32328;120;6;126
76;32;32329;163;3;166
76;32;32330;195;5;200
76;32;32331;1250;35;1285
76;32;32332;126;1;127
76;32;32333;182;0;182
76;32;32334;1578;39;1617
76;32;32335;447;9;456
76;32;32336;160;9;169
76;32;32337;74;3;77
76;32;32338;168;5;173
76;32;32339;245;9;254
76;32;32340;286;3;289
76;32;32341;245;4;249
76;32;32342;57;2;59
76;32;32343;175;7;182
76;32;32344;1829;100;1929
76;32;32345;568;15;583
76;32;32346;212;5;217
76;32;32347;283;7;290
76;32;32348;562;23;585
76;32;32349;103;4;107
76;32;32350;33;2;35
76;32;32351;108;1;109
76;32;32352;115;4;119
76;32;32353;146;7;153
76;32;32354;138;1;139
76;32;32355;86;2;88
76;32;32356;127;1;128
76;32;32357;128;1;129
76;32;32358;190;4;194
76;32;32359;154;5;159
76;32;32360;139;3;142
76;32;32361;136;8;144
76;32;32362;143;3;146
76;32;32363;95;4;99
76;32;32364;95;3;98
76;32;32365;335;6;341
76;32;32366;74;1;75
76;32;32367;64;2;66
76;32;32368;544;11;555
76;32;32369;376;12;388
76;32;32370;1046;66;1112
76;32;32371;80;1;81
76;32;32372;288;4;292
76;32;32373;204;10;214
76;32;32374;181;6;187
76;32;32375;95;4;99
76;32;32376;114;3;117
76;32;32377;179;1;180
76;32;32378;499;6;505
76;32;32379;208;7;215
76;32;32380;138;10;148
76;32;32381;411;20;431
76;32;32382;309;14;323
76;32;32383;127;6;133
76;32;32384;278;6;284
76;32;32385;184;1;185
76;32;32386;143;1;144
76;32;32387;101;2;103
76;32;32388;439;7;446
76;32;32389;457;20;477
76;32;32390;240;5;245
76;32;32391;122;7;129
76;32;32392;88;1;89
76;32;32393;137;5;142
76;32;32394;338;5;343
76;32;32395;209;4;213
76;32;32396;234;3;237
76;32;32397;244;14;258
76;32;32398;315;10;325
76;32;32399;81;3;84
76;32;32400;208;9;217
76;32;32401;89;1;90
76;32;32402;106;3;109
76;32;32403;61;1;62
76;32;32404;589;15;604
76;32;32405;178;6;184
76;32;32406;355;10;365
76;32;32407;160;4;164
76;32;32408;134;4;138
76;32;32409;91;0;91
76;32;32410;2328;102;2430
76;32;32411;100;3;103
76;32;32412;842;14;856
76;32;32413;82;2;84
76;32;32414;231;6;237
76;32;32415;90;1;91
76;32;32416;361;15;376
76;32;32417;403;13;416
76;32;32418;279;64;343
76;32;32419;106;3;109
76;32;32420;66;2;68
76;32;32421;139;1;140
76;32;32422;43;1;44
76;32;32423;57;3;60
76;32;32424;225;8;233
76;32;32425;1168;28;1196
76;32;32426;1096;10;1106
76;32;32427;60;1;61
76;32;32428;66;4;70
76;32;32429;296;5;301
76;32;32430;80;0;80
76;32;32431;39;4;43
76;32;32432;242;2;244
76;32;32433;711;17;728
76;32;32434;97;3;100
76;32;32435;167;9;176
76;32;32436;482;6;488
76;32;32437;227;6;233
76;32;32438;101;0;101
76;32;32439;169;2;171
76;32;32440;250;6;256
76;32;32441;61;0;61
76;32;32442;381;4;385
76;32;32443;186;3;189
76;32;32444;260;7;267
76;32;32445;156;5;161
76;32;32446;285;6;291
76;32;32447;91;1;92
76;32;32448;507;16;523
76;32;32449;272;2;274
76;32;32450;128;4;132
76;32;32451;182;2;184
76;32;32452;260;8;268
76;32;32453;111;6;117
76;32;32454;69;3;72
76;32;32455;183;5;188
76;32;32456;53;0;53
76;32;32457;282;13;295
76;32;32458;233;3;236
76;32;32459;1122;20;1142
76;32;32460;306;8;314
76;32;32461;114;3;117
76;32;32462;3546;61;3607
76;32;32463;511;11;522
76;32;32464;840;20;860
76;32;32465;123;5;128
76;32;32466;114;2;116
76;32;32467;142;4;146
76;32;32468;84;0;84
75;33;33001;1982;26;2008
75;33;33002;834;14;848
75;33;33003;16636;156;16792
75;33;33004;3053;19;3072
75;33;33005;12242;275;12517
75;33;33006;931;12;943
75;33;33007;1335;7;1342
75;33;33008;489;8;497
75;33;33009;11630;268;11898
75;33;33010;529;7;536
75;33;33011;6381;122;6503
75;33;33012;3747;48;3795
75;33;33013;8656;79;8735
75;33;33014;1110;21;1131
75;33;33015;1992;41;2033
75;33;33016;443;9;452
75;33;33017;276;11;287
75;33;33018;3621;42;3663
75;33;33019;8680;121;8801
75;33;33020;143;0;143
75;33;33021;1049;14;1063
75;33;33022;3018;41;3059
75;33;33023;1332;16;1348
75;33;33024;301;9;310
75;33;33025;450;4;454
75;33;33026;497;5;502
75;33;33027;289;9;298
75;33;33028;1170;16;1186
75;33;33029;5605;81;5686
75;33;33030;2074;22;2096
75;33;33031;131;5;136
75;33;33032;7472;61;7533
75;33;33033;919;7;926
75;33;33034;460;4;464
75;33;33035;721;2;723
75;33;33036;4801;256;5057
75;33;33037;2330;39;2369
75;33;33038;915;8;923
75;33;33039;30642;349;30991
75;33;33040;1202;13;1215
75;33;33042;5732;93;5825
75;33;33043;278;1;279
75;33;33044;220;6;226
75;33;33045;335;8;343
75;33;33046;1125;30;1155
75;33;33047;1812;31;1843
75;33;33048;266;7;273
75;33;33049;2489;27;2516
75;33;33050;639;8;647
75;33;33051;10990;123;11113
75;33;33052;1148;35;1183
75;33;33053;229;1;230
75;33;33054;286;5;291
75;33;33055;464;4;468
75;33;33056;15419;605;16024
75;33;33057;909;20;929
75;33;33058;4838;112;4950
75;33;33059;306;6;312
75;33;33060;454;67;521
75;33;33061;990;19;1009
75;33;33062;742;12;754
75;33;33063;260958;3299;264257
75;33;33064;38;0;38
75;33;33065;3706;72;3778
75;33;33066;90;1;91
75;33;33067;2278;38;2316
75;33;33068;93;3;96
75;33;33069;23890;277;24167
75;33;33070;786;2;788
75;33;33071;1307;17;1324
75;33;33072;241;4;245
75;33;33073;1535;29;1564
75;33;33074;202;8;210
75;33;33075;19403;187;19590
75;33;33076;808;14;822
75;33;33077;2413;26;2439
75;33;33078;507;12;519
75;33;33079;356;7;363
75;33;33080;6464;70;6534
75;33;33081;2836;28;2864
75;33;33082;1331;16;1347
75;33;33083;1019;13;1032
75;33;33084;1732;17;1749
75;33;33085;2984;142;3126
75;33;33086;360;5;365
75;33;33087;414;5;419
75;33;33088;598;10;608
75;33;33089;503;6;509
75;33;33090;6061;73;6134
75;33;33093;775;17;792
75;33;33094;217;7;224
75;33;33095;1358;21;1379
75;33;33096;8254;82;8336
75;33;33097;2418;36;2454
75;33;33098;509;5;514
75;33;33099;4141;43;4184
75;33;33100;1201;21;1222
75;33;33101;1233;21;1254
75;33;33102;383;4;387
75;33;33103;53;0;53
75;33;33104;4804;65;4869
75;33;33105;222;12;234
75;33;33106;1454;19;1473
75;33;33108;3194;35;3229
75;33;33109;2391;19;2410
75;33;33111;1117;15;1132
75;33;33112;142;2;144
75;33;33113;154;3;157
75;33;33114;2198;15;2213
75;33;33115;236;1;237
75;33;33116;409;5;414
75;33;33117;225;3;228
75;33;33118;2082;34;2116
75;33;33119;25496;227;25723
75;33;33120;2138;20;2158
75;33;33121;190;2;192
75;33;33122;17053;276;17329
75;33;33123;2654;33;2687
75;33;33124;727;15;742
75;33;33125;2191;27;2218
75;33;33126;860;22;882
75;33;33127;222;5;227
75;33;33128;659;14;673
75;33;33129;155;0;155
75;33;33130;1035;27;1062
75;33;33131;209;2;211
75;33;33132;550;8;558
75;33;33133;72;1;73
75;33;33134;271;7;278
75;33;33135;128;2;130
75;33;33136;283;4;287
75;33;33137;221;4;225
75;33;33138;8602;130;8732
75;33;33139;98;3;101
75;33;33140;4832;100;4932
75;33;33141;691;9;700
75;33;33142;1650;16;1666
75;33;33143;2501;26;2527
75;33;33144;792;130;922
75;33;33145;659;18;677
75;33;33146;2330;28;2358
75;33;33147;470;6;476
75;33;33148;88;5;93
75;33;33149;154;1;155
75;33;33150;340;2;342
75;33;33151;915;18;933
75;33;33152;119;5;124
75;33;33153;266;4;270
75;33;33154;2142;101;2243
75;33;33155;158;4;162
75;33;33156;288;8;296
75;33;33157;792;15;807
75;33;33158;240;8;248
75;33;33159;1481;14;1495
75;33;33160;587;17;604
75;33;33161;764;6;770
75;33;33162;24488;264;24752
75;33;33163;433;6;439
75;33;33164;1651;34;1685
75;33;33165;3203;34;3237
75;33;33166;510;4;514
75;33;33167;18181;97;18278
75;33;33168;587;9;596
75;33;33169;109;4;113
75;33;33170;789;16;805
75;33;33171;231;3;234
75;33;33172;287;13;300
75;33;33173;188;7;195
75;33;33174;1142;34;1176
75;33;33175;739;10;749
75;33;33176;352;7;359
75;33;33177;2344;42;2386
75;33;33178;373;3;376
75;33;33179;3022;55;3077
75;33;33180;190;8;198
75;33;33181;280;4;284
75;33;33182;730;16;746
75;33;33183;1382;15;1397
75;33;33184;541;11;552
75;33;33185;1987;36;2023
75;33;33186;710;10;720
75;33;33187;1316;24;1340
75;33;33188;183;3;186
75;33;33189;430;10;440
75;33;33190;88;1;89
75;33;33191;586;4;590
75;33;33192;25694;334;26028
75;33;33193;1486;23;1509
75;33;33194;698;15;713
75;33;33195;1197;8;1205
75;33;33196;160;4;164
75;33;33197;451;6;457
75;33;33198;1591;35;1626
75;33;33199;21887;447;22334
75;33;33200;11539;189;11728
75;33;33201;833;18;851
75;33;33202;1433;18;1451
75;33;33203;3813;67;3880
75;33;33204;542;7;549
75;33;33205;1377;21;1398
75;33;33206;523;3;526
75;33;33207;6167;68;6235
75;33;33208;957;10;967
75;33;33209;283;7;290
75;33;33210;229;4;233
75;33;33211;599;2;601
75;33;33212;124;1;125
75;33;33213;4420;491;4911
75;33;33214;5070;72;5142
75;33;33215;194;6;200
75;33;33216;171;5;176
75;33;33218;1667;16;1683
75;33;33219;2540;25;2565
75;33;33220;1323;12;1335
75;33;33221;1166;23;1189
75;33;33222;659;15;674
75;33;33223;218;3;221
75;33;33224;100;0;100
75;33;33225;2195;37;2232
75;33;33226;2154;31;2185
75;33;33227;7357;146;7503
75;33;33228;701;10;711
75;33;33229;7285;139;7424
75;33;33230;507;10;517
75;33;33231;287;4;291
75;33;33232;39;0;39
75;33;33233;2844;21;2865
75;33;33234;3523;146;3669
75;33;33235;230;2;232
75;33;33236;8352;170;8522
75;33;33237;820;20;840
75;33;33238;10571;173;10744
75;33;33239;478;5;483
75;33;33240;5808;99;5907
75;33;33241;571;8;579
75;33;33242;555;10;565
75;33;33243;24257;544;24801
75;33;33244;439;8;447
75;33;33245;811;15;826
75;33;33246;150;6;156
75;33;33247;176;3;179
75;33;33248;2788;39;2827
75;33;33249;23181;317;23498
75;33;33250;313;8;321
75;33;33251;730;9;739
75;33;33252;834;12;846
75;33;33253;1118;10;1128
75;33;33254;510;8;518
75;33;33255;244;3;247
75;33;33256;5131;45;5176
75;33;33257;496;6;502
75;33;33258;304;7;311
75;33;33259;1346;24;1370
75;33;33260;974;21;995
75;33;33261;1240;38;1278
75;33;33262;4410;25;4435
75;33;33263;277;4;281
75;33;33264;1001;12;1013
75;33;33266;813;19;832
75;33;33268;2876;31;2907
75;33;33269;393;4;397
75;33;33270;183;8;191
75;33;33271;218;2;220
75;33;33272;1213;22;1235
75;33;33273;7624;131;7755
75;33;33274;3279;40;3319
75;33;33275;106;1;107
75;33;33276;142;5;147
75;33;33277;225;6;231
75;33;33278;236;6;242
75;33;33279;775;10;785
75;33;33280;542;4;546
75;33;33281;72197;723;72920
75;33;33282;350;4;354
75;33;33283;230;3;233
75;33;33284;10781;128;10909
75;33;33285;429;8;437
75;33;33287;601;5;606
75;33;33288;287;4;291
75;33;33289;1604;71;1675
75;33;33290;1521;132;1653
75;33;33291;178;3;181
75;33;33292;137;7;144
75;33;33293;3364;50;3414
75;33;33294;549;8;557
75;33;33295;86;9;95
75;33;33296;1032;15;1047
75;33;33297;1877;34;1911
75;33;33298;1006;19;1025
75;33;33299;385;8;393
75;33;33300;1083;23;1106
75;33;33301;605;6;611
75;33;33302;345;11;356
75;33;33303;841;8;849
75;33;33304;145;4;149
75;33;33305;509;5;514
75;33;33306;501;6;507
75;33;33307;1676;36;1712
75;33;33308;306;2;308
75;33;33309;496;6;502
75;33;33310;184;2;186
75;33;33311;1204;24;1228
75;33;33312;9136;84;9220
75;33;33314;4997;82;5079
75;33;33315;1622;21;1643
75;33;33316;968;13;981
75;33;33317;1194;16;1210
75;33;33318;65245;762;66007
75;33;33319;446;9;455
75;33;33320;720;11;731
75;33;33321;2148;28;2176
75;33;33322;6890;141;7031
75;33;33323;910;18;928
75;33;33324;4438;111;4549
75;33;33325;935;21;956
75;33;33326;219;5;224
75;33;33327;3160;49;3209
75;33;33328;579;11;590
75;33;33329;267;3;270
75;33;33330;3170;54;3224
75;33;33331;463;14;477
75;33;33332;867;11;878
75;33;33333;3294;46;3340
75;33;33334;2757;34;2791
75;33;33335;622;8;630
75;33;33336;1003;13;1016
75;33;33337;2154;33;2187
75;33;33339;1374;29;1403
75;33;33341;2325;33;2358
75;33;33342;823;21;844
75;33;33343;830;16;846
75;33;33344;528;6;534
75;33;33345;407;4;411
75;33;33346;418;11;429
75;33;33347;307;9;316
75;33;33348;1367;15;1382
75;33;33349;2195;22;2217
75;33;33350;1236;25;1261
75;33;33351;1602;26;1628
75;33;33352;4355;82;4437
75;33;33353;198;4;202
75;33;33354;192;5;197
75;33;33355;1525;36;1561
75;33;33356;431;1;432
75;33;33357;1742;27;1769
75;33;33358;467;8;475
75;33;33359;284;3;287
75;33;33360;308;3;311
75;33;33361;598;10;608
75;33;33362;1300;15;1315
75;33;33363;4499;70;4569
75;33;33364;385;7;392
75;33;33365;201;9;210
75;33;33366;12372;181;12553
75;33;33367;432;4;436
75;33;33369;675;12;687
75;33;33370;542;8;550
75;33;33372;56;2;58
75;33;33373;582;10;592
75;33;33374;866;19;885
75;33;33375;368;8;376
75;33;33376;7495;214;7709
75;33;33377;78;3;81
75;33;33378;1478;22;1500
75;33;33379;315;2;317
75;33;33380;1779;23;1802
75;33;33381;3399;34;3433
75;33;33382;1904;30;1934
75;33;33383;277;3;280
75;33;33384;418;7;425
75;33;33385;653;5;658
75;33;33386;191;6;197
75;33;33387;1481;24;1505
75;33;33388;781;16;797
75;33;33389;3021;42;3063
75;33;33390;422;9;431
75;33;33391;321;4;325
75;33;33392;866;16;882
75;33;33393;5688;68;5756
75;33;33394;1859;47;1906
75;33;33395;1592;50;1642
75;33;33396;195;4;199
75;33;33397;4832;82;4914
75;33;33398;168;2;170
75;33;33399;289;7;296
75;33;33400;340;5;345
75;33;33401;148;2;150
75;33;33402;2627;31;2658
75;33;33403;131;2;133
75;33;33404;190;4;194
75;33;33405;494;12;506
75;33;33406;380;7;387
75;33;33407;856;17;873
75;33;33408;383;17;400
75;33;33409;86;1;87
75;33;33411;156;3;159
75;33;33412;1256;20;1276
75;33;33413;2231;36;2267
75;33;33414;390;4;394
75;33;33415;1905;20;1925
75;33;33416;927;19;946
75;33;33417;2838;44;2882
75;33;33418;375;7;382
75;33;33419;79;0;79
75;33;33420;130;1;131
75;33;33421;463;7;470
75;33;33422;8980;163;9143
75;33;33423;611;0;611
75;33;33424;4860;88;4948
75;33;33425;1484;28;1512
75;33;33426;252;1;253
75;33;33427;247;5;252
75;33;33428;84;0;84
75;33;33429;326;5;331
75;33;33431;341;4;345
75;33;33432;236;2;238
75;33;33433;9909;108;10017
75;33;33434;2161;15;2176
75;33;33435;2078;95;2173
75;33;33436;1042;21;1063
75;33;33437;2029;11;2040
75;33;33438;1994;49;2043
75;33;33439;1624;19;1643
75;33;33440;239;5;244
75;33;33441;1158;98;1256
75;33;33442;550;5;555
75;33;33443;154;3;157
75;33;33444;576;10;586
75;33;33445;844;17;861
75;33;33446;168;1;169
75;33;33447;2391;22;2413
75;33;33448;3098;40;3138
75;33;33449;31808;520;32328
75;33;33450;245;3;248
75;33;33451;527;4;531
75;33;33452;836;13;849
75;33;33453;222;4;226
75;33;33454;1724;21;1745
75;33;33456;497;8;505
75;33;33457;600;10;610
75;33;33458;977;17;994
75;33;33459;187;3;190
75;33;33460;609;12;621
75;33;33461;375;5;380
75;33;33462;493;10;503
75;33;33463;1311;20;1331
75;33;33464;289;6;295
75;33;33465;1227;21;1248
75;33;33466;2559;32;2591
75;33;33467;238;4;242
75;33;33468;435;9;444
75;33;33470;871;24;895
75;33;33471;1280;23;1303
75;33;33472;360;6;366
75;33;33473;3250;37;3287
75;33;33474;3423;41;3464
75;33;33475;408;6;414
75;33;33476;704;12;716
75;33;33477;763;17;780
75;33;33478;3141;21;3162
75;33;33479;251;2;253
75;33;33480;1316;29;1345
75;33;33481;230;3;233
75;33;33482;250;3;253
75;33;33483;4762;67;4829
75;33;33484;1831;31;1862
75;33;33485;1910;32;1942
75;33;33486;355;9;364
75;33;33487;1000;8;1008
75;33;33488;357;13;370
75;33;33489;354;5;359
75;33;33490;1791;24;1815
75;33;33491;383;5;388
75;33;33492;2427;24;2451
75;33;33493;348;24;372
75;33;33494;1171;11;1182
75;33;33496;2630;40;2670
75;33;33498;7411;139;7550
75;33;33499;333;9;342
75;33;33500;429;9;438
75;33;33501;3255;57;3312
75;33;33502;485;5;490
75;33;33503;532;9;541
75;33;33504;814;9;823
75;33;33505;1546;55;1601
75;33;33506;1853;22;1875
75;33;33507;324;11;335
75;33;33508;626;13;639
75;33;33509;501;9;510
75;33;33510;218;1;219
75;33;33511;339;4;343
75;33;33512;362;8;370
75;33;33513;122;2;124
75;33;33514;2825;25;2850
75;33;33515;422;8;430
75;33;33516;199;5;204
75;33;33517;1655;17;1672
75;33;33518;1084;23;1107
75;33;33519;10141;145;10286
75;33;33520;283;3;286
75;33;33521;764;7;771
75;33;33522;43820;979;44799
75;33;33523;2054;24;2078
75;33;33524;337;7;344
75;33;33525;1297;21;1318
75;33;33526;133;3;136
75;33;33527;8500;179;8679
75;33;33528;633;7;640
75;33;33529;26168;378;26546
75;33;33530;880;9;889
75;33;33531;346;5;351
75;33;33532;472;9;481
75;33;33533;2752;28;2780
75;33;33534;802;11;813
75;33;33535;4895;52;4947
75;33;33536;257;5;262
75;33;33537;459;10;469
75;33;33538;539;10;549
75;33;33539;4123;53;4176
75;33;33540;2410;37;2447
75;33;33541;1017;17;1034
75;33;33542;946;14;960
75;33;33543;1020;9;1029
75;33;33544;1326;11;1337
75;33;33545;1314;22;1336
75;33;33546;503;12;515
75;33;33547;1120;26;1146
75;33;33548;1250;24;1274
75;33;33549;348;6;354
75;33;33550;36754;205;36959
75;33;33551;397;6;403
75;33;33552;1092;13;1105
75;33;33553;1171;5;1176
75;33;33554;2838;23;2861
75;33;33555;4992;81;5073
76;34;34001;1795;24;1819
76;34;34002;1259;25;1284
76;34;34003;29600;400;30000
76;34;34004;245;4;249
76;34;34005;285;9;294
76;34;34006;271;7;278
76;34;34007;470;5;475
76;34;34008;605;11;616
76;34;34009;1753;28;1781
76;34;34010;2918;39;2957
76;34;34011;111;4;115
76;34;34012;973;25;998
76;34;34013;1662;29;1691
76;34;34014;1488;42;1530
76;34;34015;164;3;167
76;34;34016;531;17;548
76;34;34017;494;16;510
76;34;34018;923;15;938
76;34;34019;276;8;284
76;34;34020;360;12;372
76;34;34021;297;6;303
76;34;34022;7654;101;7755
76;34;34023;6991;91;7082
76;34;34024;2648;42;2690
76;34;34025;2155;35;2190
76;34;34026;221;4;225
76;34;34027;2144;49;2193
76;34;34028;5743;231;5974
76;34;34029;681;10;691
76;34;34030;211;0;211
76;34;34031;5162;76;5238
76;34;34032;78308;1242;79550
76;34;34033;2072;41;2113
76;34;34034;39;1;40
76;34;34035;1028;19;1047
76;34;34036;1362;24;1386
76;34;34037;3367;56;3423
76;34;34038;1584;24;1608
76;34;34039;1643;24;1667
76;34;34040;54;0;54
76;34;34041;940;17;957
76;34;34042;605;14;619
76;34;34043;361;5;366
76;34;34044;341;10;351
76;34;34045;524;16;540
76;34;34046;49;0;49
76;34;34047;699;10;709
76;34;34048;310;5;315
76;34;34049;229;4;233
76;34;34050;1950;26;1976
76;34;34051;3506;46;3552
76;34;34052;3281;59;3340
76;34;34053;128;0;128
76;34;34054;106;1;107
76;34;34055;216;3;219
76;34;34056;1253;24;1277
76;34;34057;22534;382;22916
76;34;34058;6294;103;6397
76;34;34059;315;6;321
76;34;34060;402;5;407
76;34;34061;619;10;629
76;34;34062;152;1;153
76;34;34063;2538;47;2585
76;34;34064;458;14;472
76;34;34065;608;11;619
76;34;34066;215;3;218
76;34;34067;1536;40;1576
76;34;34068;412;9;421
76;34;34069;5060;94;5154
76;34;34070;627;12;639
76;34;34071;329;5;334
76;34;34072;27;1;28
76;34;34073;2560;50;2610
76;34;34074;2336;49;2385
76;34;34075;413;8;421
76;34;34076;1368;26;1394
76;34;34077;5411;101;5512
76;34;34078;1671;37;1708
76;34;34079;9029;161;9190
76;34;34080;482;14;496
76;34;34081;2684;44;2728
76;34;34082;1742;41;1783
76;34;34083;326;3;329
76;34;34084;1724;31;1755
76;34;34085;353;4;357
76;34;34086;616;13;629
76;34;34087;3454;31;3485
76;34;34088;6423;78;6501
76;34;34089;1313;26;1339
76;34;34090;9310;133;9443
76;34;34091;56;0;56
76;34;34092;967;17;984
76;34;34093;146;5;151
76;34;34094;1109;23;1132
76;34;34095;7293;127;7420
76;34;34096;546;9;555
76;34;34097;473;6;479
76;34;34098;153;4;157
76;34;34099;48;1;49
76;34;34100;55;4;59
76;34;34101;5057;79;5136
76;34;34102;349;9;358
76;34;34103;1045;19;1064
76;34;34104;126;0;126
76;34;34105;254;3;257
76;34;34106;180;9;189
76;34;34107;343;3;346
76;34;34108;23028;227;23255
76;34;34109;844;19;863
76;34;34110;733;26;759
76;34;34111;4098;102;4200
76;34;34112;207;4;211
76;34;34113;6507;79;6586
76;34;34114;6480;114;6594
76;34;34115;118;1;119
76;34;34116;8798;99;8897
76;34;34117;608;9;617
76;34;34118;502;12;514
76;34;34119;1515;26;1541
76;34;34120;6808;102;6910
76;34;34121;285;13;298
76;34;34122;528;7;535
76;34;34123;11344;103;11447
76;34;34124;308;10;318
76;34;34125;111;4;115
76;34;34126;2500;17;2517
76;34;34127;3099;43;3142
76;34;34128;1625;31;1656
76;34;34129;17453;227;17680
76;34;34130;1770;29;1799
76;34;34131;638;20;658
76;34;34132;205;2;207
76;34;34133;57;0;57
76;34;34134;3328;54;3382
76;34;34135;3299;54;3353
76;34;34136;1567;29;1596
76;34;34137;148;7;155
76;34;34138;333;13;346
76;34;34139;1385;40;1425
76;34;34140;3218;85;3303
76;34;34141;521;8;529
76;34;34142;7477;237;7714
76;34;34143;2191;39;2230
76;34;34144;661;13;674
76;34;34145;26385;242;26627
76;34;34146;4367;45;4412
76;34;34147;3371;52;3423
76;34;34148;4628;85;4713
76;34;34149;717;2;719
76;34;34150;7734;104;7838
76;34;34151;6407;78;6485
76;34;34152;672;10;682
76;34;34153;2005;41;2046
76;34;34154;16705;194;16899
76;34;34155;2260;48;2308
76;34;34156;44;3;47
76;34;34157;12307;166;12473
76;34;34158;103;1;104
76;34;34159;3310;50;3360
76;34;34160;627;15;642
76;34;34161;3960;75;4035
76;34;34162;4324;59;4383
76;34;34163;4052;47;4099
76;34;34164;1028;11;1039
76;34;34165;2934;60;2994
76;34;34166;2865;51;2916
76;34;34167;254;4;258
76;34;34168;74;0;74
76;34;34169;3960;162;4122
76;34;34170;213;5;218
76;34;34171;163;4;167
76;34;34172;295542;3391;298933
76;34;34173;1360;24;1384
76;34;34174;866;26;892
76;34;34175;205;5;210
76;34;34176;2753;29;2782
76;34;34177;324;10;334
76;34;34178;3105;54;3159
76;34;34179;1863;30;1893
76;34;34180;1437;23;1460
76;34;34181;1039;25;1064
76;34;34182;1827;29;1856
76;34;34183;3996;61;4057
76;34;34184;677;15;692
76;34;34185;507;11;518
76;34;34186;522;12;534
76;34;34187;662;14;676
76;34;34188;188;4;192
76;34;34189;1687;19;1706
76;34;34190;237;7;244
76;34;34191;571;12;583
76;34;34192;5844;41;5885
76;34;34193;177;6;183
76;34;34194;4016;53;4069
76;34;34195;55;1;56
76;34;34196;159;5;164
76;34;34197;1040;17;1057
76;34;34198;9016;122;9138
76;34;34199;8002;271;8273
76;34;34200;236;10;246
76;34;34201;293;7;300
76;34;34202;7959;109;8068
76;34;34203;1906;22;1928
76;34;34204;1373;17;1390
76;34;34205;283;10;293
76;34;34206;538;11;549
76;34;34207;2196;44;2240
76;34;34208;358;15;373
76;34;34209;3104;64;3168
76;34;34210;2082;46;2128
76;34;34211;1008;30;1038
76;34;34212;175;6;181
76;34;34213;5993;78;6071
76;34;34214;1172;18;1190
76;34;34215;959;22;981
76;34;34216;334;9;343
76;34;34217;5908;111;6019
76;34;34218;310;8;318
76;34;34219;505;9;514
76;34;34220;251;5;256
76;34;34221;499;11;510
76;34;34222;616;13;629
76;34;34223;1152;23;1175
76;34;34224;1348;23;1371
76;34;34225;3037;50;3087
76;34;34226;1796;26;1822
76;34;34227;2109;29;2138
76;34;34228;77;5;82
76;34;34229;739;26;765
76;34;34230;147;4;151
76;34;34231;21;2;23
76;34;34232;604;11;615
76;34;34233;210;3;213
76;34;34234;97;1;98
76;34;34235;275;5;280
76;34;34236;68;0;68
76;34;34237;2187;29;2216
76;34;34238;36;1;37
76;34;34239;6198;106;6304
76;34;34240;3786;33;3819
76;34;34241;873;14;887
76;34;34242;1074;24;1098
76;34;34243;2001;31;2032
76;34;34244;3209;43;3252
76;34;34245;1697;34;1731
76;34;34246;2107;44;2151
76;34;34247;5016;244;5260
76;34;34248;943;17;960
76;34;34249;2735;58;2793
76;34;34250;302;7;309
76;34;34251;519;17;536
76;34;34252;253;5;258
76;34;34253;34;1;35
76;34;34254;1163;32;1195
76;34;34255;10197;265;10462
76;34;34256;2017;33;2050
76;34;34257;216;2;218
76;34;34258;1669;30;1699
76;34;34259;5552;66;5618
76;34;34260;855;15;870
76;34;34261;245;8;253
76;34;34262;250;0;250
76;34;34263;433;3;436
76;34;34264;210;0;210
76;34;34265;750;23;773
76;34;34266;500;7;507
76;34;34267;1727;34;1761
76;34;34268;634;17;651
76;34;34269;147;6;153
76;34;34270;11086;204;11290
76;34;34271;219;3;222
76;34;34272;3278;29;3307
76;34;34273;143;5;148
76;34;34274;2766;26;2792
76;34;34276;4883;96;4979
76;34;34277;186;6;192
76;34;34278;55;1;56
76;34;34279;325;3;328
76;34;34280;615;7;622
76;34;34281;2329;37;2366
76;34;34282;1248;19;1267
76;34;34283;135;1;136
76;34;34284;1794;185;1979
76;34;34285;638;11;649
76;34;34286;401;12;413
76;34;34287;267;7;274
76;34;34288;976;22;998
76;34;34289;2807;36;2843
76;34;34290;719;10;729
76;34;34291;355;23;378
76;34;34292;302;6;308
76;34;34293;1132;20;1152
76;34;34294;1011;19;1030
76;34;34295;1616;33;1649
76;34;34296;1004;21;1025
76;34;34297;426;8;434
76;34;34298;5485;97;5582
76;34;34299;7504;158;7662
76;34;34300;5233;92;5325
76;34;34301;43858;601;44459
76;34;34302;744;8;752
76;34;34303;38;1;39
76;34;34304;920;12;932
76;34;34305;127;0;127
76;34;34306;174;2;176
76;34;34307;2802;57;2859
76;34;34308;457;13;470
76;34;34309;4595;107;4702
76;34;34310;3029;74;3103
76;34;34311;1719;157;1876
76;34;34312;1279;29;1308
76;34;34313;676;24;700
76;34;34314;576;13;589
76;34;34315;430;5;435
76;34;34316;226;2;228
76;34;34317;186;7;193
76;34;34318;721;12;733
76;34;34319;151;4;155
76;34;34320;2584;56;2640
76;34;34321;2057;29;2086
76;34;34322;766;24;790
76;34;34323;44;0;44
76;34;34324;4206;58;4264
76;34;34325;1641;32;1673
76;34;34326;91;0;91
76;34;34327;6423;84;6507
76;34;34328;1122;27;1149
76;34;34329;2723;81;2804
76;34;34331;95;2;97
76;34;34332;5717;65;5782
76;34;34333;3373;28;3401
76;34;34334;269;0;269
76;34;34335;419;12;431
76;34;34336;4102;53;4155
76;34;34337;10344;121;10465
76;34;34338;69;3;72
76;34;34339;174;2;176
76;34;34340;1467;43;1510
76;34;34341;3859;68;3927
76;34;34342;206;4;210
76;34;34343;1228;28;1256
76;34;34344;8696;104;8800
53;35;35001;6834;164;6998
53;35;35002;1759;37;1796
53;35;35003;946;9;955
53;35;35004;4137;88;4225
53;35;35005;313;12;325
53;35;35006;4502;129;4631
53;35;35007;485;2;487
53;35;35008;674;18;692
53;35;35009;1703;27;1730
53;35;35010;1738;16;1754
53;35;35012;7314;165;7479
53;35;35013;3503;162;3665
53;35;35014;2455;32;2487
53;35;35015;2218;48;2266
53;35;35016;2188;61;2249
53;35;35017;673;10;683
53;35;35018;1069;21;1090
53;35;35019;1856;27;1883
53;35;35021;1357;36;1393
53;35;35022;688;15;703
53;35;35023;4417;73;4490
53;35;35024;12265;259;12524
53;35;35025;1054;15;1069
53;35;35026;102;6;108
53;35;35027;1707;33;1740
53;35;35028;722;14;736
53;35;35029;1539;25;1564
53;35;35030;676;17;693
53;35;35031;4526;101;4627
53;35;35032;4515;62;4577
53;35;35033;3295;69;3364
53;35;35034;1200;24;1224
53;35;35035;598;11;609
53;35;35037;6404;81;6485
53;35;35038;633;21;654
53;35;35039;2059;43;2102
53;35;35040;3655;78;3733
53;35;35041;1006;17;1023
53;35;35042;670;30;700
53;35;35044;381;10;391
53;35;35045;866;19;885
53;35;35046;540;8;548
53;35;35047;18905;461;19366
53;35;35049;5226;91;5317
53;35;35050;593;9;602
53;35;35051;17082;534;17616
53;35;35052;514;15;529
53;35;35054;1815;45;1860
53;35;35055;10278;191;10469
53;35;35056;814;20;834
53;35;35057;1496;26;1522
53;35;35058;1295;15;1310
53;35;35059;4682;96;4778
53;35;35060;1011;19;1030
53;35;35061;711;17;728
53;35;35062;1475;27;1502
53;35;35063;452;6;458
53;35;35064;984;20;1004
53;35;35065;2219;44;2263
53;35;35066;8157;134;8291
53;35;35067;1598;28;1626
53;35;35068;7336;154;7490
53;35;35069;10283;263;10546
53;35;35070;1710;25;1735
53;35;35071;436;6;442
53;35;35072;1675;35;1710
53;35;35075;808;19;827
53;35;35076;4268;82;4350
53;35;35077;347;11;358
53;35;35078;1092;22;1114
53;35;35079;2325;57;2382
53;35;35080;2410;62;2472
53;35;35081;908;30;938
53;35;35082;1465;35;1500
53;35;35084;695;11;706
53;35;35085;5963;142;6105
53;35;35086;611;9;620
53;35;35087;964;32;996
53;35;35088;3434;56;3490
53;35;35089;455;12;467
53;35;35090;2862;40;2902
53;35;35091;597;6;603
53;35;35092;834;14;848
53;35;35093;10181;526;10707
53;35;35094;1638;24;1662
53;35;35095;5738;332;6070
53;35;35096;2383;55;2438
53;35;35097;2020;51;2071
53;35;35098;1396;27;1423
53;35;35099;3680;65;3745
53;35;35101;1195;21;1216
53;35;35102;510;10;520
53;35;35103;420;10;430
53;35;35104;1417;26;1443
53;35;35105;1697;53;1750
53;35;35106;1514;14;1528
53;35;35107;1949;35;1984
53;35;35108;1061;23;1084
53;35;35109;2585;59;2644
53;35;35110;1014;19;1033
53;35;35111;710;6;716
53;35;35112;939;26;965
53;35;35114;261;6;267
53;35;35115;20595;653;21248
53;35;35116;2571;58;2629
53;35;35117;1619;22;1641
53;35;35118;1525;24;1549
53;35;35119;946;21;967
53;35;35120;5521;109;5630
53;35;35121;2000;37;2037
53;35;35122;1943;46;1989
53;35;35123;4321;90;4411
53;35;35124;2455;38;2493
53;35;35125;4249;147;4396
53;35;35126;8674;203;8877
53;35;35127;3986;97;4083
53;35;35128;1701;39;1740
53;35;35130;2247;54;2301
53;35;35131;4629;81;4710
53;35;35132;1389;34;1423
53;35;35133;4553;93;4646
53;35;35134;273;12;285
53;35;35135;2263;37;2300
53;35;35136;8470;159;8629
53;35;35137;2105;70;2175
53;35;35138;1173;28;1201
53;35;35139;5116;149;5265
53;35;35140;561;10;571
53;35;35141;693;21;714
53;35;35142;1183;22;1205
53;35;35143;929;30;959
53;35;35144;1031;19;1050
53;35;35145;1385;25;1410
53;35;35146;606;2;608
53;35;35148;157;0;157
53;35;35149;1757;39;1796
53;35;35150;3260;95;3355
53;35;35151;777;15;792
53;35;35152;7949;137;8086
53;35;35153;367;11;378
53;35;35154;1718;41;1759
53;35;35155;648;15;663
53;35;35156;612;10;622
53;35;35157;643;15;658
53;35;35159;326;3;329
53;35;35160;247;5;252
53;35;35161;1912;36;1948
53;35;35162;3340;59;3399
53;35;35163;1823;29;1852
53;35;35164;743;11;754
53;35;35165;951;21;972
53;35;35166;1027;15;1042
53;35;35167;2583;65;2648
53;35;35168;3954;81;4035
53;35;35169;1470;17;1487
53;35;35170;607;16;623
53;35;35171;1819;48;1867
53;35;35172;1918;30;1948
53;35;35173;6958;107;7065
53;35;35174;649;12;661
53;35;35175;1012;16;1028
53;35;35176;7107;142;7249
53;35;35177;4971;121;5092
53;35;35178;1799;19;1818
53;35;35179;4148;80;4228
53;35;35180;792;16;808
53;35;35181;1483;35;1518
53;35;35183;820;21;841
53;35;35184;6086;246;6332
53;35;35185;266;1;267
53;35;35186;1085;31;1116
53;35;35187;1332;45;1377
53;35;35188;6726;173;6899
53;35;35189;3515;62;3577
53;35;35190;250;8;258
53;35;35191;2319;49;2368
53;35;35192;232;5;237
53;35;35193;1972;44;2016
53;35;35194;1006;32;1038
53;35;35195;2390;35;2425
53;35;35196;7338;141;7479
53;35;35197;1718;19;1737
53;35;35198;713;25;738
53;35;35199;343;9;352
53;35;35200;919;16;935
53;35;35201;885;7;892
53;35;35202;1022;9;1031
53;35;35203;353;5;358
53;35;35204;3281;59;3340
53;35;35205;380;8;388
53;35;35206;7003;127;7130
53;35;35207;6133;150;6283
53;35;35208;5152;124;5276
53;35;35210;11860;329;12189
53;35;35211;1772;40;1812
53;35;35212;1191;32;1223
53;35;35214;649;1;650
53;35;35215;1331;43;1374
53;35;35216;1780;28;1808
53;35;35217;1380;29;1409
53;35;35218;883;20;903
53;35;35219;3813;76;3889
53;35;35220;3031;54;3085
53;35;35221;2780;54;2834
53;35;35222;1973;33;2006
53;35;35223;4008;87;4095
53;35;35224;2796;52;2848
53;35;35225;781;15;796
53;35;35226;1927;27;1954
53;35;35227;3474;51;3525
53;35;35228;6982;124;7106
53;35;35229;1319;52;1371
53;35;35230;374;4;378
53;35;35231;1195;31;1226
53;35;35232;391;7;398
53;35;35233;1578;37;1615
53;35;35234;1194;17;1211
53;35;35235;1076;47;1123
53;35;35236;9287;745;10032
53;35;35237;1034;22;1056
53;35;35238;220488;4167;224655
53;35;35239;4438;96;4534
53;35;35240;8932;293;9225
53;35;35241;2403;85;2488
53;35;35242;345;4;349
53;35;35243;2458;55;2513
53;35;35244;248;3;251
53;35;35245;4032;73;4105
53;35;35246;1361;27;1388
53;35;35247;998;12;1010
53;35;35248;459;8;467
53;35;35249;1029;14;1043
53;35;35250;2206;39;2245
53;35;35251;3916;82;3998
53;35;35252;923;34;957
53;35;35253;4006;162;4168
53;35;35255;975;30;1005
53;35;35256;2193;63;2256
53;35;35257;4958;96;5054
53;35;35258;331;9;340
53;35;35259;1140;22;1162
53;35;35260;563;6;569
53;35;35261;235;2;237
53;35;35262;356;6;362
53;35;35263;2820;88;2908
53;35;35264;2034;45;2079
53;35;35265;2562;49;2611
53;35;35266;3311;73;3384
53;35;35268;429;8;437
53;35;35270;371;4;375
53;35;35271;1487;26;1513
53;35;35272;951;23;974
53;35;35273;2062;31;2093
53;35;35274;962;15;977
53;35;35275;5178;85;5263
53;35;35276;571;12;583
53;35;35277;377;6;383
53;35;35278;9890;372;10262
53;35;35279;1207;28;1235
53;35;35280;1025;20;1045
53;35;35281;13948;158;14106
53;35;35282;2886;52;2938
53;35;35283;1334;23;1357
53;35;35284;2683;71;2754
53;35;35285;1055;23;1078
53;35;35286;284;10;294
53;35;35287;2460;88;2548
53;35;35288;46803;1338;48141
53;35;35289;1076;18;1094
53;35;35290;578;11;589
53;35;35291;437;9;446
53;35;35292;1633;39;1672
53;35;35294;2265;65;2330
53;35;35295;538;11;549
53;35;35296;1322;23;1345
53;35;35297;4599;164;4763
53;35;35299;4327;108;4435
53;35;35300;1356;39;1395
53;35;35302;1127;24;1151
53;35;35304;1313;29;1342
53;35;35305;418;8;426
53;35;35306;2333;163;2496
53;35;35307;1042;19;1061
53;35;35308;4336;75;4411
53;35;35309;819;13;832
53;35;35310;1531;27;1558
53;35;35311;584;4;588
53;35;35312;1829;48;1877
53;35;35314;943;50;993
53;35;35315;1382;41;1423
53;35;35316;827;9;836
53;35;35317;589;61;650
53;35;35318;947;21;968
53;35;35319;2114;43;2157
53;35;35320;540;4;544
53;35;35321;794;10;804
53;35;35322;1109;27;1136
53;35;35324;616;17;633
53;35;35325;155;6;161
53;35;35326;2566;41;2607
53;35;35327;3804;88;3892
53;35;35328;2135;43;2178
53;35;35329;547;11;558
53;35;35330;993;26;1019
53;35;35331;2489;51;2540
53;35;35332;1069;11;1080
53;35;35333;1725;33;1758
53;35;35334;8575;211;8786
53;35;35335;837;22;859
53;35;35336;182;3;185
53;35;35337;3739;191;3930
53;35;35338;1223;29;1252
53;35;35339;591;4;595
53;35;35340;1307;24;1331
53;35;35342;347;12;359
53;35;35343;1244;20;1264
53;35;35345;895;23;918
53;35;35346;209;4;213
53;35;35347;2580;57;2637
53;35;35350;806;24;830
53;35;35351;1436;24;1460
53;35;35352;8169;146;8315
53;35;35353;6114;113;6227
53;35;35354;317;2;319
53;35;35355;1245;6;1251
53;35;35356;2025;25;2050
53;35;35357;306;5;311
53;35;35358;1220;32;1252
53;35;35359;838;17;855
53;35;35360;18487;553;19040
53;35;35361;1054;7;1061
53;35;35362;1177;9;1186
53;35;35363;4413;106;4519
24;36;36001;1420;27;1447
24;36;36002;118;0;118
24;36;36003;891;23;914
24;36;36004;322;8;330
24;36;36005;3850;82;3932
24;36;36006;4880;213;5093
24;36;36007;601;9;610
24;36;36008;222;9;231
24;36;36009;1218;43;1261
24;36;36010;867;18;885
24;36;36011;175;2;177
24;36;36012;363;0;363
24;36;36013;428;5;433
24;36;36014;199;6;205
24;36;36015;54;1;55
24;36;36016;945;22;967
24;36;36017;368;5;373
24;36;36018;6250;222;6472
24;36;36019;312;5;317
24;36;36020;74;1;75
24;36;36021;891;20;911
24;36;36022;410;8;418
24;36;36023;261;5;266
24;36;36024;130;1;131
24;36;36025;608;11;619
24;36;36026;596;8;604
24;36;36027;249;6;255
24;36;36028;115;2;117
24;36;36029;230;3;233
24;36;36030;244;4;248
24;36;36031;4516;74;4590
24;36;36032;724;22;746
24;36;36033;398;4;402
24;36;36034;2763;38;2801
24;36;36035;1086;14;1100
24;36;36036;149;1;150
24;36;36037;283;6;289
24;36;36038;137;2;139
24;36;36040;102;0;102
24;36;36041;140;1;141
24;36;36042;703;11;714
24;36;36043;574;23;597
24;36;36044;43122;1540;44662
24;36;36045;2360;34;2394
24;36;36046;4054;117;4171
24;36;36047;504;8;512
24;36;36048;271;9;280
24;36;36049;125;2;127
24;36;36050;457;7;464
24;36;36051;186;5;191
24;36;36052;153;2;155
24;36;36053;543;13;556
24;36;36054;233;7;240
24;36;36055;1004;18;1022
24;36;36056;984;15;999
24;36;36057;881;23;904
24;36;36058;645;17;662
24;36;36059;233;8;241
24;36;36060;703;14;717
24;36;36061;332;9;341
24;36;36062;441;6;447
24;36;36063;7609;149;7758
24;36;36064;749;16;765
24;36;36065;260;5;265
24;36;36066;441;14;455
24;36;36067;101;3;104
24;36;36068;422;7;429
24;36;36069;1216;23;1239
24;36;36070;1345;37;1382
24;36;36071;1012;20;1032
24;36;36073;213;5;218
24;36;36074;536;9;545
24;36;36075;89;1;90
24;36;36076;249;3;252
24;36;36077;245;3;248
24;36;36078;356;5;361
24;36;36079;77;1;78
24;36;36080;72;2;74
24;36;36081;280;8;288
24;36;36082;252;1;253
24;36;36083;117;4;121
24;36;36084;287;2;289
24;36;36085;247;6;253
24;36;36086;390;8;398
24;36;36087;312;5;317
24;36;36088;11477;290;11767
24;36;36089;405;6;411
24;36;36090;118;2;120
24;36;36091;656;18;674
24;36;36092;270;8;278
24;36;36093;2923;37;2960
24;36;36094;449;7;456
24;36;36095;106;2;108
24;36;36096;214;3;217
24;36;36097;323;9;332
24;36;36098;85;3;88
24;36;36099;299;4;303
24;36;36100;261;6;267
24;36;36101;1536;39;1575
24;36;36102;102;2;104
24;36;36103;1340;16;1356
24;36;36104;234;2;236
24;36;36105;257;3;260
24;36;36106;155;1;156
24;36;36107;728;12;740
24;36;36108;214;2;216
24;36;36109;1054;19;1073
24;36;36110;260;6;266
24;36;36111;193;3;196
24;36;36112;750;19;769
24;36;36113;938;20;958
24;36;36114;296;8;304
24;36;36115;128;2;130
24;36;36116;118;1;119
24;36;36117;429;7;436
24;36;36118;378;3;381
24;36;36119;540;13;553
24;36;36120;669;12;681
24;36;36121;172;6;178
24;36;36122;197;2;199
24;36;36123;990;20;1010
24;36;36124;274;11;285
24;36;36125;120;5;125
24;36;36126;446;5;451
24;36;36127;1570;36;1606
24;36;36128;1673;167;1840
24;36;36129;557;14;571
24;36;36130;108;2;110
24;36;36131;472;7;479
24;36;36132;64;3;67
24;36;36133;216;6;222
24;36;36134;402;12;414
24;36;36135;295;6;301
24;36;36136;129;3;132
24;36;36137;365;16;381
24;36;36138;187;7;194
24;36;36139;657;16;673
24;36;36140;1174;21;1195
24;36;36141;1652;38;1690
24;36;36142;1583;31;1614
24;36;36143;449;13;462
24;36;36144;295;7;302
24;36;36145;177;3;180
24;36;36146;728;10;738
24;36;36147;138;3;141
24;36;36148;410;3;413
24;36;36149;794;12;806
24;36;36150;496;9;505
24;36;36152;440;3;443
24;36;36153;339;8;347
24;36;36154;1859;38;1897
24;36;36155;791;55;846
24;36;36156;366;2;368
24;36;36157;451;13;464
24;36;36158;765;9;774
24;36;36159;5820;174;5994
24;36;36160;214;5;219
24;36;36161;937;10;947
24;36;36162;826;19;845
24;36;36163;669;11;680
24;36;36164;225;3;228
24;36;36165;1036;28;1064
24;36;36166;166;4;170
24;36;36167;157;3;160
24;36;36168;586;15;601
24;36;36169;511;10;521
24;36;36170;104;0;104
24;36;36171;2010;37;2047
24;36;36172;528;10;538
24;36;36173;519;13;532
24;36;36174;361;11;372
24;36;36175;276;2;278
24;36;36176;586;8;594
24;36;36177;325;6;331
24;36;36178;277;12;289
24;36;36179;232;0;232
24;36;36180;825;18;843
24;36;36181;167;3;170
24;36;36182;576;17;593
24;36;36184;495;8;503
24;36;36185;362;3;365
24;36;36186;256;3;259
24;36;36187;132;2;134
24;36;36188;182;150;332
24;36;36189;967;13;980
24;36;36190;270;1;271
24;36;36191;532;7;539
24;36;36192;1772;23;1795
24;36;36193;256;8;264
24;36;36194;950;16;966
24;36;36195;571;14;585
24;36;36196;100;3;103
24;36;36197;292;7;299
24;36;36198;406;14;420
24;36;36199;1145;24;1169
24;36;36200;1506;24;1530
24;36;36202;3685;77;3762
24;36;36203;52;0;52
24;36;36204;323;7;330
24;36;36205;109;4;113
24;36;36207;611;13;624
24;36;36208;774;14;788
24;36;36209;268;13;281
24;36;36210;300;11;311
24;36;36211;457;8;465
24;36;36212;155;2;157
24;36;36213;256;4;260
24;36;36214;300;10;310
24;36;36215;496;13;509
24;36;36216;65;1;66
24;36;36217;98;3;101
24;36;36218;144;6;150
24;36;36219;648;7;655
24;36;36220;896;18;914
24;36;36221;382;8;390
24;36;36222;234;7;241
24;36;36223;139;4;143
24;36;36224;1132;25;1157
24;36;36225;181;1;182
24;36;36226;353;1;354
24;36;36227;248;2;250
24;36;36228;2338;107;2445
24;36;36229;957;10;967
24;36;36230;1945;39;1984
24;36;36231;964;20;984
24;36;36232;1052;16;1068
24;36;36233;741;8;749
24;36;36234;326;6;332
24;36;36235;376;8;384
24;36;36236;317;5;322
24;36;36237;716;19;735
24;36;36238;99;3;102
24;36;36239;461;6;467
24;36;36240;298;4;302
24;36;36241;2687;47;2734
24;36;36242;107;1;108
24;36;36243;319;4;323
24;36;36244;873;6;879
24;36;36246;168;2;170
24;36;36247;1228;22;1250
24;36;36248;231;3;234
24;37;37001;1149;17;1166
24;37;37002;1757;29;1786
24;37;37003;12533;379;12912
24;37;37004;423;11;434
24;37;37005;508;5;513
24;37;37006;2649;52;2701
24;37;37007;166;4;170
24;37;37008;2716;39;2755
24;37;37009;439;4;443
24;37;37010;2222;70;2292
24;37;37011;1868;39;1907
24;37;37012;554;3;557
24;37;37013;468;10;478
24;37;37014;3501;99;3600
24;37;37015;3099;68;3167
24;37;37016;367;14;381
24;37;37018;8102;140;8242
24;37;37019;455;10;465
24;37;37020;1761;33;1794
24;37;37021;1719;19;1738
24;37;37022;2689;90;2779
24;37;37023;242;5;247
24;37;37024;906;27;933
24;37;37025;692;6;698
24;37;37026;536;4;540
24;37;37027;5257;65;5322
24;37;37028;744;23;767
24;37;37029;328;5;333
24;37;37030;795;7;802
24;37;37031;3894;77;3971
24;37;37032;271;7;278
24;37;37033;210;5;215
24;37;37034;301;7;308
24;37;37035;291;6;297
24;37;37036;189;1;190
24;37;37037;215;5;220
24;37;37038;750;8;758
24;37;37039;494;13;507
24;37;37040;262;9;271
24;37;37041;323;5;328
24;37;37042;185;3;188
24;37;37043;1051;24;1075
24;37;37044;369;5;374
24;37;37045;1059;15;1074
24;37;37046;437;8;445
24;37;37047;1215;26;1241
24;37;37048;321;5;326
24;37;37049;1250;25;1275
24;37;37050;11880;262;12142
24;37;37051;829;8;837
24;37;37052;1135;18;1153
24;37;37053;119;7;126
24;37;37054;3525;47;3572
24;37;37055;816;16;832
24;37;37056;569;10;579
24;37;37057;681;14;695
24;37;37058;1446;26;1472
24;37;37059;1306;31;1337
24;37;37060;1311;20;1331
24;37;37061;501;16;517
24;37;37062;1736;18;1754
24;37;37063;4917;78;4995
24;37;37064;226;7;233
24;37;37065;549;5;554
24;37;37066;560;5;565
24;37;37067;1816;21;1837
24;37;37068;729;10;739
24;37;37069;230;8;238
24;37;37070;351;5;356
24;37;37071;132;2;134
24;37;37072;8104;318;8422
24;37;37073;583;14;597
24;37;37074;2085;24;2109
24;37;37075;461;5;466
24;37;37076;398;10;408
24;37;37077;3729;51;3780
24;37;37078;412;8;420
24;37;37079;1791;57;1848
24;37;37080;203;4;207
24;37;37081;1401;20;1421
24;37;37082;447;4;451
24;37;37083;1800;26;1826
24;37;37084;538;6;544
24;37;37085;801;23;824
24;37;37086;498;8;506
24;37;37087;247;9;256
24;37;37088;110;1;111
24;37;37089;655;18;673
24;37;37090;109;2;111
24;37;37091;2379;59;2438
24;37;37092;665;14;679
24;37;37093;535;6;541
24;37;37094;561;16;577
24;37;37095;347;7;354
24;37;37096;619;10;629
24;37;37097;673;23;696
24;37;37098;751;19;770
24;37;37099;964;12;976
24;37;37100;406;4;410
24;37;37101;155;2;157
24;37;37103;144;2;146
24;37;37104;6109;111;6220
24;37;37105;253;6;259
24;37;37106;320;4;324
24;37;37107;238;5;243
24;37;37108;716;14;730
24;37;37109;10301;523;10824
24;37;37110;1383;35;1418
24;37;37111;1505;32;1537
24;37;37112;378;7;385
24;37;37113;875;19;894
24;37;37114;174;1;175
24;37;37115;3366;61;3427
24;37;37116;557;16;573
24;37;37117;875;10;885
24;37;37118;1425;35;1460
24;37;37119;1527;38;1565
24;37;37121;253;4;257
24;37;37122;38444;412;38856
24;37;37123;4455;63;4518
24;37;37124;2500;40;2540
24;37;37125;531;2;533
24;37;37126;325;8;333
24;37;37127;339;8;347
24;37;37128;1296;23;1319
24;37;37129;1058;21;1079
24;37;37130;2130;33;2163
24;37;37131;1278;22;1300
24;37;37132;6199;536;6735
24;37;37133;474;10;484
24;37;37134;677;14;691
24;37;37136;527;3;530
24;37;37137;140;3;143
24;37;37138;842;16;858
24;37;37139;5101;143;5244
24;37;37140;239;5;244
24;37;37141;966;18;984
24;37;37142;568;4;572
24;37;37143;1348;28;1376
24;37;37144;529;6;535
24;37;37145;240;1;241
24;37;37146;219;3;222
24;37;37147;562;10;572
24;37;37148;603;6;609
24;37;37149;483;7;490
24;37;37150;1390;13;1403
24;37;37151;3300;62;3362
24;37;37152;2068;66;2134
24;37;37153;4643;54;4697
24;37;37154;4542;91;4633
24;37;37155;641;8;649
24;37;37156;10868;149;11017
24;37;37157;322;4;326
24;37;37158;776;11;787
24;37;37159;7876;143;8019
24;37;37160;343;6;349
24;37;37161;806;13;819
24;37;37162;468;17;485
24;37;37163;3508;56;3564
24;37;37165;439;5;444
24;37;37166;794;7;801
24;37;37167;2098;37;2135
24;37;37168;289;9;298
24;37;37169;920;28;948
24;37;37170;1081;63;1144
24;37;37171;1134;19;1153
24;37;37172;4234;83;4317
24;37;37173;737;9;746
24;37;37174;812;16;828
24;37;37175;1244;31;1275
24;37;37176;1183;49;1232
24;37;37177;715;16;731
24;37;37178;611;4;615
24;37;37179;2474;32;2506
24;37;37180;636;6;642
24;37;37181;234;10;244
24;37;37182;1409;15;1424
24;37;37183;1464;27;1491
24;37;37184;338;7;345
24;37;37185;1675;73;1748
24;37;37186;1212;13;1225
24;37;37187;360;7;367
24;37;37188;896;6;902
24;37;37189;1004;21;1025
24;37;37190;166;3;169
24;37;37191;231;6;237
24;37;37192;1278;18;1296
24;37;37193;1149;26;1175
24;37;37194;1751;33;1784
24;37;37195;10317;80;10397
24;37;37196;1664;18;1682
24;37;37197;511;13;524
24;37;37198;312;2;314
24;37;37199;471;9;480
24;37;37200;987;14;1001
24;37;37201;703;20;723
24;37;37202;527;11;538
24;37;37203;3145;90;3235
24;37;37204;1345;23;1368
24;37;37205;1403;16;1419
24;37;37206;1715;36;1751
24;37;37207;338;2;340
24;37;37208;14995;297;15292
24;37;37210;849;17;866
24;37;37211;2625;32;2657
24;37;37212;774;11;785
24;37;37213;1105;24;1129
24;37;37214;16419;415;16834
24;37;37216;1575;28;1603
24;37;37217;1653;20;1673
24;37;37218;571;12;583
24;37;37219;1039;17;1056
24;37;37220;364;4;368
24;37;37221;623;8;631
24;37;37222;761;29;790
24;37;37223;319;2;321
24;37;37224;943;15;958
24;37;37225;3181;57;3238
24;37;37226;4150;52;4202
24;37;37228;1095;14;1109
24;37;37229;247;8;255
24;37;37230;993;19;1012
24;37;37231;1647;25;1672
24;37;37232;1900;39;1939
24;37;37233;15967;250;16217
24;37;37234;497;15;512
24;37;37236;608;11;619
24;37;37237;1254;18;1272
24;37;37238;541;8;549
24;37;37240;709;15;724
24;37;37241;1342;22;1364
24;37;37242;1563;32;1595
24;37;37243;3234;76;3310
24;37;37244;250;4;254
24;37;37245;2173;45;2218
24;37;37246;207;4;211
24;37;37247;617;10;627
24;37;37248;375;21;396
24;37;37249;1399;20;1419
24;37;37250;2752;76;2828
24;37;37251;874;11;885
24;37;37252;393;6;399
24;37;37253;182;6;188
24;37;37254;1722;29;1751
24;37;37255;264;1;265
24;37;37256;293;3;296
24;37;37257;1769;23;1792
24;37;37258;288;3;291
24;37;37259;460;10;470
24;37;37260;520;8;528
24;37;37261;137087;2756;139843
24;37;37262;296;4;300
24;37;37263;2452;40;2492
24;37;37264;1299;20;1319
24;37;37265;240;5;245
24;37;37266;6423;118;6541
24;37;37267;4570;80;4650
24;37;37268;128;0;128
24;37;37269;474;11;485
24;37;37270;2713;41;2754
24;37;37271;1048;9;1057
24;37;37272;1133;37;1170
24;37;37273;5585;71;5656
24;37;37274;301;3;304
24;37;37275;119;2;121
24;37;37276;1329;31;1360
24;37;37277;588;3;591
24;37;37278;1074;7;1081
24;37;37279;754;7;761
24;37;37280;225;6;231
24;37;37281;3254;70;3324
24;37;37282;1354;27;1381
84;38;38001;6389;106;6495
84;38;38002;1044;29;1073
84;38;38003;1149;22;1171
84;38;38004;1279;25;1304
84;38;38005;946;18;964
84;38;38006;4023;106;4129
84;38;38008;27;0;27
84;38;38009;1045;24;1069
84;38;38010;696;18;714
84;38;38011;1077;13;1090
84;38;38012;2882;54;2936
84;38;38013;3380;91;3471
84;38;38015;1824;38;1862
84;38;38017;1586;36;1622
84;38;38018;363;10;373
84;38;38019;1480;29;1509
84;38;38020;183;4;187
84;38;38022;7804;159;7963
84;38;38023;198;5;203
84;38;38026;1100;12;1112
84;38;38027;1950;57;2007
84;38;38029;1941;41;1982
84;38;38030;1740;30;1770
84;38;38031;21;0;21
84;38;38032;561;11;572
84;38;38033;635;18;653
84;38;38034;4977;83;5060
84;38;38035;1114;15;1129
84;38;38036;95;2;97
84;38;38037;991;14;1005
84;38;38038;599;14;613
84;38;38039;3025;104;3129
84;38;38040;141;1;142
84;38;38041;107;3;110
84;38;38042;1023;21;1044
84;38;38043;1575;43;1618
84;38;38044;1454;41;1495
84;38;38045;2331;92;2423
84;38;38046;991;15;1006
84;38;38047;149;3;152
84;38;38048;1073;18;1091
84;38;38049;302;7;309
84;38;38050;629;9;638
84;38;38051;1351;21;1372
84;38;38052;3286;103;3389
84;38;38053;28834;609;29443
84;38;38054;1542;21;1563
84;38;38055;632;8;640
84;38;38056;93;2;95
84;38;38057;671;12;683
84;38;38058;2186;37;2223
84;38;38059;2545;42;2587
84;38;38060;141;5;146
84;38;38061;3235;70;3305
84;38;38062;732;12;744
84;38;38063;441;14;455
84;38;38064;3113;70;3183
84;38;38065;2119;50;2169
84;38;38066;175;4;179
84;38;38067;1697;38;1735
84;38;38068;1200;30;1230
84;38;38069;1436;23;1459
84;38;38070;1211;14;1225
84;38;38071;3172;32;3204
84;38;38072;2726;42;2768
84;38;38073;195;3;198
84;38;38074;360;6;366
84;38;38075;2986;107;3093
84;38;38076;1886;67;1953
84;38;38077;757;16;773
84;38;38078;584;6;590
84;38;38080;767;20;787
84;38;38081;1969;45;2014
84;38;38082;1918;46;1964
84;38;38083;450;15;465
84;38;38084;1407;26;1433
84;38;38085;10102;84;10186
84;38;38086;402;8;410
84;38;38087;6308;57;6365
84;38;38089;225;5;230
84;38;38090;268;5;273
84;38;38091;753;13;766
84;38;38092;91;3;94
84;38;38093;439;7;446
84;38;38094;2020;42;2062
84;38;38095;2480;159;2639
84;38;38097;4869;64;4933
84;38;38098;712;18;730
84;38;38099;726;23;749
84;38;38100;2528;43;2571
84;38;38101;1028;16;1044
84;38;38102;626;21;647
84;38;38103;306;2;308
84;38;38104;1411;32;1443
84;38;38105;2369;45;2414
84;38;38106;346;9;355
84;38;38107;1679;51;1730
84;38;38108;120;0;120
84;38;38109;1051;27;1078
84;38;38110;2260;44;2304
84;38;38111;7924;216;8140
84;38;38112;100;1;101
84;38;38113;536;6;542
84;38;38114;1450;33;1483
84;38;38115;730;19;749
84;38;38116;40;0;40
84;38;38117;630;14;644
84;38;38118;1625;44;1669
84;38;38120;709;17;726
84;38;38124;2238;47;2285
84;38;38126;4075;130;4205
84;38;38127;163;5;168
84;38;38128;450;5;455
84;38;38129;360;17;377
84;38;38130;4829;277;5106
84;38;38131;2024;75;2099
84;38;38132;73;0;73
84;38;38133;5216;400;5616
84;38;38134;920;19;939
84;38;38135;1282;21;1303
84;38;38136;530;16;546
84;38;38137;432;13;445
84;38;38138;3375;64;3439
84;38;38139;1503;19;1522
84;38;38140;8293;256;8549
84;38;38141;758;15;773
84;38;38144;2799;37;2836
84;38;38146;827;26;853
84;38;38147;885;25;910
84;38;38148;3192;71;3263
84;38;38149;1675;36;1711
84;38;38150;6677;70;6747
84;38;38151;36932;212;37144
84;38;38152;1441;29;1470
84;38;38153;449;20;469
84;38;38154;221;2;223
84;38;38155;1871;30;1901
84;38;38156;972;32;1004
84;38;38157;3535;73;3608
84;38;38158;9980;119;10099
84;38;38159;539;13;552
84;38;38160;2303;115;2418
84;38;38161;1062;6;1068
84;38;38162;1464;40;1504
84;38;38163;387;9;396
84;38;38166;466;10;476
84;38;38167;540;5;545
84;38;38169;23211;234;23445
84;38;38170;3172;35;3207
84;38;38171;328;4;332
84;38;38172;1625;33;1658
84;38;38173;247;7;254
84;38;38174;1092;23;1115
84;38;38175;3392;59;3451
84;38;38176;2096;55;2151
84;38;38177;103;0;103
84;38;38179;7134;86;7220
84;38;38180;1013;38;1051
84;38;38181;2476;36;2512
84;38;38182;3079;57;3136
84;38;38183;502;9;511
84;38;38184;1627;21;1648
84;38;38185;158198;2243;160441
84;38;38186;377;12;389
84;38;38187;1796;25;1821
84;38;38188;1362;23;1385
84;38;38189;4712;64;4776
84;38;38190;1171;28;1199
84;38;38191;1306;34;1340
84;38;38192;195;6;201
84;38;38193;16584;318;16902
84;38;38194;2137;35;2172
84;38;38195;745;9;754
84;38;38197;1816;20;1836
84;38;38198;1059;22;1081
84;38;38199;2156;56;2212
84;38;38200;3779;69;3848
84;38;38203;465;8;473
84;38;38204;192;5;197
84;38;38205;2676;119;2795
84;38;38206;983;36;1019
84;38;38207;151;3;154
84;38;38208;148;3;151
84;38;38209;235;7;242
84;38;38210;871;14;885
84;38;38211;352;5;357
84;38;38212;1284;8;1292
84;38;38213;584;12;596
84;38;38214;2166;73;2239
84;38;38215;2314;44;2358
84;38;38216;54;2;56
84;38;38217;71;2;73
84;38;38218;1176;21;1197
84;38;38219;645;15;660
84;38;38221;141;3;144
84;38;38222;750;17;767
84;38;38223;1876;66;1942
84;38;38224;91;3;94
84;38;38225;3039;103;3142
84;38;38226;1393;75;1468
84;38;38228;479;18;497
84;38;38229;17786;391;18177
84;38;38230;1023;43;1066
84;38;38231;1025;30;1055
84;38;38232;638;12;650
84;38;38235;456;8;464
84;38;38236;1733;38;1771
84;38;38237;190;4;194
84;38;38238;1941;42;1983
84;38;38239;7499;156;7655
84;38;38240;738;15;753
84;38;38241;16;0;16
84;38;38242;1428;31;1459
84;38;38243;250;6;256
84;38;38244;797;19;816
84;38;38245;269;4;273
84;38;38246;1132;17;1149
84;38;38247;3467;55;3522
84;38;38248;524;21;545
84;38;38249;5477;562;6039
84;38;38250;569;17;586
84;38;38252;337;9;346
84;38;38253;1929;36;1965
84;38;38254;500;13;513
84;38;38255;139;0;139
84;38;38256;1833;23;1856
84;38;38257;446;12;458
84;38;38258;76;4;80
84;38;38259;972;16;988
84;38;38260;525;18;543
84;38;38261;4526;99;4625
84;38;38263;391;5;396
84;38;38264;136;0;136
84;38;38265;1692;21;1713
84;38;38266;450;9;459
84;38;38267;768;13;781
84;38;38268;264;3;267
84;38;38269;4920;208;5128
84;38;38270;1858;65;1923
84;38;38271;862;11;873
84;38;38272;399;7;406
84;38;38273;464;19;483
84;38;38275;308;41;349
84;38;38276;2648;69;2717
84;38;38277;536;6;542
84;38;38278;498;9;507
84;38;38279;1131;12;1143
84;38;38280;521;21;542
84;38;38281;2256;77;2333
84;38;38282;871;28;899
84;38;38283;109;3;112
84;38;38284;849;27;876
84;38;38285;161;4;165
84;38;38286;6;0;6
84;38;38287;1039;20;1059
84;38;38288;1668;32;1700
84;38;38289;213;4;217
84;38;38290;855;15;870
84;38;38291;1153;17;1170
84;38;38292;2528;60;2588
84;38;38294;660;16;676
84;38;38295;723;12;735
84;38;38296;876;37;913
84;38;38297;1851;43;1894
84;38;38298;6516;59;6575
84;38;38299;137;2;139
84;38;38300;362;9;371
84;38;38301;175;4;179
84;38;38303;565;5;570
84;38;38304;1493;37;1530
84;38;38307;521;9;530
84;38;38308;271;2;273
84;38;38309;2127;27;2154
84;38;38310;1212;16;1228
84;38;38311;709;15;724
84;38;38313;296;15;311
84;38;38314;7348;171;7519
84;38;38315;3570;142;3712
84;38;38316;5980;44;6024
84;38;38317;10716;76;10792
84;38;38318;5313;50;5363
84;38;38319;785;31;816
84;38;38320;1786;40;1826
84;38;38321;165;8;173
84;38;38322;92;2;94
84;38;38323;1161;22;1183
84;38;38324;716;18;734
84;38;38325;513;9;522
84;38;38326;367;12;379
84;38;38328;897;33;930
84;38;38329;68;0;68
84;38;38330;102;1;103
84;38;38331;998;31;1029
84;38;38332;3467;51;3518
84;38;38333;324;6;330
84;38;38334;1313;43;1356
84;38;38335;1051;26;1077
84;38;38336;1974;35;2009
84;38;38337;6668;83;6751
84;38;38338;740;9;749
84;38;38339;2128;56;2184
84;38;38340;1981;37;2018
84;38;38341;1090;40;1130
84;38;38342;316;7;323
84;38;38343;1584;31;1615
84;38;38344;8457;119;8576
84;38;38345;611;10;621
84;38;38346;397;7;404
84;38;38347;1132;27;1159
84;38;38348;4717;108;4825
84;38;38349;2285;22;2307
84;38;38350;554;18;572
84;38;38351;1089;22;1111
84;38;38352;2130;61;2191
84;38;38353;840;19;859
84;38;38354;410;5;415
84;38;38355;123;6;129
84;38;38356;310;18;328
84;38;38357;2760;143;2903
84;38;38358;717;11;728
84;38;38359;1162;28;1190
84;38;38360;414;8;422
84;38;38361;79;3;82
84;38;38362;1157;53;1210
84;38;38363;932;38;970
84;38;38364;430;4;434
84;38;38365;814;19;833
84;38;38366;260;8;268
84;38;38368;1094;25;1119
84;38;38369;985;38;1023
84;38;38370;653;18;671
84;38;38372;724;10;734
84;38;38373;1149;42;1191
84;38;38374;3689;91;3780
84;38;38375;110;0;110
84;38;38376;824;9;833
84;38;38377;3456;59;3515
84;38;38378;3705;86;3791
84;38;38379;269;8;277
84;38;38380;308;5;313
84;38;38381;2098;53;2151
84;38;38382;15944;220;16164
84;38;38383;2595;108;2703
84;38;38384;3206;44;3250
84;38;38386;2394;41;2435
84;38;38387;506;13;519
84;38;38388;2537;32;2569
84;38;38389;3439;68;3507
84;38;38390;544;9;553
84;38;38391;247;5;252
84;38;38392;615;22;637
84;38;38393;1558;33;1591
84;38;38394;1869;32;1901
84;38;38395;2380;73;2453
84;38;38396;810;27;837
84;38;38397;7064;314;7378
84;38;38398;976;16;992
84;38;38399;4590;101;4691
84;38;38400;3564;80;3644
84;38;38401;1636;40;1676
84;38;38402;529;19;548
84;38;38403;286;5;291
84;38;38404;300;4;304
84;38;38405;1224;28;1252
84;38;38406;152;4;156
84;38;38407;987;30;1017
84;38;38408;2656;61;2717
84;38;38409;1311;33;1344
84;38;38410;1399;24;1423
84;38;38412;4510;102;4612
84;38;38413;429;9;438
84;38;38414;41;2;43
84;38;38415;1432;39;1471
84;38;38416;7766;179;7945
84;38;38417;479;17;496
84;38;38418;235;2;237
84;38;38419;185;2;187
84;38;38420;248;5;253
84;38;38421;37935;265;38200
84;38;38422;5512;175;5687
84;38;38423;5880;62;5942
84;38;38424;168;3;171
84;38;38425;6387;94;6481
84;38;38426;656;16;672
84;38;38427;299;4;303
84;38;38428;31;0;31
84;38;38429;281;7;288
84;38;38430;325;7;332
84;38;38431;2960;90;3050
84;38;38432;977;25;1002
84;38;38433;1083;31;1114
84;38;38434;648;6;654
84;38;38436;2247;41;2288
84;38;38437;293;6;299
84;38;38438;267;1;268
84;38;38439;3372;55;3427
84;38;38440;758;16;774
84;38;38442;962;26;988
84;38;38443;465;12;477
84;38;38444;116;6;122
84;38;38445;781;6;787
84;38;38446;570;14;584
84;38;38448;1407;31;1438
84;38;38449;6020;64;6084
84;38;38450;1475;19;1494
84;38;38451;3346;41;3387
84;38;38452;368;10;378
84;38;38453;1785;41;1826
84;38;38454;2107;50;2157
84;38;38455;4202;83;4285
84;38;38456;477;10;487
84;38;38457;2921;65;2986
84;38;38458;614;16;630
84;38;38459;918;7;925
84;38;38460;431;12;443
84;38;38462;540;14;554
84;38;38463;1713;38;1751
84;38;38464;2249;49;2298
84;38;38465;1093;22;1115
84;38;38466;1505;48;1553
84;38;38467;1452;38;1490
84;38;38468;4488;71;4559
84;38;38469;68;0;68
84;38;38470;335;8;343
84;38;38471;1133;30;1163
84;38;38472;214;4;218
84;38;38473;1158;22;1180
84;38;38474;11062;197;11259
84;38;38475;2487;28;2515
84;38;38476;898;10;908
84;38;38478;1063;13;1076
84;38;38479;2016;52;2068
84;38;38480;2071;41;2112
84;38;38481;1106;32;1138
84;38;38483;1659;50;1709
84;38;38484;2116;27;2143
84;38;38485;11891;142;12033
84;38;38486;7827;108;7935
84;38;38487;2049;52;2101
84;38;38488;583;16;599
84;38;38489;133;2;135
84;38;38490;1946;47;1993
84;38;38492;703;21;724
84;38;38494;797;21;818
84;38;38495;585;4;589
84;38;38496;1239;25;1264
84;38;38497;143;0;143
84;38;38498;735;22;757
84;38;38499;1206;16;1222
84;38;38500;574;6;580
84;38;38501;2128;23;2151
84;38;38503;2510;127;2637
84;38;38504;1995;95;2090
84;38;38505;772;15;787
84;38;38507;7555;99;7654
84;38;38508;794;26;820
84;38;38509;8167;207;8374
84;38;38511;3176;101;3277
84;38;38512;777;25;802
84;38;38513;301;7;308
84;38;38514;177;1;178
84;38;38515;2212;56;2268
84;38;38516;6602;140;6742
84;38;38517;7816;123;7939
84;38;38518;506;12;518
84;38;38519;2879;49;2928
84;38;38520;698;20;718
84;38;38521;67;2;69
84;38;38522;130;2;132
84;38;38523;843;19;862
84;38;38524;8301;164;8465
84;38;38525;461;5;466
84;38;38526;360;11;371
84;38;38527;342;4;346
84;38;38528;1321;30;1351
84;38;38529;3965;60;4025
84;38;38530;2537;51;2588
84;38;38531;561;6;567
84;38;38532;923;10;933
84;38;38533;732;16;748
84;38;38535;262;7;269
84;38;38536;1397;24;1421
84;38;38537;7293;88;7381
84;38;38538;4933;64;4997
84;38;38539;617;21;638
84;38;38540;1433;26;1459
84;38;38542;330;15;345
84;38;38543;2142;35;2177
84;38;38544;29993;341;30334
84;38;38545;8547;126;8673
84;38;38546;973;81;1054
84;38;38547;7249;105;7354
84;38;38548;4234;225;4459
84;38;38549;28;3;31
84;38;38550;57;0;57
84;38;38551;40;1;41
84;38;38552;403;12;415
84;38;38553;18835;271;19106
84;38;38554;1820;69;1889
84;38;38555;1160;30;1190
84;38;38556;1179;20;1199
84;38;38557;5113;89;5202
84;38;38558;1920;31;1951
84;38;38559;4352;73;4425
84;38;38560;1537;19;1556
84;38;38561;1664;32;1696
84;38;38562;7246;168;7414
84;38;38563;20372;499;20871
84;38;38564;234;10;244
84;38;38565;9275;373;9648
84;38;38566;1700;48;1748
84;38;38567;407;5;412
27;39;39001;859;25;884
27;39;39002;61;1;62
27;39;39003;46;0;46
27;39;39004;53;3;56
27;39;39006;444;16;460
27;39;39007;151;5;156
27;39;39008;444;49;493
27;39;39009;509;11;520
27;39;39010;93;1;94
27;39;39011;404;5;409
27;39;39013;3295;209;3504
27;39;39014;216;6;222
27;39;39015;116;2;118
27;39;39016;1094;34;1128
27;39;39017;1206;37;1243
27;39;39018;658;18;676
27;39;39019;218;10;228
27;39;39020;100;4;104
27;39;39021;594;14;608
27;39;39022;739;12;751
27;39;39024;272;6;278
27;39;39025;269;7;276
27;39;39026;181;1;182
27;39;39027;191;6;197
27;39;39028;475;7;482
27;39;39029;370;9;379
27;39;39030;820;21;841
27;39;39031;201;3;204
27;39;39032;364;17;381
27;39;39034;315;8;323
27;39;39035;351;9;360
27;39;39037;195;4;199
27;39;39038;146;2;148
27;39;39039;239;5;244
27;39;39040;177;2;179
27;39;39041;160;6;166
27;39;39042;492;21;513
27;39;39043;1398;20;1418
27;39;39045;81;3;84
27;39;39046;71;4;75
27;39;39047;527;16;543
27;39;39048;251;8;259
27;39;39049;408;14;422
27;39;39050;158;10;168
27;39;39051;409;5;414
27;39;39052;68;0;68
27;39;39053;208;4;212
27;39;39054;110;1;111
27;39;39055;47;1;48
27;39;39056;1500;28;1528
27;39;39057;101;1;102
27;39;39058;174;5;179
27;39;39059;1642;42;1684
27;39;39060;55;1;56
27;39;39061;109;5;114
27;39;39062;70;0;70
27;39;39063;267;6;273
27;39;39065;112;0;112
27;39;39066;179;6;185
27;39;39068;308;9;317
27;39;39070;94;2;96
27;39;39072;268;7;275
27;39;39073;170;6;176
27;39;39074;206;8;214
27;39;39076;220;1;221
27;39;39077;43;1;44
27;39;39078;682;14;696
27;39;39079;204;9;213
27;39;39080;62;2;64
27;39;39081;388;8;396
27;39;39083;319;6;325
27;39;39084;143;4;147
27;39;39085;89;1;90
27;39;39086;237;2;239
27;39;39088;392;11;403
27;39;39090;184;4;188
27;39;39091;91;1;92
27;39;39092;182;1;183
27;39;39093;424;10;434
27;39;39094;163;7;170
27;39;39095;123;5;128
27;39;39096;469;8;477
27;39;39097;8014;407;8421
27;39;39099;438;7;445
27;39;39100;102;3;105
27;39;39101;1442;33;1475
27;39;39102;228;4;232
27;39;39103;308;1;309
27;39;39104;604;9;613
27;39;39105;219;9;228
27;39;39106;289;6;295
27;39;39107;139;3;142
27;39;39108;55;3;58
27;39;39109;178;2;180
27;39;39110;66;0;66
27;39;39111;39;0;39
27;39;39112;110;1;111
27;39;39114;141;7;148
27;39;39116;149;2;151
27;39;39117;109;6;115
27;39;39118;53;0;53
27;39;39119;86;3;89
27;39;39120;130;8;138
27;39;39121;406;7;413
27;39;39122;108;5;113
27;39;39124;472;15;487
27;39;39126;395;11;406
27;39;39127;106;1;107
27;39;39128;1575;24;1599
27;39;39129;396;14;410
27;39;39130;805;22;827
27;39;39131;571;13;584
27;39;39132;34;0;34
27;39;39133;70;2;72
27;39;39134;227;8;235
27;39;39136;37;1;38
27;39;39137;440;15;455
27;39;39138;343;10;353
27;39;39139;73;0;73
27;39;39140;39;0;39
27;39;39141;281;6;287
27;39;39142;129;1;130
27;39;39143;34;0;34
27;39;39145;295;19;314
27;39;39146;627;25;652
27;39;39147;100;4;104
27;39;39149;310;9;319
27;39;39150;1023;30;1053
27;39;39151;124;6;130
27;39;39153;795;31;826
27;39;39154;1435;43;1478
27;39;39155;77;0;77
27;39;39156;245;7;252
27;39;39157;53;3;56
27;39;39159;262;2;264
27;39;39160;896;17;913
27;39;39162;260;5;265
27;39;39163;114;3;117
27;39;39164;664;27;691
27;39;39165;55;0;55
27;39;39166;216;4;220
27;39;39167;360;5;365
27;39;39168;46;0;46
27;39;39169;592;15;607
27;39;39170;923;28;951
27;39;39171;1144;31;1175
27;39;39172;254;14;268
27;39;39173;1300;25;1325
27;39;39174;65;0;65
27;39;39175;72;7;79
27;39;39176;526;8;534
27;39;39177;969;24;993
27;39;39178;73;1;74
27;39;39179;237;5;242
27;39;39180;253;120;373
27;39;39182;677;25;702
27;39;39183;630;80;710
27;39;39184;194;5;199
27;39;39185;390;12;402
27;39;39187;270;7;277
27;39;39188;345;4;349
27;39;39189;2629;79;2708
27;39;39190;1293;28;1321
27;39;39191;85;5;90
27;39;39192;72;1;73
27;39;39193;1012;17;1029
27;39;39194;481;6;487
27;39;39196;114;2;116
27;39;39197;359;11;370
27;39;39198;23711;893;24604
27;39;39199;1232;30;1262
27;39;39200;219;7;226
27;39;39201;281;39;320
27;39;39202;139;1;140
27;39;39203;104;2;106
27;39;39204;29;3;32
27;39;39205;382;8;390
27;39;39206;228;10;238
27;39;39207;78;3;81
27;39;39208;136;8;144
27;39;39209;325;7;332
27;39;39210;582;14;596
27;39;39211;256;3;259
27;39;39214;122;3;125
27;39;39216;310;11;321
27;39;39217;565;14;579
27;39;39218;427;6;433
27;39;39219;657;12;669
27;39;39220;401;9;410
27;39;39221;31;1;32
27;39;39222;82;7;89
27;39;39223;197;2;199
27;39;39225;195;6;201
27;39;39227;189;7;196
27;39;39228;1081;28;1109
27;39;39229;203;10;213
27;39;39230;75;3;78
27;39;39232;442;11;453
27;39;39233;2266;40;2306
27;39;39234;79;0;79
27;39;39235;1192;14;1206
27;39;39236;59;1;60
27;39;39237;51;4;55
27;39;39238;110;7;117
27;39;39239;39;2;41
27;39;39240;167;5;172
27;39;39241;375;9;384
27;39;39244;159;5;164
27;39;39245;360;9;369
27;39;39246;425;13;438
27;39;39247;72;2;74
27;39;39248;44;0;44
27;39;39249;76;4;80
27;39;39250;172;7;179
27;39;39251;452;95;547
27;39;39252;706;10;716
27;39;39253;276;8;284
27;39;39254;137;6;143
27;39;39255;232;4;236
27;39;39258;626;19;645
27;39;39259;32;1;33
27;39;39261;141;2;143
27;39;39262;135;1;136
27;39;39263;396;14;410
27;39;39265;197;4;201
27;39;39266;344;2;346
27;39;39267;103;1;104
27;39;39268;58;1;59
27;39;39269;269;1;270
27;39;39270;546;62;608
27;39;39271;394;17;411
27;39;39272;49;3;52
27;39;39273;241;7;248
27;39;39274;285;13;298
27;39;39275;647;17;664
27;39;39277;60;1;61
27;39;39278;143;2;145
27;39;39279;606;13;619
27;39;39280;101;2;103
27;39;39281;85;2;87
27;39;39282;80;2;82
27;39;39283;629;18;647
27;39;39284;142;2;144
27;39;39285;328;8;336
27;39;39286;2352;108;2460
27;39;39288;385;5;390
27;39;39289;350;7;357
27;39;39290;476;17;493
27;39;39291;240;5;245
27;39;39292;154;4;158
27;39;39293;207;4;211
27;39;39295;167;1;168
27;39;39296;215;5;220
27;39;39297;1143;32;1175
27;39;39298;60;3;63
27;39;39299;491;10;501
27;39;39300;17189;810;17999
27;39;39301;171;4;175
27;39;39302;94;4;98
27;39;39304;222;9;231
27;39;39305;562;10;572
27;39;39306;955;36;991
27;39;39307;332;10;342
27;39;39308;318;7;325
27;39;39310;470;13;483
27;39;39312;111;4;115
27;39;39313;213;1;214
27;39;39314;80;4;84
27;39;39315;396;22;418
27;39;39317;352;15;367
27;39;39318;192;13;205
27;39;39319;144;1;145
27;39;39320;334;1;335
27;39;39321;157;2;159
27;39;39322;53;2;55
27;39;39323;312;14;326
27;39;39324;7;0;7
27;39;39325;577;15;592
27;39;39326;177;4;181
27;39;39327;847;13;860
27;39;39328;421;7;428
27;39;39329;172;3;175
27;39;39330;152;5;157
27;39;39331;828;26;854
27;39;39333;2120;113;2233
27;39;39334;127;5;132
27;39;39335;567;11;578
27;39;39336;110;4;114
27;39;39337;88;3;91
27;39;39338;506;6;512
27;39;39339;1123;28;1151
27;39;39342;123;1;124
27;39;39343;15;1;16
27;39;39344;335;14;349
27;39;39345;405;15;420
27;39;39346;114;5;119
27;39;39348;417;47;464
27;39;39349;490;23;513
27;39;39350;310;4;314
27;39;39351;147;7;154
27;39;39352;132;2;134
27;39;39353;166;9;175
27;39;39354;367;3;370
27;39;39355;238;8;246
27;39;39356;207;8;215
27;39;39359;32;1;33
27;39;39360;171;2;173
27;39;39361;195;5;200
27;39;39362;3082;331;3413
27;39;39363;84;1;85
27;39;39364;491;14;505
27;39;39365;1275;22;1297
27;39;39366;242;6;248
27;39;39367;2263;82;2345
27;39;39368;5275;270;5545
27;39;39370;1070;313;1383
27;39;39372;87;9;96
27;39;39373;160;4;164
27;39;39375;129;0;129
27;39;39376;74;2;76
27;39;39377;173;8;181
27;39;39378;765;15;780
27;39;39379;525;11;536
27;39;39380;46;2;48
27;39;39381;96;3;99
27;39;39385;541;5;546
27;39;39386;89;0;89
27;39;39387;291;6;297
27;39;39388;196;8;204
27;39;39389;589;14;603
27;39;39390;296;12;308
27;39;39391;408;12;420
27;39;39392;194;3;197
27;39;39393;63;2;65
27;39;39394;71;4;75
27;39;39396;1134;16;1150
27;39;39397;1606;45;1651
27;39;39398;395;3;398
27;39;39399;349;8;357
27;39;39400;144;2;146
27;39;39401;238;5;243
27;39;39402;319;7;326
27;39;39403;220;5;225
27;39;39404;488;10;498
27;39;39405;999;21;1020
27;39;39406;262;3;265
27;39;39407;335;6;341
27;39;39408;149;6;155
27;39;39409;133;1;134
27;39;39411;1515;46;1561
27;39;39412;320;2;322
27;39;39413;334;7;341
27;39;39415;1095;10;1105
27;39;39418;98;2;100
27;39;39419;62;1;63
27;39;39420;209;3;212
27;39;39421;238;15;253
27;39;39422;528;13;541
27;39;39423;106;9;115
27;39;39424;161;3;164
27;39;39425;89;1;90
27;39;39426;212;10;222
27;39;39427;62;0;62
27;39;39428;23;3;26
27;39;39429;440;3;443
27;39;39430;105;2;107
27;39;39431;335;4;339
27;39;39432;127;1;128
27;39;39434;4003;362;4365
27;39;39435;630;22;652
27;39;39436;230;8;238
27;39;39437;274;5;279
27;39;39439;524;12;536
27;39;39441;1200;31;1231
27;39;39443;123;5;128
27;39;39444;61;2;63
27;39;39445;283;15;298
27;39;39446;244;3;247
27;39;39447;253;6;259
27;39;39448;477;15;492
27;39;39449;266;10;276
27;39;39451;504;4;508
27;39;39452;532;7;539
27;39;39453;453;12;465
27;39;39454;91;2;93
27;39;39455;55;1;56
27;39;39456;342;4;346
27;39;39457;54;0;54
27;39;39458;243;12;255
27;39;39460;193;8;201
27;39;39461;82;0;82
27;39;39462;677;5;682
27;39;39463;230;6;236
27;39;39464;210;6;216
27;39;39465;201;2;203
27;39;39466;123;0;123
27;39;39467;156;6;162
27;39;39468;138;4;142
27;39;39469;113;2;115
27;39;39470;3648;82;3730
27;39;39471;747;17;764
27;39;39472;213;4;217
27;39;39473;90;2;92
27;39;39474;355;10;365
27;39;39475;2392;100;2492
27;39;39476;1814;43;1857
27;39;39477;260;5;265
27;39;39478;8985;240;9225
27;39;39479;241;6;247
27;39;39480;260;15;275
27;39;39481;389;9;398
27;39;39485;787;13;800
27;39;39486;115;4;119
27;39;39487;1812;36;1848
27;39;39489;461;11;472
27;39;39490;249;7;256
27;39;39491;2260;94;2354
27;39;39492;236;3;239
27;39;39493;235;2;237
27;39;39494;359;21;380
27;39;39495;66;0;66
27;39;39497;93;2;95
27;39;39498;602;12;614
27;39;39499;194;3;197
27;39;39500;2551;149;2700
27;39;39501;1200;12;1212
27;39;39502;281;7;288
27;39;39503;385;15;400
27;39;39504;224;9;233
27;39;39505;61;3;64
27;39;39507;79;1;80
27;39;39508;719;10;729
27;39;39510;800;24;824
27;39;39511;63;3;66
27;39;39512;49;1;50
27;39;39513;236;1;237
27;39;39514;189;11;200
27;39;39517;517;20;537
27;39;39518;70;1;71
27;39;39519;177;6;183
27;39;39520;478;5;483
27;39;39522;103;2;105
27;39;39523;189;8;197
27;39;39525;395;7;402
27;39;39526;3957;97;4054
27;39;39527;118;1;119
27;39;39528;384;7;391
27;39;39529;65;1;66
27;39;39530;855;24;879
27;39;39531;185;5;190
27;39;39532;39;1;40
27;39;39533;217;6;223
27;39;39534;245;4;249
27;39;39535;462;16;478
27;39;39537;456;12;468
27;39;39538;59;1;60
27;39;39539;286;7;293
27;39;39540;191;11;202
27;39;39543;216;8;224
27;39;39545;173;7;180
27;39;39546;354;13;367
27;39;39547;682;18;700
27;39;39548;74;5;79
27;39;39550;193;5;198
27;39;39551;116;3;119
27;39;39552;303;11;314
27;39;39553;292;10;302
27;39;39554;230;5;235
27;39;39555;247;2;249
27;39;39556;95;3;98
27;39;39557;187;9;196
27;39;39558;288;12;300
27;39;39559;395;4;399
27;39;39560;615;20;635
27;39;39561;391;6;397
27;39;39565;85;1;86
27;39;39567;301;9;310
27;39;39568;42;3;45
27;39;39569;678;10;688
27;39;39570;215;1;216
27;39;39571;232;2;234
27;39;39572;392;7;399
27;39;39573;775;13;788
27;39;39574;712;20;732
27;39;39575;88;0;88
27;39;39576;928;34;962
27;39;39577;399;2;401
27;39;39579;904;42;946
27;39;39581;282;4;286
27;39;39582;770;23;793
27;39;39583;184;6;190
27;39;39584;163;2;165
27;39;39585;22;0;22
27;39;39586;30;0;30
75;40;40001;6189;555;6744
75;40;40002;1569;23;1592
75;40;40003;274;9;283
75;40;40004;2129;49;2178
75;40;40005;202;3;205
75;40;40006;698;7;705
75;40;40007;166;2;168
75;40;40008;97;2;99
75;40;40011;334;3;337
75;40;40012;259;4;263
75;40;40013;101;5;106
75;40;40014;358;4;362
75;40;40015;48;1;49
75;40;40016;253;3;256
75;40;40017;397;1;398
75;40;40018;384;6;390
75;40;40019;1068;28;1096
75;40;40020;620;23;643
75;40;40021;883;20;903
75;40;40022;396;14;410
75;40;40023;350;8;358
75;40;40024;264;4;268
75;40;40025;831;31;862
75;40;40026;359;10;369
75;40;40027;154;2;156
75;40;40028;253;9;262
75;40;40029;313;3;316
75;40;40030;50;0;50
75;40;40031;1185;12;1197
75;40;40032;207;1;208
75;40;40033;160;5;165
75;40;40034;604;13;617
75;40;40035;574;11;585
75;40;40036;3683;70;3753
75;40;40037;1832;46;1878
75;40;40038;105;4;109
75;40;40039;151;0;151
75;40;40040;358;2;360
75;40;40041;128;2;130
75;40;40042;328;7;335
75;40;40043;763;13;776
75;40;40044;919;33;952
75;40;40046;13947;345;14292
75;40;40047;268;5;273
75;40;40049;394;6;400
75;40;40050;211;2;213
75;40;40051;820;25;845
75;40;40052;224;4;228
75;40;40053;306;4;310
75;40;40054;263;6;269
75;40;40055;1612;29;1641
75;40;40056;780;22;802
75;40;40057;252;6;258
75;40;40058;227;11;238
75;40;40059;763;20;783
75;40;40060;142;4;146
75;40;40061;999;26;1025
75;40;40062;510;7;517
75;40;40063;812;27;839
75;40;40064;166;2;168
75;40;40065;9037;314;9351
75;40;40066;528;4;532
75;40;40067;632;5;637
75;40;40068;585;17;602
75;40;40069;409;5;414
75;40;40070;398;17;415
75;40;40071;601;43;644
75;40;40072;186;2;188
75;40;40073;115;2;117
75;40;40074;556;20;576
75;40;40075;2463;27;2490
75;40;40076;443;7;450
75;40;40077;799;17;816
75;40;40078;397;8;405
75;40;40079;137;5;142
75;40;40080;1115;32;1147
75;40;40081;411;6;417
75;40;40082;258;8;266
75;40;40083;123;7;130
75;40;40084;754;35;789
75;40;40085;426;12;438
75;40;40086;508;9;517
75;40;40087;361;7;368
75;40;40088;20843;841;21684
75;40;40089;855;27;882
75;40;40090;464;10;474
75;40;40091;654;19;673
75;40;40092;229;6;235
75;40;40093;254;3;257
75;40;40094;744;11;755
75;40;40095;701;18;719
75;40;40096;104;2;106
75;40;40097;447;10;457
75;40;40098;355;13;368
75;40;40099;321;3;324
75;40;40100;410;2;412
75;40;40101;480;18;498
75;40;40102;1289;246;1535
75;40;40103;627;16;643
75;40;40104;1405;34;1439
75;40;40105;437;11;448
75;40;40106;210;6;216
75;40;40108;862;14;876
75;40;40109;431;10;441
75;40;40110;723;14;737
75;40;40111;701;16;717
75;40;40112;101;1;102
75;40;40113;517;9;526
75;40;40114;363;13;376
75;40;40115;289;10;299
75;40;40116;274;3;277
75;40;40117;2440;82;2522
75;40;40118;1466;25;1491
75;40;40119;4651;113;4764
75;40;40120;592;17;609
75;40;40121;277;5;282
75;40;40122;970;30;1000
75;40;40123;1150;33;1183
75;40;40124;141;2;143
75;40;40125;1352;38;1390
75;40;40126;1875;42;1917
75;40;40127;618;4;622
75;40;40128;694;20;714
75;40;40129;869;27;896
75;40;40130;157;0;157
75;40;40131;691;5;696
75;40;40132;1420;25;1445
75;40;40133;6887;115;7002
75;40;40134;2736;44;2780
75;40;40135;866;8;874
75;40;40136;157;4;161
75;40;40137;283;10;293
75;40;40138;281;6;287
75;40;40139;552;15;567
75;40;40140;189;3;192
75;40;40141;296;4;300
75;40;40142;1049;21;1070
75;40;40143;305;4;309
75;40;40144;244;9;253
75;40;40145;615;23;638
75;40;40146;162;3;165
75;40;40147;371;3;374
75;40;40148;83;3;86
75;40;40149;376;5;381
75;40;40150;1918;52;1970
75;40;40151;431;12;443
75;40;40152;1033;25;1058
75;40;40153;238;6;244
75;40;40154;310;6;316
75;40;40155;1502;39;1541
75;40;40156;556;5;561
75;40;40157;1657;39;1696
75;40;40158;276;3;279
75;40;40159;310;7;317
75;40;40160;180;6;186
75;40;40161;86;1;87
75;40;40162;581;13;594
75;40;40163;567;9;576
75;40;40164;356;1;357
75;40;40165;386;11;397
75;40;40166;75;1;76
75;40;40167;657;10;667
75;40;40168;2322;35;2357
75;40;40169;125;3;128
75;40;40170;235;3;238
75;40;40171;114;3;117
75;40;40172;266;4;270
75;40;40173;139;5;144
75;40;40174;86;1;87
75;40;40175;440;6;446
75;40;40176;89;1;90
75;40;40177;315;17;332
75;40;40178;628;28;656
75;40;40179;1820;47;1867
75;40;40180;1147;31;1178
75;40;40181;968;31;999
75;40;40182;828;11;839
75;40;40183;978;32;1010
75;40;40184;7255;165;7420
75;40;40185;357;8;365
75;40;40186;810;17;827
75;40;40187;1185;16;1201
75;40;40188;468;12;480
75;40;40189;83;3;86
75;40;40190;385;11;396
75;40;40191;620;13;633
75;40;40192;29807;1413;31220
75;40;40193;75;2;77
75;40;40194;1183;30;1213
75;40;40195;620;13;633
75;40;40196;574;11;585
75;40;40197;4987;132;5119
75;40;40198;173;8;181
75;40;40199;270;3;273
75;40;40200;674;10;684
75;40;40201;1343;103;1446
75;40;40202;3230;74;3304
75;40;40203;325;13;338
75;40;40204;265;4;269
75;40;40205;247;8;255
75;40;40206;325;13;338
75;40;40207;1507;207;1714
75;40;40208;366;6;372
75;40;40209;5520;121;5641
75;40;40210;1025;19;1044
75;40;40211;742;18;760
75;40;40212;1002;16;1018
75;40;40213;635;10;645
75;40;40214;501;5;506
75;40;40215;285;8;293
75;40;40216;201;2;203
75;40;40217;6684;216;6900
75;40;40218;505;4;509
75;40;40219;107;2;109
75;40;40220;139;6;145
75;40;40221;338;13;351
75;40;40222;701;22;723
75;40;40223;233;8;241
75;40;40224;3648;180;3828
75;40;40225;200;6;206
75;40;40226;205;3;208
75;40;40227;1449;20;1469
75;40;40228;1569;27;1596
75;40;40229;1648;32;1680
75;40;40230;2868;97;2965
75;40;40231;1154;31;1185
75;40;40232;222;10;232
75;40;40233;3071;81;3152
75;40;40234;906;28;934
75;40;40235;691;11;702
75;40;40236;782;20;802
75;40;40237;764;6;770
75;40;40238;622;19;641
75;40;40239;105;3;108
75;40;40240;517;19;536
75;40;40242;104;0;104
75;40;40243;3023;42;3065
75;40;40244;1257;29;1286
75;40;40245;1898;49;1947
75;40;40246;1165;150;1315
75;40;40247;179;6;185
75;40;40248;1889;28;1917
75;40;40249;501;13;514
75;40;40250;694;22;716
75;40;40251;419;14;433
75;40;40252;636;16;652
75;40;40253;645;12;657
75;40;40254;428;11;439
75;40;40255;474;11;485
75;40;40256;711;17;728
75;40;40257;1281;21;1302
75;40;40258;252;3;255
75;40;40259;431;13;444
75;40;40260;420;8;428
75;40;40261;2752;49;2801
75;40;40262;312;6;318
75;40;40263;413;8;421
75;40;40264;1699;24;1723
75;40;40265;110;0;110
75;40;40266;1683;34;1717
75;40;40267;1001;13;1014
75;40;40268;685;22;707
75;40;40269;1229;38;1267
75;40;40270;442;14;456
75;40;40271;1200;25;1225
75;40;40272;1625;39;1664
75;40;40273;5776;131;5907
75;40;40274;1383;40;1423
75;40;40275;606;19;625
75;40;40276;311;8;319
75;40;40277;711;49;760
75;40;40278;970;16;986
75;40;40279;13381;481;13862
75;40;40280;1725;32;1757
75;40;40281;9689;360;10049
75;40;40282;4890;96;4986
75;40;40283;3307;225;3532
75;40;40284;7734;252;7986
75;40;40285;626;14;640
75;40;40286;1132;22;1154
75;40;40287;4431;66;4497
75;40;40288;1158;22;1180
75;40;40289;248;1;249
75;40;40290;108;3;111
75;40;40291;1734;32;1766
75;40;40292;1495;72;1567
75;40;40293;1107;23;1130
75;40;40294;1560;32;1592
75;40;40295;1081;18;1099
75;40;40296;3876;95;3971
75;40;40297;232;3;235
75;40;40298;397;14;411
75;40;40299;192;11;203
75;40;40300;964;34;998
75;40;40301;139;2;141
75;40;40303;328;2;330
75;40;40304;3480;86;3566
75;40;40305;196;8;204
75;40;40306;623;13;636
75;40;40307;1153;23;1176
75;40;40308;906;27;933
75;40;40309;1125;19;1144
75;40;40310;8235;199;8434
75;40;40311;628;13;641
75;40;40312;12634;299;12933
75;40;40313;3225;45;3270
75;40;40314;1259;40;1299
75;40;40315;773;11;784
75;40;40316;836;19;855
75;40;40317;3219;79;3298
75;40;40318;329;6;335
75;40;40319;242;4;246
75;40;40320;598;20;618
75;40;40321;246;9;255
75;40;40322;201;2;203
75;40;40323;254;5;259
75;40;40324;261;10;271
75;40;40325;271;12;283
75;40;40326;1420;34;1454
75;40;40327;224;5;229
75;40;40328;1614;22;1636
75;40;40329;484;6;490
75;40;40330;316;6;322
75;40;40331;2436;46;2482
75;40;40332;2304;55;2359
75;40;40333;1337;26;1363
75;40;40334;381;13;394
24;41;41001;191;5;196
24;41;41002;818;23;841
24;41;41003;597;213;810
24;41;41004;265;5;270
24;41;41006;446;8;454
24;41;41007;735;13;748
24;41;41008;737;16;753
24;41;41009;688;15;703
24;41;41010;1009;29;1038
24;41;41012;209;12;221
24;41;41013;275;5;280
24;41;41014;162;2;164
24;41;41016;1033;10;1043
24;41;41017;659;17;676
24;41;41018;45898;1520;47418
24;41;41019;95;2;97
24;41;41020;459;6;465
24;41;41022;130;1;131
24;41;41024;175;7;182
24;41;41025;1309;18;1327
24;41;41026;174;4;178
24;41;41027;145;2;147
24;41;41028;468;9;477
24;41;41029;1505;25;1530
24;41;41030;228;3;231
24;41;41031;2652;70;2722
24;41;41032;2674;79;2753
24;41;41034;92;1;93
24;41;41035;618;15;633
24;41;41036;453;7;460
24;41;41037;208;4;212
24;41;41038;419;11;430
24;41;41039;699;20;719
24;41;41040;799;27;826
24;41;41041;162;3;165
24;41;41042;535;4;539
24;41;41043;1691;32;1723
24;41;41044;1106;10;1116
24;41;41045;1077;10;1087
24;41;41046;1073;15;1088
24;41;41047;4524;116;4640
24;41;41048;226;4;230
24;41;41049;942;13;955
24;41;41050;923;39;962
24;41;41051;1080;27;1107
24;41;41052;1101;34;1135
24;41;41053;533;5;538
24;41;41054;337;5;342
24;41;41055;2393;54;2447
24;41;41057;170;0;170
24;41;41058;184;5;189
24;41;41059;6723;157;6880
24;41;41060;689;12;701
24;41;41061;1550;26;1576
24;41;41062;551;7;558
24;41;41063;490;8;498
24;41;41065;566;16;582
24;41;41066;435;10;445
24;41;41067;2802;77;2879
24;41;41068;501;9;510
24;41;41069;253;6;259
24;41;41070;519;9;528
24;41;41071;543;12;555
24;41;41072;398;17;415
24;41;41073;681;17;698
24;41;41074;1227;14;1241
24;41;41075;1009;8;1017
24;41;41077;130;6;136
24;41;41078;824;17;841
24;41;41079;103;0;103
24;41;41080;1388;30;1418
24;41;41081;227;5;232
24;41;41083;555;4;559
24;41;41084;969;27;996
24;41;41085;1055;14;1069
24;41;41086;640;9;649
24;41;41087;330;5;335
24;41;41088;234;6;240
24;41;41089;202;2;204
24;41;41090;258;6;264
24;41;41091;1309;19;1328
24;41;41093;271;9;280
24;41;41094;1145;37;1182
24;41;41095;1069;22;1091
24;41;41096;342;3;345
24;41;41097;2376;30;2406
24;41;41098;174;4;178
24;41;41099;496;13;509
24;41;41100;170;8;178
24;41;41101;1181;36;1217
24;41;41102;383;3;386
24;41;41103;416;11;427
24;41;41104;2337;52;2389
24;41;41105;862;19;881
24;41;41106;4667;61;4728
24;41;41107;472;6;478
24;41;41108;123;3;126
24;41;41109;742;21;763
24;41;41110;824;19;843
24;41;41112;245;9;254
24;41;41113;179;8;187
24;41;41114;288;7;295
24;41;41115;392;6;398
24;41;41116;198;3;201
24;41;41118;200;4;204
24;41;41119;348;6;354
24;41;41120;1253;35;1288
24;41;41121;31;0;31
24;41;41122;236;2;238
24;41;41123;673;11;684
24;41;41124;337;20;357
24;41;41125;725;15;740
24;41;41126;1158;21;1179
24;41;41127;336;6;342
24;41;41128;715;17;732
24;41;41129;716;13;729
24;41;41130;666;12;678
24;41;41131;833;28;861
24;41;41132;322;6;328
24;41;41134;630;22;652
24;41;41135;875;9;884
24;41;41136;6171;105;6276
24;41;41137;571;24;595
24;41;41138;312;9;321
24;41;41139;1091;11;1102
24;41;41140;739;18;757
24;41;41141;374;2;376
24;41;41142;2353;93;2446
24;41;41143;1313;53;1366
24;41;41144;735;23;758
24;41;41145;799;21;820
24;41;41146;959;15;974
24;41;41147;1920;43;1963
24;41;41148;1326;35;1361
24;41;41149;3721;196;3917
24;41;41150;3311;90;3401
24;41;41151;3719;50;3769
24;41;41152;637;13;650
24;41;41153;153;3;156
24;41;41154;1083;27;1110
24;41;41155;1235;30;1265
24;41;41156;527;14;541
24;41;41157;1518;17;1535
24;41;41158;2404;59;2463
24;41;41159;1242;17;1259
24;41;41160;322;4;326
24;41;41161;2323;47;2370
24;41;41163;117;2;119
24;41;41164;2721;32;2753
24;41;41166;377;5;382
24;41;41167;3452;102;3554
24;41;41168;235;4;239
24;41;41171;1734;29;1763
24;41;41172;225;1;226
24;41;41173;3488;68;3556
24;41;41174;178;7;185
24;41;41175;1116;18;1134
24;41;41176;754;18;772
24;41;41177;160;0;160
24;41;41178;63;2;65
24;41;41179;186;1;187
24;41;41180;1523;176;1699
24;41;41181;800;21;821
24;41;41182;285;9;294
24;41;41184;604;7;611
24;41;41185;2319;55;2374
24;41;41186;309;5;314
24;41;41187;175;4;179
24;41;41188;118;3;121
24;41;41189;476;6;482
24;41;41190;216;7;223
24;41;41191;68;3;71
24;41;41192;267;3;270
24;41;41193;133;3;136
24;41;41194;17924;471;18395
24;41;41195;152;2;154
24;41;41196;85;3;88
24;41;41198;2852;90;2942
24;41;41199;1204;28;1232
24;41;41200;471;29;500
24;41;41201;322;3;325
24;41;41203;497;10;507
24;41;41204;1781;41;1822
24;41;41205;175;2;177
24;41;41206;863;26;889
24;41;41207;1133;20;1153
24;41;41208;115;4;119
24;41;41209;814;41;855
24;41;41211;2731;38;2769
24;41;41212;3174;96;3270
24;41;41213;104;5;109
24;41;41214;685;12;697
24;41;41215;96;2;98
24;41;41216;560;8;568
24;41;41217;753;15;768
24;41;41218;764;12;776
24;41;41219;310;3;313
24;41;41220;4337;85;4422
24;41;41221;646;17;663
24;41;41222;372;7;379
24;41;41223;760;10;770
24;41;41224;180;1;181
24;41;41225;568;11;579
24;41;41226;3087;92;3179
24;41;41228;292;3;295
24;41;41229;1461;33;1494
24;41;41230;1840;55;1895
24;41;41231;1180;30;1210
24;41;41232;4953;98;5051
24;41;41233;900;15;915
24;41;41234;288;9;297
24;41;41235;1026;22;1048
24;41;41236;97;3;100
24;41;41237;1040;19;1059
24;41;41238;1976;28;2004
24;41;41239;1017;23;1040
24;41;41241;1342;29;1371
24;41;41242;4573;65;4638
24;41;41243;814;13;827
24;41;41245;382;4;386
24;41;41246;482;18;500
24;41;41247;1620;22;1642
24;41;41248;1042;23;1065
24;41;41249;1047;14;1061
24;41;41250;480;7;487
24;41;41251;535;8;543
24;41;41252;1595;37;1632
24;41;41253;260;5;265
24;41;41254;186;7;193
24;41;41255;331;6;337
24;41;41256;1246;19;1265
24;41;41258;1157;23;1180
24;41;41259;843;33;876
24;41;41260;418;6;424
24;41;41261;134;3;137
24;41;41262;1115;16;1131
24;41;41265;285;10;295
24;41;41266;84;3;87
24;41;41267;940;18;958
24;41;41268;161;4;165
24;41;41269;15856;642;16498
24;41;41271;631;6;637
24;41;41273;457;7;464
24;41;41274;127;0;127
24;41;41275;1257;23;1280
24;41;41276;2463;80;2543
24;41;41277;125;0;125
24;41;41278;260;8;268
24;41;41279;397;5;402
24;41;41280;2657;66;2723
24;41;41281;422;9;431
24;41;41282;442;9;451
24;41;41283;273;4;277
24;41;41284;63;2;65
24;41;41285;484;4;488
24;41;41286;150;5;155
24;41;41287;507;12;519
24;41;41288;810;16;826
24;41;41289;391;8;399
24;41;41290;236;0;236
24;41;41291;321;4;325
24;41;41292;201;1;202
24;41;41293;241;5;246
24;41;41294;1120;58;1178
24;41;41295;8091;212;8303
24;41;41296;1466;34;1500
24;41;41297;760;8;768
84;42;42001;452;7;459
84;42;42002;172;2;174
84;42;42003;1903;47;1950
84;42;42005;9963;150;10113
84;42;42006;406;8;414
84;42;42007;215;5;220
84;42;42008;109;1;110
84;42;42009;528;5;533
84;42;42010;1665;22;1687
84;42;42011;2840;56;2896
84;42;42012;674;23;697
84;42;42013;1993;50;2043
84;42;42014;314;8;322
84;42;42015;1477;26;1503
84;42;42016;424;10;434
84;42;42017;455;6;461
84;42;42018;460;11;471
84;42;42019;3120;72;3192
84;42;42020;1170;21;1191
84;42;42021;1252;10;1262
84;42;42022;4093;58;4151
84;42;42023;2937;56;2993
84;42;42025;198;4;202
84;42;42026;1719;39;1758
84;42;42027;403;7;410
84;42;42028;376;9;385
84;42;42029;1520;48;1568
84;42;42030;536;3;539
84;42;42031;306;7;313
84;42;42032;1704;24;1728
84;42;42033;622;24;646
84;42;42034;108;7;115
84;42;42035;210;9;219
84;42;42036;496;17;513
84;42;42037;592;23;615
84;42;42038;709;14;723
84;42;42039;454;5;459
84;42;42040;47;2;49
84;42;42041;618;5;623
84;42;42042;1036;20;1056
84;42;42043;1791;37;1828
84;42;42044;11948;80;12028
84;42;42045;39;1;40
84;42;42046;1935;44;1979
84;42;42047;327;2;329
84;42;42048;1479;30;1509
84;42;42049;654;21;675
84;42;42050;130;3;133
84;42;42051;532;14;546
84;42;42052;3695;94;3789
84;42;42053;1630;21;1651
84;42;42054;346;8;354
84;42;42055;140;8;148
84;42;42056;2897;50;2947
84;42;42058;258;6;264
84;42;42059;5423;99;5522
84;42;42060;527;6;533
84;42;42061;569;15;584
84;42;42062;1164;25;1189
84;42;42063;399;9;408
84;42;42064;761;30;791
84;42;42065;1411;54;1465
84;42;42066;512;12;524
84;42;42067;298;3;301
84;42;42068;426;11;437
84;42;42069;3005;93;3098
84;42;42070;916;21;937
84;42;42071;6880;179;7059
84;42;42072;65;1;66
84;42;42073;734;18;752
84;42;42074;1082;26;1108
84;42;42075;1363;14;1377
84;42;42076;907;22;929
84;42;42077;307;6;313
84;42;42078;257;11;268
84;42;42079;711;12;723
84;42;42081;1544;20;1564
84;42;42083;532;4;536
84;42;42084;159;4;163
84;42;42085;835;18;853
84;42;42086;523;13;536
84;42;42087;1224;53;1277
84;42;42088;748;17;765
84;42;42089;666;29;695
84;42;42090;495;12;507
84;42;42091;683;15;698
84;42;42092;2643;105;2748
84;42;42093;1379;20;1399
84;42;42094;8302;146;8448
84;42;42095;16901;188;17089
84;42;42096;681;11;692
84;42;42097;4666;64;4730
84;42;42098;582;14;596
84;42;42099;3733;53;3786
84;42;42100;278;11;289
84;42;42101;143;1;144
84;42;42102;890;22;912
84;42;42103;5172;41;5213
84;42;42104;861;20;881
84;42;42105;254;2;256
84;42;42106;251;8;259
84;42;42107;320;9;329
84;42;42108;1106;13;1119
84;42;42109;109;1;110
84;42;42110;4746;42;4788
84;42;42112;419;8;427
84;42;42113;233;6;239
84;42;42115;1224;15;1239
84;42;42116;247;7;254
84;42;42117;115;8;123
84;42;42118;749;20;769
84;42;42119;366;11;377
84;42;42120;1777;40;1817
84;42;42121;156;2;158
84;42;42122;1715;79;1794
84;42;42123;4716;31;4747
84;42;42124;296;7;303
84;42;42125;141;2;143
84;42;42126;1284;30;1314
84;42;42127;7653;118;7771
84;42;42128;391;8;399
84;42;42129;1819;68;1887
84;42;42130;569;10;579
84;42;42131;332;9;341
84;42;42132;566;16;582
84;42;42133;695;19;714
84;42;42134;1391;47;1438
84;42;42135;530;27;557
84;42;42136;765;32;797
84;42;42137;797;15;812
84;42;42138;668;12;680
84;42;42139;1329;66;1395
84;42;42140;443;8;451
84;42;42141;570;11;581
84;42;42142;320;4;324
84;42;42143;490;5;495
84;42;42145;1083;19;1102
84;42;42146;66;3;69
84;42;42147;15915;623;16538
84;42;42148;504;9;513
84;42;42149;5342;79;5421
84;42;42150;1393;30;1423
84;42;42151;413;80;493
84;42;42152;546;315;861
84;42;42153;481;12;493
84;42;42154;460;51;511
84;42;42155;1007;23;1030
84;42;42156;1372;18;1390
84;42;42157;794;14;808
84;42;42158;210;3;213
84;42;42159;1571;106;1677
84;42;42160;190;6;196
84;42;42161;573;19;592
84;42;42162;1154;19;1173
84;42;42163;1057;20;1077
84;42;42164;71;0;71
84;42;42165;2892;86;2978
84;42;42166;624;16;640
84;42;42167;376;10;386
84;42;42168;3738;100;3838
84;42;42169;1580;27;1607
84;42;42170;2110;180;2290
84;42;42171;288;7;295
84;42;42172;1059;24;1083
84;42;42173;359;10;369
84;42;42174;1150;25;1175
84;42;42175;1202;35;1237
84;42;42176;2172;46;2218
84;42;42177;2532;53;2585
84;42;42178;833;10;843
84;42;42179;858;28;886
84;42;42180;1035;99;1134
84;42;42181;1512;30;1542
84;42;42182;3198;106;3304
84;42;42183;7872;48;7920
84;42;42184;10848;280;11128
84;42;42185;698;20;718
84;42;42186;14978;121;15099
84;42;42187;33809;738;34547
84;42;42188;254;4;258
84;42;42189;9884;92;9976
84;42;42191;980;33;1013
84;42;42192;433;7;440
84;42;42193;1427;39;1466
84;42;42194;201;2;203
84;42;42195;972;23;995
84;42;42196;120;4;124
84;42;42197;1045;32;1077
84;42;42198;934;23;957
84;42;42199;1927;63;1990
84;42;42200;1527;26;1553
84;42;42201;689;31;720
84;42;42202;688;15;703
84;42;42203;301;12;313
84;42;42204;1510;47;1557
84;42;42205;688;15;703
84;42;42206;1669;41;1710
84;42;42207;34841;412;35253
84;42;42208;1903;42;1945
84;42;42209;396;11;407
84;42;42210;477;7;484
84;42;42211;2447;35;2482
84;42;42212;961;28;989
84;42;42213;311;12;323
84;42;42214;1041;29;1070
84;42;42215;1260;25;1285
84;42;42216;673;19;692
84;42;42217;421;7;428
84;42;42218;173821;1971;175792
84;42;42219;1025;26;1051
84;42;42220;621;19;640
84;42;42221;514;15;529
84;42;42222;5826;146;5972
84;42;42223;6123;70;6193
84;42;42224;2918;144;3062
84;42;42225;3894;76;3970
84;42;42226;431;3;434
84;42;42227;412;10;422
84;42;42228;1467;26;1493
84;42;42229;230;6;236
84;42;42230;1608;31;1639
84;42;42231;1238;75;1313
84;42;42232;637;11;648
84;42;42233;954;24;978
84;42;42234;3637;55;3692
84;42;42235;337;5;342
84;42;42236;529;10;539
84;42;42237;6615;69;6684
84;42;42238;320;11;331
84;42;42239;1153;24;1177
84;42;42240;859;19;878
84;42;42241;390;5;395
84;42;42242;1928;29;1957
84;42;42243;283;5;288
84;42;42245;585;6;591
84;42;42246;1143;18;1161
84;42;42247;282;8;290
84;42;42248;1130;38;1168
84;42;42249;1656;35;1691
84;42;42251;581;13;594
84;42;42252;252;2;254
84;42;42253;1157;40;1197
84;42;42254;799;17;816
84;42;42255;283;7;290
84;42;42256;5001;50;5051
84;42;42257;836;16;852
84;42;42259;3815;75;3890
84;42;42260;890;59;949
84;42;42261;906;20;926
84;42;42262;1817;21;1838
84;42;42264;980;24;1004
84;42;42265;856;25;881
84;42;42266;663;13;676
84;42;42267;1696;47;1743
84;42;42268;796;9;805
84;42;42269;174;10;184
84;42;42270;1357;31;1388
84;42;42271;4817;59;4876
84;42;42272;1704;38;1742
84;42;42273;381;8;389
84;42;42274;257;8;265
84;42;42275;6106;95;6201
84;42;42276;430;6;436
84;42;42277;341;1;342
84;42;42278;144;1;145
84;42;42279;15229;280;15509
84;42;42280;402;11;413
84;42;42281;134;2;136
84;42;42282;239;5;244
84;42;42283;1218;28;1246
84;42;42284;1417;59;1476
84;42;42285;4090;64;4154
84;42;42286;949;15;964
84;42;42287;1088;21;1109
84;42;42288;706;12;718
84;42;42289;1899;36;1935
84;42;42290;588;22;610
84;42;42293;1191;20;1211
84;42;42294;974;28;1002
84;42;42295;556;7;563
84;42;42296;547;16;563
84;42;42297;595;30;625
84;42;42298;377;5;382
84;42;42299;3430;74;3504
84;42;42300;643;13;656
84;42;42301;689;8;697
84;42;42302;7874;167;8041
84;42;42303;276;6;282
84;42;42304;6653;270;6923
84;42;42305;6977;99;7076
84;42;42306;483;6;489
84;42;42307;902;32;934
84;42;42308;776;8;784
84;42;42310;149;2;151
84;42;42311;1471;37;1508
84;42;42312;606;17;623
84;42;42313;665;8;673
84;42;42314;291;8;299
84;42;42315;423;14;437
84;42;42316;8418;80;8498
84;42;42317;124;6;130
84;42;42318;1487;23;1510
84;42;42319;705;11;716
84;42;42320;707;10;717
84;42;42321;102;1;103
84;42;42322;1075;26;1101
84;42;42323;8973;105;9078
84;42;42324;1192;17;1209
84;42;42325;376;5;381
84;42;42326;877;28;905
84;42;42327;664;14;678
84;42;42328;712;75;787
84;42;42329;377;5;382
84;42;42330;7942;159;8101
84;42;42331;1022;31;1053
84;42;42332;5030;142;5172
84;42;42333;589;13;602
84;42;42334;1250;17;1267
84;42;42335;442;20;462
84;42;42336;637;20;657
84;42;42337;224;5;229
84;42;42338;1488;61;1549
84;42;42339;218;5;223
84;43;43001;178;4;182
84;43;43002;1473;63;1536
84;43;43003;874;18;892
84;43;43004;119;7;126
84;43;43005;156;3;159
84;43;43006;129;2;131
84;43;43007;602;17;619
84;43;43008;143;6;149
84;43;43009;23;0;23
84;43;43010;1193;29;1222
84;43;43011;178;5;183
84;43;43012;6142;83;6225
84;43;43013;306;10;316
84;43;43014;56;2;58
84;43;43015;50;0;50
84;43;43016;898;22;920
84;43;43017;282;5;287
84;43;43018;1376;126;1502
84;43;43019;108;2;110
84;43;43020;4377;86;4463
84;43;43021;1040;20;1060
84;43;43022;276;12;288
84;43;43023;210;2;212
84;43;43024;851;13;864
84;43;43025;2969;67;3036
84;43;43026;445;12;457
84;43;43027;45;0;45
84;43;43028;472;15;487
84;43;43029;97;1;98
84;43;43030;401;10;411
84;43;43031;135;5;140
84;43;43032;1687;51;1738
84;43;43033;636;8;644
84;43;43034;355;1;356
84;43;43035;68;3;71
84;43;43036;409;6;415
84;43;43037;280;7;287
84;43;43038;998;27;1025
84;43;43039;609;13;622
84;43;43040;6609;325;6934
84;43;43041;4185;224;4409
84;43;43042;710;17;727
84;43;43043;470;8;478
84;43;43044;209;4;213
84;43;43045;426;13;439
84;43;43046;2464;68;2532
84;43;43047;332;8;340
84;43;43048;616;36;652
84;43;43049;487;9;496
84;43;43050;124;0;124
84;43;43051;2431;40;2471
84;43;43052;193;2;195
84;43;43053;205;4;209
84;43;43054;176;9;185
84;43;43055;165;4;169
84;43;43056;428;13;441
84;43;43057;46;2;48
84;43;43058;1054;29;1083
84;43;43059;109;1;110
84;43;43060;69;4;73
84;43;43061;868;23;891
84;43;43062;806;15;821
84;43;43063;156;2;158
84;43;43064;64;4;68
84;43;43065;123;4;127
84;43;43066;118;4;122
84;43;43067;268;6;274
84;43;43068;33;2;35
84;43;43069;319;7;326
84;43;43070;171;2;173
84;43;43071;472;6;478
84;43;43072;153;5;158
84;43;43073;134;3;137
84;43;43074;884;25;909
84;43;43075;73;3;76
84;43;43076;137;1;138
84;43;43077;538;16;554
84;43;43078;3258;89;3347
84;43;43079;301;11;312
84;43;43080;1951;41;1992
84;43;43082;71;2;73
84;43;43083;150;4;154
84;43;43084;1678;35;1713
84;43;43085;56;5;61
84;43;43086;179;9;188
84;43;43087;2668;65;2733
84;43;43088;322;9;331
84;43;43089;3497;170;3667
84;43;43090;127;4;131
84;43;43091;324;14;338
84;43;43092;355;7;362
84;43;43093;325;7;332
84;43;43094;82;2;84
84;43;43095;134;4;138
84;43;43096;902;228;1130
84;43;43097;105;1;106
84;43;43098;109;5;114
84;43;43099;552;6;558
84;43;43100;174;2;176
84;43;43101;57;6;63
84;43;43102;1103;17;1120
84;43;43103;113;2;115
84;43;43104;197;6;203
84;43;43105;178;7;185
84;43;43106;145;3;148
84;43;43107;86;0;86
84;43;43108;439;10;449
84;43;43109;77;3;80
84;43;43110;844;14;858
84;43;43111;878;22;900
84;43;43112;3489;77;3566
84;43;43113;1923;54;1977
84;43;43114;1729;38;1767
84;43;43115;1009;18;1027
84;43;43116;63;3;66
84;43;43117;247;7;254
84;43;43118;272;4;276
84;43;43119;832;17;849
84;43;43120;1325;26;1351
84;43;43121;216;5;221
84;43;43122;289;5;294
84;43;43123;393;16;409
84;43;43124;931;18;949
84;43;43125;81;1;82
84;43;43126;761;15;776
84;43;43127;846;15;861
84;43;43128;134;2;136
84;43;43129;156;7;163
84;43;43130;1110;29;1139
84;43;43131;196;2;198
84;43;43132;1445;42;1487
84;43;43133;139;1;140
84;43;43134;150;4;154
84;43;43135;1768;31;1799
84;43;43136;211;1;212
84;43;43137;8875;425;9300
84;43;43138;412;12;424
84;43;43139;54;0;54
84;43;43140;685;24;709
84;43;43141;1149;24;1173
84;43;43142;586;10;596
84;43;43143;128;0;128
84;43;43144;98;3;101
84;43;43145;57;0;57
84;43;43147;638;21;659
84;43;43148;868;18;886
84;43;43149;116;4;120
84;43;43150;468;13;481
84;43;43151;190;5;195
84;43;43152;2810;84;2894
84;43;43153;1902;30;1932
84;43;43154;546;16;562
84;43;43155;62;1;63
84;43;43156;115;6;121
84;43;43157;19215;881;20096
84;43;43158;333;12;345
84;43;43159;940;24;964
84;43;43160;194;3;197
84;43;43162;2990;58;3048
84;43;43163;1179;18;1197
84;43;43164;486;2;488
84;43;43165;1531;30;1561
84;43;43166;375;16;391
84;43;43167;191;4;195
84;43;43168;116;1;117
84;43;43169;50;0;50
84;43;43170;450;6;456
84;43;43171;85;3;88
84;43;43172;213;2;215
84;43;43173;92;2;94
84;43;43174;953;13;966
84;43;43175;164;6;170
84;43;43177;3451;52;3503
84;43;43178;194;8;202
84;43;43180;98;5;103
84;43;43181;758;20;778
84;43;43182;53;0;53
84;43;43183;113;2;115
84;43;43184;2473;31;2504
84;43;43185;3200;77;3277
84;43;43186;402;4;406
84;43;43187;319;4;323
84;43;43188;473;8;481
84;43;43189;518;13;531
84;43;43190;3666;83;3749
84;43;43191;249;4;253
84;43;43192;283;11;294
84;43;43193;160;1;161
84;43;43194;716;22;738
84;43;43195;186;5;191
84;43;43196;174;2;176
84;43;43197;351;5;356
84;43;43198;295;8;303
84;43;43199;968;26;994
84;43;43200;1997;43;2040
84;43;43201;245;8;253
84;43;43202;71;1;72
84;43;43203;482;13;495
84;43;43204;174;1;175
84;43;43205;4225;60;4285
84;43;43206;411;16;427
84;43;43207;246;11;257
84;43;43208;43;2;45
84;43;43210;230;7;237
84;43;43211;2634;72;2706
84;43;43212;1009;16;1025
84;43;43213;2293;52;2345
84;43;43214;110;3;113
84;43;43215;186;5;191
84;43;43216;2435;56;2491
84;43;43217;542;11;553
84;43;43218;1187;27;1214
84;43;43219;113;4;117
84;43;43220;174;4;178
84;43;43221;397;13;410
84;43;43222;162;1;163
84;43;43223;1106;24;1130
84;43;43224;5989;101;6090
84;43;43225;52;0;52
84;43;43226;107;4;111
84;43;43227;822;16;838
84;43;43228;90;2;92
84;43;43229;610;9;619
84;43;43230;1028;19;1047
84;43;43231;136;4;140
84;43;43232;361;5;366
84;43;43233;1088;41;1129
84;43;43234;1697;124;1821
84;43;43236;1480;20;1500
84;43;43237;227;6;233
84;43;43238;299;7;306
84;43;43239;800;15;815
84;43;43240;263;7;270
84;43;43241;1272;32;1304
84;43;43242;72;3;75
84;43;43244;3074;45;3119
84;43;43245;222;8;230
84;43;43246;464;17;481
84;43;43247;67;1;68
84;43;43249;520;11;531
84;43;43250;43;3;46
84;43;43251;3420;121;3541
84;43;43252;24;2;26
84;43;43253;195;9;204
84;43;43254;267;4;271
84;43;43256;343;6;349
84;43;43257;517;7;524
84;43;43258;1815;50;1865
84;43;43259;362;11;373
84;43;43260;23;0;23
84;43;43261;617;6;623
84;43;43262;1167;37;1204
84;43;43263;67;0;67
84;43;43264;285;15;300
84;43;43265;1442;46;1488
84;43;43267;1454;15;1469
84;43;43268;7278;425;7703
52;44;44001;2067;40;2107
52;44;44002;4014;138;4152
52;44;44003;11037;398;11435
52;44;44005;6895;106;7001
52;44;44006;1847;42;1889
52;44;44007;2458;55;2513
52;44;44009;9136;241;9377
52;44;44010;2824;72;2896
52;44;44012;3049;44;3093
52;44;44013;3183;41;3224
52;44;44014;3907;71;3978
52;44;44015;9954;174;10128
52;44;44016;1054;18;1072
52;44;44018;8008;139;8147
52;44;44019;1019;14;1033
52;44;44020;19903;305;20208
52;44;44021;4962;88;5050
52;44;44022;2682;49;2731
52;44;44023;3068;45;3113
52;44;44024;2849;59;2908
52;44;44025;3959;67;4026
52;44;44026;20365;466;20831
52;44;44027;2421;28;2449
52;44;44028;3974;106;4080
52;44;44029;6975;122;7097
52;44;44030;4338;91;4429
52;44;44031;798;8;806
52;44;44032;3357;49;3406
52;44;44033;3145;45;3190
52;44;44035;19551;406;19957
52;44;44036;12031;497;12528
52;44;44037;3164;175;3339
52;44;44038;2930;46;2976
52;44;44039;1120;8;1128
52;44;44041;5782;88;5870
52;44;44043;7435;241;7676
52;44;44044;1095;28;1123
52;44;44045;3754;47;3801
52;44;44046;2640;55;2695
52;44;44047;22309;275;22584
52;44;44048;2548;51;2599
52;44;44049;4118;56;4174
52;44;44050;2983;26;3009
52;44;44051;3505;428;3933
52;44;44052;8152;94;8246
52;44;44053;2270;37;2307
52;44;44054;3043;72;3115
52;44;44055;16255;542;16797
52;44;44056;3676;62;3738
52;44;44057;2349;61;2410
52;44;44058;472;11;483
52;44;44061;3216;57;3273
52;44;44062;1821;41;1862
52;44;44063;3719;88;3807
52;44;44064;4851;360;5211
52;44;44065;769;21;790
52;44;44066;6439;117;6556
52;44;44067;5233;82;5315
52;44;44068;3374;55;3429
52;44;44069;16112;575;16687
52;44;44070;4691;111;4802
52;44;44071;5893;157;6050
52;44;44072;7046;127;7173
52;44;44073;6288;114;6402
52;44;44074;4040;45;4085
52;44;44075;1807;39;1846
52;44;44076;1391;21;1412
52;44;44077;2561;33;2594
52;44;44078;332;3;335
52;44;44079;3083;296;3379
52;44;44080;772;26;798
52;44;44081;4565;112;4677
52;44;44082;5302;106;5408
52;44;44083;2467;30;2497
52;44;44084;8397;135;8532
52;44;44085;986;40;1026
52;44;44086;1055;21;1076
52;44;44087;7581;236;7817
52;44;44088;3007;43;3050
52;44;44089;3531;55;3586
52;44;44090;1621;17;1638
52;44;44091;1519;15;1534
52;44;44092;692;13;705
52;44;44094;3244;65;3309
52;44;44095;1547;24;1571
52;44;44096;4749;80;4829
52;44;44097;2039;45;2084
52;44;44098;5398;68;5466
52;44;44099;1968;60;2028
52;44;44100;2290;60;2350
52;44;44101;6290;140;6430
52;44;44102;3191;55;3246
52;44;44103;7180;79;7259
52;44;44104;840;11;851
52;44;44105;372;7;379
52;44;44106;1765;21;1786
52;44;44107;1911;25;1936
52;44;44108;2865;54;2919
52;44;44109;318808;5167;323975
52;44;44110;9082;194;9276
52;44;44111;2260;25;2285
52;44;44112;591;11;602
52;44;44113;4195;89;4284
52;44;44114;27209;699;27908
52;44;44115;3872;66;3938
52;44;44116;3023;111;3134
52;44;44117;3257;51;3308
52;44;44118;1409;24;1433
52;44;44119;1985;27;2012
52;44;44120;5200;208;5408
52;44;44121;426;4;430
52;44;44122;3755;53;3808
52;44;44123;990;17;1007
52;44;44124;750;15;765
52;44;44125;2220;50;2270
52;44;44126;4379;86;4465
52;44;44127;2739;32;2771
52;44;44128;5266;105;5371
52;44;44129;10901;260;11161
52;44;44130;6470;87;6557
52;44;44131;15859;438;16297
52;44;44132;11141;299;11440
52;44;44133;2928;44;2972
52;44;44134;1071;22;1093
52;44;44135;4015;93;4108
52;44;44136;1237;27;1264
52;44;44137;3474;67;3541
52;44;44138;1159;17;1176
52;44;44139;1386;10;1396
52;44;44140;1525;25;1550
52;44;44141;1290;13;1303
52;44;44142;1958;34;1992
52;44;44143;42919;791;43710
52;44;44144;2358;58;2416
52;44;44145;3069;38;3107
52;44;44146;2185;42;2227
52;44;44148;701;8;709
52;44;44149;3952;49;4001
52;44;44150;3954;60;4014
52;44;44151;6744;179;6923
52;44;44152;2933;53;2986
52;44;44153;1763;52;1815
52;44;44154;14287;318;14605
52;44;44155;3417;75;3492
52;44;44156;3022;39;3061
52;44;44157;1727;22;1749
52;44;44158;7515;193;7708
52;44;44159;1236;23;1259
52;44;44161;3769;69;3838
52;44;44162;47415;720;48135
52;44;44163;4764;106;4870
52;44;44164;2322;45;2367
52;44;44165;2320;47;2367
52;44;44166;5987;114;6101
52;44;44168;4087;63;4150
52;44;44169;7392;106;7498
52;44;44170;967;22;989
52;44;44171;1939;33;1972
52;44;44172;15319;269;15588
52;44;44173;2126;47;2173
52;44;44174;2229;39;2268
52;44;44175;4817;94;4911
52;44;44176;3193;54;3247
52;44;44178;2571;42;2613
52;44;44179;5118;85;5203
52;44;44180;6480;125;6605
52;44;44182;5233;89;5322
52;44;44183;2716;59;2775
52;44;44184;71394;1745;73139
52;44;44185;3245;66;3311
52;44;44186;6980;132;7112
52;44;44187;4576;147;4723
52;44;44188;9076;194;9270
52;44;44189;2397;34;2431
52;44;44190;27493;676;28169
52;44;44192;2631;44;2675
52;44;44193;1533;26;1559
52;44;44194;8478;166;8644
52;44;44195;9064;186;9250
52;44;44196;1631;25;1656
52;44;44197;1630;34;1664
52;44;44198;8765;132;8897
52;44;44199;2003;56;2059
52;44;44200;343;7;350
52;44;44201;7221;202;7423
52;44;44202;1804;25;1829
52;44;44203;2028;17;2045
52;44;44204;10482;179;10661
52;44;44205;2494;29;2523
52;44;44206;1867;25;1892
52;44;44207;1094;10;1104
52;44;44208;930;11;941
52;44;44209;9617;246;9863
52;44;44210;7983;81;8064
52;44;44211;4734;95;4829
52;44;44212;9460;179;9639
52;44;44213;7480;127;7607
52;44;44214;2051;29;2080
52;44;44215;25541;599;26140
52;44;44216;4010;75;4085
52;44;44217;6175;130;6305
52;44;44218;682;14;696
52;44;44220;1615;25;1640
52;44;44221;1536;19;1555
52;44;44222;1225;21;1246
52;44;44223;3677;48;3725
52;44;44224;1711;21;1732
24;45;45001;202;5;207
24;45;45002;383;5;388
24;45;45004;13233;590;13823
24;45;45005;258;6;264
24;45;45006;1092;28;1120
24;45;45008;1951;30;1981
24;45;45009;1136;30;1166
24;45;45010;1104;39;1143
24;45;45011;208;4;212
24;45;45012;184;3;187
24;45;45013;227;8;235
24;45;45014;500;13;513
24;45;45015;699;13;712
24;45;45016;967;28;995
24;45;45017;339;3;342
24;45;45018;971;18;989
24;45;45019;654;27;681
24;45;45020;987;18;1005
24;45;45021;313;6;319
24;45;45022;449;4;453
24;45;45023;114;2;116
24;45;45024;2065;39;2104
24;45;45025;1548;21;1569
24;45;45026;969;15;984
24;45;45027;393;8;401
24;45;45028;7339;186;7525
24;45;45029;1789;21;1810
24;45;45030;2021;129;2150
24;45;45031;1455;88;1543
24;45;45032;317;8;325
24;45;45033;373;20;393
24;45;45034;2094;50;2144
24;45;45035;1132;23;1155
24;45;45036;840;29;869
24;45;45037;505;10;515
24;45;45038;413;12;425
24;45;45039;710;16;726
24;45;45040;1867;26;1893
24;45;45041;109;3;112
24;45;45042;1920;46;1966
24;45;45043;1002;24;1026
24;45;45044;161;7;168
24;45;45045;314;12;326
24;45;45046;1053;18;1071
24;45;45047;417;13;430
24;45;45049;1218;31;1249
24;45;45050;1324;38;1362
24;45;45051;1741;34;1775
24;45;45052;97;0;97
24;45;45053;5213;96;5309
24;45;45054;546;10;556
24;45;45055;554;15;569
24;45;45056;322;6;328
24;45;45058;176;7;183
24;45;45059;193;1;194
24;45;45060;786;18;804
24;45;45061;2419;53;2472
24;45;45062;1491;24;1515
24;45;45063;932;19;951
24;45;45064;450;10;460
24;45;45065;240;3;243
24;45;45066;679;11;690
24;45;45067;3881;110;3991
24;45;45068;12688;262;12950
24;45;45069;952;14;966
24;45;45070;62;0;62
24;45;45072;1574;22;1596
24;45;45073;483;8;491
24;45;45074;115;2;117
24;45;45075;10180;218;10398
24;45;45076;232;7;239
24;45;45077;626;6;632
24;45;45078;253;2;255
24;45;45079;156;0;156
24;45;45080;350;14;364
24;45;45081;613;16;629
24;45;45082;8212;118;8330
24;45;45083;2118;34;2152
24;45;45084;445;9;454
24;45;45085;1874;26;1900
24;45;45086;278;8;286
24;45;45087;3108;52;3160
24;45;45088;293;10;303
24;45;45089;8652;175;8827
24;45;45091;319;13;332
24;45;45092;1463;36;1499
24;45;45093;2658;39;2697
24;45;45094;223;2;225
24;45;45095;2061;41;2102
24;45;45096;525;8;533
24;45;45097;1215;13;1228
24;45;45098;3425;67;3492
24;45;45099;516;9;525
24;45;45100;494;21;515
24;45;45101;274;6;280
24;45;45102;356;10;366
24;45;45103;1551;18;1569
24;45;45104;2815;56;2871
24;45;45105;75;2;77
24;45;45107;318;0;318
24;45;45108;2294;36;2330
24;45;45109;541;11;552
24;45;45110;311;2;313
24;45;45111;451;3;454
24;45;45112;342;11;353
24;45;45113;260;5;265
24;45;45114;236;6;242
24;45;45115;3907;65;3972
24;45;45116;956;24;980
24;45;45118;338;6;344
24;45;45119;2430;66;2496
24;45;45120;173;2;175
24;45;45121;475;9;484
24;45;45122;1452;37;1489
24;45;45123;1864;31;1895
24;45;45124;175;3;178
24;45;45125;113;3;116
24;45;45126;2864;39;2903
24;45;45127;3280;36;3316
24;45;45129;1358;28;1386
24;45;45130;1397;34;1431
24;45;45131;389;10;399
24;45;45132;353;5;358
24;45;45133;562;17;579
24;45;45134;1430;27;1457
24;45;45135;311;5;316
24;45;45136;535;5;540
24;45;45137;726;17;743
24;45;45138;51;0;51
24;45;45139;493;17;510
24;45;45141;157;1;158
24;45;45142;3754;67;3821
24;45;45143;33;1;34
24;45;45144;1142;85;1227
24;45;45145;3702;81;3783
24;45;45146;7404;160;7564
24;45;45147;21010;266;21276
24;45;45148;1726;13;1739
24;45;45149;273;2;275
24;45;45150;181;4;185
24;45;45151;253;8;261
24;45;45152;211;4;215
24;45;45153;728;24;752
24;45;45154;2057;34;2091
24;45;45155;13566;408;13974
24;45;45156;603;17;620
24;45;45157;414;6;420
24;45;45158;322;10;332
24;45;45159;193;3;196
24;45;45160;704;8;712
24;45;45161;797;19;816
24;45;45162;524;14;538
24;45;45164;645;16;661
24;45;45165;612;9;621
24;45;45166;284;8;292
24;45;45167;1704;29;1733
24;45;45168;556;4;560
24;45;45169;9482;236;9718
24;45;45170;165;2;167
24;45;45171;548;14;562
24;45;45173;4676;49;4725
24;45;45174;265;6;271
24;45;45175;1440;33;1473
24;45;45176;430;4;434
24;45;45177;236;4;240
24;45;45178;1386;22;1408
24;45;45179;3103;47;3150
24;45;45180;82;0;82
24;45;45181;88;2;90
24;45;45182;1230;27;1257
24;45;45183;139;1;140
24;45;45184;398;6;404
24;45;45185;299;10;309
24;45;45186;579;13;592
24;45;45187;2973;62;3035
24;45;45188;2492;61;2553
24;45;45189;250;6;256
24;45;45191;8073;166;8239
24;45;45193;2138;47;2185
24;45;45194;2866;56;2922
24;45;45195;562;14;576
24;45;45196;1508;25;1533
24;45;45197;1692;37;1729
24;45;45198;300;9;309
24;45;45199;502;4;506
24;45;45200;1423;40;1463
24;45;45201;179;3;182
24;45;45202;1004;15;1019
24;45;45203;6540;95;6635
24;45;45204;815;20;835
24;45;45205;262;5;267
24;45;45206;321;4;325
24;45;45207;405;9;414
24;45;45208;14976;545;15521
24;45;45209;305;5;310
24;45;45210;736;18;754
24;45;45212;1269;26;1295
24;45;45213;627;15;642
24;45;45214;239;4;243
24;45;45215;242;3;245
24;45;45216;132;2;134
24;45;45217;167;5;172
24;45;45218;115;1;116
24;45;45219;196;1;197
24;45;45220;576;17;593
24;45;45222;1480;38;1518
24;45;45223;355;7;362
24;45;45224;4947;77;5024
24;45;45225;357;13;370
24;45;45226;1359;27;1386
24;45;45227;1167;23;1190
24;45;45228;1195;11;1206
24;45;45229;2589;38;2627
24;45;45230;737;5;742
24;45;45231;132;9;141
24;45;45232;22386;481;22867
24;45;45233;402;3;405
24;45;45234;116269;2363;118632
24;45;45235;4147;79;4226
24;45;45237;124;1;125
24;45;45238;711;12;723
24;45;45239;413;6;419
24;45;45240;1312;23;1335
24;45;45241;547;11;558
24;45;45242;266;5;271
24;45;45243;313;6;319
24;45;45244;2641;82;2723
24;45;45245;1117;20;1137
24;45;45246;138;1;139
24;45;45247;3688;66;3754
24;45;45248;2244;37;2281
24;45;45249;908;24;932
24;45;45250;252;2;254
24;45;45251;316;4;320
24;45;45252;9023;144;9167
24;45;45253;1769;41;1810
24;45;45254;2396;62;2458
24;45;45255;442;9;451
24;45;45256;244;6;250
24;45;45257;501;7;508
24;45;45258;3424;58;3482
24;45;45259;1133;22;1155
24;45;45260;250;7;257
24;45;45261;1311;16;1327
24;45;45262;140;2;142
24;45;45263;300;8;308
24;45;45264;185;5;190
24;45;45265;410;5;415
24;45;45266;204;1;205
24;45;45268;611;8;619
24;45;45269;3561;71;3632
24;45;45270;2004;51;2055
24;45;45271;968;23;991
24;45;45272;3295;76;3371
24;45;45273;3021;40;3061
24;45;45274;7589;191;7780
24;45;45275;451;4;455
24;45;45276;508;5;513
24;45;45277;453;12;465
24;45;45278;1065;68;1133
24;45;45279;1904;18;1922
24;45;45280;1096;19;1115
24;45;45281;953;17;970
24;45;45282;3071;85;3156
24;45;45283;164;6;170
24;45;45284;21288;592;21880
24;45;45285;16411;267;16678
24;45;45286;9070;233;9303
24;45;45288;395;10;405
24;45;45289;1202;18;1220
24;45;45290;1761;27;1788
24;45;45291;1235;47;1282
24;45;45292;856;12;868
24;45;45293;1155;25;1180
24;45;45294;135;1;136
24;45;45296;752;15;767
24;45;45297;1031;16;1047
24;45;45298;6076;102;6178
24;45;45299;267;1;268
24;45;45300;4114;100;4214
24;45;45301;405;3;408
24;45;45302;16357;206;16563
24;45;45303;632;13;645
24;45;45305;212;1;213
24;45;45306;788;14;802
24;45;45307;1099;24;1123
24;45;45308;3224;77;3301
24;45;45309;713;6;719
24;45;45310;1684;25;1709
24;45;45311;665;17;682
24;45;45312;475;8;483
24;45;45313;814;13;827
24;45;45314;450;9;459
24;45;45315;5213;66;5279
24;45;45316;790;23;813
24;45;45317;1357;37;1394
24;45;45320;413;11;424
24;45;45321;712;19;731
24;45;45322;185;4;189
24;45;45323;222;4;226
24;45;45324;2333;51;2384
24;45;45325;288;4;292
24;45;45326;392;9;401
24;45;45327;3448;83;3531
24;45;45328;295;5;300
24;45;45329;1288;25;1313
24;45;45330;217;4;221
24;45;45331;614;9;623
24;45;45332;1494;26;1520
24;45;45333;1953;39;1992
24;45;45334;632;8;640
24;45;45335;1939;44;1983
24;45;45336;868;13;881
24;45;45337;286;8;294
24;45;45338;6782;367;7149
24;45;45339;484;8;492
24;45;45340;575;6;581
24;45;45341;200;6;206
24;45;45342;394;3;397
24;45;45343;208;6;214
24;45;45344;1100;21;1121
24;45;45345;1128;34;1162
24;45;45346;2243;40;2283
24;45;45347;815;16;831
24;45;45348;698;17;715
76;46;46001;521;14;535
76;46;46002;64;2;66
76;46;46003;691;24;715
76;46;46004;221;6;227
76;46;46005;333;9;342
76;46;46006;383;4;387
76;46;46007;983;23;1006
76;46;46008;210;3;213
76;46;46009;633;18;651
76;46;46010;370;10;380
76;46;46011;356;9;365
76;46;46012;553;12;565
76;46;46013;174;2;176
76;46;46015;1467;38;1505
76;46;46016;386;15;401
76;46;46017;141;4;145
76;46;46018;137;3;140
76;46;46020;232;12;244
76;46;46021;705;26;731
76;46;46022;209;1;210
76;46;46023;517;6;523
76;46;46024;404;12;416
76;46;46026;115;3;118
76;46;46027;118;2;120
76;46;46028;1064;29;1093
76;46;46029;2044;57;2101
76;46;46030;340;13;353
76;46;46031;131;3;134
76;46;46032;403;5;408
76;46;46033;577;8;585
76;46;46034;314;9;323
76;46;46035;182;8;190
76;46;46036;126;2;128
76;46;46037;92;1;93
76;46;46038;1368;29;1397
76;46;46039;221;5;226
76;46;46040;225;8;233
76;46;46041;157;8;165
76;46;46042;19937;940;20877
76;46;46043;206;1;207
76;46;46044;597;22;619
76;46;46045;1119;32;1151
76;46;46046;457;10;467
76;46;46047;169;6;175
76;46;46049;202;3;205
76;46;46050;141;4;145
76;46;46051;388;11;399
76;46;46052;257;5;262
76;46;46053;424;13;437
76;46;46054;386;2;388
76;46;46055;1112;25;1137
76;46;46056;106;5;111
76;46;46057;616;13;629
76;46;46058;413;15;428
76;46;46059;223;10;233
76;46;46060;228;1;229
76;46;46061;178;4;182
76;46;46062;434;8;442
76;46;46063;1833;38;1871
76;46;46064;896;7;903
76;46;46065;436;14;450
76;46;46066;637;5;642
76;46;46068;170;3;173
76;46;46069;165;2;167
76;46;46070;587;14;601
76;46;46072;305;6;311
76;46;46073;420;17;437
76;46;46074;410;8;418
76;46;46075;237;5;242
76;46;46076;344;9;353
76;46;46078;97;2;99
76;46;46079;102;2;104
76;46;46080;778;14;792
76;46;46081;73;3;76
76;46;46082;360;9;369
76;46;46083;1118;23;1141
76;46;46084;314;8;322
76;46;46085;235;6;241
76;46;46086;632;13;645
76;46;46087;657;17;674
76;46;46088;822;22;844
76;46;46089;955;7;962
76;46;46090;148;2;150
76;46;46091;210;4;214
76;46;46092;221;3;224
76;46;46093;88;2;90
76;46;46094;268;5;273
76;46;46095;1041;25;1066
76;46;46096;96;2;98
76;46;46097;108;6;114
76;46;46098;300;7;307
76;46;46100;684;28;712
76;46;46101;461;7;468
76;46;46102;9802;670;10472
76;46;46103;1003;26;1029
76;46;46104;94;6;100
76;46;46105;780;17;797
76;46;46106;241;8;249
76;46;46107;170;5;175
76;46;46108;409;19;428
76;46;46109;501;9;510
76;46;46111;167;4;171
76;46;46112;240;5;245
76;46;46113;305;6;311
76;46;46114;361;7;368
76;46;46115;163;7;170
76;46;46116;70;6;76
76;46;46117;670;43;713
76;46;46118;675;15;690
76;46;46119;292;0;292
76;46;46120;336;4;340
76;46;46121;146;3;149
76;46;46122;104;4;108
76;46;46123;365;7;372
76;46;46124;301;12;313
76;46;46125;327;10;337
76;46;46126;221;4;225
76;46;46127;3981;127;4108
76;46;46128;3469;58;3527
76;46;46129;287;11;298
76;46;46130;222;5;227
76;46;46131;169;5;174
76;46;46132;519;21;540
76;46;46133;265;3;268
76;46;46134;274;6;280
76;46;46135;50;1;51
76;46;46136;270;7;277
76;46;46137;1244;22;1266
76;46;46138;918;20;938
76;46;46139;201;7;208
76;46;46140;363;15;378
76;46;46142;169;2;171
76;46;46143;1277;36;1313
76;46;46144;255;13;268
76;46;46145;793;13;806
76;46;46146;94;1;95
76;46;46147;126;0;126
76;46;46148;1785;46;1831
76;46;46149;695;21;716
76;46;46151;117;3;120
76;46;46152;301;4;305
76;46;46153;580;16;596
76;46;46154;350;13;363
76;46;46155;138;1;139
76;46;46156;1226;24;1250
76;46;46157;134;5;139
76;46;46159;223;12;235
76;46;46160;424;15;439
76;46;46161;248;6;254
76;46;46162;201;6;207
76;46;46163;288;4;292
76;46;46164;251;11;262
76;46;46165;462;11;473
76;46;46167;106;0;106
76;46;46168;187;1;188
76;46;46169;206;7;213
76;46;46170;927;23;950
76;46;46171;227;3;230
76;46;46172;500;16;516
76;46;46173;738;17;755
76;46;46174;233;8;241
76;46;46175;917;33;950
76;46;46176;699;13;712
76;46;46177;512;20;532
76;46;46178;261;1;262
76;46;46179;127;5;132
76;46;46180;593;25;618
76;46;46181;96;4;100
76;46;46182;1789;26;1815
76;46;46183;203;2;205
76;46;46184;350;12;362
76;46;46185;1625;41;1666
76;46;46186;362;7;369
76;46;46187;524;10;534
76;46;46188;300;10;310
76;46;46189;498;16;514
76;46;46190;129;3;132
76;46;46191;1140;20;1160
76;46;46192;269;8;277
76;46;46193;457;11;468
76;46;46194;182;3;185
76;46;46195;357;9;366
76;46;46196;99;1;100
76;46;46197;1062;125;1187
76;46;46198;110;1;111
76;46;46199;348;6;354
76;46;46200;267;5;272
76;46;46201;1772;48;1820
76;46;46202;549;5;554
76;46;46203;212;6;218
76;46;46204;600;9;609
76;46;46205;325;2;327
76;46;46206;120;6;126
76;46;46207;301;5;306
76;46;46208;287;11;298
76;46;46209;163;8;171
76;46;46210;68;1;69
76;46;46211;353;2;355
76;46;46212;70;3;73
76;46;46213;154;10;164
76;46;46214;385;9;394
76;46;46215;618;17;635
76;46;46216;658;29;687
76;46;46217;437;11;448
76;46;46218;187;3;190
76;46;46219;346;13;359
76;46;46220;788;25;813
76;46;46221;533;9;542
76;46;46222;192;3;195
76;46;46223;175;1;176
76;46;46224;3562;102;3664
76;46;46225;2384;76;2460
76;46;46226;230;7;237
76;46;46227;222;4;226
76;46;46228;718;15;733
76;46;46229;1015;18;1033
76;46;46230;86;4;90
76;46;46231;1940;29;1969
76;46;46232;1006;24;1030
76;46;46233;109;1;110
76;46;46234;100;2;102
76;46;46235;172;4;176
76;46;46236;143;0;143
76;46;46237;372;10;382
76;46;46238;279;9;288
76;46;46239;212;5;217
76;46;46240;623;20;643
76;46;46241;190;4;194
76;46;46242;179;5;184
76;46;46243;191;1;192
76;46;46244;94;1;95
76;46;46245;77;1;78
76;46;46246;74;1;75
76;46;46247;154;5;159
76;46;46249;120;5;125
76;46;46250;81;2;83
76;46;46251;3414;160;3574
76;46;46252;312;8;320
76;46;46253;181;2;183
76;46;46254;139;5;144
76;46;46255;334;13;347
76;46;46256;200;2;202
76;46;46257;122;3;125
76;46;46258;163;1;164
76;46;46259;141;2;143
76;46;46260;221;9;230
76;46;46262;633;14;647
76;46;46263;696;17;713
76;46;46264;200;7;207
76;46;46265;331;7;338
76;46;46266;538;8;546
76;46;46267;569;12;581
76;46;46268;893;20;913
76;46;46269;61;2;63
76;46;46270;242;3;245
76;46;46271;404;17;421
76;46;46272;271;4;275
76;46;46273;846;25;871
76;46;46276;185;5;190
76;46;46277;205;4;209
76;46;46279;210;3;213
76;46;46280;178;5;183
76;46;46281;200;7;207
76;46;46282;94;0;94
76;46;46283;316;8;324
76;46;46284;405;8;413
76;46;46286;176;5;181
76;46;46288;213;10;223
76;46;46289;159;0;159
76;46;46290;341;8;349
76;46;46292;186;6;192
76;46;46293;483;12;495
76;46;46294;146;3;149
76;46;46295;212;4;216
76;46;46296;437;16;453
76;46;46297;1207;25;1232
76;46;46299;120;4;124
76;46;46301;520;5;525
76;46;46302;135;2;137
76;46;46303;128;3;131
76;46;46304;137;1;138
76;46;46305;306;2;308
76;46;46306;86;3;89
76;46;46307;640;6;646
76;46;46308;102;1;103
76;46;46309;3201;318;3519
76;46;46310;126;2;128
76;46;46311;1331;20;1351
76;46;46312;273;2;275
76;46;46313;442;9;451
76;46;46314;174;40;214
76;46;46315;167;3;170
76;46;46316;290;5;295
76;46;46317;481;13;494
76;46;46318;232;12;244
76;46;46319;168;5;173
76;46;46320;317;15;332
76;46;46321;370;8;378
76;46;46322;809;31;840
76;46;46323;99;2;101
76;46;46324;214;4;218
76;46;46328;335;12;347
76;46;46329;326;2;328
76;46;46330;1303;25;1328
76;46;46332;334;5;339
76;46;46333;179;4;183
76;46;46334;1565;57;1622
76;46;46335;395;16;411
76;46;46336;349;31;380
76;46;46337;259;7;266
76;46;46338;77;1;78
76;46;46339;369;8;377
76;46;46340;365;12;377
75;47;47001;32602;862;33464
75;47;47002;105;4;109
75;47;47003;421;9;430
75;47;47004;4421;141;4562
75;47;47005;487;5;492
75;47;47006;593;13;606
75;47;47007;164;6;170
75;47;47008;110;4;114
75;47;47009;229;8;237
75;47;47010;224;3;227
75;47;47011;199;7;206
75;47;47012;311;2;313
75;47;47013;324;11;335
75;47;47014;202;7;209
75;47;47015;2031;39;2070
75;47;47016;1154;25;1179
75;47;47017;415;9;424
75;47;47018;173;6;179
75;47;47019;989;21;1010
75;47;47020;184;8;192
75;47;47021;1511;81;1592
75;47;47022;538;9;547
75;47;47023;354;5;359
75;47;47024;1632;41;1673
75;47;47025;550;6;556
75;47;47026;231;8;239
75;47;47027;2997;45;3042
75;47;47028;850;18;868
75;47;47029;495;13;508
75;47;47030;209;6;215
75;47;47031;5631;94;5725
75;47;47032;6224;148;6372
75;47;47033;412;3;415
75;47;47034;633;13;646
75;47;47035;328;80;408
75;47;47036;375;6;381
75;47;47037;253;4;257
75;47;47038;613;24;637
75;47;47039;36;0;36
75;47;47040;2090;46;2136
75;47;47041;747;15;762
75;47;47042;184;6;190
75;47;47043;1260;14;1274
75;47;47044;309;3;312
75;47;47045;472;5;477
75;47;47046;613;12;625
75;47;47047;183;5;188
75;47;47048;1339;19;1358
75;47;47049;2433;48;2481
75;47;47050;129;2;131
75;47;47051;2393;48;2441
75;47;47052;4518;56;4574
75;47;47053;375;7;382
75;47;47054;1796;23;1819
75;47;47055;516;7;523
75;47;47056;894;32;926
75;47;47057;1370;20;1390
75;47;47058;257;1;258
75;47;47059;261;4;265
75;47;47060;1109;19;1128
75;47;47061;774;7;781
75;47;47062;417;4;421
75;47;47063;162;2;164
75;47;47064;238;7;245
75;47;47065;2594;198;2792
75;47;47066;911;12;923
75;47;47067;393;8;401
75;47;47068;1087;23;1110
75;47;47069;3113;49;3162
75;47;47070;850;23;873
75;47;47071;242;3;245
75;47;47072;108;3;111
75;47;47073;198;5;203
75;47;47074;360;6;366
75;47;47075;1078;23;1101
75;47;47076;281;5;286
75;47;47077;851;18;869
75;47;47078;1357;46;1403
75;47;47079;517;18;535
75;47;47080;133;3;136
75;47;47081;716;15;731
75;47;47082;216;1;217
75;47;47083;104;1;105
75;47;47084;270;6;276
75;47;47085;297;3;300
75;47;47086;1219;20;1239
75;47;47087;163;9;172
75;47;47088;614;9;623
75;47;47089;150;2;152
75;47;47090;366;8;374
75;47;47091;2189;41;2230
75;47;47092;392;6;398
75;47;47093;347;9;356
75;47;47094;810;15;825
75;47;47095;863;19;882
75;47;47096;205;5;210
75;47;47097;1010;21;1031
75;47;47098;356;9;365
75;47;47099;622;16;638
75;47;47100;5449;219;5668
75;47;47101;1330;28;1358
75;47;47102;737;11;748
75;47;47103;230;4;234
75;47;47104;253;4;257
75;47;47105;282;5;287
75;47;47106;4755;99;4854
75;47;47107;308;6;314
75;47;47108;246;7;253
75;47;47109;291;5;296
75;47;47110;1651;28;1679
75;47;47111;589;17;606
75;47;47112;422;13;435
75;47;47113;141;3;144
75;47;47114;396;1;397
75;47;47115;254;7;261
75;47;47117;1014;16;1030
75;47;47118;186;1;187
75;47;47119;556;8;564
75;47;47120;102;3;105
75;47;47121;302;0;302
75;47;47122;186;2;188
75;47;47123;418;5;423
75;47;47124;212;6;218
75;47;47125;314;7;321
75;47;47126;95;1;96
75;47;47127;822;12;834
75;47;47128;1116;29;1145
75;47;47129;278;6;284
75;47;47130;327;5;332
75;47;47131;699;15;714
75;47;47132;224;4;228
75;47;47133;601;8;609
75;47;47134;366;9;375
75;47;47135;383;8;391
75;47;47136;136;2;138
75;47;47137;1344;32;1376
75;47;47138;1638;24;1662
75;47;47139;88;1;89
75;47;47140;687;15;702
75;47;47141;283;6;289
75;47;47142;763;6;769
75;47;47143;2263;59;2322
75;47;47144;574;20;594
75;47;47145;3686;56;3742
75;47;47146;1410;29;1439
75;47;47147;684;11;695
75;47;47148;204;1;205
75;47;47150;367;6;373
75;47;47151;423;3;426
75;47;47152;403;10;413
75;47;47154;372;4;376
75;47;47155;651;16;667
75;47;47156;856;8;864
75;47;47157;17421;587;18008
75;47;47158;174;3;177
75;47;47159;1483;34;1517
75;47;47160;183;2;185
75;47;47161;116;1;117
75;47;47162;217;5;222
75;47;47163;607;8;615
75;47;47164;112;3;115
75;47;47165;1330;59;1389
75;47;47167;1469;26;1495
75;47;47168;3092;102;3194
75;47;47169;1177;54;1231
75;47;47170;615;23;638
75;47;47171;437;8;445
75;47;47172;594;18;612
75;47;47173;882;11;893
75;47;47174;736;17;753
75;47;47175;2329;54;2383
75;47;47176;174;12;186
75;47;47177;191;4;195
75;47;47178;402;8;410
75;47;47179;2033;28;2061
75;47;47180;631;14;645
75;47;47181;271;3;274
75;47;47182;246;1;247
75;47;47183;166;6;172
75;47;47184;260;4;264
75;47;47185;2652;68;2720
75;47;47186;773;12;785
75;47;47187;328;2;330
75;47;47188;291;4;295
75;47;47189;148;0;148
75;47;47190;549;45;594
75;47;47191;846;9;855
75;47;47192;78;1;79
75;47;47193;199;4;203
75;47;47194;321;5;326
75;47;47195;6837;507;7344
75;47;47196;215;3;218
75;47;47197;254;2;256
75;47;47198;335;6;341
75;47;47199;316;5;321
75;47;47200;114;1;115
75;47;47201;9400;170;9570
75;47;47202;309;7;316
75;47;47203;2341;50;2391
75;47;47204;283;3;286
75;47;47205;201;8;209
75;47;47206;564;5;569
75;47;47207;205;5;210
75;47;47208;199;6;205
75;47;47209;4141;118;4259
75;47;47210;1846;30;1876
75;47;47211;223;7;230
75;47;47212;289;6;295
75;47;47213;995;27;1022
75;47;47214;681;13;694
75;47;47215;3675;138;3813
75;47;47216;679;13;692
75;47;47217;919;15;934
75;47;47218;240;4;244
75;47;47219;180;2;182
75;47;47220;298;5;303
75;47;47221;606;18;624
75;47;47222;486;9;495
75;47;47223;203;7;210
75;47;47224;161;6;167
75;47;47225;2048;39;2087
75;47;47226;528;9;537
75;47;47227;177;2;179
75;47;47228;717;10;727
75;47;47229;223;5;228
75;47;47230;395;9;404
75;47;47231;175;2;177
75;47;47232;520;3;523
75;47;47233;3160;98;3258
75;47;47234;663;20;683
75;47;47235;471;4;475
75;47;47236;106;1;107
75;47;47237;502;11;513
75;47;47238;1586;53;1639
75;47;47239;850;13;863
75;47;47240;279;10;289
75;47;47241;678;18;696
75;47;47242;518;13;531
75;47;47244;387;5;392
75;47;47245;93;2;95
75;47;47246;1491;39;1530
75;47;47247;248;10;258
75;47;47248;571;7;578
75;47;47249;523;4;527
75;47;47250;123;4;127
75;47;47251;320;5;325
75;47;47252;6456;175;6631
75;47;47253;645;5;650
75;47;47254;308;8;316
75;47;47255;174;3;177
75;47;47256;102;4;106
75;47;47257;613;8;621
75;47;47258;312;10;322
75;47;47259;103;4;107
75;47;47260;415;5;420
75;47;47262;423;4;427
75;47;47263;608;15;623
75;47;47264;1105;19;1124
75;47;47265;377;8;385
75;47;47266;198;2;200
75;47;47267;295;2;297
75;47;47269;844;19;863
75;47;47271;358;3;361
75;47;47272;194;7;201
75;47;47273;187;6;193
75;47;47274;396;6;402
75;47;47275;201;1;202
75;47;47276;299;7;306
75;47;47277;337;1;338
75;47;47278;475;9;484
75;47;47279;353;6;359
75;47;47280;2324;53;2377
75;47;47281;249;1;250
75;47;47282;233;7;240
75;47;47283;1163;30;1193
75;47;47284;293;7;300
75;47;47285;895;17;912
75;47;47286;106;0;106
75;47;47287;266;3;269
75;47;47288;524;14;538
75;47;47289;524;11;535
75;47;47290;549;6;555
75;47;47291;630;16;646
75;47;47292;576;6;582
75;47;47293;387;18;405
75;47;47294;219;1;220
75;47;47295;304;6;310
75;47;47296;155;2;157
75;47;47297;141;3;144
75;47;47298;213;3;216
75;47;47299;172;5;177
75;47;47300;1172;20;1192
75;47;47301;1062;11;1073
75;47;47302;651;7;658
75;47;47303;226;9;235
75;47;47304;61;2;63
75;47;47305;386;6;392
75;47;47306;1048;19;1067
75;47;47307;200;5;205
75;47;47308;222;3;225
75;47;47309;456;4;460
75;47;47310;9130;225;9355
75;47;47311;133;8;141
75;47;47312;761;13;774
75;47;47313;138;1;139
75;47;47314;395;10;405
75;47;47315;896;26;922
75;47;47316;671;8;679
75;47;47317;569;5;574
75;47;47318;995;15;1010
75;47;47319;107;3;110
75;47;47320;389;1;390
75;47;47321;315;5;320
75;47;47323;21742;683;22425
75;47;47324;1283;32;1315
75;47;47325;459;6;465
75;47;47326;1677;34;1711
75;47;47327;398;11;409
75;47;47328;550;19;569
76;48;48001;176;4;180
76;48;48002;561;21;582
76;48;48003;253;5;258
76;48;48004;213;10;223
76;48;48005;330;8;338
76;48;48007;50;0;50
76;48;48008;193;9;202
76;48;48009;2291;82;2373
76;48;48010;372;6;378
76;48;48012;354;12;366
76;48;48013;984;41;1025
76;48;48015;178;12;190
76;48;48016;558;18;576
76;48;48017;1067;36;1103
76;48;48018;769;18;787
76;48;48019;203;9;212
76;48;48020;65;0;65
76;48;48021;154;3;157
76;48;48025;426;25;451
76;48;48026;265;1;266
76;48;48027;1039;49;1088
76;48;48028;144;10;154
76;48;48029;148;0;148
76;48;48030;387;8;395
76;48;48031;76;3;79
76;48;48032;222;6;228
76;48;48034;2122;98;2220
76;48;48036;127;2;129
76;48;48037;120;2;122
76;48;48038;543;7;550
76;48;48039;1467;33;1500
76;48;48041;77;0;77
76;48;48042;900;35;935
76;48;48043;527;8;535
76;48;48044;86;2;88
76;48;48045;292;11;303
76;48;48046;67;2;69
76;48;48048;63;3;66
76;48;48050;451;15;466
76;48;48051;691;50;741
76;48;48053;189;8;197
76;48;48054;50;5;55
76;48;48055;183;4;187
76;48;48056;405;10;415
76;48;48058;155;5;160
76;48;48059;307;5;312
76;48;48061;2067;43;2110
76;48;48063;226;3;229
76;48;48064;369;9;378
76;48;48065;80;0;80
76;48;48067;100;2;102
76;48;48068;158;6;164
76;48;48069;53;0;53
76;48;48070;751;15;766
76;48;48071;66;1;67
76;48;48072;233;6;239
76;48;48073;95;4;99
76;48;48074;231;11;242
76;48;48075;897;27;924
76;48;48077;47;2;49
76;48;48079;114;3;117
76;48;48080;2887;193;3080
76;48;48081;316;10;326
76;48;48082;99;3;102
76;48;48083;152;4;156
76;48;48085;94;4;98
76;48;48086;209;5;214
76;48;48087;265;10;275
76;48;48088;136;5;141
76;48;48089;493;11;504
76;48;48090;728;14;742
76;48;48091;50;3;53
76;48;48092;4684;244;4928
76;48;48094;960;27;987
76;48;48095;12318;829;13147
76;48;48096;807;119;926
76;48;48097;216;9;225
76;48;48098;96;4;100
76;48;48099;2092;48;2140
76;48;48100;117;3;120
76;48;48103;1193;71;1264
76;48;48104;557;32;589
76;48;48105;369;18;387
76;48;48106;96;7;103
76;48;48107;179;7;186
76;48;48108;76;2;78
76;48;48110;101;5;106
76;48;48111;237;8;245
76;48;48112;164;5;169
76;48;48115;159;7;166
76;48;48116;562;24;586
76;48;48117;121;2;123
76;48;48119;250;13;263
76;48;48121;239;10;249
76;48;48123;172;6;178
76;48;48124;104;0;104
76;48;48126;358;12;370
76;48;48127;1291;21;1312
76;48;48128;593;21;614
76;48;48129;229;6;235
76;48;48130;124;1;125
76;48;48131;133;7;140
76;48;48132;1379;33;1412
76;48;48135;182;0;182
76;48;48136;150;2;152
76;48;48137;624;25;649
76;48;48138;67;2;69
76;48;48139;251;2;253
76;48;48140;4211;589;4800
76;48;48141;107;6;113
76;48;48144;269;9;278
76;48;48145;156;7;163
76;48;48146;909;33;942
76;48;48147;643;51;694
76;48;48148;505;27;532
76;48;48149;36;2;38
76;48;48150;188;14;202
76;48;48151;63;3;66
76;48;48152;267;5;272
76;48;48153;88;5;93
76;48;48155;465;6;471
76;48;48156;870;23;893
76;48;48157;107;4;111
76;48;48158;104;4;108
76;48;48160;156;7;163
76;48;48161;69;2;71
76;48;48163;114;3;117
76;48;48165;186;10;196
76;48;48166;289;11;300
76;48;48167;37;1;38
76;48;48168;190;5;195
76;48;48169;210;11;221
76;48;48170;198;5;203
76;48;48171;191;2;193
76;48;48173;230;3;233
76;48;48174;139;3;142
76;48;48175;176;10;186
76;48;48176;90;4;94
76;48;48177;322;9;331
76;48;48178;222;6;228
76;48;48179;113;2;115
76;48;48181;63;4;67
76;48;48182;58;2;60
76;48;48185;165;5;170
76;48;48187;101;1;102
76;48;48188;244;5;249
76;48;48190;215;8;223
76;48;48191;94;3;97
76;48;48192;92;2;94
76;48;48193;214;1;215
76;48;48194;424;48;472
76;48;48198;548;12;560
52;49;49002;2975;53;3028
52;49;49003;1752;37;1789
52;49;49007;155850;3080;158930
52;49;49008;931;25;956
52;49;49009;460;4;464
52;49;49010;319;5;324
52;49;49011;428;18;446
52;49;49012;368;11;379
52;49;49015;14443;357;14800
52;49;49017;604;6;610
52;49;49018;11829;261;12090
52;49;49020;5439;107;5546
52;49;49021;7229;154;7383
52;49;49022;1368;29;1397
52;49;49023;23419;716;24135
52;49;49026;2789;90;2879
52;49;49027;2107;42;2149
52;49;49028;125;6;131
52;49;49029;1293;28;1321
52;49;49030;975;32;1007
52;49;49035;6774;141;6915
52;49;49036;751;20;771
52;49;49038;240;5;245
52;49;49041;2039;35;2074
52;49;49045;600;14;614
52;49;49048;3084;41;3125
52;49;49050;10851;274;11125
52;49;49053;350;4;354
52;49;49054;2824;62;2886
52;49;49055;2317;35;2352
52;49;49056;263;6;269
52;49;49057;337;6;343
52;49;49058;877;9;886
52;49;49060;3482;80;3562
52;49;49061;797;19;816
52;49;49063;6518;175;6693
52;49;49064;397;12;409
52;49;49067;342;8;350
52;49;49068;1864;31;1895
52;49;49069;16429;277;16706
52;49;49070;694;10;704
52;49;49076;763;7;770
52;49;49080;8759;185;8944
52;49;49082;941;17;958
52;49;49086;3994;84;4078
52;49;49089;1053;28;1081
52;49;49090;974;12;986
52;49;49092;20828;604;21432
52;49;49099;54037;1942;55979
52;49;49100;469;17;486
52;49;49102;337;5;342
52;49;49107;467;16;483
52;49;49109;1580;30;1610
52;49;49110;1886;32;1918
52;49;49112;947;28;975
52;49;49113;519;9;528
52;49;49114;145;4;149
52;49;49120;1384;23;1407
52;49;49121;480;9;489
52;49;49123;1732;55;1787
52;49;49125;11119;257;11376
52;49;49127;3358;75;3433
52;49;49129;4394;58;4452
52;49;49130;667;7;674
52;49;49131;734;7;741
52;49;49132;1547;17;1564
52;49;49135;2192;38;2230
52;49;49138;2601;58;2659
52;49;49140;1528;25;1553
52;49;49155;1432;40;1472
52;49;49160;2665;58;2723
52;49;49161;334;6;340
52;49;49163;2752;28;2780
52;49;49167;4567;111;4678
52;49;49170;807;12;819
52;49;49171;123;0;123
52;49;49174;1315;21;1336
52;49;49176;5023;76;5099
52;49;49178;876;21;897
52;49;49180;6831;121;6952
52;49;49182;880;16;896
52;49;49183;4903;84;4987
52;49;49188;837;15;852
52;49;49192;3203;78;3281
52;49;49193;3820;90;3910
52;49;49194;5925;105;6030
52;49;49195;1256;29;1285
52;49;49200;6306;171;6477
52;49;49201;2049;35;2084
52;49;49205;973;11;984
52;49;49209;440;3;443
52;49;49211;1215;30;1245
52;49;49214;7632;150;7782
52;49;49215;3726;250;3976
52;49;49216;590;6;596
52;49;49217;775;10;785
52;49;49218;15668;317;15985
52;49;49219;431;6;437
52;49;49220;3666;56;3722
52;49;49221;820;23;843
52;49;49222;2013;45;2058
52;49;49223;5660;101;5761
52;49;49224;991;10;1001
52;49;49228;5546;167;5713
52;49;49231;1454;37;1491
52;49;49235;424;15;439
52;49;49236;125;5;130
52;49;49237;132;2;134
52;49;49240;997;31;1028
52;49;49241;2552;60;2612
52;49;49244;17924;475;18399
52;49;49246;12819;541;13360
52;49;49247;2447;42;2489
52;49;49248;8970;251;9221
52;49;49253;1186;21;1207
52;49;49257;1028;16;1044
52;49;49259;2323;59;2382
52;49;49260;1947;86;2033
52;49;49261;8570;169;8739
52;49;49262;652;9;661
52;49;49266;1227;29;1256
52;49;49267;9210;228;9438
52;49;49269;2794;60;2854
52;49;49271;2098;28;2126
52;49;49272;1086;20;1106
52;49;49278;3456;254;3710
52;49;49283;3665;39;3704
52;49;49284;1406;23;1429
52;49;49288;226;6;232
52;49;49291;376;5;381
52;49;49292;3411;48;3459
52;49;49294;2924;30;2954
52;49;49298;3694;63;3757
52;49;49299;3018;70;3088
52;49;49301;25162;553;25715
52;49;49302;451;5;456
52;49;49306;1661;36;1697
52;49;49307;15902;575;16477
52;49;49308;2127;54;2181
52;49;49310;597;19;616
52;49;49311;1323;28;1351
52;49;49321;387;8;395
52;49;49323;7520;297;7817
52;49;49326;812;19;831
52;49;49328;26467;982;27449
52;49;49329;1336;50;1386
52;49;49330;1180;18;1198
52;49;49331;17462;833;18295
52;49;49332;4192;112;4304
52;49;49333;2912;60;2972
52;49;49334;332;5;337
52;49;49336;883;16;899
52;49;49338;1428;28;1456
52;49;49339;1492;39;1531
52;49;49341;748;23;771
52;49;49343;3189;73;3262
52;49;49344;1235;25;1260
52;49;49345;5751;115;5866
52;49;49347;4432;73;4505
52;49;49352;1322;33;1355
52;49;49353;14961;168;15129
52;49;49355;3088;53;3141
52;49;49358;571;14;585
52;49;49359;577;15;592
52;49;49361;1829;37;1866
52;49;49362;1218;50;1268
52;49;49364;1131;22;1153
52;49;49367;5739;84;5823
52;49;49368;1993;39;2032
52;49;49369;1270;21;1291
52;49;49370;480;7;487
52;49;49371;1727;29;1756
52;49;49373;7789;177;7966
52;49;49374;1437;32;1469
52;49;49377;5651;94;5745
52;49;49378;2537;35;2572
52;49;49381;1813;30;1843
28;50;50002;4153;439;4592
28;50;50003;2796;95;2891
28;50;50004;549;3;552
28;50;50006;154;5;159
28;50;50008;443;18;461
28;50;50013;386;9;395
28;50;50015;651;13;664
28;50;50016;182;2;184
28;50;50019;419;6;425
28;50;50021;75;1;76
28;50;50022;112;3;115
28;50;50023;676;10;686
28;50;50024;170;3;173
28;50;50025;10264;555;10819
28;50;50026;80;1;81
28;50;50027;956;27;983
28;50;50028;101;3;104
28;50;50029;1175;65;1240
28;50;50030;559;8;567
28;50;50031;2239;56;2295
28;50;50032;1035;40;1075
28;50;50033;141;4;145
28;50;50034;544;18;562
28;50;50036;429;8;437
28;50;50038;426;11;437
28;50;50039;126;4;130
28;50;50040;123;6;129
28;50;50041;11173;336;11509
28;50;50042;433;5;438
28;50;50044;321;2;323
28;50;50045;608;23;631
28;50;50046;427;6;433
28;50;50048;556;9;565
28;50;50049;660;19;679
28;50;50050;138;0;138
28;50;50052;143;2;145
28;50;50054;191;4;195
28;50;50055;113;2;115
28;50;50058;1620;45;1665
28;50;50059;324;1;325
28;50;50060;436;8;444
28;50;50062;116;0;116
28;50;50064;178;7;185
28;50;50066;2367;79;2446
28;50;50069;345;12;357
28;50;50070;74;5;79
28;50;50072;212;6;218
28;50;50074;2139;146;2285
28;50;50076;3455;87;3542
28;50;50077;1037;44;1081
28;50;50078;408;7;415
28;50;50079;409;9;418
28;50;50081;771;29;800
28;50;50082;5826;150;5976
28;50;50083;600;7;607
28;50;50084;544;18;562
28;50;50085;1223;41;1264
28;50;50086;324;5;329
28;50;50087;2155;53;2208
28;50;50088;135;2;137
28;50;50090;611;10;621
28;50;50092;704;16;720
28;50;50093;419;5;424
28;50;50094;411;9;420
28;50;50095;1766;57;1823
28;50;50096;209;8;217
28;50;50097;121;2;123
28;50;50098;622;15;637
28;50;50099;10052;181;10233
28;50;50101;235;6;241
28;50;50102;748;16;764
28;50;50105;97;5;102
28;50;50106;268;2;270
28;50;50108;414;12;426
28;50;50109;1779;39;1818
28;50;50110;1036;19;1055
28;50;50111;1004;16;1020
28;50;50112;465;7;472
28;50;50115;383;11;394
28;50;50117;351;12;363
28;50;50118;328;6;334
28;50;50120;359;4;363
28;50;50121;244;4;248
28;50;50124;165;3;168
28;50;50126;133;7;140
28;50;50129;78549;2363;80912
28;50;50130;427;6;433
28;50;50135;226;3;229
28;50;50137;627;14;641
28;50;50138;550;10;560
28;50;50139;4044;161;4205
28;50;50142;1054;13;1067
28;50;50143;859;34;893
28;50;50144;540;5;545
28;50;50145;592;13;605
28;50;50146;235;2;237
28;50;50147;8408;1173;9581
28;50;50148;544;4;548
28;50;50149;1182;18;1200
28;50;50150;228;3;231
28;50;50151;2093;29;2122
28;50;50152;225;3;228
28;50;50155;298;13;311
28;50;50156;66;0;66
28;50;50158;280;9;289
28;50;50159;682;15;697
28;50;50161;599;9;608
28;50;50162;1598;44;1642
28;50;50164;1006;26;1032
28;50;50165;3109;74;3183
28;50;50166;327;15;342
28;50;50167;805;21;826
28;50;50168;2799;61;2860
28;50;50169;103;1;104
28;50;50172;350;8;358
28;50;50174;196;9;205
28;50;50175;196;8;204
28;50;50176;346;14;360
28;50;50177;372;6;378
28;50;50178;1263;24;1287
28;50;50181;330;8;338
28;50;50182;287;8;295
28;50;50183;346;6;352
28;50;50184;1766;22;1788
28;50;50185;1045;24;1069
28;50;50186;218;8;226
28;50;50188;1084;26;1110
28;50;50190;171;3;174
28;50;50192;130;0;130
28;50;50193;218;3;221
28;50;50194;370;8;378
28;50;50195;254;2;256
28;50;50196;488;20;508
28;50;50197;1956;25;1981
28;50;50198;471;11;482
28;50;50199;447;4;451
28;50;50200;807;8;815
28;50;50205;279;7;286
28;50;50207;175;2;177
28;50;50208;157;1;158
28;50;50209;1511;44;1555
28;50;50210;342;8;350
28;50;50214;275;6;281
28;50;50215;3229;88;3317
28;50;50216;805;91;896
28;50;50217;601;11;612
28;50;50218;12513;674;13187
28;50;50219;667;12;679
28;50;50221;59;2;61
28;50;50222;785;21;806
28;50;50225;143;1;144
28;50;50227;310;5;315
28;50;50228;1105;32;1137
28;50;50229;87;1;88
28;50;50230;883;34;917
28;50;50231;686;23;709
28;50;50232;473;18;491
28;50;50233;159;5;164
28;50;50234;77;0;77
28;50;50235;271;5;276
28;50;50236;3971;118;4089
28;50;50237;1258;25;1283
28;50;50238;457;6;463
28;50;50239;1788;45;1833
28;50;50240;547;8;555
28;50;50241;181;5;186
28;50;50243;499;16;515
28;50;50246;70;1;71
28;50;50247;188;5;193
28;50;50251;365;10;375
28;50;50252;908;16;924
28;50;50253;170;7;177
28;50;50256;3221;102;3323
28;50;50258;112;3;115
28;50;50259;641;26;667
28;50;50260;1689;41;1730
28;50;50261;169;2;171
28;50;50262;530;6;536
28;50;50263;364;10;374
28;50;50265;196;2;198
28;50;50266;413;10;423
28;50;50267;2236;55;2291
28;50;50268;249;5;254
28;50;50269;206;6;212
28;50;50270;399;12;411
28;50;50271;86;1;87
28;50;50272;1019;19;1038
28;50;50273;1412;20;1432
28;50;50274;1012;153;1165
28;50;50275;125;7;132
28;50;50276;583;19;602
28;50;50277;590;15;605
28;50;50278;283;6;289
28;50;50279;600;15;615
28;50;50281;772;19;791
28;50;50282;298;10;308
28;50;50283;74;1;75
28;50;50285;313;4;317
28;50;50288;1294;29;1323
28;50;50289;720;12;732
28;50;50290;324;7;331
28;50;50291;121;4;125
28;50;50292;2687;58;2745
28;50;50294;1305;38;1343
28;50;50295;143;2;145
28;50;50296;220;9;229
28;50;50297;1019;30;1049
28;50;50298;646;13;659
28;50;50299;220;7;227
28;50;50300;164;7;171
28;50;50302;286;7;293
28;50;50304;195;7;202
28;50;50305;733;18;751
28;50;50310;170;4;174
28;50;50311;226;8;234
28;50;50312;134;4;138
28;50;50315;248;8;256
28;50;50317;272;3;275
28;50;50321;499;21;520
28;50;50324;112;2;114
28;50;50326;235;1;236
28;50;50327;186;6;192
28;50;50328;776;14;790
28;50;50332;711;15;726
28;50;50334;276;3;279
28;50;50335;501;9;510
28;50;50336;227;3;230
28;50;50338;299;4;303
28;50;50340;189;4;193
28;50;50341;2106;104;2210
28;50;50342;802;27;829
28;50;50345;691;20;711
28;50;50347;234;4;238
28;50;50349;1374;35;1409
28;50;50350;519;9;528
28;50;50351;92;2;94
28;50;50352;334;7;341
28;50;50353;29;0;29
28;50;50356;804;20;824
28;50;50357;72;1;73
28;50;50359;2929;265;3194
28;50;50360;276;12;288
28;50;50361;241;5;246
28;50;50362;285;5;290
28;50;50363;1451;35;1486
28;50;50364;707;8;715
28;50;50365;489;10;499
28;50;50368;68;2;70
28;50;50369;819;25;844
28;50;50370;614;4;618
28;50;50371;407;12;419
28;50;50372;180;3;183
28;50;50373;89;4;93
28;50;50374;27;1;28
28;50;50376;388;13;401
28;50;50378;634;9;643
28;50;50379;159;3;162
28;50;50382;633;19;652
28;50;50384;221;3;224
28;50;50387;360;6;366
28;50;50388;1147;38;1185
28;50;50389;443;12;455
28;50;50390;154;3;157
28;50;50391;2643;92;2735
28;50;50393;2600;106;2706
28;50;50394;2256;31;2287
28;50;50395;271;4;275
28;50;50397;210;6;216
28;50;50398;201;2;203
28;50;50399;178;4;182
28;50;50400;3263;37;3300
28;50;50401;739;13;752
28;50;50402;3220;88;3308
28;50;50403;1432;37;1469
28;50;50405;239;8;247
28;50;50407;929;37;966
28;50;50408;569;13;582
28;50;50409;1924;210;2134
28;50;50410;4318;78;4396
28;50;50411;678;15;693
28;50;50412;2556;68;2624
28;50;50413;574;6;580
28;50;50417;1779;30;1809
28;50;50419;3199;65;3264
28;50;50420;865;23;888
28;50;50421;267;6;273
28;50;50422;193;0;193
28;50;50423;201;6;207
28;50;50425;1116;26;1142
28;50;50426;370;6;376
28;50;50428;513;4;517
28;50;50429;741;32;773
28;50;50430;39;3;42
28;50;50431;1072;12;1084
28;50;50433;1002;22;1024
28;50;50435;597;15;612
28;50;50436;1278;43;1321
28;50;50437;799;10;809
28;50;50442;250;6;256
28;50;50443;516;10;526
28;50;50444;2500;57;2557
28;50;50445;353;13;366
28;50;50446;544;13;557
28;50;50447;458;13;471
28;50;50448;661;17;678
28;50;50450;333;7;340
28;50;50451;127;2;129
28;50;50452;664;22;686
28;50;50453;785;18;803
28;50;50454;423;9;432
28;50;50455;961;20;981
28;50;50456;548;9;557
28;50;50457;196;5;201
28;50;50461;198;9;207
28;50;50462;369;8;377
28;50;50463;525;10;535
28;50;50464;632;5;637
28;50;50467;494;13;507
28;50;50468;770;15;785
28;50;50469;313;7;320
28;50;50471;284;11;295
28;50;50472;204;10;214
28;50;50473;390;7;397
28;50;50474;545;11;556
28;50;50475;955;46;1001
28;50;50476;225;1;226
28;50;50478;426;7;433
28;50;50479;110;4;114
28;50;50480;757;23;780
28;50;50481;900;18;918
28;50;50482;162;3;165
28;50;50483;955;28;983
28;50;50484;5850;332;6182
28;50;50486;619;9;628
28;50;50487;4907;109;5016
28;50;50488;638;5;643
28;50;50489;531;14;545
28;50;50490;354;9;363
28;50;50491;447;6;453
28;50;50492;2498;55;2553
28;50;50493;1443;37;1480
28;50;50495;75;5;80
28;50;50496;384;8;392
28;50;50498;798;26;824
28;50;50499;481;7;488
28;50;50500;654;12;666
28;50;50502;19050;913;19963
28;50;50504;206;1;207
28;50;50505;679;35;714
28;50;50506;482;4;486
28;50;50507;344;7;351
28;50;50509;712;18;730
28;50;50510;602;4;606
28;50;50511;128;4;132
28;50;50512;526;9;535
28;50;50513;176;3;179
28;50;50514;307;1;308
28;50;50517;172;5;177
28;50;50518;327;4;331
28;50;50519;567;8;575
28;50;50521;154;4;158
28;50;50522;255;7;262
28;50;50523;3076;51;3127
28;50;50525;328;1;329
28;50;50528;305;12;317
28;50;50529;81;2;83
28;50;50531;767;35;802
28;50;50532;4078;149;4227
28;50;50533;178;3;181
28;50;50535;921;26;947
28;50;50536;158;0;158
28;50;50537;414;19;433
28;50;50538;456;8;464
28;50;50539;1810;25;1835
28;50;50540;620;18;638
28;50;50541;1399;47;1446
28;50;50542;490;7;497
28;50;50543;1345;32;1377
28;50;50546;3247;68;3315
28;50;50548;121;3;124
28;50;50549;402;6;408
28;50;50550;3601;148;3749
28;50;50551;2088;40;2128
28;50;50552;331;6;337
28;50;50553;346;2;348
28;50;50554;1420;59;1479
28;50;50556;696;10;706
28;50;50562;1712;30;1742
28;50;50563;279;8;287
28;50;50564;1322;29;1351
28;50;50565;2815;58;2873
28;50;50567;880;22;902
28;50;50568;462;15;477
28;50;50569;450;8;458
28;50;50570;426;7;433
28;50;50571;34;1;35
28;50;50572;189;7;196
28;50;50574;271;11;282
28;50;50575;769;13;782
28;50;50576;952;31;983
28;50;50577;311;8;319
28;50;50578;79;1;80
28;50;50579;1421;29;1450
28;50;50580;465;9;474
28;50;50582;3156;64;3220
28;50;50584;407;6;413
28;50;50585;1154;27;1181
28;50;50587;17;1;18
28;50;50588;678;22;700
28;50;50589;289;12;301
28;50;50590;406;5;411
28;50;50591;1674;27;1701
28;50;50592;2277;44;2321
28;50;50593;588;8;596
28;50;50594;1041;23;1064
28;50;50596;338;12;350
28;50;50597;953;23;976
28;50;50598;270;3;273
28;50;50599;1569;44;1613
28;50;50601;4397;55;4452
28;50;50603;778;24;802
28;50;50604;755;13;768
28;50;50606;520;5;525
28;50;50607;391;6;397
28;50;50609;127;3;130
28;50;50610;209;6;215
28;50;50612;745;86;831
28;50;50613;402;9;411
28;50;50615;6822;266;7088
28;50;50616;1971;71;2042
28;50;50617;331;2;333
28;50;50618;244;11;255
28;50;50619;326;10;336
28;50;50621;72;0;72
28;50;50624;479;24;503
28;50;50626;377;8;385
28;50;50628;155;4;159
28;50;50629;737;4;741
28;50;50633;119;3;122
28;50;50634;84;1;85
28;50;50637;316;3;319
28;50;50639;3852;67;3919
28;50;50641;657;15;672
28;50;50643;783;24;807
28;50;50647;1135;43;1178
28;50;50648;1182;31;1213
44;51;51001;166;1;167
44;51;51002;1407;23;1430
44;51;51003;276;5;281
44;51;51004;117;4;121
44;51;51005;175;3;178
44;51;51006;147;4;151
44;51;51007;957;25;982
44;51;51008;218;6;224
44;51;51009;834;11;845
44;51;51010;139;4;143
44;51;51012;71;0;71
44;51;51013;99;5;104
44;51;51014;298;6;304
44;51;51015;112;1;113
44;51;51016;238;4;242
44;51;51017;325;6;331
44;51;51018;900;20;920
44;51;51019;253;8;261
44;51;51020;53;3;56
44;51;51022;188;5;193
44;51;51023;266;6;272
44;51;51025;1074;10;1084
44;51;51027;302;21;323
44;51;51028;1031;12;1043
44;51;51029;1754;160;1914
44;51;51030;5309;86;5395
44;51;51031;266;10;276
44;51;51032;427;5;432
44;51;51033;251;3;254
44;51;51034;20;0;20
44;51;51035;253;3;256
44;51;51036;507;7;514
44;51;51037;338;2;340
44;51;51038;183;6;189
44;51;51039;95;5;100
44;51;51040;250;3;253
44;51;51041;103;4;107
44;51;51042;386;8;394
44;51;51043;2352;28;2380
44;51;51044;796;16;812
44;51;51045;104;0;104
44;51;51046;995;15;1010
44;51;51047;44;3;47
44;51;51048;161;0;161
44;51;51049;576;4;580
44;51;51050;135;2;137
44;51;51051;221;2;223
44;51;51052;596;4;600
44;51;51053;76;7;83
44;51;51054;1281;14;1295
44;51;51055;7069;108;7177
44;51;51056;255;3;258
44;51;51057;76;2;78
44;51;51058;2978;70;3048
44;51;51059;361;6;367
44;51;51060;171;3;174
44;51;51061;119;2;121
44;51;51062;95;3;98
44;51;51063;164;2;166
44;51;51065;632;13;645
44;51;51066;330;3;333
44;51;51068;202;2;204
44;51;51069;118;1;119
44;51;51070;227;0;227
44;51;51071;194;7;201
44;51;51072;220;3;223
44;51;51073;223;3;226
44;51;51074;1773;27;1800
44;51;51075;1422;33;1455
44;51;51076;441;9;450
44;51;51077;182;4;186
44;51;51078;575;14;589
44;51;51079;867;23;890
44;51;51080;190;1;191
44;51;51081;320;5;325
44;51;51082;93;6;99
44;51;51083;81;3;84
44;51;51084;78;1;79
44;51;51085;378;3;381
44;51;51086;334;11;345
44;51;51087;217;8;225
44;51;51088;448;7;455
44;51;51089;72;4;76
44;51;51090;312;12;324
44;51;51091;134;7;141
44;51;51092;357;4;361
44;51;51093;445;14;459
44;51;51094;177;7;184
44;51;51095;94;3;97
44;51;51097;175;4;179
44;51;51098;136;4;140
44;51;51099;322;9;331
44;51;51100;107;2;109
44;51;51101;689;8;697
44;51;51102;469;10;479
44;51;51103;140;1;141
44;51;51104;138;4;142
44;51;51105;1438;25;1463
44;51;51106;125;5;130
44;51;51107;336;3;339
44;51;51108;44379;1246;45625
44;51;51109;188;2;190
44;51;51110;55;1;56
44;51;51111;147;8;155
44;51;51112;430;6;436
44;51;51113;122;2;124
44;51;51115;568;3;571
44;51;51116;279;4;283
44;51;51117;319;8;327
44;51;51118;1573;25;1598
44;51;51119;512;7;519
44;51;51120;155;0;155
44;51;51121;250;3;253
44;51;51122;117;5;122
44;51;51124;47;3;50
44;51;51125;51;1;52
44;51;51126;47;3;50
44;51;51127;87;2;89
44;51;51128;54;2;56
44;51;51129;249;9;258
44;51;51130;231;5;236
44;51;51132;117;0;117
44;51;51133;63;0;63
44;51;51134;245;8;253
44;51;51135;78;0;78
44;51;51136;638;16;654
44;51;51137;223;3;226
44;51;51138;35;2;37
44;51;51139;316;13;329
44;51;51140;390;2;392
44;51;51141;778;15;793
44;51;51142;333;11;344
44;51;51143;56;0;56
44;51;51144;604;10;614
44;51;51145;225;6;231
44;51;51146;105;4;109
44;51;51147;330;13;343
44;51;51148;157;2;159
44;51;51149;440;13;453
44;51;51150;82;1;83
44;51;51151;174;3;177
44;51;51152;540;13;553
44;51;51153;1022;31;1053
44;51;51154;213;3;216
44;51;51155;612;10;622
44;51;51156;124;1;125
44;51;51157;72;1;73
44;51;51158;567;11;578
44;51;51160;1376;46;1422
44;51;51161;768;14;782
44;51;51162;636;7;643
44;51;51163;268;2;270
44;51;51164;148;3;151
44;51;51165;1036;30;1066
44;51;51166;68;2;70
44;51;51167;148;3;151
44;51;51168;220;8;228
44;51;51169;95;5;100
44;51;51170;111;2;113
44;51;51171;1487;26;1513
44;51;51172;6458;92;6550
44;51;51173;124;1;125
44;51;51174;62;0;62
44;51;51175;210;7;217
44;51;51176;151;7;158
44;51;51177;205;4;209
44;51;51178;80;2;82
44;51;51179;164;0;164
44;51;51181;395;11;406
44;51;51182;93;3;96
44;51;51183;1210;19;1229
44;51;51184;392;13;405
44;51;51185;299;1;300
44;51;51186;47;0;47
44;51;51187;283;4;287
44;51;51188;213;8;221
44;51;51190;68;0;68
44;51;51191;60;1;61
44;51;51192;347;5;352
44;51;51193;2382;91;2473
44;51;51194;460;6;466
44;51;51195;823;23;846
44;51;51196;880;13;893
44;51;51197;79;2;81
44;51;51198;668;6;674
44;51;51199;408;6;414
44;51;51200;369;12;381
44;51;51201;126;4;130
44;51;51202;749;12;761
44;51;51203;223;2;225
44;51;51204;1377;25;1402
44;51;51205;272;4;276
44;51;51206;113;2;115
44;51;51208;110;2;112
44;51;51210;1496;34;1530
44;51;51211;68;0;68
44;51;51212;155;1;156
44;51;51213;60;2;62
44;51;51214;138;8;146
44;51;51215;127;3;130
44;51;51216;263;4;267
44;51;51217;2918;43;2961
44;51;51218;130;1;131
44;51;51219;223;1;224
44;51;51220;140;1;141
44;51;51222;95;3;98
44;51;51223;56;1;57
44;51;51224;170;2;172
44;51;51225;305;2;307
44;51;51226;55;1;56
44;51;51227;488;21;509
44;51;51228;84;0;84
44;51;51229;120;6;126
44;51;51230;22433;468;22901
44;51;51231;654;15;669
44;51;51232;415;6;421
44;51;51233;69;3;72
44;51;51234;618;11;629
44;51;51235;246;10;256
44;51;51236;139;3;142
44;51;51237;1820;30;1850
44;51;51238;490;8;498
44;51;51239;105;1;106
44;51;51240;127;3;130
44;51;51241;81;1;82
44;51;51242;4843;108;4951
44;51;51243;308;8;316
44;51;51244;241;8;249
44;51;51245;573;10;583
44;51;51246;222;6;228
44;51;51247;143;3;146
44;51;51248;2162;41;2203
44;51;51249;389;5;394
44;51;51250;5589;51;5640
44;51;51251;170;5;175
44;51;51252;518;8;526
44;51;51253;228;5;233
44;51;51254;232;2;234
44;51;51255;13;0;13
44;51;51256;340;8;348
44;51;51258;209;13;222
44;51;51259;196;7;203
44;51;51260;76;3;79
44;51;51262;1816;33;1849
44;51;51263;380;7;387
44;51;51264;512;15;527
44;51;51265;590;12;602
44;51;51266;530;16;546
44;51;51267;176;2;178
44;51;51268;178;4;182
44;51;51269;274;1;275
44;51;51270;237;5;242
44;51;51272;456;5;461
44;51;51273;70;4;74
44;51;51274;117;3;120
44;51;51275;188;3;191
44;51;51276;145;7;152
44;51;51277;272;2;274
44;51;51278;275;5;280
44;51;51279;184;4;188
44;51;51280;25;0;25
44;51;51281;619;11;630
44;51;51282;1796;45;1841
44;51;51283;147;6;153
44;51;51284;304;1;305
44;51;51285;139;5;144
44;51;51286;237;8;245
44;51;51287;675;15;690
44;51;51288;238;8;246
44;51;51289;435;9;444
44;51;51290;288;6;294
44;51;51291;1391;31;1422
44;51;51292;127;4;131
44;51;51293;478;7;485
44;51;51294;78;1;79
44;51;51295;304;2;306
44;51;51296;78;1;79
44;51;51298;428;3;431
44;51;51299;928;15;943
44;51;51300;95;2;97
44;51;51301;109;8;117
44;51;51302;95;1;96
44;51;51303;552;10;562
44;51;51304;171;4;175
44;51;51305;126;2;128
44;51;51306;103;3;106
44;51;51307;222;3;225
44;51;51308;1857;53;1910
44;51;51309;113;4;117
44;51;51310;227;2;229
44;51;51311;208;2;210
44;51;51312;938;29;967
44;51;51313;323;5;328
44;51;51314;225;3;228
44;51;51315;146;2;148
44;51;51316;273;5;278
44;51;51317;54;0;54
44;51;51318;571;16;587
44;51;51319;100;3;103
44;51;51320;310;8;318
44;51;51321;81;3;84
44;51;51322;124;1;125
44;51;51323;105;6;111
44;51;51324;114;0;114
44;51;51325;113;2;115
44;51;51326;1091;14;1105
44;51;51327;180;2;182
44;51;51328;1104;24;1128
44;51;51329;1348;18;1366
44;51;51333;674;7;681
44;51;51334;472;11;483
44;51;51336;58;1;59
44;51;51337;271;3;274
44;51;51338;640;16;656
44;51;51339;557;15;572
44;51;51340;539;14;553
44;51;51341;34;2;36
44;51;51342;246;7;253
44;51;51343;628;21;649
44;51;51344;1480;20;1500
44;51;51345;284;2;286
44;51;51346;1157;18;1175
44;51;51348;116;1;117
44;51;51349;173;4;177
44;51;51350;125;5;130
44;51;51351;108;1;109
44;51;51352;876;18;894
44;51;51353;47;1;48
44;51;51354;283;9;292
44;51;51355;52;0;52
44;51;51356;151;5;156
44;51;51357;612;13;625
44;51;51358;584;10;594
44;51;51359;207;3;210
44;51;51360;294;2;296
44;51;51361;167;1;168
44;51;51362;603;19;622
44;51;51363;254;7;261
44;51;51364;66;1;67
44;51;51365;876;21;897
44;51;51367;1055;36;1091
44;51;51368;50;3;53
44;51;51369;314;14;328
44;51;51370;193;10;203
44;51;51371;62;1;63
44;51;51372;528;9;537
44;51;51373;92;4;96
44;51;51374;26;0;26
44;51;51375;319;5;324
44;51;51376;151;3;154
44;51;51377;47;0;47
44;51;51378;348;5;353
44;51;51379;510;8;518
44;51;51380;3571;49;3620
44;51;51381;613;11;624
44;51;51382;119;4;123
44;51;51384;408;7;415
44;51;51386;136;3;139
44;51;51387;297;3;300
44;51;51388;5150;49;5199
44;51;51389;813;8;821
44;51;51390;783;10;793
44;51;51391;2119;65;2184
44;51;51392;189;5;194
44;51;51393;293;7;300
44;51;51395;98;1;99
44;51;51396;143;3;146
44;51;51397;139;2;141
44;51;51398;185;2;187
44;51;51399;544;9;553
44;51;51402;266;7;273
44;51;51403;524;5;529
44;51;51404;107;4;111
44;51;51406;152;1;153
44;51;51407;420;5;425
44;51;51409;367;10;377
44;51;51410;652;10;662
44;51;51412;60;2;62
44;51;51413;871;18;889
44;51;51414;150;5;155
44;51;51415;205;0;205
44;51;51416;550;3;553
44;51;51417;378;5;383
44;51;51418;446;3;449
44;51;51419;129;2;131
44;51;51420;82;0;82
44;51;51421;99;3;102
44;51;51422;475;10;485
44;51;51423;1766;14;1780
44;51;51424;207;1;208
44;51;51425;383;14;397
44;51;51426;66;3;69
44;51;51428;495;7;502
44;51;51429;205;3;208
44;51;51430;86;2;88
44;51;51431;1198;19;1217
44;51;51432;836;19;855
44;51;51433;256;3;259
44;51;51434;740;21;761
44;51;51435;178;2;180
44;51;51436;924;18;942
44;51;51437;95;0;95
44;51;51438;69;1;70
44;51;51439;465;8;473
44;51;51440;1745;17;1762
44;51;51441;106;1;107
44;51;51442;137;0;137
44;51;51443;121;3;124
44;51;51444;506;8;514
44;51;51445;202;1;203
44;51;51446;434;8;442
44;51;51447;486;13;499
44;51;51448;555;10;565
44;51;51449;1028;16;1044
44;51;51450;426;8;434
44;51;51451;90;5;95
44;51;51452;33;0;33
44;51;51453;1033;30;1063
44;51;51454;181194;2920;184114
44;51;51455;223;3;226
44;51;51456;60;1;61
44;51;51457;280;18;298
44;51;51458;63;0;63
44;51;51459;110;1;111
44;51;51460;195;5;200
44;51;51461;1020;22;1042
44;51;51463;168;4;172
44;51;51464;309;17;326
44;51;51465;163;2;165
44;51;51466;217;5;222
44;51;51468;363;10;373
44;51;51469;111;5;116
44;51;51470;4;0;4
44;51;51471;376;3;379
44;51;51472;1033;17;1050
44;51;51473;104;6;110
44;51;51474;3417;40;3457
44;51;51475;61;1;62
44;51;51476;819;13;832
44;51;51477;330;4;334
44;51;51478;424;12;436
44;51;51479;242;5;247
44;51;51480;138;3;141
44;51;51482;681;13;694
44;51;51483;536;7;543
44;51;51484;279;4;283
44;51;51485;346;6;352
44;51;51486;373;4;377
44;51;51487;342;6;348
44;51;51488;317;34;351
44;51;51489;32;3;35
44;51;51490;203;2;205
44;51;51491;89;3;92
44;51;51492;1426;38;1464
44;51;51493;109;3;112
44;51;51495;78;0;78
44;51;51496;268;5;273
44;51;51497;44;0;44
44;51;51498;63;1;64
44;51;51499;161;7;168
44;51;51500;118;0;118
44;51;51501;195;8;203
44;51;51502;114;0;114
44;51;51503;85;1;86
44;51;51504;804;31;835
44;51;51505;486;4;490
44;51;51506;5474;78;5552
44;51;51507;4165;116;4281
44;51;51508;204;6;210
44;51;51509;307;8;315
44;51;51510;129;0;129
44;51;51511;119;2;121
44;51;51512;102;2;104
44;51;51513;525;6;531
44;51;51514;106;2;108
44;51;51515;338;8;346
44;51;51516;51;0;51
44;51;51517;120;4;124
44;51;51518;616;24;640
44;51;51519;39;2;41
44;51;51520;77;1;78
44;51;51521;226;3;229
44;51;51522;419;4;423
44;51;51523;269;4;273
44;51;51524;304;6;310
44;51;51525;2037;86;2123
44;51;51526;386;10;396
44;51;51527;272;4;276
44;51;51528;130;0;130
44;51;51529;417;1;418
44;51;51530;671;12;683
44;51;51531;1789;32;1821
44;51;51532;568;14;582
44;51;51533;106;0;106
44;51;51534;207;4;211
44;51;51535;4772;108;4880
44;51;51536;1796;39;1835
44;51;51537;179;4;183
44;51;51538;111;0;111
44;51;51539;71;0;71
44;51;51542;190;0;190
44;51;51543;71;7;78
44;51;51544;639;19;658
44;51;51545;502;16;518
44;51;51546;506;147;653
44;51;51547;140;2;142
44;51;51548;363;262;625
44;51;51549;121;3;124
44;51;51550;270;11;281
44;51;51551;199;6;205
44;51;51552;265;4;269
44;51;51553;240;5;245
44;51;51555;166;0;166
44;51;51556;292;5;297
44;51;51557;466;9;475
44;51;51558;141;3;144
44;51;51559;3864;49;3913
44;51;51560;109;3;112
44;51;51562;2183;36;2219
44;51;51563;106;2;108
44;51;51564;607;16;623
44;51;51565;102;0;102
44;51;51566;295;2;297
44;51;51567;527;6;533
44;51;51568;301;6;307
44;51;51569;508;70;578
44;51;51570;105;2;107
44;51;51571;916;10;926
44;51;51572;233;11;244
44;51;51573;10294;139;10433
44;51;51574;138;2;140
44;51;51576;1384;13;1397
44;51;51577;151;3;154
44;51;51578;87;1;88
44;51;51579;177;3;180
44;51;51580;436;5;441
44;51;51581;246;1;247
44;51;51582;542;9;551
44;51;51583;190;5;195
44;51;51584;147;2;149
44;51;51585;794;62;856
44;51;51586;177;5;182
44;51;51587;232;5;237
44;51;51588;303;5;308
44;51;51589;174;1;175
44;51;51590;366;9;375
44;51;51591;176;3;179
44;51;51592;298;6;304
44;51;51594;65;1;66
44;51;51595;155;2;157
44;51;51596;367;10;377
44;51;51597;336;7;343
44;51;51598;485;21;506
44;51;51599;323;5;328
44;51;51600;98;1;99
44;51;51601;158;3;161
44;51;51602;65;0;65
44;51;51603;205;2;207
44;51;51604;258;3;261
44;51;51605;528;10;538
44;51;51607;206;2;208
44;51;51608;86;5;91
44;51;51609;846;20;866
44;51;51610;391;6;397
44;51;51611;286;4;290
44;51;51612;3332;176;3508
44;51;51613;1047;8;1055
44;51;51614;961;23;984
44;51;51616;233;3;236
44;51;51617;605;11;616
44;51;51618;190;3;193
44;51;51619;113;3;116
44;51;51620;173;7;180
44;51;51621;517;10;527
44;51;51622;401;9;410
44;51;51623;281;46;327
44;51;51624;648;6;654
44;51;51625;283;3;286
44;51;51626;118;4;122
44;51;51627;323;11;334
44;51;51628;122;5;127
44;51;51629;912;23;935
44;51;51630;330;5;335
44;51;51631;246;6;252
44;51;51632;237;6;243
44;51;51633;296;15;311
44;51;51634;264;8;272
44;51;51635;110;1;111
44;51;51636;501;12;513
44;51;51637;212;3;215
44;51;51638;207;6;213
44;51;51639;43;1;44
44;51;51640;213;1;214
44;51;51641;203;5;208
44;51;51642;111;4;115
44;51;51643;549;5;554
44;51;51644;308;10;318
44;51;51645;110;2;112
44;51;51646;82;3;85
44;51;51647;830;24;854
44;51;51648;382;9;391
44;51;51649;11376;251;11627
44;51;51650;46;1;47
44;51;51652;58;0;58
44;51;51654;258;2;260
44;51;51655;291;5;296
44;51;51656;454;18;472
44;51;51657;247;0;247
44;51;51658;104;0;104
44;51;51659;47;1;48
44;51;51660;2591;28;2619
44;51;51662;4971;74;5045
44;51;51663;1697;15;1712
44;52;52001;312;8;320
44;52;52002;23;0;23
44;52;52003;150;2;152
44;52;52004;13;0;13
44;52;52005;34;4;38
44;52;52006;355;4;359
44;52;52007;87;2;89
44;52;52008;867;10;877
44;52;52009;105;1;106
44;52;52011;91;0;91
44;52;52012;30;2;32
44;52;52013;124;2;126
44;52;52014;187;5;192
44;52;52015;86;0;86
44;52;52016;68;2;70
44;52;52017;729;14;743
44;52;52019;90;4;94
44;52;52021;267;4;271
44;52;52022;185;3;188
44;52;52023;155;5;160
44;52;52025;87;2;89
44;52;52027;73;2;75
44;52;52028;54;0;54
44;52;52029;138;4;142
44;52;52030;56;4;60
44;52;52031;371;9;380
44;52;52033;108;4;112
44;52;52034;143;5;148
44;52;52035;186;3;189
44;52;52037;370;3;373
44;52;52038;64;0;64
44;52;52039;89;0;89
44;52;52040;54;1;55
44;52;52042;107;1;108
44;52;52043;58;2;60
44;52;52044;553;11;564
44;52;52045;1792;39;1831
44;52;52047;103;0;103
44;52;52050;1340;31;1371
44;52;52051;85;4;89
44;52;52053;73;1;74
44;52;52055;115;2;117
44;52;52056;187;6;193
44;52;52057;104;4;108
44;52;52058;1851;27;1878
44;52;52059;141;0;141
44;52;52060;1977;53;2030
44;52;52061;291;2;293
44;52;52062;160;4;164
44;52;52063;99;1;100
44;52;52064;781;34;815
44;52;52065;65;1;66
44;52;52066;63;3;66
44;52;52067;75;0;75
44;52;52069;144;1;145
44;52;52070;123;3;126
44;52;52072;379;10;389
44;52;52074;673;20;693
44;52;52075;177;6;183
44;52;52076;448;14;462
44;52;52079;659;10;669
44;52;52082;155;5;160
44;52;52083;737;14;751
44;52;52084;42;0;42
44;52;52085;26;2;28
44;52;52087;197;20;217
44;52;52088;645;21;666
44;52;52089;76;0;76
44;52;52090;102;1;103
44;52;52091;85;7;92
44;52;52092;105;2;107
44;52;52093;2429;42;2471
44;52;52094;178;2;180
44;52;52095;190;2;192
44;52;52097;49;1;50
44;52;52099;798;10;808
44;52;52101;41;1;42
44;52;52102;422;13;435
44;52;52103;113;2;115
44;52;52104;1045;23;1068
44;52;52105;300;11;311
44;52;52106;122;2;124
44;52;52107;226;5;231
44;52;52108;146;4;150
44;52;52109;7;0;7
44;52;52110;153;6;159
44;52;52113;261;2;263
44;52;52114;1579;17;1596
44;52;52115;99;2;101
44;52;52116;49;2;51
44;52;52118;279;6;285
44;52;52119;345;9;354
44;52;52120;189;7;196
44;52;52121;21847;1195;23042
44;52;52122;116;1;117
44;52;52123;1297;21;1318
44;52;52124;76;0;76
44;52;52125;1042;172;1214
44;52;52126;159;4;163
44;52;52127;78;4;82
44;52;52128;145;3;148
44;52;52129;121;1;122
44;52;52130;189;1;190
44;52;52131;74;1;75
44;52;52132;168;3;171
44;52;52133;71;0;71
44;52;52134;223;1;224
44;52;52135;88;0;88
44;52;52136;111;0;111
44;52;52137;22;0;22
44;52;52138;63;1;64
44;52;52140;706;22;728
44;52;52141;298;6;304
44;52;52142;72;1;73
44;52;52145;118;5;123
44;52;52146;155;3;158
44;52;52147;89;0;89
44;52;52149;93;2;95
44;52;52151;148;2;150
44;52;52155;513;12;525
44;52;52156;407;7;414
44;52;52157;12;1;13
44;52;52158;282;4;286
44;52;52159;26;1;27
44;52;52160;64;2;66
44;52;52161;72;0;72
44;52;52162;197;2;199
44;52;52163;384;4;388
44;52;52164;197;5;202
44;52;52165;194;5;199
44;52;52167;262;3;265
44;52;52168;60;3;63
44;52;52169;78;2;80
44;52;52170;166;7;173
44;52;52171;243;3;246
44;52;52172;280;7;287
44;52;52173;77;2;79
44;52;52174;37;1;38
44;52;52175;390;4;394
44;52;52177;790;34;824
44;52;52178;362;10;372
44;52;52179;20;2;22
44;52;52181;91;2;93
44;52;52182;2017;46;2063
44;52;52183;39;1;40
44;52;52184;59;5;64
44;52;52185;61;1;62
44;52;52187;159;4;163
44;52;52189;400;11;411
44;52;52190;286;5;291
44;52;52193;302;13;315
44;52;52194;2033;33;2066
44;52;52195;37;0;37
44;52;52196;96;4;100
44;52;52197;1298;96;1394
44;52;52198;70;3;73
44;52;52199;50;2;52
44;52;52200;77;5;82
44;52;52201;69;0;69
44;52;52203;146;2;148
44;52;52204;63;4;67
44;52;52205;687;17;704
44;52;52206;154;4;158
44;52;52207;99;4;103
44;52;52208;146;2;148
44;52;52211;1449;23;1472
44;52;52212;308;3;311
44;52;52213;131;6;137
44;52;52214;31;1;32
44;52;52216;47;1;48
44;52;52217;87;4;91
44;52;52218;48;0;48
44;52;52219;18;0;18
44;52;52220;142;1;143
44;52;52221;118;4;122
44;52;52222;35;0;35
44;52;52223;65;3;68
44;52;52227;215;10;225
44;52;52228;78;1;79
44;52;52229;151;2;153
44;52;52230;281;5;286
44;52;52231;91;2;93
44;52;52232;62;0;62
44;52;52233;104;2;106
44;52;52234;41;0;41
44;52;52235;260;4;264
44;52;52237;278;10;288
44;52;52240;193;7;200
44;52;52242;962;16;978
44;52;52243;120;1;121
44;52;52244;761;10;771
44;52;52245;62;5;67
44;52;52246;579;12;591
44;52;52247;207;8;215
44;52;52248;545;17;562
44;52;52249;147;6;153
44;52;52250;3015;68;3083
44;52;52251;995;35;1030
44;52;52253;212;3;215
44;52;52254;85;3;88
44;52;52256;75;4;79
44;52;52257;105;2;107
44;52;52258;311;2;313
44;52;52260;123;3;126
44;52;52264;61;2;63
44;52;52265;1298;28;1326
44;52;52266;66;0;66
44;52;52267;216;3;219
44;52;52269;7668;396;8064
44;52;52271;197;6;203
44;52;52272;114;2;116
44;52;52273;121;1;122
44;52;52274;291;9;300
44;52;52275;69;0;69
44;52;52276;223;7;230
44;52;52277;59;1;60
44;52;52278;71;0;71
44;52;52280;199;3;202
44;52;52282;340;5;345
44;52;52284;94;1;95
44;52;52285;78;2;80
44;52;52286;77;0;77
44;52;52287;88;1;89
44;52;52288;121;0;121
44;52;52289;315;8;323
44;52;52290;132;2;134
44;52;52291;62;0;62
44;52;52292;722;18;740
44;52;52294;696;13;709
44;52;52295;94;0;94
44;52;52297;273;11;284
44;52;52298;73;1;74
44;52;52300;163;2;165
44;52;52301;61;1;62
44;52;52302;189;3;192
44;52;52303;95;1;96
44;52;52304;52;1;53
44;52;52305;553;5;558
44;52;52306;444;9;453
44;52;52307;214;4;218
44;52;52308;403;4;407
44;52;52310;99;2;101
44;52;52311;224;4;228
44;52;52312;53;3;56
44;52;52313;143;1;144
44;52;52315;336;1;337
44;52;52316;69;2;71
44;52;52318;245;6;251
44;52;52319;71;0;71
44;52;52320;94;3;97
44;52;52321;179;7;186
44;52;52322;132;4;136
44;52;52325;117;5;122
44;52;52326;43;0;43
44;52;52327;444;10;454
44;52;52328;32;1;33
44;52;52330;68;2;70
44;52;52331;2282;65;2347
44;52;52332;1832;54;1886
44;52;52335;120;1;121
44;52;52336;147;3;150
44;52;52337;59;0;59
44;52;52341;131;2;133
44;52;52342;27;1;28
44;52;52344;31;1;32
44;52;52346;381;6;387
44;52;52347;237;5;242
44;52;52348;580;19;599
44;52;52349;307;9;316
44;52;52350;68;0;68
44;52;52352;68;4;72
44;52;52353;3591;61;3652
44;52;52354;84;0;84
44;52;52355;151;4;155
44;52;52356;108;4;112
44;52;52357;177;2;179
44;52;52358;90;0;90
44;52;52359;150;3;153
44;52;52360;165;3;168
44;52;52362;136;2;138
44;52;52363;98;7;105
44;52;52364;102;3;105
44;52;52365;345;3;348
44;52;52366;77;1;78
44;52;52367;41;1;42
44;52;52369;70;0;70
44;52;52370;255;5;260
44;52;52371;139;2;141
44;52;52372;84;6;90
44;52;52373;33;1;34
44;52;52374;276;5;281
44;52;52375;55;0;55
44;52;52376;106;3;109
44;52;52377;288;8;296
44;52;52378;46;2;48
44;52;52380;382;4;386
44;52;52383;292;7;299
44;52;52384;112;0;112
44;52;52385;30;2;32
44;52;52386;515;4;519
44;52;52388;149;2;151
44;52;52390;56;1;57
44;52;52391;306;8;314
44;52;52392;115;2;117
44;52;52393;55;0;55
44;52;52394;213;9;222
44;52;52395;55;0;55
44;52;52396;140;3;143
44;52;52397;71;1;72
44;52;52398;632;14;646
44;52;52399;105;7;112
44;52;52400;155;0;155
44;52;52401;367;12;379
44;52;52403;78;1;79
44;52;52405;1188;22;1210
44;52;52406;198;5;203
44;52;52407;281;7;288
44;52;52411;1329;47;1376
44;52;52413;106;2;108
44;52;52414;770;12;782
44;52;52415;115;0;115
44;52;52416;63;1;64
44;52;52419;131;5;136
44;52;52420;126;1;127
44;52;52421;477;9;486
44;52;52422;262;5;267
44;52;52423;671;8;679
44;52;52424;69;0;69
44;52;52425;196;4;200
44;52;52426;128;1;129
44;52;52428;64;1;65
44;52;52429;556;3;559
44;52;52431;168;2;170
44;52;52432;1413;30;1443
44;52;52433;91;1;92
44;52;52436;49;1;50
44;52;52437;25;0;25
44;52;52438;104;2;106
44;52;52439;76;1;77
44;52;52440;375;7;382
44;52;52442;343;10;353
44;52;52443;33;0;33
44;52;52444;352;10;362
44;52;52445;69;2;71
44;52;52446;233;4;237
44;52;52447;183;2;185
44;52;52448;22928;499;23427
44;52;52449;1116;32;1148
44;52;52450;129;4;133
44;52;52452;109;0;109
44;52;52453;132;1;133
44;52;52455;236;6;242
44;52;52456;638;10;648
44;52;52457;172;3;175
44;52;52459;113;1;114
44;52;52461;380;10;390
44;52;52463;45;2;47
44;52;52464;48;2;50
44;52;52465;130;0;130
44;52;52467;59;2;61
44;52;52468;110;4;114
44;52;52469;741;16;757
44;52;52470;369;13;382
44;52;52472;141;0;141
44;52;52473;90;1;91
44;52;52474;36;0;36
44;52;52475;60;6;66
44;52;52476;81;3;84
44;52;52479;664;18;682
44;52;52480;362;8;370
44;52;52482;97;2;99
44;52;52483;68;1;69
44;52;52484;360;15;375
44;52;52486;64;0;64
44;52;52487;70;3;73
44;52;52488;271;0;271
44;52;52489;35;1;36
44;52;52490;682;21;703
44;52;52491;116;5;121
44;52;52492;554;14;568
44;52;52493;30;0;30
44;52;52494;221;9;230
44;52;52495;85;1;86
44;52;52497;433;9;442
44;52;52499;43;0;43
44;52;52500;622;9;631
44;52;52502;65;0;65
44;52;52503;25;0;25
44;52;52504;261;4;265
44;52;52505;35;0;35
44;52;52506;96;3;99
44;52;52507;56;0;56
44;52;52510;372;7;379
44;52;52511;56;2;58
44;52;52512;512;15;527
44;52;52513;62;1;63
44;52;52514;342;11;353
44;52;52515;103;4;107
44;52;52516;49;4;53
44;52;52517;134;1;135
44;52;52518;101;2;103
44;52;52519;46;0;46
44;52;52520;149;7;156
44;52;52522;339;10;349
44;52;52523;67;4;71
44;52;52524;233;0;233
44;52;52525;69;1;70
44;52;52526;79;1;80
44;52;52528;146;1;147
44;52;52529;983;18;1001
44;52;52534;1498;36;1534
44;52;52535;714;11;725
44;52;52536;45;0;45
44;52;52538;263;2;265
44;52;52539;67;0;67
44;52;52540;22;0;22
44;52;52541;204;4;208
44;52;52542;52;1;53
44;52;52543;516;10;526
44;52;52544;277;2;279
44;52;52545;107;2;109
44;52;52546;15;0;15
44;52;52547;202;1;203
44;52;52548;92;2;94
44;52;52549;27;0;27
44;52;52550;2819;110;2929
52;53;53001;1831;59;1890
52;53;53002;606;9;615
52;53;53003;2639;69;2708
52;53;53005;2319;50;2369
52;53;53007;2825;75;2900
52;53;53008;1819;50;1869
52;53;53009;659;14;673
52;53;53010;460;13;473
52;53;53011;879;19;898
52;53;53012;476;26;502
52;53;53013;564;16;580
52;53;53015;1923;44;1967
52;53;53016;1224;14;1238
52;53;53017;956;27;983
52;53;53018;1298;32;1330
52;53;53019;118;3;121
52;53;53021;1047;28;1075
52;53;53022;516;10;526
52;53;53023;561;6;567
52;53;53025;1096;12;1108
52;53;53026;529;9;538
52;53;53027;203;3;206
52;53;53028;585;12;597
52;53;53029;1252;32;1284
52;53;53030;325;4;329
52;53;53031;496;2;498
52;53;53033;115;5;120
52;53;53034;6137;193;6330
52;53;53035;587;9;596
52;53;53036;1065;20;1085
52;53;53037;729;26;755
52;53;53038;143;4;147
52;53;53039;1736;36;1772
52;53;53040;630;12;642
52;53;53041;277;5;282
52;53;53042;844;12;856
52;53;53043;554;11;565
52;53;53045;682;18;700
52;53;53046;307;3;310
52;53;53047;269;4;273
52;53;53048;1155;34;1189
52;53;53049;711;8;719
52;53;53051;600;6;606
52;53;53052;293;7;300
52;53;53053;505;21;526
52;53;53054;6209;198;6407
52;53;53055;606;15;621
52;53;53056;983;26;1009
52;53;53057;507;10;517
52;53;53058;336;13;349
52;53;53059;413;6;419
52;53;53061;464;6;470
52;53;53062;16950;666;17616
52;53;53063;455;14;469
52;53;53064;979;24;1003
52;53;53066;1381;32;1413
52;53;53067;395;12;407
52;53;53068;155;1;156
52;53;53069;160;5;165
52;53;53071;484;22;506
52;53;53072;1253;28;1281
52;53;53073;887;23;910
52;53;53074;842;35;877
52;53;53075;275;7;282
52;53;53076;329;11;340
52;53;53077;3199;77;3276
52;53;53078;852;16;868
52;53;53079;378;11;389
52;53;53080;133;2;135
52;53;53082;640;13;653
52;53;53083;854;29;883
52;53;53084;4486;178;4664
52;53;53085;194;2;196
52;53;53086;652;12;664
52;53;53087;210;4;214
52;53;53088;842;29;871
52;53;53089;509;5;514
52;53;53090;159;5;164
52;53;53091;456;15;471
52;53;53093;272;5;277
52;53;53094;2255;41;2296
52;53;53096;5717;96;5813
52;53;53097;8614;229;8843
52;53;53098;432;9;441
52;53;53099;1096;33;1129
52;53;53100;1176;15;1191
52;53;53101;836;11;847
52;53;53102;168;2;170
52;53;53103;2134;58;2192
52;53;53104;1330;23;1353
52;53;53105;230;5;235
52;53;53106;509;11;520
52;53;53107;2552;55;2607
52;53;53108;563;6;569
52;53;53109;621;17;638
52;53;53110;997;19;1016
52;53;53111;464;14;478
52;53;53112;393;7;400
52;53;53113;611;14;625
52;53;53114;204;2;206
52;53;53115;313;12;325
52;53;53116;720;18;738
52;53;53117;499;5;504
52;53;53118;235;2;237
52;53;53119;4326;157;4483
52;53;53120;455;10;465
52;53;53121;1379;30;1409
52;53;53122;750;17;767
52;53;53123;1465;14;1479
52;53;53124;1393;43;1436
52;53;53125;1156;22;1178
52;53;53126;1115;16;1131
52;53;53127;2234;58;2292
52;53;53128;364;4;368
52;53;53129;383;5;388
52;53;53130;49733;2637;52370
52;53;53131;194;2;196
52;53;53132;285;11;296
52;53;53133;718;17;735
52;53;53134;172;1;173
52;53;53135;736;23;759
52;53;53136;1194;38;1232
52;53;53137;2745;63;2808
52;53;53139;412;6;418
52;53;53140;4375;96;4471
52;53;53141;1150;31;1181
52;53;53142;291;6;297
52;53;53143;516;11;527
52;53;53144;761;24;785
52;53;53145;546;14;560
52;53;53146;1914;28;1942
52;53;53147;12823;680;13503
52;53;53148;235;1;236
52;53;53150;905;28;933
52;53;53151;1110;15;1125
52;53;53152;2808;71;2879
52;53;53153;635;13;648
52;53;53154;912;15;927
52;53;53155;1363;24;1387
52;53;53156;252;8;260
52;53;53157;1322;53;1375
52;53;53158;1039;20;1059
52;53;53160;374;7;381
52;53;53161;3162;62;3224
52;53;53162;990;17;1007
52;53;53163;778;4;782
52;53;53164;345;8;353
52;53;53165;354;7;361
52;53;53168;1206;25;1231
52;53;53169;414;9;423
52;53;53170;1158;25;1183
52;53;53172;410;9;419
52;53;53173;181;6;187
52;53;53174;840;23;863
52;53;53175;1371;48;1419
52;53;53176;549;11;560
52;53;53177;305;5;310
52;53;53178;229;10;239
52;53;53179;352;8;360
52;53;53180;642;28;670
52;53;53181;813;14;827
52;53;53182;1799;27;1826
52;53;53184;163;7;170
52;53;53185;2291;87;2378
52;53;53186;2121;64;2185
52;53;53187;229;13;242
52;53;53188;2529;58;2587
52;53;53189;103;2;105
52;53;53190;465;10;475
52;53;53191;248;2;250
52;53;53192;318;4;322
52;53;53193;566;11;577
52;53;53195;500;8;508
52;53;53196;359;12;371
52;53;53197;901;24;925
52;53;53198;229;7;236
52;53;53199;216;4;220
52;53;53200;1146;57;1203
52;53;53201;7353;259;7612
52;53;53202;308;3;311
52;53;53203;525;13;538
52;53;53204;388;12;400
52;53;53206;200;10;210
52;53;53208;494;17;511
52;53;53209;559;14;573
52;53;53210;1548;30;1578
52;53;53211;1447;33;1480
52;53;53212;429;9;438
52;53;53213;494;8;502
52;53;53214;166;4;170
52;53;53216;993;27;1020
52;53;53218;798;25;823
52;53;53219;1412;40;1452
52;53;53220;392;8;400
52;53;53221;391;9;400
52;53;53222;365;8;373
52;53;53223;335;9;344
52;53;53224;1184;31;1215
52;53;53225;512;10;522
52;53;53226;832;32;864
52;53;53228;576;14;590
52;53;53229;1652;48;1700
52;53;53230;223;9;232
52;53;53232;311;3;314
52;53;53233;340;2;342
52;53;53234;370;13;383
52;53;53235;227;4;231
52;53;53236;170;1;171
52;53;53237;454;13;467
52;53;53238;519;10;529
52;53;53240;437;6;443
52;53;53242;260;3;263
52;53;53243;1782;36;1818
52;53;53245;922;27;949
52;53;53246;1853;33;1886
52;53;53247;2265;44;2309
52;53;53248;141;3;144
52;53;53249;1113;14;1127
52;53;53250;407;6;413
52;53;53251;464;8;472
52;53;53253;515;5;520
52;53;53255;1278;31;1309
52;53;53256;172;4;176
52;53;53257;318;8;326
52;53;53258;912;28;940
52;53;53259;347;8;355
52;53;53260;415;1;416
52;53;53261;167;3;170
52;53;53262;1109;34;1143
52;53;53263;280;8;288
52;53;53264;194;3;197
52;53;53265;765;15;780
52;53;53266;227;4;231
52;53;53267;1166;32;1198
52;53;53269;609;5;614
52;53;53270;108;8;116
52;53;53271;2738;42;2780
52;53;53272;185;1;186
52;53;53273;1087;22;1109
52;53;53276;924;15;939
44;54;54001;296;3;299
44;54;54002;232;4;236
44;54;54003;96;4;100
44;54;54004;178;2;180
44;54;54005;109;1;110
44;54;54006;442;7;449
44;54;54007;520;3;523
44;54;54008;472;14;486
44;54;54009;167;3;170
44;54;54010;499;13;512
44;54;54011;654;2;656
44;54;54012;350;5;355
44;54;54013;83;2;85
44;54;54014;264;14;278
44;54;54015;259;6;265
44;54;54016;288;7;295
44;54;54017;76;1;77
44;54;54018;271;7;278
44;54;54019;79;1;80
44;54;54020;452;6;458
44;54;54021;231;1;232
44;54;54022;563;10;573
44;54;54023;248;2;250
44;54;54024;363;6;369
44;54;54025;1591;208;1799
44;54;54026;177;3;180
44;54;54027;872;12;884
44;54;54028;2617;18;2635
44;54;54029;2462;48;2510
44;54;54030;82;0;82
44;54;54031;266;5;271
44;54;54032;187;4;191
44;54;54033;129;0;129
44;54;54034;215;10;225
44;54;54035;387;3;390
44;54;54036;1150;17;1167
44;54;54037;424;2;426
44;54;54038;755;18;773
44;54;54039;4192;61;4253
44;54;54040;1553;32;1585
44;54;54041;145;7;152
44;54;54042;284;2;286
44;54;54043;1427;18;1445
44;54;54044;195;2;197
44;54;54045;433;7;440
44;54;54046;395;8;403
44;54;54047;249;6;255
44;54;54048;351;15;366
44;54;54049;538;14;552
44;54;54050;65;1;66
44;54;54051;1272;21;1293
44;54;54052;148;2;150
44;54;54053;156;6;162
44;54;54054;1557;18;1575
44;54;54055;320;5;325
44;54;54056;141;2;143
44;54;54057;75;0;75
44;54;54058;89;2;91
44;54;54059;755;10;765
44;54;54060;1465;16;1481
44;54;54061;584;11;595
44;54;54062;657;10;667
44;54;54063;174;4;178
44;54;54064;315;6;321
44;54;54065;1095;23;1118
44;54;54066;405;2;407
44;54;54067;758;11;769
44;54;54068;93;2;95
44;54;54069;439;8;447
44;54;54070;174;0;174
44;54;54071;158;1;159
44;54;54072;259;5;264
44;54;54073;918;15;933
44;54;54074;37;0;37
44;54;54075;118;2;120
44;54;54076;3973;46;4019
44;54;54077;1063;12;1075
44;54;54078;57;1;58
44;54;54079;4628;31;4659
44;54;54080;1045;19;1064
44;54;54081;422;6;428
44;54;54082;170;3;173
44;54;54083;177;3;180
44;54;54084;945;14;959
44;54;54085;89;2;91
44;54;54086;354;11;365
44;54;54087;151;1;152
44;54;54088;240;1;241
44;54;54089;1417;20;1437
44;54;54090;4159;41;4200
44;54;54091;389;4;393
44;54;54092;64;1;65
44;54;54093;168;2;170
44;54;54094;173;3;176
44;54;54095;46;0;46
44;54;54096;429;9;438
44;54;54097;102;3;105
44;54;54098;167;3;170
44;54;54099;8069;231;8300
44;54;54100;780;12;792
44;54;54101;129;1;130
44;54;54102;609;15;624
44;54;54103;224;5;229
44;54;54104;260;2;262
44;54;54105;527;15;542
44;54;54106;62;2;64
44;54;54107;74;3;77
44;54;54108;130;4;134
44;54;54109;933;12;945
44;54;54110;562;12;574
44;54;54111;2826;19;2845
44;54;54112;706;9;715
44;54;54113;1490;15;1505
44;54;54114;332;5;337
44;54;54115;6671;65;6736
44;54;54116;2159;43;2202
44;54;54117;115;3;118
44;54;54118;600;10;610
44;54;54119;87;3;90
44;54;54120;328;8;336
44;54;54121;191;3;194
44;54;54122;729;17;746
44;54;54123;1739;10;1749
44;54;54124;45;3;48
44;54;54125;490;8;498
44;54;54126;221;1;222
44;54;54127;631;19;650
44;54;54128;717;7;724
44;54;54129;1610;25;1635
44;54;54130;181;1;182
44;54;54131;496;10;506
44;54;54132;63;2;65
44;54;54133;119;4;123
44;54;54134;244;7;251
44;54;54135;1449;20;1469
44;54;54136;2383;33;2416
44;54;54137;507;17;524
44;54;54138;2741;56;2797
44;54;54139;366;2;368
44;54;54140;96;0;96
44;54;54141;149;2;151
44;54;54142;158;2;160
44;54;54143;391;7;398
44;54;54144;398;3;401
44;54;54145;931;12;943
44;54;54146;294;3;297
44;54;54147;104;2;106
44;54;54148;647;8;655
44;54;54149;1568;12;1580
44;54;54150;3082;28;3110
44;54;54151;1042;28;1070
44;54;54152;3155;45;3200
44;54;54153;55;0;55
44;54;54154;491;21;512
44;54;54155;410;7;417
44;54;54156;502;17;519
44;54;54157;4772;45;4817
44;54;54158;133;2;135
44;54;54159;9668;189;9857
44;54;54160;403;9;412
44;54;54161;311;10;321
44;54;54162;1164;14;1178
44;54;54163;258;2;260
44;54;54164;87;2;89
44;54;54165;575;28;603
44;54;54166;32;2;34
44;54;54167;1951;37;1988
44;54;54168;287;2;289
44;54;54169;93;3;96
44;54;54170;71;1;72
44;54;54171;1158;21;1179
44;54;54172;290;7;297
44;54;54173;212;4;216
44;54;54174;4428;53;4481
44;54;54175;370;3;373
44;54;54176;1116;22;1138
44;54;54177;257;3;260
44;54;54178;194;3;197
44;54;54179;302;4;306
44;54;54180;72;2;74
44;54;54181;699;17;716
44;54;54182;332;10;342
44;54;54183;78;0;78
44;54;54184;8833;188;9021
44;54;54185;60;1;61
44;54;54186;1105;21;1126
44;54;54187;113;1;114
44;54;54188;1367;10;1377
44;54;54189;597;8;605
44;54;54190;112;3;115
44;54;54191;101;2;103
44;54;54192;301;4;305
44;54;54193;77;1;78
44;54;54194;512;9;521
44;54;54195;203;0;203
44;54;54196;1735;134;1869
44;54;54197;2225;25;2250
44;54;54198;309;5;314
44;54;54199;382;11;393
44;54;54200;156;1;157
44;54;54201;309;3;312
44;54;54202;376;4;380
44;54;54203;138;3;141
44;54;54204;93;2;95
44;54;54205;2629;30;2659
44;54;54206;391;5;396
44;54;54207;100;2;102
44;54;54208;288;2;290
44;54;54209;71;0;71
44;54;54210;211;4;215
44;54;54211;189;2;191
44;54;54212;413;13;426
44;54;54213;367;5;372
44;54;54214;700;6;706
44;54;54215;6584;78;6662
44;54;54216;125;0;125
44;54;54217;169;2;171
44;54;54218;58;1;59
44;54;54219;79;0;79
44;54;54220;79;0;79
44;54;54221;230;1;231
44;54;54222;1328;23;1351
44;54;54223;218;7;225
44;54;54224;123;1;124
44;54;54225;179;3;182
44;54;54226;171;3;174
44;54;54227;1346;17;1363
44;54;54228;70;3;73
44;54;54229;366;5;371
44;54;54230;50;0;50
44;54;54231;175;3;178
44;54;54232;2712;50;2762
44;54;54233;37;2;39
44;54;54234;2877;45;2922
44;54;54235;421;9;430
44;54;54236;352;8;360
44;54;54237;86;3;89
44;54;54238;271;1;272
44;54;54239;137;2;139
44;54;54240;57;0;57
44;54;54241;75;3;78
44;54;54242;272;4;276
44;54;54243;213;7;220
44;54;54244;111;3;114
44;54;54245;61;0;61
44;54;54246;66;6;72
44;54;54247;177;4;181
44;54;54248;100;0;100
44;54;54249;254;4;258
44;54;54250;735;6;741
44;54;54251;125;1;126
44;54;54252;506;6;512
44;54;54253;773;12;785
44;54;54254;3394;43;3437
44;54;54255;85;6;91
44;54;54256;305;8;313
44;54;54257;5403;83;5486
44;54;54258;144;3;147
44;54;54259;240;2;242
44;54;54260;955;18;973
44;54;54261;4409;46;4455
44;54;54262;197;0;197
44;54;54263;6267;55;6322
44;54;54264;284;0;284
44;54;54265;2097;44;2141
44;54;54266;407;10;417
44;54;54268;142;4;146
44;54;54269;360;5;365
44;54;54270;3693;65;3758
44;54;54271;122;6;128
44;54;54272;469;3;472
44;54;54273;8219;186;8405
44;54;54274;9354;237;9591
44;54;54275;190;6;196
44;54;54276;795;7;802
44;54;54277;373;2;375
44;54;54278;99;1;100
44;54;54279;983;21;1004
44;54;54280;6570;53;6623
44;54;54281;896;18;914
44;54;54282;161;4;165
44;54;54283;290;9;299
44;54;54284;1137;20;1157
44;54;54285;56;1;57
44;54;54286;1587;30;1617
44;54;54287;260;1;261
44;54;54288;498;5;503
44;54;54289;366;10;376
44;54;54290;211;3;214
44;54;54291;291;2;293
44;54;54292;190;3;193
44;54;54293;85;4;89
44;54;54294;147;1;148
44;54;54295;972;111;1083
44;54;54296;433;4;437
44;54;54297;309;3;312
44;54;54298;153;2;155
44;54;54299;226;6;232
44;54;54300;6553;109;6662
44;54;54301;128;1;129
44;54;54302;746;18;764
44;54;54303;368;3;371
44;54;54304;14366;191;14557
44;54;54305;2400;48;2448
44;54;54306;343;5;348
44;54;54307;176;4;180
44;54;54308;146;3;149
44;54;54309;379;3;382
44;54;54310;3;0;3
44;54;54311;595;8;603
44;54;54312;480;10;490
44;54;54313;229;1;230
44;54;54314;3816;65;3881
44;54;54315;902;6;908
44;54;54316;298;5;303
44;54;54317;131;5;136
44;54;54318;5863;73;5936
44;54;54320;324;4;328
44;54;54321;2365;28;2393
44;54;54322;5218;62;5280
44;54;54323;14774;272;15046
44;54;54324;89;1;90
44;54;54325;82;8;90
44;54;54326;222;10;232
44;54;54327;630;15;645
44;54;54328;6142;89;6231
44;54;54329;17867;324;18191
44;54;54330;428;9;437
44;54;54331;280;6;286
44;54;54332;1547;24;1571
44;54;54333;248;14;262
44;54;54334;561;11;572
44;54;54335;412;4;416
44;54;54336;927;11;938
44;54;54337;129;3;132
44;54;54338;980;14;994
44;54;54339;8191;270;8461
44;54;54340;343;5;348
44;54;54343;187;5;192
44;54;54344;218;4;222
44;54;54345;344;5;349
44;54;54346;246;4;250
44;54;54348;236;8;244
44;54;54349;163;2;165
44;54;54350;697;8;705
44;54;54351;1682;15;1697
44;54;54352;829;9;838
44;54;54353;922;16;938
44;54;54354;46;0;46
44;54;54355;94;2;96
44;54;54356;67;2;69
44;54;54357;9818;119;9937
44;54;54358;279;5;284
44;54;54359;243;3;246
44;54;54360;337;8;345
44;54;54362;1281;7;1288
44;54;54363;270;6;276
44;54;54364;1289;19;1308
44;54;54365;324;9;333
44;54;54366;1976;20;1996
44;54;54367;2278;67;2345
44;54;54368;175;3;178
44;54;54369;617;7;624
44;54;54370;225;1;226
44;54;54371;1069;20;1089
44;54;54372;511;2;513
44;54;54373;618;5;623
44;54;54374;514;9;523
44;54;54375;1078;17;1095
44;54;54376;409;7;416
44;54;54377;159;0;159
44;54;54378;473;8;481
44;54;54379;97;0;97
44;54;54380;413;10;423
44;54;54381;55;2;57
44;54;54382;8994;113;9107
44;54;54383;1117;11;1128
44;54;54385;1086;25;1111
44;54;54386;92;1;93
44;54;54387;151;0;151
44;54;54388;74;2;76
44;54;54389;99;2;101
44;54;54390;101;3;104
44;54;54391;1568;23;1591
44;54;54392;312;2;314
44;54;54393;539;6;545
44;54;54394;251;6;257
44;54;54395;105058;1446;106504
44;54;54396;227;8;235
44;54;54397;6633;55;6688
44;54;54398;97;2;99
44;54;54399;248;1;249
44;54;54400;1150;22;1172
44;54;54401;127;5;132
44;54;54402;413;11;424
44;54;54403;1190;34;1224
44;54;54404;264;5;269
44;54;54405;522;0;522
44;54;54406;279;7;286
44;54;54407;96;3;99
44;54;54408;231;3;234
44;54;54409;188;0;188
44;54;54410;519;2;521
44;54;54411;218;2;220
44;54;54412;38;3;41
44;54;54413;151;1;152
44;54;54414;660;8;668
44;54;54415;4105;52;4157
44;54;54416;180;3;183
44;54;54417;240;7;247
44;54;54418;171;1;172
44;54;54419;73;0;73
44;54;54420;87;1;88
44;54;54421;317;4;321
44;54;54422;70;0;70
44;54;54423;348;10;358
44;54;54424;43;1;44
44;54;54425;2539;28;2567
44;54;54426;480;6;486
44;54;54427;94;1;95
44;54;54428;863;9;872
44;54;54429;300;2;302
44;54;54430;4870;56;4926
44;54;54431;14497;187;14684
44;54;54432;1844;38;1882
44;54;54433;229;7;236
44;54;54434;252;2;254
44;54;54435;362;4;366
44;54;54436;146;4;150
44;54;54437;1151;20;1171
44;54;54438;56;0;56
44;54;54439;5077;62;5139
44;54;54440;121;0;121
44;54;54441;234;5;239
44;54;54442;97;2;99
44;54;54443;37;0;37
44;54;54444;222;2;224
44;54;54445;102;0;102
44;54;54446;65;2;67
44;54;54447;76;1;77
44;54;54449;1048;15;1063
44;54;54450;141;1;142
44;54;54451;3809;76;3885
44;54;54452;78;2;80
44;54;54453;161;1;162
44;54;54455;158;4;162
44;54;54456;584;8;592
44;54;54457;44;0;44
44;54;54458;105;1;106
44;54;54459;2329;25;2354
44;54;54460;156;3;159
44;54;54461;70;2;72
44;54;54462;2870;28;2898
44;54;54463;235;2;237
44;54;54464;105;0;105
44;54;54465;769;11;780
44;54;54466;390;5;395
44;54;54467;191;5;196
44;54;54468;113;2;115
44;54;54469;418;5;423
44;54;54470;74;2;76
44;54;54471;71;3;74
44;54;54472;854;16;870
44;54;54473;280;6;286
44;54;54474;192;0;192
44;54;54475;155;6;161
44;54;54476;416;11;427
44;54;54477;162;3;165
44;54;54478;149;1;150
44;54;54479;95;1;96
44;54;54480;56;1;57
44;54;54481;98;3;101
44;54;54482;10019;110;10129
44;54;54483;7417;73;7490
44;54;54484;186;3;189
44;54;54485;310;6;316
44;54;54486;355;5;360
44;54;54487;64;0;64
44;54;54488;35;0;35
44;54;54489;148;4;152
44;54;54490;1473;23;1496
44;54;54491;315;7;322
44;54;54492;152;2;154
44;54;54493;2415;39;2454
44;54;54494;101;0;101
44;54;54495;4221;59;4280
44;54;54496;368;4;372
44;54;54497;106;3;109
44;54;54498;5069;66;5135
44;54;54499;112;4;116
44;54;54500;183;3;186
44;54;54501;101;0;101
44;54;54502;243;1;244
44;54;54504;668;16;684
44;54;54505;714;8;722
44;54;54507;103;2;105
44;54;54508;245;4;249
44;54;54509;994;4;998
44;54;54510;312;6;318
44;54;54511;112;4;116
44;54;54512;106;2;108
44;54;54513;646;4;650
44;54;54514;601;15;616
44;54;54515;250;0;250
44;54;54516;17;1;18
44;54;54517;203;2;205
44;54;54518;1110;10;1120
44;54;54519;587;8;595
44;54;54520;381;9;390
44;54;54521;1950;30;1980
44;54;54522;142;3;145
44;54;54523;424;2;426
44;54;54524;84;2;86
44;54;54525;664;12;676
44;54;54526;8856;289;9145
44;54;54527;675;26;701
44;54;54528;15633;265;15898
44;54;54529;28;0;28
44;54;54530;86;2;88
44;54;54531;56;1;57
44;54;54532;165;3;168
44;54;54533;2605;33;2638
44;54;54534;530;21;551
44;54;54535;200;2;202
44;54;54536;2438;24;2462
44;54;54537;690;29;719
44;54;54538;381;3;384
44;54;54539;234;13;247
44;54;54540;578;6;584
44;54;54541;165;2;167
44;54;54542;2322;35;2357
44;54;54543;158;2;160
44;54;54544;140;2;142
44;54;54545;211;5;216
44;54;54546;930;9;939
44;54;54547;29942;281;30223
44;54;54548;538;8;546
44;54;54549;3594;42;3636
44;54;54550;322;8;330
44;54;54551;60;2;62
44;54;54552;62;2;64
44;54;54553;150;4;154
44;54;54554;77;1;78
44;54;54555;88;0;88
44;54;54556;107;3;110
44;54;54557;2306;96;2402
44;54;54558;280;5;285
44;54;54559;302;2;304
44;54;54560;52;0;52
44;54;54561;47;1;48
44;54;54562;159;7;166
44;54;54563;1392;17;1409
44;54;54564;141;4;145
44;54;54565;235;2;237
44;54;54566;154;1;155
44;54;54567;366;13;379
44;54;54568;271;3;274
44;54;54569;191;4;195
44;54;54570;340;7;347
44;54;54571;594;8;602
44;54;54572;683;5;688
44;54;54573;170;0;170
44;54;54574;551;19;570
44;54;54575;1525;37;1562
44;54;54576;117;1;118
44;54;54577;143;1;144
44;54;54578;14525;302;14827
44;54;54579;339;7;346
44;54;54580;10003;108;10111
44;54;54581;297;9;306
44;54;54582;183;1;184
44;54;54583;415;8;423
44;54;54584;1032;22;1054
44;54;54585;491;6;497
44;54;54586;741;7;748
44;54;54587;195;3;198
44;54;54588;395;9;404
44;54;54589;128;6;134
44;54;54590;665;19;684
44;54;54591;330;12;342
44;54;54592;260;3;263
44;54;54593;428;5;433
44;54;54594;159;1;160
44;54;54595;561;7;568
44;54;54596;966;7;973
44;54;54597;443;3;446
44;54;54598;270;7;277
44;54;54599;112;0;112
44;54;54600;129;1;130
44;54;54601;103;1;104
44;54;54602;148;0;148
44;55;55001;290;10;300
44;55;55002;103;3;106
44;55;55004;77;0;77
44;55;55005;36;1;37
44;55;55007;241;2;243
44;55;55008;146;5;151
44;55;55009;538;19;557
44;55;55010;2662;73;2735
44;55;55011;257;3;260
44;55;55012;414;8;422
44;55;55013;474;8;482
44;55;55014;361;7;368
44;55;55015;498;12;510
44;55;55017;118;5;123
44;55;55018;40;2;42
44;55;55021;62;2;64
44;55;55022;151;4;155
44;55;55023;116;1;117
44;55;55024;162;3;165
44;55;55025;277;3;280
44;55;55026;132;5;137
44;55;55027;159;3;162
44;55;55028;113;3;116
44;55;55029;14625;596;15221
44;55;55031;378;6;384
44;55;55032;45;1;46
44;55;55033;18;1;19
44;55;55034;115;3;118
44;55;55035;147;6;153
44;55;55036;92;1;93
44;55;55037;145;2;147
44;55;55038;38;2;40
44;55;55039;0;0;0
44;55;55040;253;6;259
44;55;55041;608;16;624
44;55;55042;525;12;537
44;55;55043;3040;53;3093
44;55;55044;33;3;36
44;55;55045;558;8;566
44;55;55046;128;4;132
44;55;55047;161;6;167
44;55;55048;34;2;36
44;55;55049;421;0;421
44;55;55050;0;0;0
44;55;55051;125;3;128
44;55;55053;369;2;371
44;55;55054;61;5;66
44;55;55055;13;1;14
44;55;55057;78;2;80
44;55;55058;326;10;336
44;55;55059;191;8;199
44;55;55060;346;14;360
44;55;55061;239;6;245
44;55;55062;114;1;115
44;55;55063;2464;39;2503
44;55;55064;104;0;104
44;55;55065;119;0;119
44;55;55066;131;4;135
44;55;55067;100;2;102
44;55;55068;111;3;114
44;55;55069;229;3;232
44;55;55070;120;6;126
44;55;55071;182;5;187
44;55;55072;109;1;110
44;55;55073;691;50;741
44;55;55075;174;4;178
44;55;55076;168;1;169
44;55;55077;263;9;272
44;55;55078;305;9;314
44;55;55079;696;21;717
44;55;55080;80;4;84
44;55;55081;58;1;59
44;55;55082;46;1;47
44;55;55083;153;4;157
44;55;55084;57;2;59
44;55;55085;288;4;292
44;55;55087;81;8;89
44;55;55088;152;4;156
44;55;55089;88;1;89
44;55;55093;290;3;293
44;55;55094;549;11;560
44;55;55095;104;4;108
44;55;55096;112;1;113
44;55;55097;312;6;318
44;55;55099;121;1;122
44;55;55100;79;8;87
44;55;55101;298;8;306
44;55;55102;524;19;543
44;55;55103;21;2;23
44;55;55104;81;3;84
44;55;55105;178;4;182
44;55;55106;179;5;184
44;55;55107;47;1;48
44;55;55108;124;4;128
44;55;55109;237;7;244
44;55;55110;226;7;233
44;55;55111;444;20;464
44;55;55113;156;1;157
44;55;55114;206;4;210
44;55;55115;46;0;46
44;55;55116;55;2;57
44;55;55117;1453;34;1487
44;55;55118;96;2;98
44;55;55119;190;1;191
44;55;55120;785;23;808
44;55;55121;119;5;124
44;55;55122;5386;235;5621
44;55;55123;712;15;727
44;55;55124;309;4;313
44;55;55125;797;19;816
44;55;55127;41;0;41
44;55;55128;41;1;42
44;55;55129;37;1;38
44;55;55132;1680;29;1709
44;55;55133;87;5;92
44;55;55134;153;4;157
44;55;55137;48;0;48
44;55;55138;133;3;136
44;55;55139;0;0;0
44;55;55140;17;0;17
44;55;55141;83;0;83
44;55;55142;121;6;127
44;55;55143;127;8;135
44;55;55144;385;13;398
44;55;55145;626;74;700
44;55;55146;207;11;218
44;55;55148;112;4;116
44;55;55149;122;0;122
44;55;55150;521;13;534
44;55;55153;195;2;197
44;55;55154;1441;47;1488
44;55;55155;397;7;404
44;55;55156;138;4;142
44;55;55157;52;0;52
44;55;55158;731;8;739
44;55;55159;338;3;341
44;55;55160;38;0;38
44;55;55162;35;0;35
44;55;55163;56;3;59
44;55;55165;426;12;438
44;55;55166;1311;24;1335
44;55;55167;660;10;670
44;55;55168;44;0;44
44;55;55169;514;6;520
44;55;55170;118;1;119
44;55;55171;256;4;260
44;55;55172;63;1;64
44;55;55173;40;3;43
44;55;55174;77;0;77
44;55;55175;189;5;194
44;55;55177;46;4;50
44;55;55178;184;6;190
44;55;55179;153;3;156
44;55;55180;136;11;147
44;55;55181;3507;74;3581
44;55;55182;208;3;211
44;55;55183;37;1;38
44;55;55184;1651;32;1683
44;55;55185;89;5;94
44;55;55186;2109;58;2167
44;55;55188;44;1;45
44;55;55189;0;0;0
44;55;55191;232;5;237
44;55;55192;44;1;45
44;55;55193;123;2;125
44;55;55194;58;0;58
44;55;55195;127;4;131
44;55;55196;128;1;129
44;55;55197;167;4;171
44;55;55198;652;9;661
44;55;55199;91;2;93
44;55;55200;206;4;210
44;55;55201;59;0;59
44;55;55202;149;3;152
44;55;55204;293;5;298
44;55;55206;98;4;102
44;55;55207;53;1;54
44;55;55208;60;2;62
44;55;55210;40;0;40
44;55;55211;65;1;66
44;55;55212;81;0;81
44;55;55214;279;21;300
44;55;55215;1074;17;1091
44;55;55216;63;0;63
44;55;55217;115;6;121
44;55;55218;39;0;39
44;55;55219;102;2;104
44;55;55220;78;0;78
44;55;55221;245;6;251
44;55;55222;32;2;34
44;55;55224;583;13;596
44;55;55225;143;7;150
44;55;55226;123;1;124
44;55;55228;552;11;563
44;55;55229;272;3;275
44;55;55232;114;0;114
44;55;55236;941;24;965
44;55;55237;227;1;228
44;55;55239;0;0;0
44;55;55241;78;3;81
44;55;55242;111;4;115
44;55;55243;181;5;186
44;55;55244;232;3;235
44;55;55245;165;2;167
44;55;55246;150;1;151
44;55;55247;51;5;56
44;55;55248;285;7;292
44;55;55250;182;8;190
44;55;55251;103;3;106
44;55;55252;154;2;156
44;55;55253;715;13;728
44;55;55254;123;3;126
44;55;55255;260;6;266
44;55;55256;148;0;148
44;55;55257;43;0;43
44;55;55258;617;17;634
44;55;55260;54;2;56
44;55;55261;142;2;144
44;55;55262;266;2;268
44;55;55263;158;4;162
44;55;55264;266;5;271
44;55;55265;138;5;143
44;55;55266;50;0;50
44;55;55267;272;8;280
44;55;55268;712;17;729
44;55;55269;74;0;74
44;55;55270;28;1;29
44;55;55271;378;6;384
44;55;55272;441;17;458
44;55;55274;290;6;296
44;55;55275;87;4;91
44;55;55276;215;2;217
44;55;55278;194;3;197
44;55;55279;445;8;453
44;55;55280;59;0;59
44;55;55281;95;0;95
44;55;55282;95;3;98
44;55;55284;72;0;72
44;55;55285;153;4;157
44;55;55286;241;1;242
44;55;55288;1416;16;1432
44;55;55289;60;1;61
44;55;55290;54;2;56
44;55;55291;4018;135;4153
44;55;55292;189;7;196
44;55;55293;168;4;172
44;55;55295;31;1;32
44;55;55296;477;8;485
44;55;55297;111;1;112
44;55;55298;295;9;304
44;55;55299;120;3;123
44;55;55300;224;7;231
44;55;55301;121;8;129
44;55;55302;1129;35;1164
44;55;55303;72;4;76
44;55;55304;159;6;165
44;55;55306;113;1;114
44;55;55307;0;0;0
44;55;55310;113;4;117
44;55;55311;29;1;30
44;55;55312;165;6;171
44;55;55313;67;2;69
44;55;55315;117;5;122
44;55;55316;400;7;407
44;55;55317;142;7;149
44;55;55320;67;2;69
44;55;55321;162;7;169
44;55;55322;46;1;47
44;55;55323;68;1;69
44;55;55324;517;13;530
44;55;55325;51;1;52
44;55;55326;111;3;114
44;55;55327;251;2;253
44;55;55328;288;6;294
44;55;55329;223;2;225
44;55;55330;90;2;92
44;55;55331;78;0;78
44;55;55332;238;5;243
44;55;55333;41;0;41
44;55;55334;167;3;170
44;55;55335;252;9;261
44;55;55336;151;2;153
44;55;55338;149;5;154
44;55;55339;78;1;79
44;55;55340;377;11;388
44;55;55341;126;2;128
44;55;55343;60;2;62
44;55;55344;22;0;22
44;55;55345;102;3;105
44;55;55346;296;7;303
44;55;55347;350;3;353
44;55;55348;373;4;377
44;55;55349;111;6;117
44;55;55350;74;0;74
44;55;55351;2052;85;2137
44;55;55352;143;18;161
44;55;55353;81;0;81
44;55;55355;155;1;156
44;55;55356;105;1;106
44;55;55357;108;3;111
44;55;55358;189;5;194
44;55;55359;206;2;208
44;55;55360;110;1;111
44;55;55361;127;0;127
44;55;55362;178;3;181
44;55;55363;93;1;94
44;55;55364;667;29;696
44;55;55365;142;4;146
44;55;55366;993;34;1027
44;55;55367;136;4;140
44;55;55368;144;9;153
44;55;55369;803;21;824
44;55;55370;225;2;227
44;55;55371;74;4;78
44;55;55372;373;12;385
44;55;55373;83;5;88
44;55;55374;75;1;76
44;55;55375;64;1;65
44;55;55376;86;4;90
44;55;55377;90;1;91
44;55;55378;244;3;247
44;55;55379;71;2;73
44;55;55380;54;1;55
44;55;55381;174;8;182
44;55;55382;362;9;371
44;55;55383;216;2;218
44;55;55384;123;4;127
44;55;55385;491;16;507
44;55;55386;219;5;224
44;55;55387;239;4;243
44;55;55388;278;4;282
44;55;55389;250;6;256
44;55;55391;197;6;203
44;55;55394;6;0;6
44;55;55395;56;3;59
44;55;55396;226;5;231
44;55;55397;238;4;242
44;55;55398;1016;17;1033
44;55;55399;117;0;117
44;55;55400;43;0;43
44;55;55401;413;11;424
44;55;55403;60;1;61
44;55;55404;326;11;337
44;55;55405;256;4;260
44;55;55406;110;4;114
44;55;55407;127;6;133
44;55;55408;173;8;181
44;55;55409;65;2;67
44;55;55410;134;6;140
44;55;55411;107;1;108
44;55;55412;187;5;192
44;55;55414;184;1;185
44;55;55415;86;1;87
44;55;55416;224;7;231
44;55;55419;161;4;165
44;55;55420;77;0;77
44;55;55421;77;4;81
44;55;55422;51;0;51
44;55;55423;330;8;338
44;55;55424;50;0;50
44;55;55425;134;0;134
44;55;55426;387;15;402
44;55;55427;2802;51;2853
44;55;55428;123;1;124
44;55;55429;47;0;47
44;55;55430;65;1;66
44;55;55431;58;0;58
44;55;55433;358;13;371
44;55;55434;50;2;52
44;55;55435;782;24;806
44;55;55436;29;0;29
44;55;55437;122;3;125
44;55;55438;185;4;189
44;55;55439;89;5;94
44;55;55442;248;3;251
44;55;55443;592;6;598
44;55;55444;221;0;221
44;55;55445;189;8;197
44;55;55446;85;4;89
44;55;55447;372;7;379
44;55;55448;48;1;49
44;55;55449;289;4;293
44;55;55450;45;2;47
44;55;55452;49;2;51
44;55;55453;65;1;66
44;55;55454;166;1;167
44;55;55456;232;8;240
44;55;55457;181;5;186
44;55;55458;375;0;375
44;55;55459;239;3;242
44;55;55460;139;2;141
44;55;55461;472;16;488
44;55;55462;340;11;351
44;55;55463;4039;71;4110
44;55;55464;155;8;163
44;55;55465;104;0;104
44;55;55466;294;8;302
44;55;55467;689;14;703
44;55;55468;98;0;98
44;55;55469;90;0;90
44;55;55470;193;2;195
44;55;55471;83;1;84
44;55;55472;116;6;122
44;55;55473;113;12;125
44;55;55474;230;7;237
44;55;55475;60;1;61
44;55;55476;471;13;484
44;55;55477;405;15;420
44;55;55479;163;3;166
44;55;55481;336;2;338
44;55;55482;101;2;103
44;55;55484;47;1;48
44;55;55485;72;3;75
44;55;55487;97;2;99
44;55;55488;150;5;155
44;55;55489;274;7;281
44;55;55490;332;11;343
44;55;55492;989;13;1002
44;55;55493;190;5;195
44;55;55494;428;21;449
44;55;55495;252;1;253
44;55;55496;1066;30;1096
44;55;55497;327;3;330
44;55;55498;465;5;470
44;55;55500;832;12;844
44;55;55501;385;10;395
44;55;55502;2507;129;2636
44;55;55503;124;2;126
44;55;55504;414;11;425
44;55;55505;3165;97;3262
44;55;55506;31;0;31
44;55;55507;219;2;221
44;55;55508;348;2;350
44;55;55509;274;6;280
44;55;55510;131;3;134
44;55;55511;120;3;123
44;55;55512;279;4;283
44;55;55514;605;10;615
44;55;55515;69;1;70
44;55;55516;559;6;565
44;55;55517;513;6;519
44;55;55518;143;2;145
44;55;55519;1353;29;1382
44;55;55520;461;11;472
44;55;55521;244;1;245
44;55;55522;111;3;114
44;55;55523;189;4;193
44;55;55525;75;0;75
44;55;55526;263;4;267
44;55;55527;639;11;650
44;55;55528;51;0;51
44;55;55530;93;1;94
44;55;55531;280;27;307
44;55;55532;310;5;315
44;55;55533;1939;23;1962
44;55;55534;53;0;53
44;55;55535;96;0;96
44;55;55536;17;3;20
44;55;55537;80;0;80
44;55;55540;60;1;61
44;55;55541;525;9;534
44;55;55543;948;21;969
44;55;55544;151;2;153
44;55;55545;16942;964;17906
44;55;55546;206;8;214
44;55;55547;117;4;121
44;55;55549;89;1;90
44;55;55551;1555;94;1649
44;55;55552;82;4;86
44;55;55553;1309;36;1345
44;55;55554;267;15;282
44;55;55555;33;1;34
44;55;55556;49;1;50
44;55;55557;120;2;122
44;55;55559;46;2;48
44;55;55560;131;4;135
44;55;55561;51;5;56
44;55;55562;125;2;127
44;55;55563;80;4;84
44;55;55565;79;3;82
44;55;55566;306;3;309
44;55;55567;142;2;144
44;55;55568;280;5;285
44;55;55569;165;5;170
44;55;55570;208;7;215
44;55;55571;226;8;234
44;55;55572;87;1;88
44;55;55573;1629;30;1659
44;55;55574;44;2;46
44;55;55575;86;0;86
44;55;55577;59;2;61
44;55;55578;184;7;191
44;55;55579;102;0;102
44;55;55580;51;3;54
44;55;55581;106;3;109
44;55;55582;91;1;92
44;55;55583;201;4;205
44;55;55584;123;2;125
44;55;55586;107;3;110
53;56;56001;3886;128;4014
53;56;56002;1961;52;2013
53;56;56003;5392;175;5567
53;56;56004;1682;31;1713
53;56;56005;2198;35;2233
53;56;56006;1526;31;1557
53;56;56007;14141;423;14564
53;56;56008;4396;121;4517
53;56;56009;1012;20;1032
53;56;56010;6234;192;6426
53;56;56011;1395;27;1422
53;56;56012;1962;42;2004
53;56;56013;3760;61;3821
53;56;56014;1544;137;1681
53;56;56015;2026;30;2056
53;56;56017;2774;63;2837
53;56;56018;1008;27;1035
53;56;56019;336;10;346
53;56;56020;855;15;870
53;56;56021;1459;27;1486
53;56;56022;1300;27;1327
53;56;56023;6660;282;6942
53;56;56024;2289;35;2324
53;56;56025;192;4;196
53;56;56026;2317;59;2376
53;56;56027;540;8;548
53;56;56028;1589;37;1626
53;56;56029;1233;24;1257
53;56;56030;1039;16;1055
53;56;56031;3066;61;3127
53;56;56032;1888;53;1941
53;56;56033;3074;58;3132
53;56;56034;4236;126;4362
53;56;56035;1149;31;1180
53;56;56036;6920;202;7122
53;56;56039;979;21;1000
53;56;56040;3298;61;3359
53;56;56041;2828;90;2918
53;56;56042;2192;36;2228
53;56;56043;737;10;747
53;56;56044;786;30;816
53;56;56045;672;10;682
53;56;56046;3394;81;3475
53;56;56047;1520;47;1567
53;56;56048;708;17;725
53;56;56049;173;4;177
53;56;56050;885;32;917
53;56;56051;655;5;660
53;56;56052;1839;26;1865
53;56;56053;6261;119;6380
53;56;56054;3853;97;3950
53;56;56055;2054;180;2234
53;56;56056;199;4;203
53;56;56057;2793;58;2851
53;56;56058;3318;62;3380
53;56;56060;951;35;986
53;56;56061;3962;80;4042
53;56;56062;680;20;700
53;56;56063;2637;90;2727
53;56;56065;721;25;746
53;56;56066;3779;150;3929
53;56;56067;5552;139;5691
53;56;56068;322;3;325
53;56;56069;2234;53;2287
53;56;56070;2272;51;2323
53;56;56071;800;12;812
53;56;56072;514;10;524
53;56;56073;1060;17;1077
53;56;56074;1822;37;1859
53;56;56075;6091;300;6391
53;56;56076;1313;38;1351
53;56;56077;999;17;1016
53;56;56078;11767;309;12076
53;56;56079;1343;41;1384
53;56;56080;1305;143;1448
53;56;56081;2083;60;2143
53;56;56082;384;7;391
53;56;56083;16062;405;16467
53;56;56084;852;13;865
53;56;56085;94;6;100
53;56;56086;216;6;222
53;56;56087;620;18;638
53;56;56088;227;8;235
53;56;56089;2185;58;2243
53;56;56090;6548;135;6683
53;56;56091;2482;95;2577
53;56;56092;833;15;848
53;56;56093;720;26;746
53;56;56094;6786;216;7002
53;56;56096;2392;51;2443
53;56;56097;3961;70;4031
53;56;56098;23124;475;23599
53;56;56099;378;6;384
53;56;56100;1724;58;1782
53;56;56101;8064;151;8215
53;56;56102;2165;49;2214
53;56;56103;299;4;303
53;56;56104;801;11;812
53;56;56105;1144;23;1167
53;56;56106;874;18;892
53;56;56107;8319;243;8562
53;56;56108;1067;21;1088
53;56;56109;1167;27;1194
53;56;56110;846;21;867
53;56;56111;1312;22;1334
53;56;56112;736;15;751
53;56;56113;903;20;923
53;56;56114;931;30;961
53;56;56115;1708;39;1747
53;56;56116;1552;45;1597
53;56;56117;4505;238;4743
53;56;56118;4039;112;4151
53;56;56119;3464;63;3527
53;56;56120;1885;40;1925
53;56;56121;57246;1486;58732
53;56;56122;1621;42;1663
53;56;56123;2195;43;2238
53;56;56124;2470;78;2548
53;56;56125;1841;66;1907
53;56;56126;2421;28;2449
53;56;56127;3145;71;3216
53;56;56128;1521;27;1548
53;56;56129;1532;36;1568
53;56;56130;3238;70;3308
53;56;56131;1417;31;1448
53;56;56132;2262;53;2315
53;56;56133;1155;27;1182
53;56;56134;979;11;990
53;56;56135;1605;29;1634
53;56;56136;756;15;771
53;56;56137;3299;78;3377
53;56;56139;360;10;370
53;56;56140;3733;94;3827
53;56;56141;1733;37;1770
53;56;56143;5066;126;5192
53;56;56144;3483;63;3546
53;56;56145;1109;27;1136
53;56;56146;1390;49;1439
53;56;56147;4677;85;4762
53;56;56148;1576;32;1608
53;56;56149;2520;52;2572
53;56;56151;3605;116;3721
53;56;56152;2544;54;2598
53;56;56153;2712;43;2755
53;56;56154;1847;50;1897
53;56;56155;2019;26;2045
53;56;56156;351;6;357
53;56;56157;1953;55;2008
53;56;56158;6145;178;6323
53;56;56159;1820;43;1863
53;56;56160;1297;22;1319
53;56;56161;2988;89;3077
53;56;56162;17778;639;18417
53;56;56163;1209;26;1235
53;56;56164;6635;222;6857
53;56;56165;9791;564;10355
53;56;56166;5792;128;5920
53;56;56167;2522;82;2604
53;56;56168;2214;48;2262
53;56;56169;5386;125;5511
53;56;56170;1062;32;1094
53;56;56171;1532;26;1558
53;56;56172;2679;79;2758
53;56;56173;4355;97;4452
53;56;56174;2770;70;2840
53;56;56175;4178;94;4272
53;56;56176;5905;140;6045
53;56;56177;7676;141;7817
53;56;56178;15064;934;15998
53;56;56179;3844;85;3929
53;56;56180;729;16;745
53;56;56181;2654;100;2754
53;56;56182;967;181;1148
53;56;56184;7862;274;8136
53;56;56185;8770;238;9008
53;56;56186;4658;91;4749
53;56;56188;1416;23;1439
53;56;56189;1067;16;1083
53;56;56190;1964;52;2016
53;56;56191;411;10;421
53;56;56193;5821;144;5965
53;56;56194;2865;74;2939
53;56;56195;701;11;712
53;56;56196;641;13;654
53;56;56197;2758;75;2833
53;56;56198;1636;44;1680
53;56;56199;705;14;719
53;56;56200;1385;34;1419
53;56;56201;579;11;590
53;56;56202;529;14;543
53;56;56203;631;14;645
53;56;56204;632;8;640
53;56;56205;873;18;891
53;56;56206;11895;303;12198
53;56;56207;1160;17;1177
53;56;56208;304;10;314
53;56;56209;179;7;186
53;56;56210;480;6;486
53;56;56211;795;17;812
53;56;56212;2539;42;2581
53;56;56213;1144;30;1174
53;56;56214;1531;24;1555
53;56;56215;1106;25;1131
53;56;56216;393;4;397
53;56;56218;716;5;721
53;56;56219;1389;22;1411
53;56;56220;1262;30;1292
53;56;56221;1747;83;1830
53;56;56222;2836;140;2976
53;56;56223;1469;59;1528
53;56;56224;381;10;391
53;56;56225;202;8;210
53;56;56226;532;23;555
53;56;56227;584;14;598
53;56;56228;1106;48;1154
53;56;56229;1294;19;1313
53;56;56230;470;11;481
53;56;56231;3847;123;3970
53;56;56232;1074;41;1115
53;56;56233;1495;43;1538
53;56;56234;2056;39;2095
53;56;56236;812;18;830
53;56;56237;1865;77;1942
53;56;56238;369;9;378
53;56;56239;1563;42;1605
53;56;56240;8791;177;8968
53;56;56241;996;24;1020
53;56;56242;652;18;670
53;56;56243;8900;255;9155
53;56;56244;3066;40;3106
53;56;56245;463;14;477
53;56;56246;2104;44;2148
53;56;56247;3756;90;3846
53;56;56248;4724;96;4820
53;56;56249;2191;87;2278
53;56;56250;604;5;609
53;56;56251;8251;236;8487
53;56;56252;1210;8;1218
53;56;56253;640;25;665
53;56;56254;1308;19;1327
53;56;56255;2406;56;2462
53;56;56256;116;0;116
53;56;56257;671;17;688
53;56;56258;1622;47;1669
53;56;56259;1687;22;1709
53;56;56260;53719;1973;55692
53;56;56261;1489;30;1519
53;56;56262;2533;43;2576
53;56;56263;2770;126;2896
53;56;56264;384;10;394
44;57;57001;330;3;333
44;57;57002;70;1;71
44;57;57003;1400;20;1420
44;57;57004;79;1;80
44;57;57006;991;28;1019
44;57;57007;124;2;126
44;57;57008;204;7;211
44;57;57009;104;1;105
44;57;57010;156;2;158
44;57;57011;618;23;641
44;57;57012;6120;56;6176
44;57;57013;2535;51;2586
44;57;57014;370;7;377
44;57;57015;577;7;584
44;57;57016;389;8;397
44;57;57017;2098;23;2121
44;57;57018;132;8;140
44;57;57019;10416;72;10488
44;57;57020;305;3;308
44;57;57021;1518;30;1548
44;57;57022;1253;29;1282
44;57;57024;184;0;184
44;57;57025;527;7;534
44;57;57026;1070;18;1088
44;57;57027;126;3;129
44;57;57028;1339;39;1378
44;57;57029;215;3;218
44;57;57030;565;3;568
44;57;57031;899;15;914
44;57;57032;4704;53;4757
44;57;57033;537;15;552
44;57;57034;35;1;36
44;57;57035;117;3;120
44;57;57036;103;0;103
44;57;57037;269;5;274
44;57;57038;7048;63;7111
44;57;57039;2165;34;2199
44;57;57040;278;2;280
44;57;57041;2351;33;2384
44;57;57042;593;12;605
44;57;57043;1469;31;1500
44;57;57044;123;5;128
44;57;57045;109;1;110
44;57;57046;763;14;777
44;57;57047;1055;20;1075
44;57;57048;73;2;75
44;57;57049;4517;72;4589
44;57;57050;112;2;114
44;57;57051;368;4;372
44;57;57052;576;9;585
44;57;57053;111;6;117
44;57;57054;188;0;188
44;57;57055;536;3;539
44;57;57056;194;5;199
44;57;57057;608;6;614
44;57;57058;6562;65;6627
44;57;57059;51;2;53
44;57;57060;532;7;539
44;57;57061;1152;26;1178
44;57;57062;432;14;446
44;57;57063;216;8;224
44;57;57064;261;4;265
44;57;57065;220;6;226
44;57;57066;514;8;522
44;57;57067;2801;59;2860
44;57;57069;463;7;470
44;57;57070;248;2;250
44;57;57071;387;5;392
44;57;57072;622;8;630
44;57;57073;870;16;886
44;57;57074;824;17;841
44;57;57075;293;3;296
44;57;57076;508;17;525
44;57;57077;97;3;100
44;57;57079;445;9;454
44;57;57080;83;0;83
44;57;57081;131;1;132
44;57;57082;331;7;338
44;57;57083;1211;26;1237
44;57;57084;303;2;305
44;57;57085;384;2;386
44;57;57086;235;5;240
44;57;57087;248;4;252
44;57;57088;313;7;320
44;57;57089;4951;101;5052
44;57;57090;111;2;113
44;57;57091;1010;21;1031
44;57;57092;619;8;627
44;57;57093;646;12;658
44;57;57095;578;9;587
44;57;57096;2476;25;2501
44;57;57097;5580;71;5651
44;57;57098;239;13;252
44;57;57099;230;5;235
44;57;57100;174;5;179
44;57;57101;1248;24;1272
44;57;57102;3205;48;3253
44;57;57103;125;4;129
44;57;57104;1180;28;1208
44;57;57105;150;1;151
44;57;57106;3926;78;4004
44;57;57107;106;0;106
44;57;57108;318;5;323
44;57;57109;761;12;773
44;57;57110;430;2;432
44;57;57111;525;3;528
44;57;57112;85;1;86
44;57;57113;972;22;994
44;57;57114;425;15;440
44;57;57115;96;4;100
44;57;57116;95;1;96
44;57;57117;588;5;593
44;57;57118;167;6;173
44;57;57119;1191;31;1222
44;57;57120;123;3;126
44;57;57121;212;5;217
44;57;57122;685;11;696
44;57;57123;3415;44;3459
44;57;57124;2628;34;2662
44;57;57125;420;7;427
44;57;57126;325;10;335
44;57;57127;147;1;148
44;57;57128;321;3;324
44;57;57129;672;21;693
44;57;57130;75;1;76
44;57;57131;286;11;297
44;57;57132;2357;244;2601
44;57;57133;96;0;96
44;57;57134;1916;193;2109
44;57;57136;570;17;587
44;57;57137;812;14;826
44;57;57138;83;3;86
44;57;57139;291;6;297
44;57;57140;577;10;587
44;57;57141;91;0;91
44;57;57142;423;7;430
44;57;57143;3374;33;3407
44;57;57144;3380;42;3422
44;57;57145;326;5;331
44;57;57146;796;19;815
44;57;57147;338;14;352
44;57;57148;567;11;578
44;57;57149;200;4;204
44;57;57150;691;8;699
44;57;57151;153;2;155
44;57;57152;510;10;520
44;57;57153;2185;39;2224
44;57;57154;634;19;653
44;57;57155;3006;325;3331
44;57;57156;1172;11;1183
44;57;57158;246;1;247
44;57;57159;3871;56;3927
44;57;57160;13042;216;13258
44;57;57161;116;1;117
44;57;57162;864;14;878
44;57;57163;2430;47;2477
44;57;57165;690;9;699
44;57;57166;107;2;109
44;57;57167;371;6;377
44;57;57168;679;16;695
44;57;57169;497;16;513
44;57;57171;1148;9;1157
44;57;57172;282;1;283
44;57;57173;101;3;104
44;57;57174;96;1;97
44;57;57175;221;6;227
44;57;57176;1680;41;1721
44;57;57177;2800;232;3032
44;57;57178;346;6;352
44;57;57179;1828;33;1861
44;57;57180;345;7;352
44;57;57181;78;1;79
44;57;57182;96;3;99
44;57;57183;189;2;191
44;57;57186;954;11;965
44;57;57187;367;6;373
44;57;57188;419;77;496
44;57;57189;222;2;224
44;57;57190;418;4;422
44;57;57191;705;8;713
44;57;57192;1239;33;1272
44;57;57193;2157;25;2182
44;57;57194;1242;37;1279
44;57;57195;572;15;587
44;57;57196;420;11;431
44;57;57197;513;5;518
44;57;57198;193;3;196
44;57;57199;686;15;701
44;57;57200;399;10;409
44;57;57201;725;13;738
44;57;57202;1161;17;1178
44;57;57203;228;4;232
44;57;57204;530;10;540
44;57;57205;2506;31;2537
44;57;57206;14442;157;14599
44;57;57207;5493;56;5549
44;57;57208;1355;34;1389
44;57;57209;5154;84;5238
44;57;57210;686;17;703
44;57;57211;1179;12;1191
44;57;57212;730;9;739
44;57;57213;773;14;787
44;57;57214;414;7;421
44;57;57215;324;4;328
44;57;57216;144;5;149
44;57;57217;900;18;918
44;57;57218;1286;30;1316
44;57;57219;546;6;552
44;57;57220;119;2;121
44;57;57221;11972;93;12065
44;57;57222;1325;38;1363
44;57;57224;3949;69;4018
44;57;57225;140;0;140
44;57;57226;3095;40;3135
44;57;57227;21597;290;21887
44;57;57228;200;5;205
44;57;57229;156;3;159
44;57;57230;195;2;197
44;57;57231;99;0;99
44;57;57232;776;12;788
44;57;57233;85;1;86
44;57;57234;597;8;605
44;57;57235;1037;20;1057
44;57;57236;84;0;84
44;57;57237;304;7;311
44;57;57238;190;6;196
44;57;57239;432;6;438
44;57;57240;12725;120;12845
44;57;57241;166;8;174
44;57;57242;3028;35;3063
44;57;57244;491;11;502
44;57;57245;570;9;579
44;57;57246;215;4;219
44;57;57247;80;3;83
44;57;57248;87;1;88
44;57;57249;259;7;266
44;57;57250;1494;40;1534
44;57;57251;339;2;341
44;57;57252;480;10;490
44;57;57253;501;3;504
44;57;57254;1157;10;1167
44;57;57255;575;23;598
44;57;57256;827;4;831
44;57;57257;105;0;105
44;57;57258;118;1;119
44;57;57259;319;7;326
44;57;57260;3296;53;3349
44;57;57261;1350;40;1390
44;57;57262;647;7;654
44;57;57263;642;19;661
44;57;57264;411;6;417
44;57;57265;58;4;62
44;57;57266;150;4;154
44;57;57267;850;18;868
44;57;57268;123;4;127
44;57;57269;7559;67;7626
44;57;57270;583;13;596
44;57;57271;667;17;684
44;57;57272;88;5;93
44;57;57273;395;9;404
44;57;57274;856;20;876
44;57;57275;919;12;931
44;57;57276;328;5;333
44;57;57277;149;6;155
44;57;57278;66;0;66
44;57;57280;370;20;390
44;57;57281;246;5;251
44;57;57282;357;4;361
44;57;57283;9287;105;9392
44;57;57284;113;5;118
44;57;57286;305;9;314
44;57;57287;2226;44;2270
44;57;57288;2848;40;2888
44;57;57289;2875;67;2942
44;57;57290;180;2;182
44;57;57291;263;4;267
44;57;57292;20;0;20
44;57;57293;258;6;264
44;57;57294;198;8;206
44;57;57295;106;1;107
44;57;57296;1096;20;1116
44;57;57297;183;6;189
44;57;57298;382;7;389
44;57;57299;917;16;933
44;57;57300;330;7;337
44;57;57301;304;12;316
44;57;57302;189;1;190
44;57;57303;599;9;608
44;57;57304;355;11;366
44;57;57305;451;8;459
44;57;57306;16005;186;16191
44;57;57307;249;5;254
44;57;57308;149;5;154
44;57;57309;483;9;492
44;57;57310;190;4;194
44;57;57311;527;9;536
44;57;57312;506;8;514
44;57;57313;141;3;144
44;57;57314;496;3;499
44;57;57315;712;15;727
44;57;57316;744;16;760
44;57;57317;108;4;112
44;57;57318;215;5;220
44;57;57319;521;5;526
44;57;57320;183;3;186
44;57;57321;563;19;582
44;57;57322;466;6;472
44;57;57323;7779;167;7946
44;57;57324;617;22;639
44;57;57325;832;17;849
44;57;57326;333;4;337
44;57;57328;89;2;91
44;57;57329;433;11;444
44;57;57330;1283;21;1304
44;57;57331;543;10;553
44;57;57332;6283;61;6344
44;57;57333;827;23;850
44;57;57334;324;10;334
44;57;57335;221;4;225
44;57;57336;5229;56;5285
44;57;57337;593;17;610
44;57;57338;515;6;521
44;57;57339;367;6;373
44;57;57340;1345;20;1365
44;57;57341;707;16;723
44;57;57342;96;1;97
44;57;57343;1835;31;1866
44;57;57344;734;9;743
44;57;57345;422;31;453
44;57;57346;590;23;613
44;57;57347;174;3;177
44;57;57348;797;17;814
44;57;57349;154;3;157
44;57;57350;1438;20;1458
44;57;57351;1223;19;1242
44;57;57352;445;15;460
44;57;57353;72;1;73
44;57;57354;122;5;127
44;57;57355;806;17;823
44;57;57356;1198;22;1220
44;57;57357;404;2;406
44;57;57358;1080;22;1102
44;57;57359;170;4;174
44;57;57360;1199;33;1232
44;57;57361;598;17;615
44;57;57362;174;3;177
44;57;57364;312;7;319
44;57;57365;474;11;485
44;57;57366;139;2;141
44;57;57367;225;4;229
44;57;57368;3192;59;3251
44;57;57370;2256;39;2295
44;57;57371;584;7;591
44;57;57372;1357;15;1372
44;57;57373;932;27;959
44;57;57374;198;6;204
44;57;57375;186;1;187
44;57;57376;504;6;510
44;57;57377;243;4;247
44;57;57379;273;2;275
44;57;57380;106;3;109
44;57;57381;292;6;298
44;57;57382;557;6;563
44;57;57383;164;6;170
44;57;57384;620;18;638
44;57;57385;1220;22;1242
44;57;57386;345;7;352
44;57;57387;290;1;291
44;57;57388;267;4;271
44;57;57389;471;12;483
44;57;57390;1432;38;1470
44;57;57391;65;1;66
44;57;57392;527;4;531
44;57;57393;206;3;209
44;57;57394;340;12;352
44;57;57395;204;4;208
44;57;57396;736;28;764
44;57;57397;102;1;103
44;57;57398;502;8;510
44;57;57399;94;8;102
44;57;57401;85;1;86
44;57;57402;120;4;124
44;57;57403;123;0;123
44;57;57404;209;7;216
44;57;57405;53;1;54
44;57;57406;138;7;145
44;57;57407;591;6;597
44;57;57408;877;19;896
44;57;57409;673;15;688
44;57;57410;137;3;140
44;57;57411;334;1;335
44;57;57412;3955;64;4019
44;57;57413;3651;84;3735
44;57;57414;1147;26;1173
44;57;57415;1748;76;1824
44;57;57416;657;17;674
44;57;57417;68;0;68
44;57;57418;322;4;326
44;57;57419;904;23;927
44;57;57421;153;3;156
44;57;57422;880;11;891
44;57;57423;75;0;75
44;57;57424;233;2;235
44;57;57425;573;4;577
44;57;57426;896;8;904
44;57;57427;568;10;578
44;57;57428;2753;67;2820
44;57;57430;330;5;335
44;57;57431;401;3;404
44;57;57433;11668;127;11795
44;57;57434;488;9;497
44;57;57436;127;6;133
44;57;57437;631;15;646
44;57;57438;348;5;353
44;57;57439;602;13;615
44;57;57440;142;3;145
44;57;57441;2915;59;2974
44;57;57442;242;2;244
44;57;57443;6458;57;6515
44;57;57444;351;2;353
44;57;57445;701;9;710
44;57;57446;41;1;42
44;57;57447;10108;231;10339
44;57;57448;257;6;263
44;57;57449;598;6;604
44;57;57451;168;3;171
44;57;57452;1011;16;1027
44;57;57453;298;10;308
44;57;57454;1139;24;1163
44;57;57455;149;3;152
44;57;57456;674;24;698
44;57;57457;139;2;141
44;57;57459;286;2;288
44;57;57460;1481;26;1507
44;57;57461;273;8;281
44;57;57462;419;7;426
44;57;57463;118489;1846;120335
44;57;57464;968;28;996
44;57;57465;2264;53;2317
44;57;57466;659;10;669
44;57;57467;294;2;296
44;57;57468;689;10;699
44;57;57469;603;5;608
44;57;57470;5;0;5
44;57;57471;297;3;300
44;57;57472;148;0;148
44;57;57473;67;2;69
44;57;57474;5631;77;5708
44;57;57475;525;14;539
44;57;57476;410;6;416
44;57;57477;1621;43;1664
44;57;57478;87;0;87
44;57;57479;465;12;477
44;57;57480;21879;357;22236
44;57;57481;2732;18;2750
44;57;57482;1759;31;1790
44;57;57483;3408;84;3492
44;57;57484;2684;29;2713
44;57;57485;124;2;126
44;57;57486;117;1;118
44;57;57487;5007;61;5068
44;57;57488;562;9;571
44;57;57489;302;6;308
44;57;57490;345;4;349
44;57;57491;7506;65;7571
44;57;57492;451;8;459
44;57;57493;211;5;216
44;57;57494;239;0;239
44;57;57495;116;1;117
44;57;57496;335;5;340
44;57;57497;263;9;272
44;57;57498;2590;52;2642
44;57;57499;1357;30;1387
44;57;57500;43;0;43
44;57;57501;36;0;36
44;57;57502;330;12;342
44;57;57504;280;4;284
44;57;57505;1211;22;1233
44;57;57506;252;1;253
44;57;57507;266;2;268
44;57;57508;4515;53;4568
44;57;57509;479;10;489
44;57;57510;1072;10;1082
44;57;57511;1033;21;1054
44;57;57512;716;11;727
44;57;57513;150;1;151
44;57;57514;1194;25;1219
44;57;57515;1823;24;1847
44;57;57516;337;10;347
44;57;57517;283;4;287
44;57;57518;331;9;340
44;57;57519;160;3;163
44;57;57520;33;2;35
44;57;57521;2706;53;2759
44;57;57524;128;1;129
44;57;57525;55;1;56
44;57;57526;383;1;384
44;57;57527;356;4;360
44;57;57528;101;1;102
44;57;57529;3099;65;3164
44;57;57530;442;6;448
44;57;57531;743;13;756
44;57;57532;229;3;232
44;57;57533;874;18;892
44;57;57534;1842;124;1966
44;57;57535;1443;36;1479
44;57;57536;221;5;226
44;57;57537;6298;98;6396
44;57;57538;295;2;297
44;57;57539;46;3;49
44;57;57540;4729;240;4969
44;57;57541;593;17;610
44;57;57542;974;11;985
44;57;57543;1498;24;1522
44;57;57544;615;16;631
44;57;57545;2021;57;2078
44;57;57546;811;31;842
44;57;57547;699;9;708
44;57;57548;543;7;550
44;57;57549;733;14;747
44;57;57550;2478;65;2543
44;57;57551;213;1;214
44;57;57552;627;8;635
44;57;57553;630;4;634
44;57;57554;694;21;715
44;57;57555;111;0;111
44;57;57556;3089;45;3134
44;57;57557;1009;24;1033
44;57;57558;80;0;80
44;57;57559;176;0;176
44;57;57560;624;13;637
44;57;57561;737;19;756
44;57;57562;847;18;865
44;57;57563;256;2;258
44;57;57564;557;15;572
44;57;57565;995;20;1015
44;57;57566;2358;64;2422
44;57;57567;147;1;148
44;57;57568;1397;28;1425
44;57;57569;320;6;326
44;57;57570;423;5;428
44;57;57571;1049;31;1080
44;57;57572;2006;101;2107
44;57;57573;135;3;138
44;57;57574;512;13;525
44;57;57575;1357;29;1386
44;57;57576;770;65;835
44;57;57577;375;7;382
44;57;57578;496;6;502
44;57;57579;128;1;129
44;57;57580;187;2;189
44;57;57581;351;7;358
44;57;57582;2092;42;2134
44;57;57583;136;2;138
44;57;57584;652;17;669
44;57;57586;186;2;188
44;57;57587;250;5;255
44;57;57588;1265;32;1297
44;57;57589;2313;49;2362
44;57;57590;256;6;262
44;57;57591;9861;99;9960
44;57;57592;348;2;350
44;57;57593;1018;10;1028
44;57;57594;98;3;101
44;57;57595;50;1;51
44;57;57596;747;11;758
44;57;57597;2650;20;2670
44;57;57598;2005;52;2057
44;57;57599;362;9;371
44;57;57600;1408;24;1432
44;57;57601;1343;42;1385
44;57;57602;2431;54;2485
44;57;57603;1273;17;1290
44;57;57604;624;6;630
44;57;57605;299;2;301
44;57;57606;15415;352;15767
44;57;57607;761;10;771
44;57;57609;174;2;176
44;57;57610;303;6;309
44;57;57611;191;6;197
44;57;57612;240;5;245
44;57;57613;357;3;360
44;57;57614;709;4;713
44;57;57615;968;19;987
44;57;57616;3373;84;3457
44;57;57617;284;6;290
44;57;57618;653;20;673
44;57;57619;472;10;482
44;57;57620;4350;61;4411
44;57;57621;109;1;110
44;57;57622;1909;21;1930
44;57;57623;711;50;761
44;57;57624;584;31;615
44;57;57625;178;2;180
44;57;57626;531;8;539
44;57;57627;324;4;328
44;57;57628;4485;94;4579
44;57;57629;777;6;783
44;57;57630;12449;312;12761
44;57;57631;20635;470;21105
44;57;57633;1262;31;1293
44;57;57634;1507;39;1546
44;57;57635;364;7;371
44;57;57636;316;12;328
44;57;57637;304;9;313
44;57;57638;2491;40;2531
44;57;57639;540;9;549
44;57;57640;479;14;493
44;57;57641;303;4;307
44;57;57642;2675;53;2728
44;57;57643;199;6;205
44;57;57644;1753;42;1795
44;57;57645;1021;9;1030
44;57;57647;4163;57;4220
44;57;57648;493;5;498
44;57;57649;475;4;479
44;57;57650;1776;13;1789
44;57;57651;648;6;654
44;57;57652;552;6;558
44;57;57653;33;2;35
44;57;57654;693;11;704
44;57;57655;1119;57;1176
44;57;57656;382;7;389
44;57;57657;19;0;19
44;57;57658;1053;20;1073
44;57;57659;3232;56;3288
44;57;57660;11178;126;11304
44;57;57661;174;3;177
44;57;57662;100;5;105
44;57;57663;7781;187;7968
44;57;57664;61;2;63
44;57;57665;1060;19;1079
44;57;57666;7134;90;7224
44;57;57667;790;8;798
44;57;57668;1280;35;1315
44;57;57669;2473;44;2517
44;57;57670;135;1;136
44;57;57671;154;0;154
44;57;57672;40778;756;41534
44;57;57673;47;0;47
44;57;57674;174;5;179
44;57;57675;115;1;116
44;57;57676;93;1;94
44;57;57677;1047;18;1065
44;57;57678;2220;35;2255
44;57;57679;533;4;537
44;57;57680;1256;28;1284
44;57;57681;338;5;343
44;57;57682;11;0;11
44;57;57683;6926;47;6973
44;57;57684;513;10;523
44;57;57685;151;2;153
44;57;57686;250;2;252
44;57;57687;213;4;217
44;57;57689;314;5;319
44;57;57690;3019;66;3085
44;57;57691;86;4;90
44;57;57692;74;0;74
44;57;57693;823;19;842
44;57;57694;438;11;449
44;57;57695;521;9;530
44;57;57696;961;26;987
44;57;57697;315;9;324
44;57;57698;317;6;323
44;57;57700;504;8;512
44;57;57701;810;26;836
44;57;57702;168;0;168
44;57;57703;233;17;250
44;57;57704;650;15;665
44;57;57705;207;5;212
44;57;57706;549;14;563
44;57;57707;652;6;658
44;57;57708;1953;43;1996
44;57;57709;310;7;317
44;57;57711;418;7;425
44;57;57712;1283;105;1388
44;57;57713;248;8;256
44;57;57714;431;9;440
44;57;57715;377;11;388
44;57;57716;1741;34;1775
44;57;57717;186;3;189
44;57;57718;218;1;219
44;57;57719;79;3;82
44;57;57720;495;12;507
44;57;57721;346;9;355
44;57;57723;293;6;299
44;57;57724;3021;35;3056
44;57;57725;348;7;355
44;57;57726;382;4;386
44;57;57727;122;1;123
44;57;57728;253;3;256
44;57;57730;566;12;578
44;57;57731;2269;40;2309
44;57;57732;777;21;798
44;57;57733;2034;29;2063
44;57;57734;458;11;469
44;57;57736;614;8;622
44;57;57737;31;2;33
44;57;57738;405;6;411
44;57;57739;504;2;506
44;57;57740;807;12;819
44;57;57741;438;13;451
44;57;57742;1499;41;1540
44;57;57743;243;7;250
44;57;57745;931;21;952
44;57;57746;1548;36;1584
44;57;57747;269;7;276
44;57;57748;765;17;782
44;57;57749;156;6;162
44;57;57750;718;26;744
44;57;57751;14014;137;14151
44;57;57752;2986;51;3037
44;57;57753;60;1;61
44;57;57754;111;1;112
44;57;57755;98;1;99
44;57;57756;310;3;313
44;57;57757;17143;265;17408
44;57;57759;63;1;64
44;57;57760;844;20;864
44;57;57761;267;4;271
44;57;57762;707;6;713
44;57;57763;46;2;48
44;57;57764;1245;14;1259
44;57;57765;1057;16;1073
44;57;57767;1308;34;1342
27;58;58001;160;0;160
27;58;58002;905;13;918
27;58;58003;607;7;614
27;58;58004;377;9;386
27;58;58005;224;1;225
27;58;58006;244;3;247
27;58;58007;340;5;345
27;58;58008;169;5;174
27;58;58009;128;1;129
27;58;58010;683;12;695
27;58;58011;283;5;288
27;58;58012;574;11;585
27;58;58013;97;1;98
27;58;58014;67;1;68
27;58;58015;120;3;123
27;58;58016;141;3;144
27;58;58017;226;7;233
27;58;58018;47;0;47
27;58;58019;83;3;86
27;58;58020;253;4;257
27;58;58021;204;5;209
27;58;58023;175;3;178
27;58;58024;280;11;291
27;58;58025;162;7;169
27;58;58026;141;9;150
27;58;58027;121;3;124
27;58;58028;117;3;120
27;58;58029;81;0;81
27;58;58030;284;11;295
27;58;58031;299;3;302
27;58;58032;361;6;367
27;58;58033;296;8;304
27;58;58034;183;6;189
27;58;58035;302;2;304
27;58;58036;464;9;473
27;58;58037;592;36;628
27;58;58038;160;5;165
27;58;58039;236;3;239
27;58;58040;144;3;147
27;58;58041;171;5;176
27;58;58042;136;2;138
27;58;58043;54;0;54
27;58;58044;813;10;823
27;58;58045;158;1;159
27;58;58046;1713;25;1738
27;58;58047;661;16;677
27;58;58048;107;5;112
27;58;58049;83;2;85
27;58;58050;45;2;47
27;58;58051;1526;133;1659
27;58;58052;45;2;47
27;58;58053;325;7;332
27;58;58054;39;1;40
27;58;58055;761;15;776
27;58;58056;297;7;304
27;58;58057;1152;19;1171
27;58;58058;300;5;305
27;58;58059;4742;57;4799
27;58;58060;619;9;628
27;58;58061;122;1;123
27;58;58062;1932;384;2316
27;58;58063;546;10;556
27;58;58064;499;15;514
27;58;58065;905;16;921
27;58;58066;84;0;84
27;58;58067;1503;23;1526
27;58;58068;209;5;214
27;58;58069;160;4;164
27;58;58070;57;2;59
27;58;58071;138;7;145
27;58;58072;618;10;628
27;58;58073;122;6;128
27;58;58074;339;5;344
27;58;58075;215;4;219
27;58;58076;79;0;79
27;58;58077;374;6;380
27;58;58078;54;0;54
27;58;58079;3590;183;3773
27;58;58080;169;1;170
27;58;58081;276;4;280
27;58;58082;285;4;289
27;58;58083;1440;109;1549
27;58;58084;85;4;89
27;58;58085;753;13;766
27;58;58086;9589;238;9827
27;58;58087;706;8;714
27;58;58088;3724;87;3811
27;58;58089;189;7;196
27;58;58090;219;1;220
27;58;58092;395;9;404
27;58;58093;127;2;129
27;58;58094;448;4;452
27;58;58095;5233;175;5408
27;58;58096;495;9;504
27;58;58097;92;1;93
27;58;58098;112;4;116
27;58;58099;164;3;167
27;58;58101;190;2;192
27;58;58102;1575;27;1602
27;58;58103;470;8;478
27;58;58104;1466;24;1490
27;58;58105;308;6;314
27;58;58106;353;4;357
27;58;58107;144;2;146
27;58;58108;85;1;86
27;58;58109;748;14;762
27;58;58110;245;2;247
27;58;58111;106;0;106
27;58;58112;632;7;639
27;58;58113;98;3;101
27;58;58114;93;4;97
27;58;58115;227;6;233
27;58;58116;131;5;136
27;58;58117;4125;53;4178
27;58;58118;642;7;649
27;58;58119;82;3;85
27;58;58120;224;0;224
27;58;58121;3740;46;3786
27;58;58122;425;8;433
27;58;58123;129;9;138
27;58;58124;769;9;778
27;58;58125;95;2;97
27;58;58126;450;7;457
27;58;58127;188;3;191
27;58;58128;91;0;91
27;58;58129;176;5;181
27;58;58130;95;2;97
27;58;58131;2510;40;2550
27;58;58132;227;11;238
27;58;58133;73;2;75
27;58;58134;3202;38;3240
27;58;58135;102;0;102
27;58;58136;68;2;70
27;58;58137;68;0;68
27;58;58138;357;10;367
27;58;58139;116;0;116
27;58;58140;231;5;236
27;58;58141;71;0;71
27;58;58142;239;4;243
27;58;58143;144;5;149
27;58;58144;698;6;704
27;58;58145;1273;29;1302
27;58;58146;978;19;997
27;58;58147;278;5;283
27;58;58148;615;11;626
27;58;58149;1988;38;2026
27;58;58150;110;6;116
27;58;58151;3240;53;3293
27;58;58152;1395;27;1422
27;58;58153;71;2;73
27;58;58154;117;1;118
27;58;58155;561;17;578
27;58;58156;145;2;147
27;58;58157;282;16;298
27;58;58158;306;6;312
27;58;58159;197;3;200
27;58;58160;3724;201;3925
27;58;58161;144;0;144
27;58;58162;110;1;111
27;58;58163;185;3;188
27;58;58164;667;28;695
27;58;58165;160;7;167
27;58;58166;231;2;233
27;58;58168;441;5;446
27;58;58169;15;3;18
27;58;58170;122;2;124
27;58;58171;289;2;291
27;58;58172;122;2;124
27;58;58173;158;0;158
27;58;58174;120;2;122
27;58;58175;157;1;158
27;58;58176;634;23;657
27;58;58177;281;1;282
27;58;58178;153;2;155
27;58;58179;259;7;266
27;58;58180;513;3;516
27;58;58181;145;5;150
27;58;58182;1445;24;1469
27;58;58183;97;1;98
27;58;58184;103;1;104
27;58;58185;529;4;533
27;58;58186;69;1;70
27;58;58187;518;6;524
27;58;58188;114;3;117
27;58;58189;478;4;482
27;58;58190;105;2;107
27;58;58191;113;3;116
27;58;58192;218;9;227
27;58;58193;1410;31;1441
27;58;58194;33005;1064;34069
27;58;58195;279;1;280
27;58;58196;347;3;350
27;58;58197;159;1;160
27;58;58198;301;5;306
27;58;58199;154;4;158
27;58;58200;149;1;150
27;58;58201;143;3;146
27;58;58202;24;0;24
27;58;58203;63;1;64
27;58;58204;540;8;548
27;58;58205;600;7;607
27;58;58206;36;0;36
27;58;58207;970;32;1002
27;58;58208;296;10;306
27;58;58209;150;5;155
27;58;58210;301;4;305
27;58;58211;147;3;150
27;58;58212;328;4;332
27;58;58213;467;9;476
27;58;58214;2355;51;2406
27;58;58215;1606;24;1630
27;58;58216;158;3;161
27;58;58217;198;3;201
27;58;58218;1823;27;1850
27;58;58219;208;4;212
27;58;58220;654;10;664
27;58;58221;150;2;152
27;58;58222;159;1;160
27;58;58223;630;8;638
27;58;58224;89;4;93
27;58;58225;369;7;376
27;58;58226;131;2;133
27;58;58227;1225;25;1250
27;58;58228;580;4;584
27;58;58229;311;5;316
27;58;58230;71;0;71
27;58;58231;392;8;400
27;58;58232;1265;20;1285
27;58;58233;166;7;173
27;58;58234;144;1;145
27;58;58235;260;3;263
27;58;58236;135;2;137
27;58;58237;29;2;31
27;58;58238;2221;50;2271
27;58;58239;159;2;161
27;58;58240;77;2;79
27;58;58241;316;4;320
27;58;58242;125;0;125
27;58;58243;116;3;119
27;58;58244;217;7;224
27;58;58245;166;4;170
27;58;58246;714;13;727
27;58;58247;484;7;491
27;58;58248;214;5;219
27;58;58249;352;2;354
27;58;58250;1863;46;1909
27;58;58251;474;7;481
27;58;58252;127;3;130
27;58;58253;78;5;83
27;58;58254;570;13;583
27;58;58255;279;5;284
27;58;58256;376;13;389
27;58;58257;64;0;64
27;58;58258;561;6;567
27;58;58259;144;3;147
27;58;58260;1246;27;1273
27;58;58261;1059;20;1079
27;58;58262;212;7;219
27;58;58263;170;2;172
27;58;58264;1879;26;1905
27;58;58265;94;3;97
27;58;58266;155;0;155
27;58;58267;724;80;804
27;58;58268;196;5;201
27;58;58269;413;10;423
27;58;58270;351;6;357
27;58;58271;187;3;190
27;58;58272;108;4;112
27;58;58273;1434;40;1474
27;58;58274;115;3;118
27;58;58275;297;4;301
27;58;58276;221;3;224
27;58;58277;191;7;198
27;58;58278;1482;68;1550
27;58;58279;180;6;186
27;58;58280;598;16;614
27;58;58281;596;14;610
27;58;58282;333;11;344
27;58;58283;74;2;76
27;58;58284;38;2;40
27;58;58285;160;5;165
27;58;58286;575;10;585
27;58;58287;191;4;195
27;58;58288;102;2;104
27;58;58289;189;0;189
27;58;58290;46;1;47
27;58;58291;176;0;176
27;58;58292;167;0;167
27;58;58293;416;4;420
27;58;58294;119;2;121
27;58;58295;986;15;1001
27;58;58296;137;0;137
27;58;58297;243;1;244
27;58;58298;398;9;407
27;58;58299;219;3;222
27;58;58300;1746;35;1781
27;58;58301;298;5;303
27;58;58302;928;5;933
27;58;58303;9201;177;9378
27;58;58304;1103;200;1303
27;58;58305;135;2;137
27;58;58306;296;9;305
27;58;58307;179;4;183
27;58;58308;62;0;62
27;58;58309;407;8;415
27;58;58310;48;1;49
27;58;58311;242;6;248
27;58;58312;269;9;278
27;58;58313;80;4;84
32;59;59001;469;13;482
32;59;59002;4309;34;4343
32;59;59003;372;6;378
32;59;59004;1320;14;1334
32;59;59005;3456;59;3515
32;59;59006;216;8;224
32;59;59007;890;9;899
32;59;59008;10085;83;10168
32;59;59009;61957;656;62613
32;59;59010;259;2;261
32;59;59011;10471;112;10583
32;59;59012;3221;45;3266
32;59;59013;1517;16;1533
32;59;59014;13329;82;13411
32;59;59015;3177;27;3204
32;59;59016;2200;47;2247
32;59;59017;24909;360;25269
32;59;59018;1570;17;1587
32;59;59019;1061;12;1073
32;59;59021;1815;18;1833
32;59;59022;2261;32;2293
32;59;59023;546;7;553
32;59;59024;4551;29;4580
32;59;59025;1674;22;1696
32;59;59026;1166;17;1183
32;59;59027;1705;15;1720
32;59;59028;7239;34;7273
32;59;59029;1502;21;1523
32;59;59031;372;4;376
32;59;59032;7224;71;7295
32;59;59033;8840;240;9080
32;59;59034;2641;44;2685
32;59;59035;2371;46;2417
32;59;59036;4195;138;4333
32;59;59037;3630;34;3664
32;59;59038;1449;17;1466
32;59;59039;816;18;834
32;59;59041;2291;17;2308
32;59;59042;1791;29;1820
32;59;59043;15163;241;15404
32;59;59044;4777;49;4826
32;59;59045;167;4;171
32;59;59046;812;11;823
32;59;59047;349;3;352
32;59;59048;523;11;534
32;59;59049;437;7;444
32;59;59050;344;8;352
32;59;59051;6509;51;6560
32;59;59052;5086;44;5130
32;59;59053;3264;60;3324
32;59;59054;998;8;1006
32;59;59055;511;11;522
32;59;59056;851;23;874
32;59;59057;561;14;575
32;59;59058;1014;14;1028
32;59;59059;441;4;445
32;59;59060;234;3;237
32;59;59061;266;2;268
32;59;59062;164;6;170
32;59;59063;2004;20;2024
32;59;59064;1261;12;1273
32;59;59065;813;10;823
32;59;59066;156;5;161
32;59;59067;3600;44;3644
32;59;59068;3175;36;3211
32;59;59069;736;12;748
32;59;59070;371;4;375
32;59;59071;2263;47;2310
32;59;59072;256;6;262
32;59;59073;556;13;569
32;59;59074;2168;36;2204
32;59;59075;755;11;766
32;59;59076;310;5;315
32;59;59077;257;6;263
32;59;59078;624;6;630
32;59;59079;6809;34;6843
32;59;59080;2796;31;2827
32;59;59081;572;6;578
32;59;59082;1801;30;1831
32;59;59083;253;2;255
32;59;59084;2059;30;2089
32;59;59085;305;6;311
32;59;59086;2155;30;2185
32;59;59087;750;13;763
32;59;59088;1739;21;1760
32;59;59089;1424;30;1454
32;59;59090;9808;181;9989
32;59;59091;578;14;592
32;59;59092;3924;40;3964
32;59;59093;341;5;346
32;59;59094;7152;50;7202
32;59;59096;1661;39;1700
32;59;59097;402;5;407
32;59;59098;4804;54;4858
32;59;59099;1757;14;1771
32;59;59100;348;4;352
32;59;59101;387;11;398
32;59;59102;438;4;442
32;59;59103;521;9;530
32;59;59104;3194;22;3216
32;59;59105;1532;25;1557
32;59;59106;756;14;770
32;59;59107;4495;45;4540
32;59;59108;750;4;754
32;59;59109;771;9;780
32;59;59110;1421;30;1451
32;59;59111;399;4;403
32;59;59112;11258;40;11298
32;59;59113;1361;6;1367
32;59;59114;1667;15;1682
32;59;59115;709;4;713
32;59;59116;414;12;426
32;59;59117;1049;12;1061
32;59;59118;2456;25;2481
32;59;59119;609;9;618
32;59;59120;2019;32;2051
32;59;59121;618;7;625
32;59;59122;32176;618;32794
32;59;59123;1699;23;1722
32;59;59124;2499;41;2540
32;59;59125;404;9;413
32;59;59126;1685;14;1699
32;59;59127;145;5;150
32;59;59128;2537;30;2567
32;59;59129;2268;27;2295
32;59;59130;1151;19;1170
32;59;59131;7920;74;7994
32;59;59132;1020;13;1033
32;59;59133;1033;19;1052
32;59;59134;1246;10;1256
32;59;59135;2265;100;2365
32;59;59136;7030;141;7171
32;59;59137;805;8;813
32;59;59138;682;14;696
32;59;59139;14121;140;14261
32;59;59140;452;10;462
32;59;59141;567;15;582
32;59;59142;709;5;714
32;59;59143;8577;94;8671
32;59;59144;862;10;872
32;59;59145;772;12;784
32;59;59146;2973;41;3014
32;59;59147;49;2;51
32;59;59148;361;1;362
32;59;59149;1088;16;1104
32;59;59150;526;11;537
32;59;59151;1617;17;1634
32;59;59152;12788;99;12887
32;59;59153;9515;54;9569
32;59;59155;20851;293;21144
32;59;59156;2842;32;2874
32;59;59157;2205;20;2225
32;59;59158;3077;45;3122
32;59;59159;668;6;674
32;59;59160;4495;30;4525
32;59;59161;751;45;796
32;59;59162;665;21;686
32;59;59163;20881;276;21157
32;59;59164;247;8;255
32;59;59165;6400;98;6498
32;59;59166;1337;36;1373
32;59;59167;198;1;199
32;59;59168;4849;69;4918
32;59;59169;202;4;206
32;59;59170;5360;33;5393
32;59;59171;37;2;39
32;59;59172;19877;122;19999
32;59;59173;1818;25;1843
32;59;59174;330;2;332
32;59;59175;310;9;319
32;59;59176;326;3;329
32;59;59177;857;14;871
32;59;59178;39613;858;40471
32;59;59179;10293;32;10325
32;59;59180;1466;19;1485
32;59;59181;551;6;557
32;59;59182;266;6;272
32;59;59183;86279;1268;87547
32;59;59184;658;10;668
32;59;59185;1963;13;1976
32;59;59186;80;1;81
32;59;59187;268;5;273
32;59;59188;140;4;144
32;59;59189;1221;26;1247
32;59;59190;986;14;1000
32;59;59191;625;5;630
32;59;59192;847;47;894
32;59;59193;3108;25;3133
32;59;59194;1282;23;1305
32;59;59195;613;9;622
32;59;59196;1304;19;1323
32;59;59197;2236;22;2258
32;59;59198;248;0;248
32;59;59199;686;11;697
32;59;59200;504;6;510
32;59;59201;597;11;608
32;59;59202;5316;40;5356
32;59;59203;1587;9;1596
32;59;59204;484;4;488
32;59;59205;9682;43;9725
32;59;59206;3218;28;3246
32;59;59207;4208;28;4236
32;59;59208;304;10;314
32;59;59209;674;8;682
32;59;59210;2116;39;2155
32;59;59211;906;19;925
32;59;59212;6461;136;6597
32;59;59213;458;15;473
32;59;59214;1103;21;1124
32;59;59215;959;33;992
32;59;59216;350;8;358
32;59;59217;346;7;353
32;59;59218;1307;15;1322
32;59;59219;712;8;720
32;59;59220;18191;122;18313
32;59;59221;2545;69;2614
32;59;59222;2213;45;2258
32;59;59223;504;4;508
32;59;59224;1698;14;1712
32;59;59225;6809;69;6878
32;59;59226;1454;16;1470
32;59;59227;5510;50;5560
32;59;59228;1458;17;1475
32;59;59229;564;9;573
32;59;59230;5273;52;5325
32;59;59231;1058;13;1071
32;59;59232;426;4;430
32;59;59233;365;3;368
32;59;59234;5781;43;5824
32;59;59236;261;4;265
32;59;59237;986;23;1009
32;59;59238;1635;25;1660
32;59;59239;5598;93;5691
32;59;59240;127;3;130
32;59;59241;520;15;535
32;59;59242;674;7;681
32;59;59243;1220;18;1238
32;59;59244;1776;31;1807
32;59;59246;570;4;574
32;59;59247;1462;18;1480
32;59;59249;11563;191;11754
32;59;59250;2231;105;2336
32;59;59251;376;4;380
32;59;59252;2447;20;2467
32;59;59253;7499;41;7540
32;59;59254;880;12;892
32;59;59255;571;8;579
32;59;59256;3290;33;3323
32;59;59257;1041;15;1056
32;59;59258;2827;642;3469
32;59;59259;511;20;531
32;59;59260;4131;60;4191
32;59;59261;1758;29;1787
32;59;59262;2086;38;2124
32;59;59263;1049;26;1075
32;59;59264;730;11;741
32;59;59265;2308;36;2344
32;59;59266;4031;42;4073
32;59;59267;302;4;306
32;59;59268;5639;49;5688
32;59;59269;1475;25;1500
32;59;59270;482;7;489
32;59;59271;22522;209;22731
32;59;59272;5130;47;5177
32;59;59273;11014;188;11202
32;59;59274;482;4;486
32;59;59275;1267;36;1303
32;59;59276;4689;34;4723
32;59;59277;332;4;336
32;59;59278;4676;37;4713
32;59;59279;20743;114;20857
32;59;59280;788;10;798
32;59;59281;1281;12;1293
32;59;59282;407;11;418
32;59;59283;613;10;623
32;59;59284;3918;31;3949
32;59;59285;2680;20;2700
32;59;59286;14725;115;14840
32;59;59287;193;4;197
32;59;59288;2340;26;2366
32;59;59289;1521;33;1554
32;59;59290;394;1;395
32;59;59291;14517;97;14614
32;59;59292;3304;6;3310
32;59;59293;1413;18;1431
32;59;59294;314;7;321
32;59;59295;21408;457;21865
32;59;59296;354;10;364
32;59;59297;1979;9;1988
32;59;59299;18636;174;18810
32;59;59300;548;9;557
32;59;59301;4433;27;4460
32;59;59302;4127;29;4156
32;59;59303;2393;27;2420
32;59;59304;418;8;426
32;59;59305;1649;34;1683
32;59;59306;292;3;295
32;59;59307;903;5;908
32;59;59308;934;24;958
32;59;59309;4060;82;4142
32;59;59310;867;10;877
32;59;59311;561;7;568
32;59;59312;760;17;777
32;59;59313;1423;9;1432
32;59;59314;3562;21;3583
32;59;59315;886;12;898
32;59;59316;3337;47;3384
32;59;59317;7782;94;7876
32;59;59318;984;8;992
32;59;59319;3194;202;3396
32;59;59320;1635;12;1647
32;59;59321;676;5;681
32;59;59322;3371;31;3402
32;59;59323;1145;26;1171
32;59;59324;10344;111;10455
32;59;59325;854;16;870
32;59;59326;1163;21;1184
32;59;59327;6364;39;6403
32;59;59328;27400;435;27835
32;59;59329;5007;84;5091
32;59;59330;2392;42;2434
32;59;59331;3482;107;3589
32;59;59332;1819;7;1826
32;59;59333;249;9;258
32;59;59334;1621;23;1644
32;59;59335;2847;55;2902
32;59;59336;1372;13;1385
32;59;59337;683;21;704
32;59;59338;651;27;678
32;59;59339;9378;80;9458
32;59;59340;4207;97;4304
32;59;59341;435;7;442
32;59;59342;225;4;229
32;59;59343;9012;85;9097
32;59;59344;2516;10;2526
32;59;59345;2430;23;2453
32;59;59346;3050;21;3071
32;59;59347;537;16;553
32;59;59348;1426;15;1441
32;59;59349;1916;30;1946
32;59;59350;234475;1925;236400
32;59;59351;550;7;557
32;59;59352;8275;97;8372
32;59;59353;326;7;333
32;59;59354;714;13;727
32;59;59356;2230;48;2278
32;59;59357;2082;33;2115
32;59;59358;1190;23;1213
32;59;59359;6085;76;6161
32;59;59360;22866;241;23107
32;59;59361;3952;18;3970
32;59;59363;931;19;950
32;59;59364;869;12;881
32;59;59365;6371;39;6410
32;59;59366;775;15;790
32;59;59367;13643;151;13794
32;59;59368;21856;188;22044
32;59;59369;4066;40;4106
32;59;59370;711;11;722
32;59;59371;639;15;654
32;59;59372;489;6;495
32;59;59374;473;4;477
32;59;59375;4584;63;4647
32;59;59377;1900;25;1925
32;59;59378;38486;697;39183
32;59;59379;748;3;751
32;59;59381;812;20;832
32;59;59382;1444;15;1459
32;59;59383;12083;114;12197
32;59;59384;1428;23;1451
32;59;59385;2701;21;2722
32;59;59386;10798;69;10867
32;59;59387;1897;12;1909
32;59;59388;1998;24;2022
32;59;59389;2745;29;2774
32;59;59390;4109;45;4154
32;59;59391;881;5;886
32;59;59392;29589;283;29872
32;59;59393;1033;12;1045
32;59;59394;403;3;406
32;59;59395;305;4;309
32;59;59396;720;7;727
32;59;59397;606;12;618
32;59;59398;3199;136;3335
32;59;59399;1011;28;1039
32;59;59400;9641;89;9730
32;59;59401;2307;37;2344
32;59;59402;837;22;859
32;59;59403;718;12;730
32;59;59405;481;3;484
32;59;59406;455;6;461
32;59;59407;538;9;547
32;59;59408;1632;19;1651
32;59;59409;2521;20;2541
32;59;59410;21277;138;21415
32;59;59411;2115;37;2152
32;59;59412;276;4;280
32;59;59413;557;9;566
32;59;59414;4793;40;4833
32;59;59415;224;1;225
32;59;59416;2524;41;2565
32;59;59418;1595;7;1602
32;59;59419;1408;16;1424
32;59;59420;58;2;60
32;59;59421;13121;177;13298
32;59;59422;630;12;642
32;59;59423;1263;19;1282
32;59;59424;1309;5;1314
32;59;59425;302;8;310
32;59;59426;10264;68;10332
32;59;59427;640;10;650
32;59;59428;3782;40;3822
32;59;59429;2688;16;2704
32;59;59430;1088;12;1100
32;59;59431;7512;79;7591
32;59;59432;514;7;521
32;59;59433;917;13;930
32;59;59434;1351;17;1368
32;59;59435;2549;37;2586
32;59;59436;788;10;798
32;59;59437;858;12;870
32;59;59438;811;13;824
32;59;59439;271;5;276
32;59;59440;697;6;703
32;59;59441;660;6;666
32;59;59442;269;6;275
32;59;59443;385;5;390
32;59;59444;924;11;935
32;59;59445;1189;17;1206
32;59;59446;649;8;657
32;59;59447;8789;64;8853
32;59;59448;471;5;476
32;59;59449;8633;145;8778
32;59;59450;640;9;649
32;59;59451;553;3;556
32;59;59452;5454;26;5480
32;59;59453;677;14;691
32;59;59454;517;4;521
32;59;59455;1009;8;1017
32;59;59456;6088;262;6350
32;59;59457;8542;42;8584
32;59;59458;918;19;937
32;59;59459;4887;37;4924
32;59;59461;310;2;312
32;59;59462;4820;38;4858
32;59;59463;973;12;985
32;59;59464;2222;18;2240
32;59;59465;776;3;779
32;59;59466;2911;92;3003
32;59;59467;2469;27;2496
32;59;59468;425;4;429
32;59;59469;412;4;416
32;59;59470;2123;24;2147
32;59;59471;1993;24;2017
32;59;59472;837;10;847
32;59;59473;309;7;316
32;59;59474;1036;21;1057
32;59;59475;2220;26;2246
32;59;59476;3124;75;3199
32;59;59477;4403;40;4443
32;59;59478;1129;26;1155
32;59;59479;3077;26;3103
32;59;59480;870;20;890
32;59;59481;4870;120;4990
32;59;59482;6931;62;6993
32;59;59483;136;2;138
32;59;59484;6362;33;6395
32;59;59485;1802;21;1823
32;59;59486;2701;44;2745
32;59;59487;1401;19;1420
32;59;59488;2179;40;2219
32;59;59489;4008;55;4063
32;59;59490;177;2;179
32;59;59491;12324;64;12388
32;59;59492;602;7;609
32;59;59493;228;1;229
32;59;59494;162;1;163
32;59;59495;2446;24;2470
32;59;59496;242;1;243
32;59;59497;2120;30;2150
32;59;59498;352;8;360
32;59;59499;1977;33;2010
32;59;59500;373;5;378
32;59;59501;1261;26;1287
32;59;59502;1432;9;1441
32;59;59503;198;3;201
32;59;59504;3807;21;3828
32;59;59505;760;3;763
32;59;59506;469;7;476
32;59;59507;19294;120;19414
32;59;59508;13482;129;13611
32;59;59509;6037;48;6085
32;59;59511;1931;27;1958
32;59;59512;98828;466;99294
32;59;59513;456;7;463
32;59;59514;4072;53;4125
32;59;59515;655;6;661
32;59;59516;928;19;947
32;59;59517;771;14;785
32;59;59518;459;7;466
32;59;59519;1758;33;1791
32;59;59520;1436;25;1461
32;59;59521;443;8;451
32;59;59522;1937;38;1975
32;59;59523;2830;27;2857
32;59;59524;5481;51;5532
32;59;59525;2799;25;2824
32;59;59526;15870;164;16034
32;59;59527;13151;117;13268
32;59;59528;1565;17;1582
32;59;59529;354;8;362
32;59;59530;348;1;349
32;59;59531;340;3;343
32;59;59532;309;8;317
32;59;59533;1566;14;1580
32;59;59534;827;31;858
32;59;59535;1706;49;1755
32;59;59536;902;22;924
32;59;59537;506;9;515
32;59;59538;425;11;436
32;59;59539;985;18;1003
32;59;59541;1027;7;1034
32;59;59542;511;12;523
32;59;59543;1095;10;1105
32;59;59544;11276;159;11435
32;59;59545;1216;23;1239
32;59;59546;1160;29;1189
32;59;59547;853;9;862
32;59;59548;640;8;648
32;59;59549;327;3;330
32;59;59550;2945;22;2967
32;59;59551;1707;24;1731
32;59;59552;196;6;202
32;59;59553;5608;50;5658
32;59;59554;608;15;623
32;59;59555;1437;18;1455
32;59;59556;259;3;262
32;59;59557;2492;16;2508
32;59;59558;1688;19;1707
32;59;59559;1974;32;2006
32;59;59560;12463;94;12557
32;59;59562;544;7;551
32;59;59563;237;3;240
32;59;59564;3117;16;3133
32;59;59565;651;11;662
32;59;59566;4775;37;4812
32;59;59567;414;6;420
32;59;59568;476;8;484
32;59;59569;15428;109;15537
32;59;59570;923;35;958
32;59;59571;4290;108;4398
32;59;59572;1780;21;1801
32;59;59573;139;3;142
32;59;59574;11934;77;12011
32;59;59575;403;4;407
32;59;59576;1806;27;1833
32;59;59577;649;5;654
32;59;59578;1673;30;1703
32;59;59579;1371;25;1396
32;59;59580;4429;85;4514
32;59;59581;3672;54;3726
32;59;59582;948;23;971
32;59;59583;471;4;475
32;59;59584;957;12;969
32;59;59585;3465;34;3499
32;59;59586;6332;87;6419
32;59;59587;522;14;536
32;59;59588;8285;220;8505
32;59;59589;2999;25;3024
32;59;59590;912;14;926
32;59;59591;836;3;839
32;59;59592;3884;33;3917
32;59;59593;751;11;762
32;59;59594;1119;13;1132
32;59;59595;541;7;548
32;59;59596;509;17;526
32;59;59597;651;23;674
32;59;59598;3911;29;3940
32;59;59599;98656;689;99345
32;59;59600;903;14;917
32;59;59601;2771;66;2837
32;59;59602;1405;30;1435
32;59;59603;6292;88;6380
32;59;59604;824;7;831
32;59;59605;1443;24;1467
32;59;59606;43229;448;43677
32;59;59607;488;5;493
32;59;59608;1098;21;1119
32;59;59609;1564;21;1585
32;59;59610;1073;9;1082
32;59;59611;2483;55;2538
32;59;59612;510;10;520
32;59;59613;1464;14;1478
32;59;59614;1414;20;1434
32;59;59615;2512;42;2554
32;59;59616;10465;51;10516
32;59;59617;635;7;642
32;59;59618;881;6;887
32;59;59619;1046;15;1061
32;59;59620;661;6;667
32;59;59622;1187;17;1204
32;59;59623;691;4;695
32;59;59624;2142;26;2168
32;59;59625;396;4;400
32;59;59626;1287;21;1308
32;59;59627;1008;11;1019
32;59;59628;563;6;569
32;59;59629;1338;23;1361
32;59;59630;2636;40;2676
32;59;59631;2153;30;2183
32;59;59632;5610;39;5649
32;59;59633;282;7;289
32;59;59634;794;20;814
32;59;59635;363;6;369
32;59;59636;10608;104;10712
32;59;59637;1319;14;1333
32;59;59638;1330;15;1345
32;59;59639;1102;23;1125
32;59;59640;767;11;778
32;59;59641;1996;43;2039
32;59;59642;581;17;598
32;59;59643;237;2;239
32;59;59645;595;4;599
32;59;59646;20860;232;21092
32;59;59647;2599;29;2628
32;59;59648;15075;193;15268
32;59;59649;240;5;245
32;59;59650;40898;172;41070
32;59;59651;1637;12;1649
32;59;59652;409;1;410
32;59;59653;7771;64;7835
32;59;59654;7402;69;7471
32;59;59655;254;4;258
32;59;59656;5353;50;5403
32;59;59657;637;7;644
32;59;59658;522;7;529
32;59;59659;2855;33;2888
32;59;59660;3048;40;3088
32;59;59661;136;2;138
32;59;59662;1313;23;1336
32;59;59663;5672;83;5755
32;59;59664;317;4;321
32;59;59665;296;6;302
32;59;59666;1536;25;1561
32;59;59667;228;6;234
32;59;59668;1601;60;1661
32;59;59669;518;17;535
32;59;59670;1337;13;1350
32;60;60001;621;8;629
32;60;60002;807;24;831
32;60;60003;503;13;516
32;60;60004;405;7;412
32;60;60005;872;13;885
32;60;60006;1155;20;1175
32;60;60007;3044;97;3141
32;60;60008;378;163;541
32;60;60009;1622;30;1652
32;60;60010;1747;17;1764
32;60;60011;404;5;409
32;60;60012;3286;49;3335
32;60;60013;1393;29;1422
32;60;60014;172;5;177
32;60;60015;1154;14;1168
32;60;60016;274;8;282
32;60;60017;1208;25;1233
32;60;60019;414;12;426
32;60;60020;256;8;264
32;60;60021;549;8;557
32;60;60022;644;15;659
32;60;60023;547;17;564
32;60;60024;769;8;777
32;60;60025;1881;40;1921
32;60;60026;585;13;598
32;60;60027;537;14;551
32;60;60028;459;25;484
32;60;60029;2836;60;2896
32;60;60030;558;9;567
32;60;60031;270;8;278
32;60;60032;719;14;733
32;60;60033;888;39;927
32;60;60034;1156;17;1173
32;60;60035;250;4;254
32;60;60036;384;6;390
32;60;60037;509;7;516
32;60;60039;487;6;493
32;60;60040;646;11;657
32;60;60041;2318;55;2373
32;60;60042;1469;46;1515
32;60;60043;622;13;635
32;60;60044;1682;24;1706
32;60;60045;578;10;588
32;60;60046;339;7;346
32;60;60047;761;16;777
32;60;60048;266;5;271
32;60;60049;114;3;117
32;60;60050;348;9;357
32;60;60051;180;1;181
32;60;60052;98;3;101
32;60;60053;595;50;645
32;60;60054;867;21;888
32;60;60055;338;5;343
32;60;60056;66;1;67
32;60;60057;57071;1449;58520
32;60;60058;216;4;220
32;60;60059;206;6;212
32;60;60060;621;10;631
32;60;60061;84;5;89
32;60;60062;319;4;323
32;60;60063;787;37;824
32;60;60064;991;16;1007
32;60;60065;1633;32;1665
32;60;60066;205;10;215
32;60;60067;1005;20;1025
32;60;60068;3108;40;3148
32;60;60069;1120;39;1159
32;60;60070;453;10;463
32;60;60071;173;5;178
32;60;60072;316;12;328
32;60;60073;569;6;575
32;60;60074;1185;29;1214
32;60;60075;143;1;144
32;60;60076;522;7;529
32;60;60077;356;9;365
32;60;60078;108;2;110
32;60;60079;982;12;994
32;60;60081;476;9;485
32;60;60082;790;17;807
32;60;60083;989;23;1012
32;60;60084;187;1;188
32;60;60085;198;2;200
32;60;60086;2142;44;2186
32;60;60087;338;18;356
32;60;60088;4764;73;4837
32;60;60089;409;11;420
32;60;60090;383;7;390
32;60;60091;407;6;413
32;60;60092;217;5;222
32;60;60093;460;9;469
32;60;60094;317;6;323
32;60;60095;343;7;350
32;60;60097;206;6;212
32;60;60098;153;1;154
32;60;60099;172;3;175
32;60;60100;112;0;112
32;60;60101;653;13;666
32;60;60102;2011;40;2051
32;60;60103;4022;54;4076
32;60;60104;4221;115;4336
32;60;60105;421;8;429
32;60;60106;2667;39;2706
32;60;60107;3116;146;3262
32;60;60108;288;8;296
32;60;60109;255;4;259
32;60;60110;247;0;247
32;60;60111;153;2;155
32;60;60112;349;1;350
32;60;60113;198;2;200
32;60;60114;148;0;148
32;60;60115;878;16;894
32;60;60116;2961;38;2999
32;60;60117;314;13;327
32;60;60118;506;9;515
32;60;60119;1943;38;1981
32;60;60120;1198;24;1222
32;60;60121;159;4;163
32;60;60122;488;9;497
32;60;60123;480;0;480
32;60;60124;310;7;317
32;60;60125;765;19;784
32;60;60126;502;6;508
32;60;60127;399;3;402
32;60;60128;226;0;226
32;60;60129;1513;20;1533
32;60;60130;1037;23;1060
32;60;60131;106;2;108
32;60;60132;188;3;191
32;60;60133;543;4;547
32;60;60134;2621;25;2646
32;60;60135;1640;39;1679
32;60;60136;501;13;514
32;60;60137;295;3;298
32;60;60138;908;28;936
32;60;60139;10147;133;10280
32;60;60140;313;4;317
32;60;60141;10950;228;11178
32;60;60142;3140;90;3230
32;60;60143;3340;42;3382
32;60;60144;177;3;180
32;60;60145;473;13;486
32;60;60146;455;3;458
32;60;60147;816;34;850
32;60;60148;416;8;424
32;60;60149;2021;68;2089
32;60;60150;1212;18;1230
32;60;60151;3288;105;3393
32;60;60152;245;1;246
32;60;60153;102;0;102
32;60;60154;1588;58;1646
32;60;60155;3996;50;4046
32;60;60156;2224;46;2270
32;60;60157;10163;235;10398
32;60;60158;244;2;246
32;60;60159;40615;1028;41643
32;60;60160;725;13;738
32;60;60161;72;0;72
32;60;60162;320;8;328
32;60;60163;406;6;412
32;60;60164;870;10;880
32;60;60165;533;15;548
32;60;60166;1067;32;1099
32;60;60167;576;14;590
32;60;60168;211;2;213
32;60;60169;809;21;830
32;60;60170;569;35;604
32;60;60171;180;3;183
32;60;60172;3976;148;4124
32;60;60173;810;12;822
32;60;60174;211;3;214
32;60;60175;36169;259;36428
32;60;60176;14788;266;15054
32;60;60177;445;8;453
32;60;60178;3503;123;3626
32;60;60179;150;1;151
32;60;60180;502;4;506
32;60;60181;901;20;921
32;60;60182;178;4;182
32;60;60183;256;3;259
32;60;60184;207;10;217
32;60;60185;1116;10;1126
32;60;60186;252;4;256
32;60;60187;970;14;984
32;60;60188;2216;106;2322
32;60;60189;981;21;1002
32;60;60190;297;6;303
32;60;60191;625;5;630
32;60;60192;220;5;225
32;60;60193;210;2;212
32;60;60194;248;2;250
32;60;60195;500;11;511
32;60;60196;1017;16;1033
32;60;60197;889;7;896
32;60;60198;395;6;401
32;60;60199;256;8;264
32;60;60200;318;2;320
32;60;60201;241;3;244
32;60;60203;426;8;434
32;60;60204;306;4;310
32;60;60205;51;1;52
32;60;60206;857;14;871
32;60;60207;288;6;294
32;60;60208;124;7;131
32;60;60209;540;10;550
32;60;60210;260;8;268
32;60;60211;599;5;604
32;60;60212;1606;27;1633
32;60;60213;996;21;1017
32;60;60214;216;3;219
32;60;60215;594;13;607
32;60;60216;184;2;186
32;60;60217;218;4;222
32;60;60218;1610;13;1623
32;60;60219;167;2;169
32;60;60220;502;5;507
32;60;60221;711;7;718
32;60;60222;554;16;570
32;60;60223;3759;54;3813
32;60;60224;151;1;152
32;60;60225;808;42;850
32;60;60226;421;6;427
32;60;60227;227;2;229
32;60;60228;466;8;474
32;60;60229;227;4;231
32;60;60230;523;14;537
32;60;60231;424;14;438
32;60;60232;473;3;476
32;60;60233;1366;21;1387
32;60;60234;2575;28;2603
32;60;60235;661;20;681
32;60;60236;217;0;217
32;60;60237;89;1;90
32;60;60238;1886;84;1970
32;60;60239;568;12;580
32;60;60240;238;3;241
32;60;60241;336;15;351
32;60;60242;505;7;512
32;60;60243;173;6;179
32;60;60244;139;1;140
32;60;60245;2113;28;2141
32;60;60247;146;2;148
32;60;60248;214;6;220
32;60;60249;199;2;201
32;60;60250;428;14;442
32;60;60251;281;5;286
32;60;60252;526;3;529
32;60;60253;490;8;498
32;60;60254;549;16;565
32;60;60255;338;3;341
32;60;60256;1321;26;1347
32;60;60257;438;10;448
32;60;60258;162;6;168
32;60;60259;893;23;916
32;60;60260;679;21;700
32;60;60261;517;12;529
32;60;60262;246;6;252
32;60;60263;261;1;262
32;60;60264;515;15;530
32;60;60265;984;13;997
32;60;60267;177;5;182
32;60;60268;338;1;339
32;60;60269;347;5;352
32;60;60270;338;85;423
32;60;60271;85;2;87
32;60;60272;631;19;650
32;60;60273;532;19;551
32;60;60274;377;13;390
32;60;60275;223;0;223
32;60;60276;215;2;217
32;60;60277;1544;39;1583
32;60;60278;398;3;401
32;60;60279;200;5;205
32;60;60280;109;0;109
32;60;60281;550;14;564
32;60;60282;8978;385;9363
32;60;60283;25;0;25
32;60;60284;1792;59;1851
32;60;60285;306;15;321
32;60;60286;2820;78;2898
32;60;60287;354;4;358
32;60;60288;474;5;479
32;60;60289;265;4;269
32;60;60290;387;4;391
32;60;60291;1805;24;1829
32;60;60292;237;7;244
32;60;60293;373;8;381
32;60;60294;85;1;86
32;60;60295;449;9;458
32;60;60296;138;1;139
32;60;60297;188;2;190
32;60;60298;645;7;652
32;60;60299;540;8;548
32;60;60301;136;5;141
32;60;60302;789;23;812
32;60;60303;196;1;197
32;60;60304;273;9;282
32;60;60305;334;4;338
32;60;60306;153;3;156
32;60;60307;638;10;648
32;60;60308;468;9;477
32;60;60309;873;21;894
32;60;60310;628;27;655
32;60;60311;238;2;240
32;60;60312;115;2;117
32;60;60313;2509;41;2550
32;60;60314;324;5;329
32;60;60315;496;10;506
32;60;60316;243;7;250
32;60;60317;719;8;727
32;60;60318;667;13;680
32;60;60319;608;6;614
32;60;60320;258;3;261
32;60;60321;831;7;838
32;60;60322;322;5;327
32;60;60323;650;11;661
32;60;60324;877;11;888
32;60;60325;2300;64;2364
32;60;60326;602;22;624
32;60;60327;1039;16;1055
32;60;60328;309;9;318
32;60;60329;202;6;208
32;60;60330;1347;26;1373
32;60;60331;442;6;448
32;60;60332;710;9;719
32;60;60333;1660;37;1697
32;60;60334;870;14;884
32;60;60335;148;1;149
32;60;60336;192;3;195
32;60;60337;732;29;761
32;60;60338;4891;163;5054
32;60;60339;363;9;372
32;60;60340;531;18;549
32;60;60341;2050;55;2105
32;60;60342;4721;52;4773
32;60;60343;626;23;649
32;60;60344;501;9;510
32;60;60345;190;2;192
32;60;60346;8784;231;9015
32;60;60347;283;5;288
32;60;60348;514;9;523
32;60;60350;1382;24;1406
32;60;60351;119;2;121
32;60;60352;163;2;165
32;60;60353;195;1;196
32;60;60354;35;1;36
32;60;60355;1175;51;1226
32;60;60356;640;17;657
32;60;60357;551;7;558
32;60;60358;1008;26;1034
32;60;60359;196;3;199
32;60;60360;7010;65;7075
32;60;60361;591;20;611
32;60;60362;177;6;183
32;60;60363;221;1;222
32;60;60364;705;8;713
32;60;60365;422;5;427
32;60;60366;363;5;368
32;60;60367;333;8;341
32;60;60368;2604;59;2663
32;60;60369;2004;36;2040
32;60;60370;1311;14;1325
32;60;60371;151;1;152
32;60;60372;662;16;678
32;60;60373;777;19;796
32;60;60374;2678;31;2709
32;60;60375;399;10;409
32;60;60376;165;1;166
32;60;60377;290;8;298
32;60;60378;394;5;399
32;60;60379;614;15;629
32;60;60380;1604;24;1628
32;60;60381;256;3;259
32;60;60382;8676;177;8853
32;60;60383;538;12;550
32;60;60385;668;13;681
32;60;60386;480;8;488
32;60;60387;1475;10;1485
32;60;60388;133;6;139
32;60;60389;245;2;247
32;60;60390;327;6;333
32;60;60391;230;3;233
32;60;60392;772;17;789
32;60;60393;613;13;626
32;60;60394;105;1;106
32;60;60395;14452;182;14634
32;60;60396;631;5;636
32;60;60397;77;1;78
32;60;60398;2207;30;2237
32;60;60399;239;18;257
32;60;60400;270;7;277
32;60;60401;787;33;820
32;60;60402;2327;62;2389
32;60;60403;1814;31;1845
32;60;60404;1474;36;1510
32;60;60405;1147;16;1163
32;60;60406;830;16;846
32;60;60407;218;2;220
32;60;60408;787;13;800
32;60;60409;2181;39;2220
32;60;60410;247;8;255
32;60;60411;775;12;787
32;60;60412;677;12;689
32;60;60413;412;9;421
32;60;60414;13645;166;13811
32;60;60415;137;9;146
32;60;60416;174;2;176
32;60;60418;412;13;425
32;60;60420;481;11;492
32;60;60421;401;7;408
32;60;60422;199;11;210
32;60;60423;1126;26;1152
32;60;60424;264;4;268
32;60;60425;477;17;494
32;60;60426;245;2;247
32;60;60427;178;1;179
32;60;60428;643;27;670
32;60;60429;416;16;432
32;60;60430;1088;13;1101
32;60;60431;542;11;553
32;60;60432;868;29;897
32;60;60433;987;20;1007
32;60;60434;223;6;229
32;60;60435;490;4;494
32;60;60436;76;2;78
32;60;60437;82;0;82
32;60;60438;196;5;201
32;60;60439;5237;74;5311
32;60;60440;609;16;625
32;60;60441;696;7;703
32;60;60442;147;2;149
32;60;60443;582;4;586
32;60;60444;159;5;164
32;60;60445;317;3;320
32;60;60446;4201;61;4262
32;60;60447;656;14;670
32;60;60448;388;6;394
32;60;60449;280;4;284
32;60;60450;3970;44;4014
32;60;60451;1645;28;1673
32;60;60452;490;14;504
32;60;60454;959;31;990
32;60;60456;927;28;955
32;60;60457;155;2;157
32;60;60458;317;15;332
32;60;60459;206;3;209
32;60;60460;199;8;207
32;60;60461;189;24;213
32;60;60462;2829;44;2873
32;60;60463;20780;362;21142
32;60;60464;1092;16;1108
32;60;60465;183;6;189
32;60;60466;250;3;253
32;60;60468;311;4;315
32;60;60469;363;9;372
32;60;60470;890;14;904
32;60;60471;13190;260;13450
32;60;60472;119;1;120
32;60;60473;289;1;290
32;60;60474;285;5;290
32;60;60476;199;8;207
32;60;60477;1399;23;1422
32;60;60478;356;9;365
32;60;60479;677;10;687
32;60;60480;551;17;568
32;60;60481;605;13;618
32;60;60482;3351;90;3441
32;60;60483;528;52;580
32;60;60484;277;6;283
32;60;60485;240;5;245
32;60;60486;575;10;585
32;60;60487;332;15;347
32;60;60488;273;6;279
32;60;60489;1174;14;1188
32;60;60490;372;14;386
32;60;60491;1833;210;2043
32;60;60492;853;19;872
32;60;60493;506;11;517
32;60;60494;1882;41;1923
32;60;60495;409;5;414
32;60;60496;162;1;163
32;60;60497;212;0;212
32;60;60498;528;3;531
32;60;60499;231;5;236
32;60;60500;3833;55;3888
32;60;60501;1351;31;1382
32;60;60502;99;4;103
32;60;60503;112;3;115
32;60;60504;1125;16;1141
32;60;60505;849;21;870
32;60;60506;681;12;693
32;60;60507;451;10;461
32;60;60508;3242;74;3316
32;60;60509;12602;122;12724
32;60;60510;645;16;661
32;60;60511;398;12;410
32;60;60512;159;2;161
32;60;60513;3220;70;3290
32;60;60514;242;1;243
32;60;60515;377;12;389
32;60;60516;411;3;414
32;60;60517;852;12;864
32;60;60518;207;4;211
32;60;60519;176;5;181
32;60;60520;222;8;230
32;60;60521;401;16;417
32;60;60522;316;3;319
32;60;60523;918;25;943
32;60;60524;2541;23;2564
32;60;60525;127;5;132
32;60;60526;1071;13;1084
32;60;60527;145;1;146
32;60;60528;129;2;131
32;60;60529;76;0;76
32;60;60530;217;9;226
32;60;60531;1920;39;1959
32;60;60533;1700;28;1728
32;60;60534;630;23;653
32;60;60535;331;6;337
32;60;60536;136;8;144
32;60;60537;3705;174;3879
32;60;60538;306;4;310
32;60;60539;1548;21;1569
32;60;60540;625;15;640
32;60;60541;356;12;368
32;60;60542;992;16;1008
32;60;60543;119;1;120
32;60;60544;195;1;196
32;60;60545;531;8;539
32;60;60546;139;4;143
32;60;60547;627;17;644
32;60;60548;603;7;610
32;60;60549;220;6;226
32;60;60550;222;0;222
32;60;60551;299;7;306
32;60;60552;246;9;255
32;60;60553;273;7;280
32;60;60554;472;9;481
32;60;60555;53;0;53
32;60;60556;205;3;208
32;60;60557;308;6;314
32;60;60558;461;18;479
32;60;60559;829;9;838
32;60;60560;727;33;760
32;60;60561;196;6;202
32;60;60562;1594;27;1621
32;60;60563;595;6;601
32;60;60564;280;3;283
32;60;60565;518;4;522
32;60;60566;205;3;208
32;60;60567;1165;29;1194
32;60;60568;332;8;340
32;60;60569;188;9;197
32;60;60570;1563;24;1587
32;60;60571;83;3;86
32;60;60572;296;9;305
32;60;60573;332;2;334
32;60;60574;623;16;639
32;60;60575;3344;44;3388
32;60;60576;485;13;498
32;60;60577;1709;35;1744
32;60;60578;1080;17;1097
32;60;60579;322;7;329
32;60;60581;6055;46;6101
32;60;60582;771;20;791
32;60;60583;356;9;365
32;60;60584;4678;99;4777
32;60;60585;283;5;288
32;60;60586;1033;22;1055
32;60;60587;1463;28;1491
32;60;60588;375;6;381
32;60;60589;2847;115;2962
32;60;60590;1243;24;1267
32;60;60591;1556;63;1619
32;60;60592;708;8;716
32;60;60593;139;2;141
32;60;60594;279;6;285
32;60;60595;438;3;441
32;60;60596;247;2;249
32;60;60597;1732;32;1764
32;60;60598;1043;86;1129
32;60;60599;291;5;296
32;60;60600;639;7;646
32;60;60601;1041;16;1057
32;60;60602;59;6;65
32;60;60603;897;22;919
32;60;60604;267;2;269
32;60;60605;349;6;355
32;60;60608;104;1;105
32;60;60609;887;23;910
32;60;60610;768;13;781
32;60;60611;597;14;611
32;60;60612;14760;626;15386
32;60;60613;344;7;351
32;60;60614;205;6;211
32;60;60615;134;1;135
32;60;60616;2739;33;2772
32;60;60617;269;4;273
32;60;60618;283;10;293
32;60;60619;1166;26;1192
32;60;60620;450;9;459
32;60;60621;142;1;143
32;60;60622;482;5;487
32;60;60623;982;80;1062
32;60;60624;173;4;177
32;60;60625;570;12;582
32;60;60626;669;18;687
32;60;60627;259;3;262
32;60;60628;1067;22;1089
32;60;60629;196;9;205
32;60;60630;186;3;189
32;60;60631;1077;24;1101
32;60;60632;757;16;773
32;60;60633;418;2;420
32;60;60634;437;11;448
32;60;60635;1075;10;1085
32;60;60636;4484;74;4558
32;60;60637;513;5;518
32;60;60638;672;9;681
32;60;60639;1234;24;1258
32;60;60640;172;1;173
32;60;60641;1725;49;1774
32;60;60642;1068;32;1100
32;60;60643;1371;14;1385
32;60;60644;1935;31;1966
32;60;60645;306;5;311
32;60;60646;1308;32;1340
32;60;60647;2063;54;2117
32;60;60648;324;4;328
32;60;60650;532;25;557
32;60;60651;1890;31;1921
32;60;60652;929;10;939
32;60;60653;301;2;303
32;60;60654;267;5;272
32;60;60655;365;10;375
32;60;60656;286;3;289
32;60;60657;253;5;258
32;60;60658;691;10;701
32;60;60659;171;2;173
32;60;60660;403;11;414
32;60;60661;987;83;1070
32;60;60662;505;13;518
32;60;60663;257;3;260
32;60;60664;453;11;464
32;60;60665;2884;62;2946
32;60;60666;1135;26;1161
32;60;60667;3813;53;3866
32;60;60668;740;24;764
32;60;60669;489;13;502
32;60;60670;4707;115;4822
32;60;60671;360;20;380
32;60;60672;273;13;286
32;60;60673;209;1;210
32;60;60674;615;31;646
32;60;60675;433;6;439
32;60;60676;758;16;774
32;60;60677;255;4;259
32;60;60678;1165;22;1187
32;60;60679;155;6;161
32;60;60680;664;17;681
32;60;60681;466;18;484
32;60;60682;708;38;746
32;60;60683;394;16;410
32;60;60684;6434;64;6498
32;60;60685;1012;9;1021
32;60;60686;2318;57;2375
32;60;60687;372;9;381
32;60;60688;161;1;162
32;60;60689;1390;58;1448
32;60;60691;118;1;119
32;60;60692;146;2;148
32;60;60693;425;4;429
32;60;60695;1402;50;1452
32;60;60697;34;1;35
32;60;60698;280;9;289
32;60;60699;165;5;170
32;60;60700;1187;21;1208
32;60;60701;1283;8;1291
32;60;60702;248;3;251
32;60;60703;870;17;887
28;61;61001;25870;752;26622
28;61;61002;669;10;679
28;61;61005;281;6;287
28;61;61006;13395;353;13748
28;61;61007;4217;85;4302
28;61;61008;1268;45;1313
28;61;61010;120;6;126
28;61;61011;416;14;430
28;61;61012;217;5;222
28;61;61013;136;0;136
28;61;61014;247;9;256
28;61;61015;262;7;269
28;61;61017;79;0;79
28;61;61018;62;1;63
28;61;61020;214;7;221
28;61;61021;102;4;106
28;61;61023;611;24;635
28;61;61024;600;14;614
28;61;61026;185;8;193
28;61;61028;457;11;468
28;61;61029;840;23;863
28;61;61030;272;4;276
28;61;61032;334;8;342
28;61;61034;204;7;211
28;61;61035;274;2;276
28;61;61036;204;0;204
28;61;61037;132;3;135
28;61;61038;1468;19;1487
28;61;61039;129;1;130
28;61;61040;1074;30;1104
28;61;61041;209;3;212
28;61;61043;1096;21;1117
28;61;61044;451;16;467
28;61;61046;133;0;133
28;61;61048;125;4;129
28;61;61049;128;2;130
28;61;61050;592;22;614
28;61;61051;358;6;364
28;61;61052;188;4;192
28;61;61053;235;7;242
28;61;61054;253;4;257
28;61;61055;614;11;625
28;61;61056;166;1;167
28;61;61060;166;1;167
28;61;61061;1478;31;1509
28;61;61062;91;2;93
28;61;61063;1517;41;1558
28;61;61064;93;3;96
28;61;61066;107;5;112
28;61;61067;161;4;165
28;61;61068;207;1;208
28;61;61069;170;7;177
28;61;61070;815;26;841
28;61;61071;176;7;183
28;61;61072;203;4;207
28;61;61074;643;7;650
28;61;61075;1172;26;1198
28;61;61076;134;6;140
28;61;61077;866;16;882
28;61;61078;714;48;762
28;61;61079;1770;24;1794
28;61;61080;83;2;85
28;61;61081;889;25;914
28;61;61082;88;4;92
28;61;61084;170;4;174
28;61;61085;33;0;33
28;61;61086;107;0;107
28;61;61087;162;4;166
28;61;61088;46;1;47
28;61;61089;96;0;96
28;61;61091;892;22;914
28;61;61092;677;6;683
28;61;61093;1259;17;1276
28;61;61094;589;17;606
28;61;61095;530;8;538
28;61;61096;3051;110;3161
28;61;61097;517;15;532
28;61;61098;448;31;479
28;61;61099;247;8;255
28;61;61100;282;17;299
28;61;61101;202;9;211
28;61;61102;405;10;415
28;61;61103;173;1;174
28;61;61104;51;1;52
28;61;61105;186;7;193
28;61;61107;393;11;404
28;61;61108;168;4;172
28;61;61111;329;13;342
28;61;61113;63;1;64
28;61;61114;154;5;159
28;61;61116;2058;40;2098
28;61;61117;2490;48;2538
28;61;61118;123;5;128
28;61;61120;75;0;75
28;61;61121;293;8;301
28;61;61122;83;6;89
28;61;61123;221;5;226
28;61;61124;500;5;505
28;61;61126;509;10;519
28;61;61129;366;11;377
28;61;61130;458;13;471
28;61;61133;707;18;725
28;61;61137;132;5;137
28;61;61138;209;4;213
28;61;61139;303;11;314
28;61;61140;847;16;863
28;61;61141;410;17;427
28;61;61142;138;4;142
28;61;61143;2464;63;2527
28;61;61145;4196;124;4320
28;61;61146;398;5;403
28;61;61148;299;11;310
28;61;61149;387;8;395
28;61;61150;742;13;755
28;61;61151;394;11;405
28;61;61152;98;0;98
28;61;61153;2190;49;2239
28;61;61156;537;14;551
28;61;61158;148;2;150
28;61;61159;70;1;71
28;61;61160;186;5;191
28;61;61162;160;3;163
28;61;61163;1545;22;1567
28;61;61164;241;2;243
28;61;61165;746;14;760
28;61;61166;141;3;144
28;61;61167;3092;62;3154
28;61;61168;5186;402;5588
28;61;61169;14762;364;15126
28;61;61170;196;3;199
28;61;61171;103;1;104
28;61;61176;143;2;145
28;61;61178;54;2;56
28;61;61180;84;1;85
28;61;61181;1811;59;1870
28;61;61182;418;5;423
28;61;61183;141;3;144
28;61;61187;194;7;201
28;61;61188;91;5;96
28;61;61189;458;216;674
28;61;61190;74;1;75
28;61;61192;107;3;110
28;61;61193;282;3;285
28;61;61194;883;14;897
28;61;61195;192;4;196
28;61;61196;1565;51;1616
28;61;61197;135;4;139
28;61;61198;134;0;134
28;61;61199;328;7;335
28;61;61202;464;11;475
28;61;61203;902;26;928
28;61;61206;252;4;256
28;61;61207;606;23;629
28;61;61208;617;15;632
28;61;61209;420;2;422
28;61;61210;248;9;257
28;61;61211;2162;54;2216
28;61;61212;126;4;130
28;61;61213;275;10;285
28;61;61214;7961;239;8200
28;61;61215;356;7;363
28;61;61216;192;3;195
28;61;61217;53;1;54
28;61;61218;1793;54;1847
28;61;61219;158;1;159
28;61;61221;450;8;458
28;61;61222;759;20;779
28;61;61224;452;6;458
28;61;61225;29;0;29
28;61;61227;145;3;148
28;61;61228;770;16;786
28;61;61229;126;4;130
28;61;61230;2985;50;3035
28;61;61232;1118;39;1157
28;61;61233;228;7;235
28;61;61234;1129;37;1166
28;61;61237;316;1;317
28;61;61238;88;1;89
28;61;61240;368;4;372
28;61;61241;411;11;422
28;61;61242;223;10;233
28;61;61243;1388;43;1431
28;61;61244;269;12;281
28;61;61248;520;8;528
28;61;61251;155;6;161
28;61;61252;136;4;140
28;61;61255;533;12;545
28;61;61256;153;5;158
28;61;61257;119;2;121
28;61;61258;670;11;681
28;61;61259;73;0;73
28;61;61260;539;10;549
28;61;61261;169;3;172
28;61;61262;112;1;113
28;61;61263;207;7;214
28;61;61264;54;1;55
28;61;61265;165;4;169
28;61;61266;76;0;76
28;61;61267;205;3;208
28;61;61268;110;5;115
28;61;61269;484;8;492
28;61;61271;86;0;86
28;61;61272;22;1;23
28;61;61273;52;3;55
28;61;61274;238;6;244
28;61;61275;772;19;791
28;61;61276;156;6;162
28;61;61277;281;6;287
28;61;61278;1854;54;1908
28;61;61279;611;15;626
28;61;61281;255;7;262
28;61;61283;283;9;292
28;61;61284;222;2;224
28;61;61286;79;0;79
28;61;61287;720;19;739
28;61;61288;519;7;526
28;61;61289;50;0;50
28;61;61290;131;4;135
28;61;61291;63;0;63
28;61;61292;654;9;663
28;61;61293;3775;296;4071
28;61;61294;1153;27;1180
28;61;61295;162;2;164
28;61;61297;732;10;742
28;61;61298;314;11;325
28;61;61300;383;8;391
28;61;61301;212;1;213
28;61;61302;136;3;139
28;61;61303;517;13;530
28;61;61304;301;6;307
28;61;61307;227;2;229
28;61;61308;206;4;210
28;61;61309;2022;63;2085
28;61;61310;446;30;476
28;61;61314;669;17;686
28;61;61316;115;3;118
28;61;61317;179;5;184
28;61;61319;263;7;270
28;61;61321;420;6;426
28;61;61322;108;2;110
28;61;61323;128;2;130
28;61;61324;1162;14;1176
28;61;61326;308;6;314
28;61;61327;341;11;352
28;61;61328;268;5;273
28;61;61329;639;11;650
28;61;61330;185;3;188
28;61;61331;137;2;139
28;61;61332;315;43;358
28;61;61333;174;4;178
28;61;61336;103;7;110
28;61;61339;2140;32;2172
28;61;61341;1647;55;1702
28;61;61342;1406;30;1436
28;61;61344;1036;13;1049
28;61;61345;1903;42;1945
28;61;61346;203;6;209
28;61;61347;176;0;176
28;61;61348;372;6;378
28;61;61349;161;3;164
28;61;61350;160;8;168
28;61;61351;133;4;137
28;61;61352;175;5;180
28;61;61357;200;3;203
28;61;61358;225;5;230
28;61;61360;91;2;93
28;61;61361;173;6;179
28;61;61362;543;19;562
28;61;61363;58;2;60
28;61;61365;406;9;415
28;61;61366;134;2;136
28;61;61367;131;2;133
28;61;61369;1026;37;1063
28;61;61370;150;2;152
28;61;61371;135;2;137
28;61;61372;115;4;119
28;61;61373;245;8;253
28;61;61374;96;4;100
28;61;61375;1190;36;1226
28;61;61376;864;18;882
28;61;61379;233;5;238
28;61;61381;59;5;64
28;61;61382;1128;19;1147
28;61;61384;256;2;258
28;61;61385;338;8;346
28;61;61386;442;31;473
28;61;61387;539;18;557
28;61;61388;157;2;159
28;61;61389;1041;23;1064
28;61;61390;158;1;159
28;61;61391;3152;113;3265
28;61;61392;142;4;146
28;61;61393;135;5;140
28;61;61394;797;20;817
28;61;61395;238;7;245
28;61;61396;80;5;85
28;61;61397;3780;132;3912
28;61;61398;59;1;60
28;61;61399;73;3;76
28;61;61400;361;7;368
28;61;61401;106;4;110
28;61;61402;307;8;315
28;61;61404;629;21;650
28;61;61405;531;12;543
28;61;61406;316;5;321
28;61;61407;698;13;711
28;61;61408;329;9;338
28;61;61411;280;11;291
28;61;61412;676;15;691
28;61;61413;138;4;142
28;61;61414;888;21;909
28;61;61415;319;6;325
28;61;61416;77;1;78
28;61;61418;417;11;428
28;61;61419;216;7;223
28;61;61420;88;1;89
28;61;61421;661;18;679
28;61;61422;617;15;632
28;61;61423;642;27;669
28;61;61424;199;4;203
28;61;61425;145;2;147
28;61;61426;562;17;579
28;61;61427;194;4;198
28;61;61429;784;16;800
28;61;61432;607;22;629
28;61;61433;284;8;292
28;61;61435;272;4;276
28;61;61436;235;2;237
28;61;61438;174;5;179
28;61;61439;121;4;125
28;61;61440;828;35;863
28;61;61442;218;6;224
28;61;61443;689;15;704
28;61;61444;119;3;122
28;61;61445;668;10;678
28;61;61446;155;5;160
28;61;61447;1404;20;1424
28;61;61448;431;6;437
28;61;61450;72;1;73
28;61;61451;311;6;317
28;61;61452;175;0;175
28;61;61453;245;7;252
28;61;61454;598;16;614
28;61;61456;1670;49;1719
28;61;61457;479;8;487
28;61;61459;308;6;314
28;61;61460;960;10;970
28;61;61461;127;3;130
28;61;61462;1039;34;1073
28;61;61463;1726;34;1760
28;61;61464;4198;444;4642
28;61;61466;1478;39;1517
28;61;61467;338;11;349
28;61;61472;305;12;317
28;61;61473;267;6;273
28;61;61474;3700;80;3780
28;61;61475;668;15;683
28;61;61476;276;5;281
28;61;61479;157;4;161
28;61;61480;232;5;237
28;61;61481;75;3;78
28;61;61482;381;9;390
28;61;61483;2732;51;2783
28;61;61484;3432;73;3505
28;61;61485;198;7;205
28;61;61486;4882;87;4969
28;61;61487;299;4;303
28;61;61488;90;2;92
28;61;61490;302;1;303
28;61;61491;3092;50;3142
28;61;61492;119;4;123
28;61;61493;60;5;65
28;61;61494;1235;66;1301
28;61;61497;1768;29;1797
28;61;61498;101;4;105
28;61;61499;146;3;149
28;61;61500;124;4;128
28;61;61501;423;5;428
28;61;61502;99;0;99
28;61;61503;196;4;200
28;61;61505;214;6;220
28;61;61507;282;5;287
28;61;61508;3116;87;3203
28;61;61510;231;4;235
28;61;61512;106;3;109
32;62;62001;1877;38;1915
32;62;62002;229;3;232
32;62;62003;604;22;626
32;62;62004;7957;108;8065
32;62;62005;971;5;976
32;62;62006;311;5;316
32;62;62007;798;5;803
32;62;62008;808;11;819
32;62;62009;274;7;281
32;62;62010;250;0;250
32;62;62011;654;16;670
32;62;62012;255;4;259
32;62;62013;1899;35;1934
32;62;62014;9691;265;9956
32;62;62015;238;2;240
32;62;62016;190;5;195
32;62;62017;203;1;204
32;62;62018;267;5;272
32;62;62019;3923;42;3965
32;62;62020;624;11;635
32;62;62021;383;1;384
32;62;62022;314;10;324
32;62;62023;2890;30;2920
32;62;62024;984;12;996
32;62;62025;1946;30;1976
32;62;62026;117;9;126
32;62;62027;221;0;221
32;62;62028;628;8;636
32;62;62029;467;1;468
32;62;62030;300;4;304
32;62;62031;1554;23;1577
32;62;62032;4698;57;4755
32;62;62033;4377;25;4402
32;62;62034;2143;14;2157
32;62;62035;5836;46;5882
32;62;62036;748;17;765
32;62;62037;2751;87;2838
32;62;62038;4403;47;4450
32;62;62039;862;17;879
32;62;62040;9584;127;9711
32;62;62041;41694;788;42482
32;62;62042;1045;13;1058
32;62;62043;2027;28;2055
32;62;62044;784;8;792
32;62;62045;1472;19;1491
32;62;62046;742;6;748
32;62;62047;151;1;152
32;62;62048;10272;44;10316
32;62;62049;530;2;532
32;62;62050;1562;16;1578
32;62;62051;4678;32;4710
32;62;62052;454;13;467
32;62;62053;662;6;668
32;62;62054;588;7;595
32;62;62055;534;8;542
32;62;62056;634;5;639
32;62;62057;5434;53;5487
32;62;62058;199;5;204
32;62;62059;289;14;303
32;62;62060;2572;24;2596
32;62;62061;292;7;299
32;62;62062;54;1;55
32;62;62063;1833;31;1864
32;62;62064;166;2;168
32;62;62065;17625;139;17764
32;62;62066;35;2;37
32;62;62067;619;4;623
32;62;62068;325;7;332
32;62;62069;310;8;318
32;62;62070;260;5;265
32;62;62071;405;7;412
32;62;62072;227;3;230
32;62;62073;1423;25;1448
32;62;62074;232;8;240
32;62;62075;1294;30;1324
32;62;62076;218;1;219
32;62;62077;366;6;372
32;62;62078;1227;10;1237
32;62;62079;88;0;88
32;62;62080;3748;319;4067
32;62;62081;477;10;487
32;62;62082;312;4;316
32;62;62083;7544;44;7588
32;62;62084;212;8;220
32;62;62085;135;5;140
32;62;62086;385;7;392
32;62;62087;1002;22;1024
32;62;62088;328;6;334
32;62;62089;394;13;407
32;62;62090;129;5;134
32;62;62091;87;1;88
32;62;62092;403;3;406
32;62;62093;229;0;229
32;62;62094;409;4;413
32;62;62095;241;1;242
32;62;62096;571;3;574
32;62;62097;1002;14;1016
32;62;62099;5552;62;5614
32;62;62100;2089;27;2116
32;62;62101;138;1;139
32;62;62102;275;3;278
32;62;62103;130;2;132
32;62;62104;432;7;439
32;62;62105;566;16;582
32;62;62106;203;6;209
32;62;62107;356;9;365
32;62;62108;13482;331;13813
32;62;62109;220;1;221
32;62;62111;283;79;362
32;62;62112;516;8;524
32;62;62113;487;12;499
32;62;62114;168;4;172
32;62;62115;467;18;485
32;62;62116;184;1;185
32;62;62117;916;14;930
32;62;62118;143;4;147
32;62;62119;25039;349;25388
32;62;62120;467;8;475
32;62;62121;173;4;177
32;62;62122;357;4;361
32;62;62123;539;4;543
32;62;62124;453;5;458
32;62;62125;460;14;474
32;62;62126;9219;160;9379
32;62;62127;388;11;399
32;62;62128;4305;47;4352
32;62;62129;97;2;99
32;62;62130;651;13;664
32;62;62131;343;3;346
32;62;62132;4885;40;4925
32;62;62133;8177;41;8218
32;62;62134;111;2;113
32;62;62135;307;3;310
32;62;62137;98;1;99
32;62;62138;716;13;729
32;62;62139;4944;133;5077
32;62;62140;501;5;506
32;62;62141;877;13;890
32;62;62142;160;7;167
32;62;62143;49;1;50
32;62;62144;465;7;472
32;62;62145;444;6;450
32;62;62146;274;0;274
32;62;62147;410;5;415
32;62;62148;819;9;828
32;62;62149;245;8;253
32;62;62150;499;7;506
32;62;62151;512;10;522
32;62;62152;244;3;247
32;62;62153;645;7;652
32;62;62154;676;14;690
32;62;62155;639;14;653
32;62;62156;559;13;572
32;62;62157;79;3;82
32;62;62158;582;13;595
32;62;62160;40251;436;40687
32;62;62161;786;5;791
32;62;62162;606;6;612
32;62;62163;248;3;251
32;62;62164;1141;18;1159
32;62;62165;233;5;238
32;62;62166;624;7;631
32;62;62167;253;4;257
32;62;62168;845;12;857
32;62;62169;238;6;244
32;62;62170;2372;93;2465
32;62;62171;131;2;133
32;62;62172;360;3;363
32;62;62173;5088;63;5151
32;62;62174;1290;13;1303
32;62;62175;159;5;164
32;62;62176;655;18;673
32;62;62177;855;22;877
32;62;62178;21903;367;22270
32;62;62179;412;7;419
32;62;62180;291;6;297
32;62;62181;1445;90;1535
32;62;62182;235;7;242
32;62;62183;765;4;769
32;62;62184;282;3;285
32;62;62185;235;1;236
32;62;62186;12156;77;12233
32;62;62187;183;2;185
32;62;62188;2833;31;2864
32;62;62189;133;2;135
32;62;62190;1257;19;1276
32;62;62191;732;3;735
32;62;62192;431;7;438
32;62;62193;72509;625;73134
32;62;62194;5507;33;5540
32;62;62195;1540;20;1560
32;62;62196;614;11;625
32;62;62197;1779;16;1795
32;62;62198;342;10;352
32;62;62199;663;126;789
32;62;62200;1229;13;1242
32;62;62201;2730;40;2770
32;62;62202;667;98;765
32;62;62203;449;11;460
32;62;62204;1942;37;1979
32;62;62205;1273;27;1300
32;62;62206;289;15;304
32;62;62207;551;22;573
32;62;62208;71;2;73
32;62;62209;154;10;164
32;62;62211;220;4;224
32;62;62212;505;11;516
32;62;62213;780;11;791
32;62;62214;588;11;599
32;62;62215;17557;103;17660
32;62;62216;207;2;209
32;62;62217;2744;15;2759
32;62;62218;337;8;345
32;62;62219;159;4;163
32;62;62220;449;6;455
32;62;62221;249;5;254
32;62;62222;159;2;161
32;62;62223;291;5;296
32;62;62224;2831;27;2858
32;62;62225;606;11;617
32;62;62227;188;2;190
32;62;62228;327;3;330
32;62;62229;793;16;809
32;62;62230;971;13;984
32;62;62231;131;0;131
32;62;62232;904;15;919
32;62;62233;1125;14;1139
32;62;62234;222;4;226
32;62;62235;2485;89;2574
32;62;62236;341;9;350
32;62;62237;505;10;515
32;62;62238;84;1;85
32;62;62239;2602;34;2636
32;62;62240;2302;17;2319
32;62;62241;310;5;315
32;62;62242;96;5;101
32;62;62243;125;3;128
32;62;62244;5430;206;5636
32;62;62245;760;7;767
32;62;62246;154;0;154
32;62;62247;604;11;615
32;62;62248;469;6;475
32;62;62249;8104;39;8143
32;62;62250;10554;96;10650
32;62;62251;512;191;703
32;62;62252;2677;71;2748
32;62;62253;71;0;71
32;62;62254;602;15;617
32;62;62255;793;15;808
32;62;62256;152;2;154
32;62;62257;470;10;480
32;62;62258;266;5;271
32;62;62259;1970;24;1994
32;62;62260;330;3;333
32;62;62261;5059;93;5152
32;62;62262;1746;23;1769
32;62;62263;5681;112;5793
32;62;62264;1346;4;1350
32;62;62265;1183;16;1199
32;62;62266;89;2;91
32;62;62267;395;6;401
32;62;62268;4875;39;4914
32;62;62269;733;11;744
32;62;62270;6963;40;7003
32;62;62271;834;17;851
32;62;62272;311;2;313
32;62;62273;618;9;627
32;62;62274;5928;44;5972
32;62;62275;303;7;310
32;62;62276;5680;46;5726
32;62;62277;2926;12;2938
32;62;62278;615;19;634
32;62;62279;1347;125;1472
32;62;62280;329;2;331
32;62;62281;387;6;393
32;62;62282;180;0;180
32;62;62283;134;0;134
32;62;62284;1685;19;1704
32;62;62285;492;9;501
32;62;62286;506;4;510
32;62;62288;2165;44;2209
32;62;62289;704;21;725
32;62;62290;381;7;388
32;62;62291;2840;31;2871
32;62;62292;876;15;891
32;62;62293;234;5;239
32;62;62295;1623;27;1650
32;62;62296;281;2;283
32;62;62297;3696;46;3742
32;62;62298;548;10;558
32;62;62299;248;5;253
32;62;62300;2662;35;2697
32;62;62301;80;1;81
32;62;62302;234;2;236
32;62;62303;245;6;251
32;62;62304;332;2;334
32;62;62306;392;3;395
32;62;62307;217;9;226
32;62;62308;476;10;486
32;62;62309;1632;21;1653
32;62;62310;1755;19;1774
32;62;62311;2039;10;2049
32;62;62312;292;6;298
32;62;62313;917;6;923
32;62;62314;364;2;366
32;62;62315;348;9;357
32;62;62316;196;6;202
32;62;62317;454;3;457
32;62;62318;10912;113;11025
32;62;62319;258;3;261
32;62;62320;311;8;319
32;62;62321;4625;26;4651
32;62;62322;114;1;115
32;62;62323;1203;21;1224
32;62;62324;590;14;604
32;62;62325;961;20;981
32;62;62326;244;5;249
32;62;62327;609;4;613
32;62;62328;909;10;919
32;62;62329;1768;20;1788
32;62;62330;1283;24;1307
32;62;62331;1024;20;1044
32;62;62332;508;10;518
32;62;62333;387;6;393
32;62;62334;868;16;884
32;62;62335;516;5;521
32;62;62336;480;7;487
32;62;62337;222;5;227
32;62;62338;2698;55;2753
32;62;62339;111;1;112
32;62;62340;883;7;890
32;62;62341;420;8;428
32;62;62342;105;1;106
32;62;62343;265;2;267
32;62;62344;108;3;111
32;62;62345;99;1;100
32;62;62346;214;4;218
32;62;62347;129;3;132
32;62;62348;165;2;167
32;62;62349;1609;23;1632
32;62;62350;1131;20;1151
32;62;62351;6434;38;6472
32;62;62352;106;2;108
32;62;62353;236;6;242
32;62;62354;870;17;887
32;62;62355;581;5;586
32;62;62356;797;8;805
32;62;62357;71;1;72
32;62;62358;228;6;234
32;62;62359;580;13;593
32;62;62360;1389;14;1403
32;62;62361;3423;56;3479
32;62;62362;240;3;243
32;62;62363;382;9;391
32;62;62364;2352;242;2594
32;62;62365;201;0;201
32;62;62366;312;7;319
32;62;62367;830;37;867
32;62;62368;203;0;203
32;62;62369;784;17;801
32;62;62370;125;1;126
32;62;62371;2030;45;2075
32;62;62372;150;3;153
32;62;62373;1040;11;1051
32;62;62374;153;8;161
32;62;62375;91;1;92
32;62;62376;2508;38;2546
32;62;62377;956;7;963
32;62;62378;200;4;204
32;62;62379;326;8;334
32;62;62380;347;1;348
32;62;62381;132;2;134
32;62;62382;652;13;665
32;62;62383;1386;19;1405
32;62;62384;646;8;654
32;62;62385;385;5;390
32;62;62386;6799;32;6831
32;62;62387;360;10;370
32;62;62388;297;1;298
32;62;62389;30;2;32
32;62;62390;1531;44;1575
32;62;62391;1399;14;1413
32;62;62392;361;9;370
32;62;62393;1097;21;1118
32;62;62395;133;4;137
32;62;62396;15;1;16
32;62;62397;5618;79;5697
32;62;62398;273;12;285
32;62;62399;659;14;673
32;62;62400;4837;37;4874
32;62;62401;4398;33;4431
32;62;62402;313;6;319
32;62;62403;1206;15;1221
32;62;62404;203;2;205
32;62;62405;481;10;491
32;62;62406;263;8;271
32;62;62407;959;13;972
32;62;62408;1457;18;1475
32;62;62409;195;3;198
32;62;62410;182;6;188
32;62;62411;53;0;53
32;62;62412;1209;6;1215
32;62;62413;12237;92;12329
32;62;62414;219;2;221
32;62;62415;435;9;444
32;62;62416;216;1;217
32;62;62418;312;8;320
32;62;62419;179;1;180
32;62;62421;405;11;416
32;62;62422;520;6;526
32;62;62423;1720;30;1750
32;62;62424;314;11;325
32;62;62425;137;4;141
32;62;62426;183;2;185
32;62;62427;25992;374;26366
32;62;62428;524;7;531
32;62;62429;287;4;291
32;62;62430;166;2;168
32;62;62432;398;8;406
32;62;62433;87;6;93
32;62;62434;141;5;146
32;62;62435;106;1;107
32;62;62436;164;3;167
32;62;62437;307;7;314
32;62;62438;533;8;541
32;62;62439;424;3;427
32;62;62440;1200;21;1221
32;62;62441;209;2;211
32;62;62442;565;5;570
32;62;62443;6245;41;6286
32;62;62444;228;6;234
32;62;62445;823;17;840
32;62;62446;718;22;740
32;62;62447;2216;14;2230
32;62;62448;1902;28;1930
32;62;62449;159;6;165
32;62;62450;231;6;237
32;62;62451;498;10;508
32;62;62452;1360;36;1396
32;62;62453;126;3;129
32;62;62454;2400;47;2447
32;62;62455;112;1;113
32;62;62456;710;12;722
32;62;62457;7110;57;7167
32;62;62458;1147;13;1160
32;62;62459;238;4;242
32;62;62460;272;7;279
32;62;62461;884;10;894
32;62;62462;144;5;149
32;62;62463;443;37;480
32;62;62464;3405;18;3423
32;62;62465;222;0;222
32;62;62466;232;1;233
32;62;62467;180;0;180
32;62;62468;218;2;220
32;62;62469;593;7;600
32;62;62470;86;0;86
32;62;62471;1066;22;1088
32;62;62472;161;6;167
32;62;62473;8717;78;8795
32;62;62474;1160;21;1181
32;62;62475;248;3;251
32;62;62476;1049;11;1060
32;62;62477;729;17;746
32;62;62478;279;5;284
32;62;62479;1660;14;1674
32;62;62480;2893;22;2915
32;62;62481;154;3;157
32;62;62483;247;2;249
32;62;62484;323;6;329
32;62;62485;369;1;370
32;62;62486;1062;14;1076
32;62;62487;1268;22;1290
32;62;62488;769;20;789
32;62;62489;3471;29;3500
32;62;62490;276;3;279
32;62;62491;4979;83;5062
32;62;62492;243;3;246
32;62;62493;233;4;237
32;62;62494;47;1;48
32;62;62495;331;6;337
32;62;62496;234;6;240
32;62;62497;7248;50;7298
32;62;62498;31461;187;31648
32;62;62499;287;8;295
32;62;62500;409;3;412
32;62;62501;219;2;221
32;62;62502;4728;73;4801
32;62;62503;293;6;299
32;62;62504;256;7;263
32;62;62505;498;9;507
32;62;62506;1625;20;1645
32;62;62507;295;6;301
32;62;62508;380;10;390
32;62;62509;330;5;335
32;62;62510;30112;363;30475
32;62;62511;141;1;142
32;62;62512;574;15;589
32;62;62513;190;6;196
32;62;62514;247;3;250
32;62;62515;521;17;538
32;62;62516;9810;88;9898
32;62;62517;196;6;202
32;62;62518;165;1;166
32;62;62519;605;8;613
32;62;62520;2396;58;2454
32;62;62521;206;4;210
32;62;62522;271;3;274
32;62;62523;5366;52;5418
32;62;62524;1487;18;1505
32;62;62525;10563;519;11082
32;62;62526;144;2;146
32;62;62527;253;6;259
32;62;62528;6879;62;6941
32;62;62529;1568;18;1586
32;62;62530;535;9;544
32;62;62531;950;19;969
32;62;62532;1291;13;1304
32;62;62533;146;3;149
32;62;62534;3601;74;3675
32;62;62535;154;8;162
32;62;62536;643;5;648
32;62;62537;108;4;112
32;62;62538;444;9;453
32;62;62539;242;3;245
32;62;62540;1707;15;1722
32;62;62541;121;4;125
32;62;62542;202;4;206
32;62;62543;2004;32;2036
32;62;62544;182;1;183
32;62;62545;147;0;147
32;62;62546;296;16;312
32;62;62547;62;1;63
32;62;62548;10529;125;10654
32;62;62549;1079;64;1143
32;62;62550;1099;20;1119
32;62;62551;237;2;239
32;62;62552;1030;8;1038
32;62;62553;284;6;290
32;62;62554;105;0;105
32;62;62555;5542;26;5568
32;62;62556;308;4;312
32;62;62557;2457;55;2512
32;62;62558;176;1;177
32;62;62559;964;14;978
32;62;62560;5083;61;5144
32;62;62561;194;1;195
32;62;62562;174;3;177
32;62;62563;8033;42;8075
32;62;62564;469;9;478
32;62;62565;77;0;77
32;62;62566;670;17;687
32;62;62567;637;9;646
32;62;62568;716;10;726
32;62;62569;662;6;668
32;62;62570;11267;69;11336
32;62;62571;3401;70;3471
32;62;62572;624;10;634
32;62;62573;3748;23;3771
32;62;62574;232;5;237
32;62;62576;144;0;144
32;62;62577;81;2;83
32;62;62578;95;2;97
32;62;62579;550;5;555
32;62;62580;515;11;526
32;62;62581;298;3;301
32;62;62582;647;37;684
32;62;62583;568;9;577
32;62;62584;1337;33;1370
32;62;62585;399;5;404
32;62;62586;451;5;456
32;62;62587;10180;54;10234
32;62;62588;1935;124;2059
32;62;62589;1014;20;1034
32;62;62590;61;0;61
32;62;62591;209;5;214
32;62;62592;557;12;569
32;62;62593;91;0;91
32;62;62594;307;3;310
32;62;62595;1131;29;1160
32;62;62596;243;5;248
32;62;62597;283;3;286
32;62;62598;727;7;734
32;62;62599;223;7;230
32;62;62600;150;3;153
32;62;62601;351;5;356
32;62;62602;203;2;205
32;62;62603;1029;8;1037
32;62;62604;3745;72;3817
32;62;62605;27;0;27
32;62;62606;1450;12;1462
32;62;62607;66;3;69
32;62;62608;168;1;169
32;62;62609;1571;37;1608
32;62;62610;649;9;658
32;62;62611;502;8;510
32;62;62612;581;12;593
32;62;62613;890;9;899
32;62;62614;580;14;594
32;62;62615;288;5;293
32;62;62616;182;2;184
32;62;62617;11575;70;11645
32;62;62618;1315;14;1329
32;62;62619;147;2;149
32;62;62620;1384;22;1406
32;62;62621;1700;30;1730
32;62;62622;258;3;261
32;62;62623;704;8;712
32;62;62624;5773;32;5805
32;62;62625;56;2;58
32;62;62626;2329;20;2349
32;62;62627;820;20;840
32;62;62628;6632;47;6679
32;62;62629;165;1;166
32;62;62630;299;5;304
32;62;62631;496;8;504
32;62;62632;380;6;386
32;62;62633;251;3;254
32;62;62634;1178;19;1197
32;62;62635;200;2;202
32;62;62636;267;14;281
32;62;62637;9993;48;10041
32;62;62638;1195;14;1209
32;62;62639;388;9;397
32;62;62640;381;1;382
32;62;62641;220;3;223
32;62;62642;763;9;772
32;62;62643;13378;170;13548
32;62;62644;503;7;510
32;62;62645;5583;84;5667
32;62;62646;570;7;577
32;62;62647;745;15;760
32;62;62648;508;11;519
32;62;62649;756;10;766
32;62;62650;754;8;762
32;62;62651;486;6;492
32;62;62652;1633;29;1662
32;62;62653;418;19;437
32;62;62654;782;11;793
32;62;62655;308;7;315
32;62;62656;947;27;974
32;62;62657;499;7;506
32;62;62658;119;9;128
32;62;62659;95;3;98
32;62;62660;460;7;467
32;62;62661;506;9;515
32;62;62662;864;21;885
32;62;62663;305;4;309
32;62;62664;236;5;241
32;62;62665;215;6;221
32;62;62666;3134;17;3151
32;62;62667;9071;114;9185
32;62;62668;190;2;192
32;62;62669;314;5;319
32;62;62670;618;7;625
32;62;62671;321;4;325
32;62;62672;652;5;657
32;62;62673;647;8;655
32;62;62674;555;18;573
32;62;62675;275;2;277
32;62;62676;451;7;458
32;62;62677;347;5;352
32;62;62678;691;3;694
32;62;62679;318;8;326
32;62;62680;731;13;744
32;62;62681;627;23;650
32;62;62682;64;0;64
32;62;62683;236;3;239
32;62;62684;2234;31;2265
32;62;62685;270;163;433
32;62;62686;359;6;365
32;62;62688;4307;117;4424
32;62;62689;393;2;395
32;62;62690;239;7;246
32;62;62691;813;13;826
32;62;62692;367;4;371
32;62;62693;1076;22;1098
32;62;62694;188;2;190
32;62;62695;263;2;265
32;62;62696;236;3;239
32;62;62697;229;0;229
32;62;62698;273;5;278
32;62;62699;644;13;657
32;62;62700;215;1;216
32;62;62701;451;2;453
32;62;62702;357;6;363
32;62;62703;384;3;387
32;62;62704;598;18;616
32;62;62705;2092;16;2108
32;62;62706;2646;57;2703
32;62;62708;32;1;33
32;62;62709;253;5;258
32;62;62710;169;4;173
32;62;62711;3038;30;3068
32;62;62712;1127;29;1156
32;62;62713;1342;23;1365
32;62;62714;784;18;802
32;62;62715;287;0;287
32;62;62716;540;6;546
32;62;62717;534;10;544
32;62;62718;1413;22;1435
32;62;62719;281;35;316
32;62;62720;44;2;46
32;62;62721;1936;49;1985
32;62;62722;89;3;92
32;62;62723;239;1;240
32;62;62724;8945;37;8982
32;62;62725;139;0;139
32;62;62726;203;5;208
32;62;62727;1542;23;1565
32;62;62728;683;11;694
32;62;62729;250;6;256
32;62;62730;1626;22;1648
32;62;62731;283;3;286
32;62;62732;330;2;332
32;62;62733;310;2;312
32;62;62734;689;8;697
32;62;62735;2404;17;2421
32;62;62736;3910;72;3982
32;62;62737;6060;34;6094
32;62;62738;157;4;161
32;62;62739;325;3;328
32;62;62740;304;9;313
32;62;62741;119;3;122
32;62;62742;269;6;275
32;62;62743;389;8;397
32;62;62744;3562;58;3620
32;62;62745;159;1;160
32;62;62746;5130;65;5195
32;62;62747;619;16;635
32;62;62748;2292;41;2333
32;62;62749;334;6;340
32;62;62750;810;9;819
32;62;62751;796;9;805
32;62;62752;1130;26;1156
32;62;62753;6542;64;6606
32;62;62754;474;4;478
32;62;62755;3410;52;3462
32;62;62756;1649;30;1679
32;62;62757;5923;134;6057
32;62;62758;11136;182;11318
32;62;62759;473;8;481
32;62;62760;279;7;286
32;62;62761;210;4;214
32;62;62762;121;5;126
32;62;62763;863;16;879
32;62;62764;4687;53;4740
32;62;62765;14903;656;15559
32;62;62766;1115;12;1127
32;62;62767;4909;161;5070
32;62;62768;105;2;107
32;62;62769;760;14;774
32;62;62770;3062;86;3148
32;62;62771;9594;41;9635
32;62;62772;479;25;504
32;62;62773;4666;147;4813
32;62;62774;4845;128;4973
32;62;62775;349;2;351
32;62;62776;195;4;199
32;62;62777;167;1;168
32;62;62778;78;1;79
32;62;62779;187;1;188
32;62;62780;364;3;367
32;62;62781;461;3;464
32;62;62782;435;8;443
32;62;62783;317;5;322
32;62;62784;775;12;787
32;62;62785;895;185;1080
32;62;62786;329;3;332
32;62;62787;317;3;320
32;62;62788;693;16;709
32;62;62789;281;1;282
32;62;62790;162;4;166
32;62;62791;51;0;51
32;62;62792;1151;32;1183
32;62;62793;1120;19;1139
32;62;62794;595;11;606
32;62;62795;112;2;114
32;62;62796;557;12;569
32;62;62797;272;3;275
32;62;62798;239;7;246
32;62;62799;882;27;909
32;62;62800;377;3;380
32;62;62801;2594;49;2643
32;62;62802;175;2;177
32;62;62803;637;5;642
32;62;62804;369;5;374
32;62;62805;269;1;270
32;62;62806;151;4;155
32;62;62808;257;0;257
32;62;62809;137;3;140
32;62;62810;1207;36;1243
32;62;62811;1099;25;1124
32;62;62812;831;7;838
32;62;62813;506;2;508
32;62;62814;101;1;102
32;62;62815;174;0;174
32;62;62816;220;5;225
32;62;62817;1435;119;1554
32;62;62818;154;1;155
32;62;62819;1084;30;1114
32;62;62820;816;19;835
32;62;62821;294;7;301
32;62;62822;92;3;95
32;62;62823;173;5;178
32;62;62824;212;5;217
32;62;62825;838;8;846
32;62;62826;4227;274;4501
32;62;62827;1400;17;1417
32;62;62828;59;0;59
32;62;62829;433;3;436
32;62;62830;176;2;178
32;62;62831;300;7;307
32;62;62832;563;18;581
32;62;62833;77;2;79
32;62;62834;249;4;253
32;62;62835;554;19;573
32;62;62836;1054;29;1083
32;62;62837;506;8;514
32;62;62838;90;3;93
32;62;62839;1023;9;1032
32;62;62840;133;0;133
32;62;62841;2436;24;2460
32;62;62842;8479;44;8523
32;62;62843;236;2;238
32;62;62844;634;14;648
32;62;62845;483;4;487
32;62;62846;4765;41;4806
32;62;62847;2019;24;2043
32;62;62848;3501;34;3535
32;62;62849;2491;54;2545
32;62;62850;344;6;350
32;62;62851;805;19;824
32;62;62852;1420;11;1431
32;62;62853;381;10;391
32;62;62854;599;10;609
32;62;62855;255;1;256
32;62;62856;366;4;370
32;62;62857;130;9;139
32;62;62858;257;5;262
32;62;62859;261;4;265
32;62;62860;121;3;124
32;62;62861;4358;79;4437
32;62;62862;156;3;159
32;62;62863;3773;33;3806
32;62;62864;649;15;664
32;62;62865;4675;52;4727
32;62;62866;438;15;453
32;62;62867;269;7;276
32;62;62868;259;6;265
32;62;62869;1083;32;1115
32;62;62870;1029;24;1053
32;62;62871;256;1;257
32;62;62872;233;5;238
32;62;62873;642;10;652
32;62;62874;716;15;731
32;62;62875;1363;23;1386
32;62;62876;134;2;136
32;62;62877;159;5;164
32;62;62878;379;7;386
32;62;62879;233;3;236
32;62;62880;202;3;205
32;62;62881;377;10;387
32;62;62882;1239;34;1273
32;62;62883;195;0;195
32;62;62885;256;1;257
32;62;62886;267;3;270
32;62;62887;243;1;244
32;62;62888;225;0;225
32;62;62889;872;19;891
32;62;62890;183;1;184
32;62;62891;136;4;140
32;62;62892;649;20;669
32;62;62893;6343;162;6505
32;62;62894;3987;80;4067
32;62;62895;8756;64;8820
32;62;62896;738;21;759
32;62;62897;511;9;520
32;62;62898;220;9;229
32;62;62899;854;17;871
32;62;62900;587;15;602
32;62;62901;993;13;1006
32;62;62902;3292;53;3345
32;62;62903;620;4;624
32;62;62904;593;10;603
32;62;62905;987;48;1035
32;62;62906;1784;22;1806
32;62;62907;8321;40;8361
32;62;62908;1616;38;1654
32;62;62909;434;5;439
84;63;63001;2767;34;2801
84;63;63002;94;0;94
84;63;63003;6655;245;6900
84;63;63004;1694;29;1723
84;63;63005;407;5;412
84;63;63006;173;2;175
84;63;63007;164;3;167
84;63;63008;585;10;595
84;63;63009;592;6;598
84;63;63010;1817;39;1856
84;63;63011;221;12;233
84;63;63012;912;17;929
84;63;63013;924;12;936
84;63;63014;10904;154;11058
84;63;63015;236;2;238
84;63;63016;887;25;912
84;63;63017;195;1;196
84;63;63019;4095;39;4134
84;63;63020;362;12;374
84;63;63021;690;8;698
84;63;63022;2004;28;2032
84;63;63023;377;10;387
84;63;63024;182;4;186
84;63;63025;139;5;144
84;63;63026;2466;46;2512
84;63;63027;111;1;112
84;63;63028;416;16;432
84;63;63029;258;3;261
84;63;63030;340;6;346
84;63;63031;467;5;472
84;63;63032;10664;225;10889
84;63;63033;306;2;308
84;63;63034;1537;27;1564
84;63;63035;1238;19;1257
84;63;63036;319;4;323
84;63;63037;455;14;469
84;63;63038;1497;68;1565
84;63;63039;289;10;299
84;63;63040;4777;81;4858
84;63;63041;320;9;329
84;63;63042;3840;57;3897
84;63;63043;440;3;443
84;63;63044;429;7;436
84;63;63045;689;17;706
84;63;63046;292;4;296
84;63;63047;1768;36;1804
84;63;63048;865;27;892
84;63;63049;729;7;736
84;63;63050;3362;122;3484
84;63;63051;628;13;641
84;63;63052;1039;86;1125
84;63;63053;261;11;272
84;63;63054;693;17;710
84;63;63055;982;16;998
84;63;63056;336;4;340
84;63;63057;242;6;248
84;63;63058;534;9;543
84;63;63059;218;5;223
84;63;63060;91;0;91
84;63;63061;469;7;476
84;63;63062;236;2;238
84;63;63063;8805;110;8915
84;63;63064;78;0;78
84;63;63065;174;3;177
84;63;63066;1677;31;1708
84;63;63067;164;2;166
84;63;63069;5510;59;5569
84;63;63070;6364;131;6495
84;63;63071;691;11;702
84;63;63072;1200;16;1216
84;63;63073;432;14;446
84;63;63074;183;0;183
84;63;63075;17276;573;17849
84;63;63076;149;2;151
84;63;63077;423;4;427
84;63;63079;151;2;153
84;63;63080;1405;22;1427
84;63;63081;271;6;277
84;63;63082;403;9;412
84;63;63083;927;27;954
84;63;63084;1703;36;1739
84;63;63085;1119;7;1126
84;63;63086;337;12;349
84;63;63087;66;1;67
84;63;63088;83;0;83
84;63;63089;1630;26;1656
84;63;63090;505;8;513
84;63;63091;901;15;916
84;63;63092;1789;26;1815
84;63;63093;1122;22;1144
84;63;63094;489;5;494
84;63;63095;206;3;209
84;63;63096;387;6;393
84;63;63097;79;2;81
84;63;63098;223;8;231
84;63;63099;3105;53;3158
84;63;63100;324;4;328
84;63;63101;68;1;69
84;63;63102;773;14;787
84;63;63103;6239;183;6422
84;63;63104;113;5;118
84;63;63105;229;6;235
84;63;63106;1699;18;1717
84;63;63107;494;8;502
84;63;63108;677;14;691
84;63;63109;527;13;540
84;63;63110;463;5;468
84;63;63111;120;5;125
84;63;63112;620;7;627
84;63;63113;147865;2731;150596
84;63;63114;158;1;159
84;63;63115;221;4;225
84;63;63116;2170;34;2204
84;63;63117;128;3;131
84;63;63118;414;7;421
84;63;63119;227;3;230
84;63;63120;762;9;771
84;63;63121;1269;15;1284
84;63;63122;62;1;63
84;63;63123;236;7;243
84;63;63124;20322;366;20688
84;63;63125;4017;147;4164
84;63;63126;1269;26;1295
84;63;63128;963;16;979
84;63;63129;167;1;168
84;63;63130;259;11;270
84;63;63131;1126;19;1145
84;63;63132;1297;26;1323
84;63;63134;68;2;70
84;63;63135;609;5;614
84;63;63136;388;8;396
84;63;63137;175;4;179
84;63;63138;709;9;718
84;63;63139;656;8;664
84;63;63140;211;5;216
84;63;63141;2057;48;2105
84;63;63142;252;12;264
84;63;63143;1131;18;1149
84;63;63144;341;9;350
84;63;63145;151;6;157
84;63;63146;808;64;872
84;63;63147;253;3;256
84;63;63148;2520;53;2573
84;63;63149;675;9;684
84;63;63150;1543;31;1574
84;63;63151;1344;38;1382
84;63;63152;291;4;295
84;63;63153;106;2;108
84;63;63154;436;6;442
84;63;63155;482;14;496
84;63;63156;59;0;59
84;63;63157;367;10;377
84;63;63158;106;6;112
84;63;63159;134;0;134
84;63;63160;926;32;958
84;63;63161;320;10;330
84;63;63162;320;8;328
84;63;63163;954;57;1011
84;63;63164;10289;86;10375
84;63;63165;797;36;833
84;63;63166;241;5;246
84;63;63167;401;6;407
84;63;63168;580;13;593
84;63;63169;16;0;16
84;63;63170;623;15;638
84;63;63171;329;13;342
84;63;63172;53;2;55
84;63;63173;200;7;207
84;63;63174;120;2;122
84;63;63175;236;8;244
84;63;63176;106;3;109
84;63;63177;408;10;418
84;63;63178;15296;405;15701
84;63;63179;1027;30;1057
84;63;63180;1132;17;1149
84;63;63181;551;14;565
84;63;63182;589;15;604
84;63;63183;65;0;65
84;63;63184;279;4;283
84;63;63185;639;8;647
84;63;63186;228;8;236
84;63;63187;523;12;535
84;63;63188;589;16;605
84;63;63189;370;4;374
84;63;63190;278;7;285
84;63;63191;104;3;107
84;63;63192;643;31;674
84;63;63193;8677;435;9112
84;63;63194;389;7;396
84;63;63195;6256;73;6329
84;63;63196;749;13;762
84;63;63197;127;2;129
84;63;63198;1384;19;1403
84;63;63199;516;5;521
84;63;63200;907;18;925
84;63;63201;1134;17;1151
84;63;63202;107;3;110
84;63;63203;1165;18;1183
84;63;63204;1132;20;1152
84;63;63205;467;4;471
84;63;63206;1387;19;1406
84;63;63207;813;11;824
84;63;63208;292;5;297
84;63;63209;209;5;214
84;63;63210;3125;50;3175
84;63;63211;1455;47;1502
84;63;63212;1425;37;1462
84;63;63213;2149;21;2170
84;63;63214;3984;55;4039
84;63;63215;676;7;683
84;63;63216;117;4;121
84;63;63218;198;6;204
84;63;63219;716;11;727
84;63;63220;96;3;99
84;63;63221;122;0;122
84;63;63222;489;8;497
84;63;63223;538;11;549
84;63;63224;1623;24;1647
84;63;63225;1048;40;1088
84;63;63226;3435;76;3511
84;63;63227;2380;59;2439
84;63;63228;294;10;304
84;63;63229;1226;23;1249
84;63;63230;228;5;233
84;63;63231;1685;34;1719
84;63;63232;541;13;554
84;63;63233;982;9;991
84;63;63234;875;17;892
84;63;63235;538;6;544
84;63;63236;1279;18;1297
84;63;63237;427;6;433
84;63;63238;228;1;229
84;63;63239;720;23;743
84;63;63240;465;9;474
84;63;63241;326;15;341
84;63;63242;380;10;390
84;63;63243;378;6;384
84;63;63244;1786;26;1812
84;63;63245;3876;66;3942
84;63;63246;483;17;500
84;63;63247;580;10;590
84;63;63248;847;21;868
84;63;63249;523;10;533
84;63;63250;858;18;876
84;63;63251;296;7;303
84;63;63252;379;7;386
84;63;63253;239;2;241
84;63;63254;2218;36;2254
84;63;63255;595;16;611
84;63;63256;150;2;152
84;63;63257;829;11;840
84;63;63258;763;20;783
84;63;63259;313;10;323
84;63;63260;158;5;163
84;63;63261;843;29;872
84;63;63262;2756;40;2796
84;63;63263;3493;105;3598
84;63;63264;247;1;248
84;63;63265;2192;43;2235
84;63;63267;532;17;549
84;63;63268;290;4;294
84;63;63269;882;15;897
84;63;63270;499;15;514
84;63;63271;1490;37;1527
84;63;63272;2705;52;2757
84;63;63273;1507;32;1539
84;63;63274;428;15;443
84;63;63275;891;19;910
84;63;63276;2121;45;2166
84;63;63277;65;0;65
84;63;63278;706;6;712
84;63;63279;318;6;324
84;63;63280;345;6;351
84;63;63281;1062;19;1081
84;63;63282;1713;21;1734
84;63;63283;634;114;748
84;63;63284;12182;305;12487
84;63;63285;762;17;779
84;63;63286;270;5;275
84;63;63287;344;7;351
84;63;63288;453;14;467
84;63;63289;261;9;270
84;63;63290;403;9;412
84;63;63291;2790;46;2836
84;63;63292;150;5;155
84;63;63293;215;8;223
84;63;63294;289;6;295
84;63;63295;1591;15;1606
84;63;63296;762;15;777
84;63;63297;382;3;385
84;63;63298;127;4;131
84;63;63299;103;0;103
84;63;63300;19004;758;19762
84;63;63301;747;9;756
84;63;63302;3483;67;3550
84;63;63303;41;1;42
84;63;63304;110;0;110
84;63;63305;860;143;1003
84;63;63306;622;10;632
84;63;63307;7791;178;7969
84;63;63308;4359;118;4477
84;63;63309;308;3;311
84;63;63310;173;2;175
84;63;63311;339;2;341
84;63;63312;151;4;155
84;63;63313;111;5;116
84;63;63314;494;27;521
84;63;63315;1747;38;1785
84;63;63317;529;3;532
84;63;63318;462;9;471
84;63;63319;706;25;731
84;63;63320;218;5;223
84;63;63321;935;15;950
84;63;63322;2218;30;2248
84;63;63323;167;3;170
84;63;63324;205;8;213
84;63;63325;418;6;424
84;63;63326;513;8;521
84;63;63327;2035;39;2074
84;63;63328;51;2;53
84;63;63329;127;5;132
84;63;63330;351;7;358
84;63;63331;232;6;238
84;63;63332;539;10;549
84;63;63333;230;8;238
84;63;63334;542;20;562
84;63;63335;525;12;537
84;63;63336;201;4;205
84;63;63337;61;1;62
84;63;63338;3572;141;3713
84;63;63339;134;2;136
84;63;63340;259;3;262
84;63;63341;547;16;563
84;63;63342;245;7;252
84;63;63343;279;7;286
84;63;63344;144;4;148
84;63;63345;3659;105;3764
84;63;63346;218;7;225
84;63;63347;464;18;482
84;63;63348;182;1;183
84;63;63349;1933;49;1982
84;63;63350;1287;19;1306
84;63;63351;72;2;74
84;63;63352;2008;42;2050
84;63;63353;483;27;510
84;63;63354;1273;144;1417
84;63;63355;224;4;228
84;63;63356;335;13;348
84;63;63357;116;2;118
84;63;63358;360;3;363
84;63;63359;85;1;86
84;63;63360;154;3;157
84;63;63362;915;17;932
84;63;63363;281;6;287
84;63;63364;664;8;672
84;63;63365;431;11;442
84;63;63366;353;3;356
84;63;63367;123;1;124
84;63;63368;1299;26;1325
84;63;63369;120;3;123
84;63;63370;365;5;370
84;63;63371;154;5;159
84;63;63372;670;5;675
84;63;63373;189;4;193
84;63;63374;287;7;294
84;63;63375;166;1;167
84;63;63376;148;7;155
84;63;63377;372;6;378
84;63;63378;941;8;949
84;63;63379;517;6;523
84;63;63380;762;3;765
84;63;63381;1650;22;1672
84;63;63382;393;13;406
84;63;63383;250;5;255
84;63;63384;132;5;137
84;63;63385;443;9;452
84;63;63386;483;5;488
84;63;63387;863;17;880
84;63;63388;702;17;719
84;63;63389;111;2;113
84;63;63390;384;13;397
84;63;63391;238;4;242
84;63;63392;579;9;588
84;63;63393;1754;33;1787
84;63;63394;207;6;213
84;63;63395;972;19;991
84;63;63396;1164;70;1234
84;63;63397;1128;20;1148
84;63;63398;88;3;91
84;63;63399;85;6;91
84;63;63400;1076;19;1095
84;63;63401;252;6;258
84;63;63402;250;7;257
84;63;63403;414;11;425
84;63;63404;608;11;619
84;63;63405;584;12;596
84;63;63406;303;6;309
84;63;63407;280;7;287
84;63;63408;166;5;171
84;63;63409;279;2;281
84;63;63410;138;3;141
84;63;63411;475;9;484
84;63;63412;529;7;536
84;63;63413;710;12;722
84;63;63414;551;12;563
84;63;63415;1296;13;1309
84;63;63416;93;3;96
84;63;63417;2429;46;2475
84;63;63418;575;9;584
84;63;63419;549;12;561
84;63;63420;799;9;808
84;63;63421;160;5;165
84;63;63422;510;9;519
84;63;63423;602;9;611
84;63;63424;580;12;592
84;63;63425;1499;42;1541
84;63;63426;766;17;783
84;63;63427;486;15;501
84;63;63428;283;2;285
84;63;63429;32;2;34
84;63;63430;11784;368;12152
84;63;63431;162;1;163
84;63;63432;915;38;953
84;63;63433;73;3;76
84;63;63434;514;24;538
84;63;63435;215;6;221
84;63;63436;75;0;75
84;63;63437;151;4;155
84;63;63438;483;5;488
84;63;63439;298;2;300
84;63;63440;125;0;125
84;63;63441;208;3;211
84;63;63442;52;3;55
84;63;63443;417;12;429
84;63;63444;300;4;304
84;63;63445;302;5;307
84;63;63446;523;4;527
84;63;63447;65;4;69
84;63;63448;813;64;877
84;63;63449;302;4;306
84;63;63450;236;10;246
84;63;63451;413;17;430
84;63;63452;72;1;73
84;63;63453;3258;32;3290
84;63;63454;537;10;547
84;63;63455;3635;57;3692
84;63;63456;343;14;357
84;63;63457;5189;99;5288
84;63;63458;151;1;152
84;63;63459;526;4;530
84;63;63460;366;10;376
84;63;63461;359;3;362
84;63;63462;268;5;273
84;63;63463;516;9;525
84;63;63464;346;12;358
84;63;63465;405;9;414
84;63;63466;196;3;199
84;63;63467;30;1;31
84;63;63468;300;9;309
84;63;63469;720;16;736
84;63;63470;4623;71;4694
84;63;63471;904;19;923
84;63;63472;652;17;669
84;63;63473;392;7;399
75;64;64001;186;7;193
75;64;64002;167;1;168
75;64;64003;214;8;222
75;64;64004;107;1;108
75;64;64005;544;13;557
75;64;64006;458;12;470
75;64;64007;1037;26;1063
75;64;64008;269;9;278
75;64;64009;2071;32;2103
75;64;64010;667;16;683
75;64;64011;115;6;121
75;64;64012;136;1;137
75;64;64013;172;5;177
75;64;64014;670;7;677
75;64;64015;215;3;218
75;64;64016;324;6;330
75;64;64017;330;4;334
75;64;64018;450;9;459
75;64;64019;233;1;234
75;64;64021;662;21;683
75;64;64022;136;3;139
75;64;64023;911;23;934
75;64;64024;39719;1121;40840
75;64;64025;97;5;102
75;64;64026;380;10;390
75;64;64027;188;3;191
75;64;64028;136;2;138
75;64;64029;665;15;680
75;64;64031;174;3;177
75;64;64032;183;8;191
75;64;64033;134;1;135
75;64;64034;297;6;303
75;64;64035;2342;62;2404
75;64;64036;317;7;324
75;64;64037;1214;22;1236
75;64;64038;3195;81;3276
75;64;64039;245;1;246
75;64;64040;1074;33;1107
75;64;64041;763;11;774
75;64;64042;702;23;725
75;64;64043;289;4;293
75;64;64044;78;1;79
75;64;64045;77;1;78
75;64;64046;396;5;401
75;64;64047;236;3;239
75;64;64048;130;1;131
75;64;64049;232;8;240
75;64;64050;95;3;98
75;64;64051;406;5;411
75;64;64052;108;0;108
75;64;64053;190;3;193
75;64;64054;767;21;788
75;64;64056;139;2;141
75;64;64057;1835;42;1877
75;64;64058;472;10;482
75;64;64059;1083;28;1111
75;64;64060;1851;52;1903
75;64;64061;3428;64;3492
75;64;64062;2239;46;2285
75;64;64063;1057;21;1078
75;64;64064;449;9;458
75;64;64065;4359;113;4472
75;64;64066;329;9;338
75;64;64067;1942;45;1987
75;64;64068;2004;51;2055
75;64;64069;231;6;237
75;64;64070;307;1;308
75;64;64071;210;5;215
75;64;64072;651;14;665
75;64;64073;260;5;265
75;64;64074;45;0;45
75;64;64075;166;1;167
75;64;64077;173;3;176
75;64;64078;230;6;236
75;64;64079;102;3;105
75;64;64080;790;24;814
75;64;64081;239;2;241
75;64;64082;140;1;141
75;64;64083;203;3;206
75;64;64084;140;2;142
75;64;64085;109;1;110
75;64;64086;1094;33;1127
75;64;64087;865;22;887
75;64;64088;299;9;308
75;64;64089;143;1;144
75;64;64090;121;2;123
75;64;64091;494;7;501
75;64;64092;346;7;353
75;64;64093;641;5;646
75;64;64094;1828;49;1877
75;64;64095;592;12;604
75;64;64096;175;1;176
75;64;64097;609;11;620
75;64;64098;65;2;67
75;64;64099;98;4;102
75;64;64100;3231;95;3326
75;64;64101;585;114;699
75;64;64102;51894;1169;53063
75;64;64103;207;3;210
75;64;64104;600;15;615
75;64;64105;271;12;283
75;64;64106;520;9;529
75;64;64107;73;3;76
75;64;64108;909;11;920
75;64;64109;1943;44;1987
75;64;64110;220;2;222
75;64;64111;109;1;110
75;64;64112;427;4;431
75;64;64113;116;5;121
75;64;64114;586;9;595
75;64;64115;159;68;227
75;64;64116;245;5;250
75;64;64117;145;4;149
75;64;64118;50;0;50
75;64;64119;673;21;694
75;64;64120;530;7;537
75;64;64121;193;2;195
75;64;64122;25787;721;26508
75;64;64123;1358;26;1384
75;64;64124;663;15;678
75;64;64125;6975;138;7113
75;64;64126;1109;30;1139
75;64;64127;390;14;404
75;64;64128;159;5;164
75;64;64129;12793;230;13023
75;64;64130;1228;20;1248
75;64;64131;637;21;658
75;64;64132;4563;126;4689
75;64;64133;1347;27;1374
75;64;64134;369;7;376
75;64;64135;794;14;808
75;64;64136;136;5;141
75;64;64137;676;20;696
75;64;64138;2887;52;2939
75;64;64139;988;23;1011
75;64;64140;8627;170;8797
75;64;64141;375;9;384
75;64;64142;844;27;871
75;64;64143;157;0;157
75;64;64144;165;2;167
75;64;64145;513;8;521
75;64;64146;334;4;338
75;64;64147;2878;45;2923
75;64;64148;870;25;895
75;64;64149;243;6;249
75;64;64150;131;2;133
75;64;64151;99;5;104
75;64;64152;1927;54;1981
75;64;64153;67;1;68
75;64;64154;206;1;207
75;64;64155;104;1;105
75;64;64156;476;14;490
75;64;64157;988;22;1010
75;64;64158;173;7;180
75;64;64159;117;4;121
75;64;64160;6622;109;6731
75;64;64161;996;19;1015
75;64;64162;101;3;104
75;64;64165;300;1;301
75;64;64166;193;9;202
75;64;64167;217;5;222
75;64;64168;667;15;682
75;64;64170;200;2;202
75;64;64171;260;2;262
75;64;64172;302;3;305
75;64;64173;162;1;163
75;64;64174;52;1;53
75;64;64175;153;4;157
75;64;64176;166;4;170
75;64;64177;624;25;649
75;64;64178;464;15;479
75;64;64179;133;6;139
75;64;64180;212;5;217
75;64;64181;330;4;334
75;64;64182;69;1;70
75;64;64183;598;18;616
75;64;64184;612;27;639
75;64;64185;61;1;62
75;64;64186;216;3;219
75;64;64187;254;9;263
75;64;64188;1083;154;1237
75;64;64189;6211;180;6391
75;64;64190;236;8;244
75;64;64191;2170;142;2312
75;64;64192;111;1;112
75;64;64193;98;2;100
75;64;64194;382;9;391
75;64;64195;95;2;97
75;64;64196;121;0;121
75;64;64197;189;5;194
75;64;64198;1766;50;1816
75;64;64199;142;4;146
75;64;64200;182;3;185
75;64;64201;227;7;234
75;64;64202;464;11;475
75;64;64203;317;7;324
75;64;64204;193;3;196
75;64;64205;237;2;239
75;64;64206;123;1;124
75;64;64207;423;12;435
75;64;64208;425;8;433
75;64;64209;438;8;446
75;64;64210;145;1;146
75;64;64211;361;4;365
75;64;64212;142;2;144
75;64;64213;1985;47;2032
75;64;64214;491;16;507
75;64;64215;105;3;108
75;64;64216;1190;46;1236
75;64;64217;538;12;550
75;64;64218;328;1;329
75;64;64219;260;6;266
75;64;64220;505;12;517
75;64;64221;154;29;183
75;64;64222;75;0;75
75;64;64223;59;2;61
75;64;64224;638;17;655
75;64;64225;615;16;631
75;64;64226;177;1;178
75;64;64227;667;13;680
75;64;64228;270;2;272
75;64;64229;127;5;132
75;64;64230;5585;107;5692
75;64;64231;498;8;506
75;64;64232;220;2;222
75;64;64233;1356;23;1379
75;64;64234;261;9;270
75;64;64235;281;8;289
75;64;64236;54;1;55
75;64;64237;3652;132;3784
75;64;64238;1969;53;2022
75;64;64239;139;1;140
75;64;64240;183;7;190
75;64;64241;477;6;483
75;64;64242;75;0;75
75;64;64243;201;2;203
75;64;64244;255;10;265
75;64;64245;576;14;590
75;64;64246;303;7;310
75;64;64247;474;13;487
75;64;64249;1326;36;1362
75;64;64250;1001;33;1034
75;64;64251;221;8;229
75;64;64252;880;27;907
75;64;64253;419;10;429
75;64;64254;576;18;594
75;64;64255;621;5;626
75;64;64256;7498;281;7779
75;64;64257;350;1;351
75;64;64258;86;1;87
75;64;64259;736;16;752
75;64;64260;16967;437;17404
75;64;64261;389;2;391
75;64;64262;275;6;281
75;64;64263;128;4;132
75;64;64264;61;2;63
75;64;64265;93;0;93
75;64;64266;243;9;252
75;64;64267;77;1;78
75;64;64268;275;4;279
75;64;64269;4903;161;5064
75;64;64270;974;48;1022
75;64;64271;537;8;545
75;64;64272;145;1;146
75;64;64273;912;13;925
75;64;64274;364;2;366
75;64;64275;672;13;685
75;64;64276;236;6;242
75;64;64277;517;13;530
75;64;64279;2168;66;2234
75;64;64280;432;3;435
75;64;64281;145;3;148
75;64;64282;1168;31;1199
75;64;64283;195;1;196
75;64;64284;7102;240;7342
75;64;64285;206;6;212
75;64;64286;432;13;445
75;64;64287;139;3;142
75;64;64288;556;13;569
75;64;64289;961;34;995
75;64;64290;604;17;621
75;64;64291;318;6;324
75;64;64292;255;2;257
75;64;64293;170;2;172
75;64;64294;159;3;162
75;64;64295;115;3;118
75;64;64296;152;4;156
75;64;64297;169;4;173
75;64;64298;131;0;131
75;64;64299;193;6;199
75;64;64300;725;12;737
75;64;64301;1158;30;1188
75;64;64302;468;12;480
75;64;64303;157;8;165
75;64;64304;2506;55;2561
75;64;64305;517;12;529
75;64;64306;699;21;720
75;64;64307;209;3;212
75;64;64308;264;5;269
75;64;64309;204;5;209
75;64;64310;493;8;501
75;64;64311;156;2;158
75;64;64312;305;9;314
75;64;64313;275;5;280
75;64;64314;436;3;439
75;64;64315;1105;27;1132
75;64;64316;195;2;197
75;64;64317;2140;31;2171
75;64;64318;182;5;187
75;64;64319;183;0;183
75;64;64320;1185;23;1208
75;64;64321;245;5;250
75;64;64322;337;6;343
75;64;64323;102;3;105
75;64;64324;1750;40;1790
75;64;64325;208;4;212
75;64;64326;118;4;122
75;64;64327;170;4;174
75;64;64328;1029;29;1058
75;64;64329;1257;59;1316
75;64;64330;250;9;259
75;64;64331;768;16;784
75;64;64332;166;4;170
75;64;64334;218;3;221
75;64;64335;9665;419;10084
75;64;64336;168;1;169
75;64;64337;150;3;153
75;64;64338;189;6;195
75;64;64339;825;81;906
75;64;64340;84;1;85
75;64;64341;135;1;136
75;64;64342;201;7;208
75;64;64343;734;8;742
75;64;64344;381;16;397
75;64;64345;203;1;204
75;64;64346;206;1;207
75;64;64347;209;3;212
75;64;64348;13707;250;13957
75;64;64349;503;18;521
75;64;64350;858;18;876
75;64;64351;136;9;145
75;64;64352;391;10;401
75;64;64353;1042;28;1070
75;64;64354;124;1;125
75;64;64355;139;2;141
75;64;64356;110;0;110
75;64;64357;63;0;63
75;64;64358;251;1;252
75;64;64359;919;20;939
75;64;64360;190;6;196
75;64;64361;179;8;187
75;64;64362;410;22;432
75;64;64363;327;4;331
75;64;64364;584;10;594
75;64;64365;408;7;415
75;64;64366;123;0;123
75;64;64367;882;25;907
75;64;64368;250;7;257
75;64;64369;250;11;261
75;64;64370;560;16;576
75;64;64371;2947;236;3183
75;64;64372;94;1;95
75;64;64373;1823;43;1866
75;64;64374;1139;19;1158
75;64;64375;279;4;283
75;64;64376;929;26;955
75;64;64377;838;23;861
75;64;64378;204;128;332
75;64;64379;161;5;166
75;64;64380;231;5;236
75;64;64381;282;9;291
75;64;64382;344;10;354
75;64;64383;133;1;134
75;64;64385;275;2;277
75;64;64386;1258;26;1284
75;64;64387;606;12;618
75;64;64388;116;1;117
75;64;64389;366;6;372
75;64;64390;159;12;171
75;64;64391;306;7;313
75;64;64392;83;2;85
75;64;64393;4435;105;4540
75;64;64394;84;1;85
75;64;64395;124;0;124
75;64;64396;1137;95;1232
75;64;64397;118;6;124
75;64;64398;430;8;438
75;64;64399;2323;306;2629
75;64;64400;1101;46;1147
75;64;64401;78;1;79
75;64;64403;178;3;181
75;64;64404;309;8;317
75;64;64405;4356;260;4616
75;64;64406;613;16;629
75;64;64407;5294;148;5442
75;64;64408;60;0;60
75;64;64409;831;22;853
75;64;64410;6122;180;6302
75;64;64411;236;3;239
75;64;64412;94;1;95
75;64;64413;762;12;774
75;64;64414;112;2;114
75;64;64415;1522;33;1555
75;64;64416;1052;23;1075
75;64;64417;3265;236;3501
75;64;64418;138;3;141
75;64;64419;1597;30;1627
75;64;64420;245;5;250
75;64;64421;1276;29;1305
75;64;64422;10594;639;11233
75;64;64423;182;3;185
75;64;64424;540;4;544
75;64;64425;487;9;496
75;64;64426;249;10;259
75;64;64427;148;2;150
75;64;64428;139;1;140
75;64;64429;114;4;118
75;64;64430;10369;678;11047
75;64;64431;536;9;545
75;64;64432;85;1;86
75;64;64433;330;19;349
75;64;64434;50;1;51
75;64;64435;214;9;223
75;64;64436;816;22;838
75;64;64437;195;2;197
75;64;64438;539;13;552
75;64;64439;1669;51;1720
75;64;64440;388;17;405
75;64;64441;261;5;266
75;64;64442;335;11;346
75;64;64443;860;23;883
75;64;64444;462;11;473
75;64;64445;75627;1443;77070
75;64;64446;157;1;158
75;64;64447;140;1;141
75;64;64448;1772;50;1822
75;64;64449;164;3;167
75;64;64450;295;6;301
75;64;64451;97;3;100
75;64;64452;260;7;267
75;64;64453;2925;57;2982
75;64;64454;186;2;188
75;64;64455;167;3;170
75;64;64456;51;3;54
75;64;64457;187;4;191
75;64;64458;295;8;303
75;64;64459;173;2;175
75;64;64460;405;7;412
75;64;64461;1125;17;1142
75;64;64462;494;6;500
75;64;64463;663;6;669
75;64;64464;83;1;84
75;64;64465;224;3;227
75;64;64466;266;7;273
75;64;64467;849;16;865
75;64;64468;122;2;124
75;64;64469;311;8;319
75;64;64470;656;21;677
75;64;64471;361;12;373
75;64;64472;866;11;877
75;64;64473;358;4;362
75;64;64474;158;2;160
75;64;64475;195;1;196
75;64;64476;411;6;417
75;64;64477;1478;39;1517
75;64;64478;746;26;772
75;64;64479;163;4;167
75;64;64480;198;5;203
75;64;64481;237;4;241
75;64;64482;620;8;628
75;64;64483;14196;422;14618
75;64;64484;840;17;857
75;64;64485;1532;295;1827
75;64;64486;67;0;67
75;64;64487;206;5;211
75;64;64488;447;12;459
75;64;64489;332;10;342
75;64;64490;538;15;553
75;64;64491;202;5;207
75;64;64492;292;6;298
75;64;64493;1841;67;1908
75;64;64494;259;6;265
75;64;64495;7037;152;7189
75;64;64496;5491;97;5588
75;64;64498;395;10;405
75;64;64499;4568;129;4697
75;64;64500;297;6;303
75;64;64501;571;8;579
75;64;64502;709;6;715
75;64;64503;90;1;91
75;64;64504;2688;37;2725
75;64;64505;310;14;324
75;64;64506;161;3;164
75;64;64507;139;3;142
75;64;64508;132;2;134
75;64;64509;175;4;179
75;64;64510;941;19;960
75;64;64511;3411;86;3497
75;64;64512;265;4;269
75;64;64513;1370;96;1466
75;64;64514;196;7;203
75;64;64515;252;4;256
75;64;64516;384;3;387
75;64;64517;160;8;168
75;64;64518;1048;21;1069
75;64;64519;4348;126;4474
75;64;64520;829;33;862
75;64;64521;571;17;588
75;64;64522;530;15;545
75;64;64523;764;14;778
75;64;64524;417;2;419
75;64;64525;773;15;788
75;64;64526;1583;20;1603
75;64;64527;1497;29;1526
75;64;64528;168;8;176
75;64;64529;377;11;388
75;64;64530;352;7;359
75;64;64531;46;2;48
75;64;64532;70;1;71
75;64;64533;558;9;567
75;64;64534;192;0;192
75;64;64535;530;6;536
75;64;64536;858;16;874
75;64;64537;129;4;133
75;64;64538;803;16;819
75;64;64539;210;5;215
75;64;64540;2725;73;2798
75;64;64541;310;3;313
75;64;64542;66;1;67
75;64;64543;277;7;284
75;64;64544;76;2;78
75;64;64545;10418;193;10611
75;64;64546;2323;34;2357
75;64;64547;6918;260;7178
75;64;64548;166;4;170
75;64;64549;1228;24;1252
75;64;64550;767;30;797
75;64;64551;287;4;291
75;64;64552;183;3;186
75;64;64554;210;3;213
75;64;64555;166;2;168
75;64;64556;385;8;393
75;64;64557;458;22;480
75;64;64558;2822;78;2900
75;64;64559;728;16;744
75;64;64560;178;0;178
76;65;65001;297;7;304
76;65;65002;826;10;836
76;65;65003;143;1;144
76;65;65004;409;10;419
76;65;65005;433;11;444
76;65;65006;269;8;277
76;65;65007;1379;26;1405
76;65;65009;171;4;175
76;65;65010;223;4;227
76;65;65011;130;3;133
76;65;65012;81;2;83
76;65;65013;57;2;59
76;65;65014;40;0;40
76;65;65015;105;7;112
76;65;65016;183;3;186
76;65;65017;249;2;251
76;65;65018;84;1;85
76;65;65019;559;11;570
76;65;65020;263;5;268
76;65;65021;390;15;405
76;65;65022;118;7;125
76;65;65023;13;0;13
76;65;65024;105;3;108
76;65;65025;2911;170;3081
76;65;65026;75;0;75
76;65;65028;206;5;211
76;65;65029;482;11;493
76;65;65031;792;27;819
76;65;65032;700;20;720
76;65;65033;113;3;116
76;65;65034;19;0;19
76;65;65035;518;12;530
76;65;65036;132;3;135
76;65;65037;88;1;89
76;65;65038;14;1;15
76;65;65039;40;0;40
76;65;65040;321;3;324
76;65;65041;119;7;126
76;65;65042;575;12;587
76;65;65043;263;7;270
76;65;65044;298;6;304
76;65;65045;230;9;239
76;65;65046;93;3;96
76;65;65047;7864;223;8087
76;65;65048;789;10;799
76;65;65049;241;3;244
76;65;65050;79;2;81
76;65;65051;208;7;215
76;65;65052;66;0;66
76;65;65053;42;1;43
76;65;65054;610;8;618
76;65;65055;334;12;346
76;65;65056;453;13;466
76;65;65057;984;17;1001
76;65;65058;143;2;145
76;65;65059;7085;283;7368
76;65;65060;60;3;63
76;65;65061;51;0;51
76;65;65062;3498;76;3574
76;65;65063;172;3;175
76;65;65064;49;1;50
76;65;65065;293;8;301
76;65;65066;32;0;32
76;65;65067;128;7;135
76;65;65068;23;1;24
76;65;65069;1224;30;1254
76;65;65070;553;18;571
76;65;65071;33;0;33
76;65;65072;1824;15;1839
76;65;65073;355;7;362
76;65;65074;110;2;112
76;65;65075;133;7;140
76;65;65076;59;2;61
76;65;65077;418;24;442
76;65;65078;399;10;409
76;65;65079;198;4;202
76;65;65080;557;9;566
76;65;65081;135;3;138
76;65;65082;51;0;51
76;65;65083;706;17;723
76;65;65084;290;3;293
76;65;65085;111;2;113
76;65;65086;151;6;157
76;65;65087;177;5;182
76;65;65088;47;1;48
76;65;65089;85;3;88
76;65;65090;79;3;82
76;65;65091;56;1;57
76;65;65092;226;2;228
76;65;65093;209;8;217
76;65;65094;122;1;123
76;65;65095;331;11;342
76;65;65096;64;3;67
76;65;65097;190;8;198
76;65;65098;325;7;332
76;65;65099;141;3;144
76;65;65100;5357;114;5471
76;65;65101;762;12;774
76;65;65102;20;2;22
76;65;65103;109;1;110
76;65;65104;295;9;304
76;65;65105;196;3;199
76;65;65106;165;4;169
76;65;65107;111;2;113
76;65;65108;865;19;884
76;65;65109;31;1;32
76;65;65110;96;0;96
76;65;65111;64;0;64
76;65;65112;156;5;161
76;65;65113;282;11;293
76;65;65114;75;4;79
76;65;65115;289;10;299
76;65;65116;299;5;304
76;65;65117;42;1;43
76;65;65118;38;1;39
76;65;65119;368;11;379
76;65;65120;337;14;351
76;65;65121;390;11;401
76;65;65123;1313;54;1367
76;65;65124;57;2;59
76;65;65125;313;7;320
76;65;65126;147;5;152
76;65;65127;1264;26;1290
76;65;65128;138;3;141
76;65;65129;799;22;821
76;65;65130;614;12;626
76;65;65131;245;2;247
76;65;65132;44;0;44
76;65;65133;235;4;239
76;65;65134;13;0;13
76;65;65135;82;0;82
76;65;65136;34;0;34
76;65;65137;96;3;99
76;65;65138;878;19;897
76;65;65139;54;1;55
76;65;65140;31;1;32
76;65;65141;56;3;59
76;65;65142;211;4;215
76;65;65143;113;2;115
76;65;65144;87;2;89
76;65;65145;49;0;49
76;65;65146;312;1;313
76;65;65147;608;12;620
76;65;65148;133;1;134
76;65;65149;169;4;173
76;65;65150;499;25;524
76;65;65151;146;4;150
76;65;65153;122;5;127
76;65;65154;59;0;59
76;65;65155;52;2;54
76;65;65156;217;5;222
76;65;65157;21;2;23
76;65;65158;82;0;82
76;65;65159;361;11;372
76;65;65160;120;3;123
76;65;65161;282;4;286
76;65;65162;33;1;34
76;65;65163;39;1;40
76;65;65164;107;2;109
76;65;65165;188;1;189
76;65;65166;53;0;53
76;65;65167;26;1;27
76;65;65168;406;12;418
76;65;65169;90;2;92
76;65;65170;78;2;80
76;65;65171;39;0;39
76;65;65172;39;0;39
76;65;65173;193;7;200
76;65;65174;105;4;109
76;65;65175;40;3;43
76;65;65176;83;0;83
76;65;65177;161;3;164
76;65;65178;53;0;53
76;65;65179;27;0;27
76;65;65180;13;0;13
76;65;65181;164;3;167
76;65;65182;124;1;125
76;65;65183;702;13;715
76;65;65184;173;2;175
76;65;65185;445;11;456
76;65;65186;35;0;35
76;65;65187;100;4;104
76;65;65189;281;2;283
76;65;65190;71;0;71
76;65;65191;123;2;125
76;65;65192;341;9;350
76;65;65193;87;4;91
76;65;65194;97;3;100
76;65;65195;139;0;139
76;65;65196;90;2;92
76;65;65197;155;9;164
76;65;65198;1117;34;1151
76;65;65199;36;0;36
76;65;65200;107;1;108
76;65;65201;183;4;187
76;65;65202;331;13;344
76;65;65203;27;1;28
76;65;65204;27;0;27
76;65;65205;54;1;55
76;65;65206;230;6;236
76;65;65207;64;0;64
76;65;65208;23;2;25
76;65;65209;78;0;78
76;65;65210;35;1;36
76;65;65211;148;5;153
76;65;65212;330;11;341
76;65;65213;121;3;124
76;65;65214;44;0;44
76;65;65215;44;2;46
76;65;65216;104;0;104
76;65;65217;55;2;57
76;65;65218;613;14;627
76;65;65219;122;1;123
76;65;65220;240;1;241
76;65;65221;255;5;260
76;65;65222;163;1;164
76;65;65223;1195;26;1221
76;65;65224;281;6;287
76;65;65225;105;1;106
76;65;65226;2906;138;3044
76;65;65228;121;0;121
76;65;65229;45;0;45
76;65;65230;255;6;261
76;65;65231;200;12;212
76;65;65232;68;2;70
76;65;65233;315;4;319
76;65;65234;93;3;96
76;65;65235;4045;95;4140
76;65;65236;441;12;453
76;65;65237;160;5;165
76;65;65238;236;10;246
76;65;65239;154;5;159
76;65;65240;385;6;391
76;65;65241;85;3;88
76;65;65242;238;3;241
76;65;65243;458;18;476
76;65;65244;529;7;536
76;65;65245;234;7;241
76;65;65247;104;1;105
76;65;65248;258;17;275
76;65;65249;101;5;106
76;65;65250;118;1;119
76;65;65251;1877;65;1942
76;65;65252;866;14;880
76;65;65253;53;0;53
76;65;65254;143;4;147
76;65;65255;30;0;30
76;65;65256;147;2;149
76;65;65257;601;9;610
76;65;65258;5816;159;5975
76;65;65259;180;5;185
76;65;65260;95;1;96
76;65;65261;48;1;49
76;65;65262;400;10;410
76;65;65263;95;3;98
76;65;65264;311;25;336
76;65;65265;329;10;339
76;65;65266;36;1;37
76;65;65267;522;17;539
76;65;65268;212;3;215
76;65;65269;168;3;171
76;65;65270;204;9;213
76;65;65271;355;4;359
76;65;65272;78;0;78
76;65;65273;198;0;198
76;65;65274;138;1;139
76;65;65275;74;2;76
76;65;65276;117;1;118
76;65;65277;92;3;95
76;65;65278;31;0;31
76;65;65279;218;8;226
76;65;65280;424;2;426
76;65;65281;242;4;246
76;65;65282;297;6;303
76;65;65283;50;3;53
76;65;65284;1040;28;1068
76;65;65285;188;3;191
76;65;65286;13132;317;13449
76;65;65287;630;13;643
76;65;65288;53;0;53
76;65;65289;111;1;112
76;65;65290;193;1;194
76;65;65291;135;3;138
76;65;65292;401;3;404
76;65;65293;104;2;106
76;65;65294;219;3;222
76;65;65295;939;15;954
76;65;65296;424;12;436
76;65;65297;41;5;46
76;65;65298;85;0;85
76;65;65299;222;4;226
76;65;65300;67;5;72
76;65;65301;260;4;264
76;65;65303;362;4;366
76;65;65304;2266;28;2294
76;65;65305;92;0;92
76;65;65306;233;4;237
76;65;65307;337;6;343
76;65;65308;106;4;110
76;65;65309;15;3;18
76;65;65310;243;5;248
76;65;65311;101;0;101
76;65;65313;744;23;767
76;65;65314;209;6;215
76;65;65315;419;221;640
76;65;65316;103;4;107
76;65;65317;36;2;38
76;65;65318;227;6;233
76;65;65319;137;2;139
76;65;65320;850;18;868
76;65;65321;144;2;146
76;65;65322;254;7;261
76;65;65323;82;0;82
76;65;65324;212;7;219
76;65;65325;44;0;44
76;65;65326;89;3;92
76;65;65327;153;2;155
76;65;65328;97;4;101
76;65;65329;210;8;218
76;65;65330;216;3;219
76;65;65331;3290;99;3389
76;65;65332;170;1;171
76;65;65333;114;1;115
76;65;65334;224;3;227
76;65;65335;523;16;539
76;65;65336;36;0;36
76;65;65337;106;3;109
76;65;65338;245;3;248
76;65;65339;327;7;334
76;65;65340;2011;43;2054
76;65;65341;111;2;113
76;65;65342;95;2;97
76;65;65343;246;4;250
76;65;65344;2374;49;2423
76;65;65345;55;0;55
76;65;65346;160;6;166
76;65;65347;44;0;44
76;65;65348;46;2;48
76;65;65349;11;0;11
76;65;65350;1197;41;1238
76;65;65351;32;0;32
76;65;65352;219;8;227
76;65;65353;259;10;269
76;65;65354;71;2;73
76;65;65355;71;0;71
76;65;65356;59;2;61
76;65;65357;168;3;171
76;65;65358;52;2;54
76;65;65359;30;0;30
76;65;65360;276;8;284
76;65;65361;93;0;93
76;65;65362;1126;25;1151
76;65;65363;450;9;459
76;65;65364;21;3;24
76;65;65366;843;17;860
76;65;65367;164;3;167
76;65;65368;43;2;45
76;65;65369;647;22;669
76;65;65370;1115;38;1153
76;65;65371;234;10;244
76;65;65372;644;14;658
76;65;65373;165;4;169
76;65;65374;232;1;233
76;65;65375;1447;25;1472
76;65;65376;223;9;232
76;65;65377;158;8;166
76;65;65378;67;2;69
76;65;65379;15;0;15
76;65;65380;149;1;150
76;65;65381;34;0;34
76;65;65382;74;3;77
76;65;65383;193;2;195
76;65;65384;173;1;174
76;65;65385;93;2;95
76;65;65386;97;0;97
76;65;65387;128;2;130
76;65;65388;844;18;862
76;65;65389;943;38;981
76;65;65390;426;14;440
76;65;65391;59;0;59
76;65;65392;445;8;453
76;65;65393;142;5;147
76;65;65394;318;3;321
76;65;65395;1159;19;1178
76;65;65396;360;7;367
76;65;65397;165;3;168
76;65;65398;254;2;256
76;65;65399;102;3;105
76;65;65400;229;7;236
76;65;65401;581;24;605
76;65;65402;25;0;25
76;65;65403;100;2;102
76;65;65404;154;3;157
76;65;65405;75;3;78
76;65;65406;257;5;262
76;65;65407;107;2;109
76;65;65408;563;20;583
76;65;65409;301;5;306
76;65;65410;518;17;535
76;65;65411;77;6;83
76;65;65412;167;4;171
76;65;65413;139;4;143
76;65;65414;79;4;83
76;65;65415;242;1;243
76;65;65416;86;3;89
76;65;65417;5085;103;5188
76;65;65418;291;7;298
76;65;65419;68;0;68
76;65;65420;77;2;79
76;65;65421;50;2;52
76;65;65422;332;3;335
76;65;65423;131;1;132
76;65;65424;117;2;119
76;65;65425;447;7;454
76;65;65426;132;6;138
76;65;65427;283;5;288
76;65;65428;63;1;64
76;65;65429;206;8;214
76;65;65430;43;1;44
76;65;65431;95;4;99
76;65;65432;180;5;185
76;65;65433;3066;58;3124
76;65;65435;274;4;278
76;65;65436;305;7;312
76;65;65437;129;3;132
76;65;65438;76;1;77
76;65;65439;271;3;274
76;65;65440;42758;1063;43821
76;65;65441;78;3;81
76;65;65442;211;1;212
76;65;65443;17;0;17
76;65;65444;319;4;323
76;65;65445;227;6;233
76;65;65446;547;8;555
76;65;65447;1172;21;1193
76;65;65448;92;4;96
76;65;65449;90;5;95
76;65;65450;37;1;38
76;65;65451;753;14;767
76;65;65452;1007;26;1033
76;65;65453;75;0;75
76;65;65454;104;1;105
76;65;65455;438;9;447
76;65;65456;288;11;299
76;65;65457;83;1;84
76;65;65458;31;1;32
76;65;65459;102;4;106
76;65;65460;4843;268;5111
76;65;65461;112;1;113
76;65;65462;243;9;252
76;65;65463;85;1;86
76;65;65464;505;10;515
76;65;65465;325;10;335
76;65;65466;86;1;87
76;65;65467;98;6;104
76;65;65468;40;1;41
76;65;65469;25;1;26
76;65;65470;144;4;148
76;65;65471;215;8;223
76;65;65472;76;5;81
76;65;65473;397;15;412
76;65;65474;112;2;114
76;65;65475;60;1;61
76;65;65476;64;4;68
76;65;65477;101;2;103
76;65;65478;32;2;34
76;65;65479;351;10;361
76;65;65481;159;5;164
76;65;65482;442;11;453
76;66;66001;73;1;74
76;66;66002;3645;61;3706
76;66;66003;3542;47;3589
76;66;66004;553;8;561
76;66;66005;561;34;595
76;66;66006;165;2;167
76;66;66007;124;3;127
76;66;66008;10260;248;10508
76;66;66009;2724;38;2762
76;66;66010;36;0;36
76;66;66011;4291;51;4342
76;66;66012;3431;64;3495
76;66;66013;117;3;120
76;66;66014;2612;50;2662
76;66;66015;1271;22;1293
76;66;66016;4738;77;4815
76;66;66017;5771;40;5811
76;66;66018;68;0;68
76;66;66019;216;4;220
76;66;66020;818;26;844
76;66;66021;7426;105;7531
76;66;66022;55;0;55
76;66;66023;949;8;957
76;66;66024;5278;55;5333
76;66;66025;1207;75;1282
76;66;66026;1532;32;1564
76;66;66027;694;14;708
76;66;66028;10301;206;10507
76;66;66029;134;1;135
76;66;66030;213;2;215
76;66;66032;59;0;59
76;66;66033;460;13;473
76;66;66034;111;5;116
76;66;66035;40;0;40
76;66;66036;24;0;24
76;66;66037;12284;251;12535
76;66;66038;6344;115;6459
76;66;66039;137;1;138
76;66;66040;41;1;42
76;66;66041;940;20;960
76;66;66042;265;6;271
76;66;66043;136;2;138
76;66;66044;293;6;299
76;66;66045;780;15;795
76;66;66046;603;11;614
76;66;66047;18;2;20
76;66;66048;1345;16;1361
76;66;66049;7857;233;8090
76;66;66050;4470;54;4524
76;66;66051;265;8;273
76;66;66052;368;11;379
76;66;66053;2407;28;2435
76;66;66054;60;3;63
76;66;66055;762;15;777
76;66;66056;1048;15;1063
76;66;66057;530;4;534
76;66;66058;1975;35;2010
76;66;66059;2327;28;2355
76;66;66060;222;20;242
76;66;66061;93;0;93
76;66;66062;169;7;176
76;66;66063;234;3;237
76;66;66064;421;11;432
76;66;66065;9248;116;9364
76;66;66066;637;23;660
76;66;66067;668;22;690
76;66;66068;108;1;109
76;66;66069;3475;135;3610
76;66;66070;165;4;169
76;66;66071;2049;18;2067
76;66;66072;477;9;486
76;66;66073;138;2;140
76;66;66074;381;9;390
76;66;66075;141;9;150
76;66;66076;65;0;65
76;66;66077;88;1;89
76;66;66078;189;7;196
76;66;66079;192;5;197
76;66;66080;117;2;119
76;66;66081;125;3;128
76;66;66082;505;4;509
76;66;66083;41;0;41
76;66;66084;1311;19;1330
76;66;66085;443;9;452
76;66;66086;25;0;25
76;66;66088;5513;63;5576
76;66;66089;321;6;327
76;66;66090;44;2;46
76;66;66091;57;1;58
76;66;66092;90;0;90
76;66;66093;2140;41;2181
76;66;66094;3158;46;3204
76;66;66095;439;4;443
76;66;66096;1038;12;1050
76;66;66097;139;4;143
76;66;66098;220;10;230
76;66;66099;317;2;319
76;66;66100;171;3;174
76;66;66101;2074;42;2116
76;66;66102;29;1;30
76;66;66103;574;7;581
76;66;66104;982;12;994
76;66;66105;277;5;282
76;66;66106;2568;49;2617
76;66;66107;794;6;800
76;66;66108;4264;69;4333
76;66;66109;242;4;246
76;66;66111;149;2;151
76;66;66112;251;5;256
76;66;66113;177;2;179
76;66;66114;1647;39;1686
76;66;66115;1235;23;1258
76;66;66116;186;4;190
76;66;66117;148;9;157
76;66;66118;338;8;346
76;66;66119;318;7;325
76;66;66120;76;1;77
76;66;66121;1287;36;1323
76;66;66122;60;2;62
76;66;66123;151;0;151
76;66;66124;1840;183;2023
76;66;66125;351;5;356
76;66;66126;332;4;336
76;66;66127;1192;15;1207
76;66;66128;25;0;25
76;66;66129;1591;20;1611
76;66;66130;1350;75;1425
76;66;66132;417;10;427
76;66;66133;3094;45;3139
76;66;66134;970;10;980
76;66;66136;119344;1427;120771
76;66;66137;549;3;552
76;66;66138;1527;25;1552
76;66;66139;40;0;40
76;66;66140;3812;55;3867
76;66;66141;9849;96;9945
76;66;66142;54;2;56
76;66;66143;93;2;95
76;66;66144;5229;85;5314
76;66;66145;2841;44;2885
76;66;66146;115;7;122
76;66;66147;105;1;106
76;66;66148;4016;77;4093
76;66;66149;6028;339;6367
76;66;66150;1175;19;1194
76;66;66151;78;3;81
76;66;66152;103;0;103
76;66;66153;48;0;48
76;66;66154;63;1;64
76;66;66155;80;0;80
76;66;66156;93;1;94
76;66;66157;26;1;27
76;66;66158;151;2;153
76;66;66159;63;0;63
76;66;66160;1255;20;1275
76;66;66161;1348;30;1378
76;66;66162;648;2;650
76;66;66164;8888;142;9030
76;66;66165;628;6;634
76;66;66166;391;7;398
76;66;66167;1146;27;1173
76;66;66168;3422;52;3474
76;66;66169;111;1;112
76;66;66170;161;2;163
76;66;66171;11040;150;11190
76;66;66172;11719;160;11879
76;66;66173;1194;20;1214
76;66;66174;2874;45;2919
76;66;66175;2841;26;2867
76;66;66176;3198;31;3229
76;66;66177;1541;17;1558
76;66;66178;2273;45;2318
76;66;66179;1044;13;1057
76;66;66180;10071;102;10173
76;66;66181;122;1;123
76;66;66182;4821;62;4883
76;66;66183;66;0;66
76;66;66184;52;3;55
76;66;66185;350;12;362
76;66;66186;2784;43;2827
76;66;66187;1790;18;1808
76;66;66188;263;10;273
76;66;66189;5564;105;5669
76;66;66190;3514;12;3526
76;66;66191;19;0;19
76;66;66192;90;1;91
76;66;66193;232;5;237
76;66;66194;219;2;221
76;66;66195;7752;115;7867
76;66;66196;3343;50;3393
76;66;66197;37;0;37
76;66;66198;498;5;503
76;66;66199;102;1;103
76;66;66201;43;1;44
76;66;66202;195;5;200
76;66;66203;56;0;56
76;66;66204;332;11;343
76;66;66205;859;21;880
76;66;66206;93;0;93
76;66;66207;720;10;730
76;66;66208;2127;99;2226
76;66;66209;40;2;42
76;66;66210;7924;135;8059
76;66;66211;172;7;179
76;66;66212;3839;68;3907
76;66;66213;7192;124;7316
76;66;66214;1085;13;1098
76;66;66215;160;0;160
76;66;66216;75;2;77
76;66;66217;2174;24;2198
76;66;66218;359;11;370
76;66;66219;50;1;51
76;66;66220;38;1;39
76;66;66221;34;0;34
76;66;66222;1450;46;1496
76;66;66223;210;5;215
76;66;66224;3248;36;3284
76;66;66225;1780;61;1841
76;66;66226;1390;24;1414
76;66;66227;3977;67;4044
76;66;66228;1372;25;1397
76;66;66230;2131;26;2157
76;66;66231;574;4;578
76;66;66232;26;0;26
76;66;66233;175;4;179
76;66;66234;69;0;69
44;67;67001;2338;32;2370
44;67;67002;390;3;393
44;67;67003;441;16;457
44;67;67004;1530;28;1558
44;67;67005;850;18;868
44;67;67006;213;1;214
44;67;67008;1363;22;1385
44;67;67009;380;13;393
44;67;67010;1738;70;1808
44;67;67011;992;12;1004
44;67;67012;647;18;665
44;67;67013;274;3;277
44;67;67016;763;11;774
44;67;67017;298;5;303
44;67;67018;670;9;679
44;67;67019;1182;18;1200
44;67;67020;838;7;845
44;67;67021;7197;193;7390
44;67;67022;233;5;238
44;67;67023;978;21;999
44;67;67025;1934;26;1960
44;67;67026;163;3;166
44;67;67027;177;0;177
44;67;67028;5801;95;5896
44;67;67029;360;4;364
44;67;67030;722;7;729
44;67;67031;1437;44;1481
44;67;67032;212;7;219
44;67;67033;602;7;609
44;67;67034;2460;41;2501
44;67;67035;444;15;459
44;67;67036;304;7;311
44;67;67037;365;5;370
44;67;67038;298;2;300
44;67;67039;515;11;526
44;67;67040;1040;10;1050
44;67;67043;17353;209;17562
44;67;67044;259;0;259
44;67;67045;3329;58;3387
44;67;67046;12746;137;12883
44;67;67047;157;3;160
44;67;67048;460;15;475
44;67;67049;1301;20;1321
44;67;67050;34;0;34
44;67;67051;313;11;324
44;67;67052;2442;64;2506
44;67;67053;321;10;331
44;67;67054;545;6;551
44;67;67055;1381;19;1400
44;67;67056;763;12;775
44;67;67057;171;6;177
44;67;67058;391;4;395
44;67;67059;411;6;417
44;67;67060;631;10;641
44;67;67061;3757;77;3834
44;67;67062;328;6;334
44;67;67063;651;16;667
44;67;67065;1313;15;1328
44;67;67066;2629;89;2718
44;67;67067;10081;104;10185
44;67;67068;280;2;282
44;67;67069;511;7;518
44;67;67070;278;3;281
44;67;67071;464;11;475
44;67;67072;663;22;685
44;67;67073;4199;88;4287
44;67;67074;667;19;686
44;67;67075;429;7;436
44;67;67076;476;9;485
44;67;67077;583;14;597
44;67;67078;270;3;273
44;67;67079;181;3;184
44;67;67080;1840;20;1860
44;67;67081;785;12;797
44;67;67082;1204;11;1215
44;67;67083;754;12;766
44;67;67084;2215;41;2256
44;67;67085;713;11;724
44;67;67086;447;10;457
44;67;67087;1439;15;1454
44;67;67088;351;7;358
44;67;67089;2610;26;2636
44;67;67090;675;43;718
44;67;67091;337;13;350
44;67;67092;631;27;658
44;67;67093;348;6;354
44;67;67094;253;2;255
44;67;67095;1595;36;1631
44;67;67096;318;11;329
44;67;67097;1233;17;1250
44;67;67098;1492;19;1511
44;67;67099;281;4;285
44;67;67100;352;1;353
44;67;67101;2613;32;2645
44;67;67102;300;5;305
44;67;67103;1038;25;1063
44;67;67104;608;15;623
44;67;67105;1438;27;1465
44;67;67106;5268;47;5315
44;67;67107;656;5;661
44;67;67108;1638;18;1656
44;67;67109;656;17;673
44;67;67110;1081;17;1098
44;67;67111;424;11;435
44;67;67112;2865;30;2895
44;67;67113;422;7;429
44;67;67115;2287;23;2310
44;67;67116;528;25;553
44;67;67117;434;11;445
44;67;67118;7049;64;7113
44;67;67119;1344;20;1364
44;67;67120;527;11;538
44;67;67121;810;10;820
44;67;67122;1332;15;1347
44;67;67123;494;1;495
44;67;67124;2453;25;2478
44;67;67125;2247;76;2323
44;67;67126;299;6;305
44;67;67127;1410;14;1424
44;67;67128;1887;18;1905
44;67;67129;595;6;601
44;67;67130;10661;123;10784
44;67;67131;5424;53;5477
44;67;67132;944;11;955
44;67;67133;471;6;477
44;67;67134;191;0;191
44;67;67135;762;5;767
44;67;67136;275;5;280
44;67;67137;5734;66;5800
44;67;67138;574;9;583
44;67;67139;474;9;483
44;67;67140;754;4;758
44;67;67141;598;4;602
44;67;67142;290;2;292
44;67;67143;643;19;662
44;67;67144;337;3;340
44;67;67145;258;6;264
44;67;67146;618;8;626
44;67;67147;498;4;502
44;67;67148;168;4;172
44;67;67149;421;7;428
44;67;67150;1366;23;1389
44;67;67151;5041;49;5090
44;67;67152;7561;79;7640
44;67;67153;397;3;400
44;67;67154;3449;55;3504
44;67;67155;1258;17;1275
44;67;67156;2586;31;2617
44;67;67159;209;6;215
44;67;67160;1057;26;1083
44;67;67161;380;11;391
44;67;67162;355;8;363
44;67;67163;544;13;557
44;67;67164;838;20;858
44;67;67165;385;7;392
44;67;67166;250;4;254
44;67;67167;1218;16;1234
44;67;67168;1666;24;1690
44;67;67169;2874;34;2908
44;67;67172;2228;40;2268
44;67;67173;1201;16;1217
44;67;67174;1167;8;1175
44;67;67176;3712;62;3774
44;67;67177;641;10;651
44;67;67178;277;5;282
44;67;67179;650;8;658
44;67;67180;35196;561;35757
44;67;67181;272;6;278
44;67;67182;1647;24;1671
44;67;67183;877;20;897
44;67;67184;1910;25;1935
44;67;67185;703;4;707
44;67;67186;433;7;440
44;67;67187;540;8;548
44;67;67188;697;11;708
44;67;67189;961;22;983
44;67;67190;195;2;197
44;67;67191;1840;26;1866
44;67;67192;937;10;947
44;67;67194;4731;73;4804
44;67;67195;619;10;629
44;67;67196;2649;31;2680
44;67;67197;1510;21;1531
44;67;67198;111;3;114
44;67;67199;82;1;83
44;67;67200;1001;8;1009
44;67;67201;307;7;314
44;67;67202;4048;38;4086
44;67;67203;384;5;389
44;67;67204;11304;81;11385
44;67;67205;4514;51;4565
44;67;67206;1118;18;1136
44;67;67208;547;7;554
44;67;67209;273;2;275
44;67;67210;505;13;518
44;67;67212;3703;30;3733
44;67;67213;632;16;648
44;67;67214;978;7;985
44;67;67215;497;3;500
44;67;67216;2672;38;2710
44;67;67217;351;4;355
44;67;67218;26698;691;27389
44;67;67220;327;2;329
44;67;67221;347;5;352
44;67;67222;4048;37;4085
44;67;67223;1183;7;1190
44;67;67225;113;2;115
44;67;67226;2112;24;2136
44;67;67227;237;4;241
44;67;67228;795;17;812
44;67;67229;199;2;201
44;67;67230;2450;19;2469
44;67;67231;212;2;214
44;67;67232;204;6;210
44;67;67233;1203;20;1223
44;67;67234;1510;30;1540
44;67;67235;427;2;429
44;67;67236;549;10;559
44;67;67237;2515;35;2550
44;67;67238;638;7;645
44;67;67239;1660;32;1692
44;67;67240;719;3;722
44;67;67241;147;4;151
44;67;67242;526;5;531
44;67;67244;154;3;157
44;67;67245;207;3;210
44;67;67246;1267;18;1285
44;67;67247;973;21;994
44;67;67248;1715;26;1741
44;67;67249;239;7;246
44;67;67250;793;18;811
44;67;67252;1079;12;1091
44;67;67253;637;10;647
44;67;67254;913;16;929
44;67;67255;478;8;486
44;67;67256;3405;53;3458
44;67;67257;706;15;721
44;67;67258;193;3;196
44;67;67259;920;11;931
44;67;67260;321;5;326
44;67;67261;2331;27;2358
44;67;67263;1548;42;1590
44;67;67264;829;12;841
44;67;67265;550;7;557
44;67;67266;664;8;672
44;67;67267;19439;150;19589
44;67;67268;2664;30;2694
44;67;67269;297;3;300
44;67;67270;390;1;391
44;67;67271;648;7;655
44;67;67272;395;6;401
44;67;67273;515;6;521
44;67;67274;246;2;248
44;67;67275;806;13;819
44;67;67276;1879;28;1907
44;67;67277;760;11;771
44;67;67278;547;13;560
44;67;67279;233;5;238
44;67;67280;798;18;816
44;67;67281;4159;65;4224
44;67;67282;4250;65;4315
44;67;67283;2712;43;2755
44;67;67285;1461;108;1569
44;67;67286;1500;19;1519
44;67;67287;584;6;590
44;67;67288;324;4;328
44;67;67289;635;10;645
44;67;67290;922;17;939
44;67;67291;3363;40;3403
44;67;67292;669;12;681
44;67;67293;652;11;663
44;67;67295;620;24;644
44;67;67296;2086;24;2110
44;67;67298;569;8;577
44;67;67299;905;25;930
44;67;67300;9343;132;9475
44;67;67301;2126;20;2146
44;67;67302;2032;37;2069
44;67;67303;684;12;696
44;67;67304;576;13;589
44;67;67305;1955;21;1976
44;67;67306;643;54;697
44;67;67307;463;5;468
44;67;67308;802;9;811
44;67;67309;4749;62;4811
44;67;67310;1169;34;1203
44;67;67311;2136;28;2164
44;67;67312;477;9;486
44;67;67313;6063;53;6116
44;67;67314;531;8;539
44;67;67315;668;14;682
44;67;67317;671;17;688
44;67;67319;365;3;368
44;67;67320;623;10;633
44;67;67321;331;8;339
44;67;67322;1102;13;1115
44;67;67324;4381;68;4449
44;67;67325;1398;17;1415
44;67;67326;1663;13;1676
44;67;67327;961;22;983
44;67;67328;877;7;884
44;67;67329;1268;22;1290
44;67;67330;927;9;936
44;67;67331;1380;13;1393
44;67;67333;292;5;297
44;67;67334;115;1;116
44;67;67335;925;16;941
44;67;67336;1740;30;1770
44;67;67337;456;16;472
44;67;67338;1349;23;1372
44;67;67339;4183;47;4230
44;67;67340;1554;27;1581
44;67;67341;390;2;392
44;67;67342;1760;29;1789
44;67;67343;5363;56;5419
44;67;67344;318;4;322
44;67;67345;3497;27;3524
44;67;67346;547;11;558
44;67;67347;1685;22;1707
44;67;67348;11765;456;12221
44;67;67349;531;9;540
44;67;67350;2279;24;2303
44;67;67351;1699;38;1737
44;67;67352;409;8;417
44;67;67353;231;2;233
44;67;67354;515;9;524
44;67;67355;1167;28;1195
44;67;67356;2518;23;2541
44;67;67358;802;13;815
44;67;67359;1305;23;1328
44;67;67360;1071;14;1085
44;67;67361;500;7;507
44;67;67362;589;5;594
44;67;67363;816;17;833
44;67;67364;930;17;947
44;67;67365;12723;129;12852
44;67;67366;782;18;800
44;67;67367;1312;32;1344
44;67;67368;1537;31;1568
44;67;67369;260;5;265
44;67;67370;660;12;672
44;67;67371;624;4;628
44;67;67372;5040;59;5099
44;67;67373;318;4;322
44;67;67375;1307;17;1324
44;67;67377;997;11;1008
44;67;67378;4465;42;4507
44;67;67379;896;15;911
44;67;67380;203;4;207
44;67;67381;359;5;364
44;67;67382;782;18;800
44;67;67383;183;5;188
44;67;67384;313;6;319
44;67;67385;245;2;247
44;67;67386;209;2;211
44;67;67387;298;9;307
44;67;67388;5402;84;5486
44;67;67389;4397;41;4438
44;67;67391;448;6;454
44;67;67392;850;12;862
44;67;67394;279;6;285
44;67;67395;393;10;403
44;67;67396;201;1;202
44;67;67397;2670;31;2701
44;67;67398;360;2;362
44;67;67400;1108;20;1128
44;67;67401;306;10;316
44;67;67403;439;11;450
44;67;67404;908;16;924
44;67;67405;2281;50;2331
44;67;67406;340;3;343
44;67;67407;1613;13;1626
44;67;67408;1214;17;1231
44;67;67409;1010;8;1018
44;67;67410;661;14;675
44;67;67411;5221;112;5333
44;67;67412;1024;9;1033
44;67;67413;522;11;533
44;67;67414;1550;20;1570
44;67;67415;470;1;471
44;67;67416;469;10;479
44;67;67417;297;9;306
44;67;67418;1929;35;1964
44;67;67420;1240;16;1256
44;67;67421;828;12;840
44;67;67422;592;10;602
44;67;67423;586;7;593
44;67;67424;237;0;237
44;67;67425;533;13;546
44;67;67426;362;1;363
44;67;67427;341;14;355
44;67;67428;492;12;504
44;67;67429;627;12;639
44;67;67430;763;25;788
44;67;67432;584;11;595
44;67;67433;1376;10;1386
44;67;67434;2796;43;2839
44;67;67435;837;21;858
44;67;67436;501;12;513
44;67;67437;11378;306;11684
44;67;67438;821;13;834
44;67;67440;553;12;565
44;67;67441;330;5;335
44;67;67442;1242;61;1303
44;67;67443;842;20;862
44;67;67444;121;3;124
44;67;67445;3217;53;3270
44;67;67446;430;11;441
44;67;67447;33780;198;33978
44;67;67448;2149;49;2198
44;67;67449;2258;21;2279
44;67;67450;695;16;711
44;67;67451;1394;32;1426
44;67;67452;1713;32;1745
44;67;67453;613;8;621
44;67;67454;400;8;408
44;67;67455;696;11;707
44;67;67456;450;10;460
44;67;67458;4942;61;5003
44;67;67459;746;17;763
44;67;67460;1715;22;1737
44;67;67461;327;14;341
44;67;67462;19242;265;19507
44;67;67463;3162;34;3196
44;67;67464;949;13;962
44;67;67465;2324;33;2357
44;67;67466;509;9;518
44;67;67467;383;7;390
44;67;67468;623;16;639
44;67;67470;99;1;100
44;67;67471;7994;62;8056
44;67;67472;4827;55;4882
44;67;67473;961;18;979
44;67;67474;3190;35;3225
44;67;67475;230;3;233
44;67;67476;740;6;746
44;67;67477;607;18;625
44;67;67478;1940;28;1968
44;67;67479;597;22;619
44;67;67480;1811;26;1837
44;67;67481;1089;14;1103
44;67;67482;287228;2878;290106
44;67;67483;233;4;237
44;67;67484;487;10;497
44;67;67485;1593;26;1619
44;67;67486;1851;24;1875
44;67;67487;1714;25;1739
44;67;67488;186;4;190
44;67;67489;811;19;830
44;67;67490;586;18;604
44;67;67491;249;0;249
44;67;67492;649;16;665
44;67;67493;440;10;450
44;67;67494;584;11;595
44;67;67495;4267;99;4366
44;67;67497;677;14;691
44;67;67498;705;6;711
44;67;67499;318;14;332
44;67;67500;1457;35;1492
44;67;67501;561;4;565
44;67;67502;209;2;211
44;67;67503;160;2;162
44;67;67504;1397;15;1412
44;67;67505;401;13;414
44;67;67506;5971;69;6040
44;67;67507;1802;33;1835
44;67;67508;417;19;436
44;67;67509;351;3;354
44;67;67510;599;1;600
44;67;67511;948;274;1222
44;67;67513;129;1;130
44;67;67514;632;9;641
44;67;67515;568;9;577
44;67;67516;665;8;673
44;67;67517;670;11;681
44;67;67519;5881;112;5993
44;67;67520;5711;65;5776
44;67;67521;450;3;453
44;67;67522;546;7;553
44;67;67523;2766;37;2803
44;67;67524;521;8;529
44;67;67525;1636;26;1662
44;67;67526;1571;18;1589
44;67;67527;335;8;343
44;67;67528;565;9;574
44;67;67529;3398;35;3433
44;67;67530;377;6;383
44;67;67531;285;6;291
44;67;67532;1088;18;1106
44;67;67534;732;3;735
44;67;67535;1057;21;1078
44;67;67536;158;1;159
44;67;67537;446;6;452
44;67;67538;1585;21;1606
44;67;67539;2330;42;2372
44;67;67540;873;12;885
44;67;67541;533;2;535
44;67;67542;482;3;485
44;67;67543;2089;29;2118
44;67;67544;7487;213;7700
44;67;67545;503;7;510
44;67;67546;671;5;676
44;67;67547;2057;25;2082
44;67;67548;881;13;894
44;67;67550;1726;23;1749
44;67;67551;4174;56;4230
44;67;67552;346;10;356
44;67;67553;317;4;321
44;67;67554;969;13;982
44;67;67555;249;3;252
44;67;67556;203;3;206
44;67;67557;812;12;824
44;67;67558;748;13;761
44;67;67559;249;2;251
44;68;68001;1124;13;1137
44;68;68002;389;4;393
44;68;68004;5659;130;5789
44;68;68005;1761;48;1809
44;68;68006;1197;28;1225
44;68;68007;2182;73;2255
44;68;68008;578;11;589
44;68;68009;863;11;874
44;68;68010;1120;20;1140
44;68;68011;1317;26;1343
44;68;68012;1771;44;1815
44;68;68013;986;22;1008
44;68;68014;370;9;379
44;68;68015;2667;48;2715
44;68;68016;985;19;1004
44;68;68017;816;17;833
44;68;68018;731;16;747
44;68;68019;566;8;574
44;68;68020;1594;33;1627
44;68;68021;3987;85;4072
44;68;68022;1594;14;1608
44;68;68023;939;24;963
44;68;68024;162;6;168
44;68;68025;236;3;239
44;68;68026;1393;28;1421
44;68;68027;341;9;350
44;68;68028;2070;48;2118
44;68;68029;1096;32;1128
44;68;68030;424;14;438
44;68;68032;1195;36;1231
44;68;68033;441;8;449
44;68;68034;312;16;328
44;68;68035;323;14;337
44;68;68036;2530;55;2585
44;68;68037;467;7;474
44;68;68038;1118;26;1144
44;68;68039;546;15;561
44;68;68040;1988;37;2025
44;68;68041;1999;26;2025
44;68;68042;4661;116;4777
44;68;68043;4122;57;4179
44;68;68044;741;30;771
44;68;68045;555;16;571
44;68;68046;417;10;427
44;68;68049;439;15;454
44;68;68050;404;13;417
44;68;68051;823;16;839
44;68;68052;184;3;187
44;68;68054;417;8;425
44;68;68055;1052;33;1085
44;68;68056;8163;214;8377
44;68;68057;279;5;284
44;68;68058;3354;37;3391
44;68;68059;1921;45;1966
44;68;68060;1749;46;1795
44;68;68061;1060;17;1077
44;68;68062;2045;105;2150
44;68;68063;11476;208;11684
44;68;68064;970;19;989
44;68;68065;708;10;718
44;68;68066;68682;1074;69756
44;68;68067;354;2;356
44;68;68068;2262;36;2298
44;68;68069;1491;32;1523
44;68;68071;297;6;303
44;68;68072;1430;53;1483
44;68;68073;479;11;490
44;68;68074;558;7;565
44;68;68075;824;17;841
44;68;68076;964;11;975
44;68;68077;371;10;381
44;68;68078;1721;41;1762
44;68;68079;255;0;255
44;68;68080;302;3;305
44;68;68081;570;9;579
44;68;68082;7512;70;7582
44;68;68083;364;13;377
44;68;68084;1479;48;1527
44;68;68085;378;5;383
44;68;68086;207;10;217
44;68;68087;461;11;472
44;68;68088;997;20;1017
44;68;68089;1601;25;1626
44;68;68090;812;13;825
44;68;68091;2267;47;2314
44;68;68092;393;6;399
44;68;68093;1438;48;1486
44;68;68094;941;14;955
44;68;68095;1168;40;1208
44;68;68096;367;4;371
44;68;68097;1316;32;1348
44;68;68098;650;7;657
44;68;68099;778;18;796
44;68;68100;339;14;353
44;68;68101;821;18;839
44;68;68102;439;10;449
44;68;68103;502;9;511
44;68;68104;296;5;301
44;68;68105;259;15;274
44;68;68106;279;6;285
44;68;68107;374;8;382
44;68;68109;696;14;710
44;68;68110;806;18;824
44;68;68111;854;25;879
44;68;68112;11020;305;11325
44;68;68113;1422;28;1450
44;68;68114;142;1;143
44;68;68115;1291;21;1312
44;68;68116;716;22;738
44;68;68117;889;18;907
44;68;68118;4999;87;5086
44;68;68119;743;16;759
44;68;68120;1245;28;1273
44;68;68121;706;19;725
44;68;68122;637;10;647
44;68;68123;784;28;812
44;68;68124;380;10;390
44;68;68125;518;9;527
44;68;68126;3369;73;3442
44;68;68127;645;14;659
44;68;68128;662;15;677
44;68;68129;1327;50;1377
44;68;68130;1036;20;1056
44;68;68131;165;1;166
44;68;68132;716;18;734
44;68;68134;1859;28;1887
44;68;68135;2770;54;2824
44;68;68136;327;11;338
44;68;68137;621;9;630
44;68;68138;2120;52;2172
44;68;68139;1462;22;1484
44;68;68140;1302;15;1317
44;68;68141;2170;58;2228
44;68;68142;375;12;387
44;68;68143;1823;59;1882
44;68;68144;1346;26;1372
44;68;68145;6234;118;6352
44;68;68146;2327;23;2350
44;68;68147;606;8;614
44;68;68148;359;8;367
44;68;68149;7261;97;7358
44;68;68150;514;13;527
44;68;68151;1048;11;1059
44;68;68152;2473;39;2512
44;68;68153;730;14;744
44;68;68154;14784;201;14985
44;68;68155;4680;75;4755
44;68;68156;3418;47;3465
44;68;68157;1367;39;1406
44;68;68158;500;15;515
44;68;68159;911;25;936
44;68;68160;585;24;609
44;68;68161;537;23;560
44;68;68162;4394;92;4486
44;68;68163;5496;102;5598
44;68;68165;242;10;252
44;68;68166;13263;150;13413
44;68;68167;734;22;756
44;68;68168;376;7;383
44;68;68169;506;10;516
44;68;68170;586;24;610
44;68;68171;945;12;957
44;68;68172;1795;30;1825
44;68;68173;2122;76;2198
44;68;68174;1650;25;1675
44;68;68175;1871;40;1911
44;68;68176;324;4;328
44;68;68177;1492;38;1530
44;68;68178;950;14;964
44;68;68179;917;15;932
44;68;68180;909;29;938
44;68;68181;248;4;252
44;68;68182;1212;27;1239
44;68;68183;183;4;187
44;68;68184;303;9;312
44;68;68185;1684;32;1716
44;68;68186;307;10;317
44;68;68187;333;10;343
44;68;68188;584;19;603
44;68;68189;855;26;881
44;68;68190;33;0;33
44;68;68191;760;23;783
44;68;68192;427;7;434
44;68;68193;751;9;760
44;68;68194;283;5;288
44;68;68195;6247;98;6345
44;68;68196;300;5;305
44;68;68197;485;10;495
44;68;68198;286;8;294
44;68;68199;502;2;504
44;68;68200;533;12;545
44;68;68201;3720;79;3799
44;68;68202;202;4;206
44;68;68203;1247;26;1273
44;68;68204;1042;15;1057
44;68;68205;1830;19;1849
44;68;68207;697;9;706
44;68;68208;597;11;608
44;68;68209;834;16;850
44;68;68210;327;1;328
44;68;68211;386;8;394
44;68;68212;519;12;531
44;68;68213;341;10;351
44;68;68214;378;8;386
44;68;68215;908;7;915
44;68;68216;409;6;415
44;68;68217;1640;20;1660
44;68;68218;3692;76;3768
44;68;68219;881;24;905
44;68;68221;926;13;939
44;68;68222;1057;19;1076
44;68;68223;782;14;796
44;68;68224;108312;1219;109531
44;68;68225;1561;28;1589
44;68;68226;4699;84;4783
44;68;68227;1286;34;1320
44;68;68228;464;12;476
44;68;68229;163;3;166
44;68;68230;584;7;591
44;68;68231;1963;16;1979
44;68;68232;484;7;491
44;68;68234;733;11;744
44;68;68235;1147;16;1163
44;68;68237;558;15;573
44;68;68238;945;25;970
44;68;68239;390;15;405
44;68;68240;1319;19;1338
44;68;68241;665;9;674
44;68;68242;1245;26;1271
44;68;68243;140;1;141
44;68;68244;358;6;364
44;68;68245;412;15;427
44;68;68246;1018;13;1031
44;68;68247;1260;14;1274
44;68;68248;673;20;693
44;68;68249;3467;66;3533
44;68;68250;1041;18;1059
44;68;68251;859;22;881
44;68;68252;1654;30;1684
44;68;68253;1973;30;2003
44;68;68254;827;18;845
44;68;68255;1386;42;1428
44;68;68256;9723;131;9854
44;68;68257;966;23;989
44;68;68258;3017;77;3094
44;68;68259;515;7;522
44;68;68260;1113;26;1139
44;68;68261;229;6;235
44;68;68262;801;17;818
44;68;68263;635;13;648
44;68;68264;628;11;639
44;68;68265;797;23;820
44;68;68266;1990;30;2020
44;68;68267;1979;25;2004
44;68;68268;704;10;714
44;68;68269;4665;176;4841
44;68;68270;3692;59;3751
44;68;68271;12520;326;12846
44;68;68273;632;40;672
44;68;68274;188;0;188
44;68;68275;446;11;457
44;68;68276;192;2;194
44;68;68277;1090;19;1109
44;68;68278;14204;201;14405
44;68;68279;902;30;932
44;68;68280;374;6;380
44;68;68281;466;13;479
44;68;68282;280;5;285
44;68;68283;771;23;794
44;68;68284;696;10;706
44;68;68285;371;8;379
44;68;68286;2371;49;2420
44;68;68287;4302;236;4538
44;68;68288;401;4;405
44;68;68289;2329;37;2366
44;68;68290;888;16;904
44;68;68291;1059;27;1086
44;68;68292;2233;43;2276
44;68;68293;83;1;84
44;68;68294;1908;30;1938
44;68;68295;3029;66;3095
44;68;68296;993;14;1007
44;68;68297;22413;287;22700
44;68;68298;5054;127;5181
44;68;68299;312;0;312
44;68;68300;5479;125;5604
44;68;68301;1269;25;1294
44;68;68302;752;30;782
44;68;68303;229;7;236
44;68;68304;1561;39;1600
44;68;68305;1390;28;1418
44;68;68306;507;8;515
44;68;68307;498;10;508
44;68;68308;325;12;337
44;68;68309;3842;76;3918
44;68;68311;598;12;610
44;68;68312;318;6;324
44;68;68313;775;11;786
44;68;68315;7048;134;7182
44;68;68316;730;21;751
44;68;68317;1106;19;1125
44;68;68318;2392;52;2444
44;68;68320;1369;47;1416
44;68;68321;4046;62;4108
44;68;68322;1349;29;1378
44;68;68323;809;24;833
44;68;68324;611;17;628
44;68;68325;764;9;773
44;68;68326;153;5;158
44;68;68327;350;7;357
44;68;68328;201;1;202
44;68;68329;1349;34;1383
44;68;68330;338;8;346
44;68;68331;1939;58;1997
44;68;68332;949;13;962
44;68;68333;296;6;302
44;68;68334;7767;148;7915
44;68;68335;464;6;470
44;68;68336;459;8;467
44;68;68337;605;11;616
44;68;68338;3831;80;3911
44;68;68340;373;15;388
44;68;68341;946;30;976
44;68;68342;1698;43;1741
44;68;68343;2381;34;2415
44;68;68344;438;10;448
44;68;68345;757;27;784
44;68;68347;693;22;715
44;68;68348;2815;51;2866
44;68;68349;4421;95;4516
44;68;68350;477;15;492
44;68;68351;639;13;652
44;68;68352;2680;24;2704
44;68;68353;491;17;508
44;68;68354;920;37;957
44;68;68355;1543;28;1571
44;68;68356;880;21;901
44;68;68357;514;17;531
44;68;68358;471;11;482
44;68;68359;1663;59;1722
44;68;68360;653;4;657
44;68;68361;320;5;325
44;68;68362;771;15;786
44;68;68363;587;12;599
44;68;68364;992;19;1011
44;68;68365;1745;64;1809
44;68;68366;711;30;741
44;68;68367;1178;21;1199
44;68;68368;1242;35;1277
44;68;68370;169;2;171
44;68;68371;310;9;319
44;68;68372;1780;39;1819
44;68;68373;300;12;312
44;68;68374;7853;408;8261
44;68;68375;10362;137;10499
44;68;68376;14776;111;14887
44;68;68377;794;19;813
44;68;68378;380;4;384
44;68;68379;1036;20;1056
44;68;68380;443;11;454
44;68;68381;799;16;815
44;68;68382;379;4;383
44;68;68383;320;8;328
44;68;68384;2538;61;2599
44;68;68385;837;25;862
44;68;68386;1041;22;1063
84;69;69001;391;3;394
84;69;69002;245;1;246
84;69;69003;2947;42;2989
84;69;69004;768;24;792
84;69;69005;584;9;593
84;69;69006;4919;119;5038
84;69;69007;2749;45;2794
84;69;69008;668;15;683
84;69;69009;7538;164;7702
84;69;69010;6410;196;6606
84;69;69012;611;15;626
84;69;69013;3897;82;3979
84;69;69014;1129;22;1151
84;69;69016;121;0;121
84;69;69017;745;21;766
84;69;69018;2148;32;2180
84;69;69019;13314;277;13591
84;69;69020;681;19;700
84;69;69021;2340;80;2420
84;69;69022;558;16;574
84;69;69023;1635;25;1660
84;69;69024;4122;103;4225
84;69;69026;548;10;558
84;69;69027;12097;175;12272
84;69;69028;6478;111;6589
84;69;69029;42244;401;42645
84;69;69030;818;15;833
84;69;69031;1379;104;1483
84;69;69032;1988;36;2024
84;69;69033;2883;74;2957
84;69;69034;43294;622;43916
84;69;69035;381;7;388
84;69;69036;1138;22;1160
84;69;69037;833;12;845
84;69;69038;928;25;953
84;69;69039;694;10;704
84;69;69040;5748;48;5796
84;69;69042;566;15;581
84;69;69043;8846;173;9019
84;69;69044;5170;146;5316
84;69;69045;1248;68;1316
84;69;69046;4563;138;4701
84;69;69047;1051;21;1072
84;69;69049;2791;65;2856
84;69;69050;2113;42;2155
84;69;69051;1170;33;1203
84;69;69052;4132;113;4245
84;69;69053;543;13;556
84;69;69054;343;2;345
84;69;69055;1448;27;1475
84;69;69056;2107;52;2159
84;69;69057;582;13;595
84;69;69058;384;9;393
84;69;69059;1537;28;1565
84;69;69060;576;83;659
84;69;69061;1188;34;1222
84;69;69062;778;23;801
84;69;69063;4315;86;4401
84;69;69064;3957;83;4040
84;69;69065;965;15;980
84;69;69066;4390;80;4470
84;69;69067;1168;21;1189
84;69;69068;2454;48;2502
84;69;69069;11248;184;11432
84;69;69070;1266;28;1294
84;69;69071;1179;27;1206
84;69;69072;8752;612;9364
84;69;69074;1550;40;1590
84;69;69075;193;2;195
84;69;69076;2595;101;2696
84;69;69077;965;12;977
84;69;69078;837;16;853
84;69;69080;1901;16;1917
84;69;69081;18948;385;19333
84;69;69082;270;8;278
84;69;69083;1164;39;1203
84;69;69084;1282;22;1304
84;69;69085;1492;42;1534
84;69;69086;2290;63;2353
84;69;69087;3033;73;3106
84;69;69088;7066;97;7163
84;69;69089;14906;258;15164
84;69;69090;809;24;833
84;69;69091;20285;104;20389
84;69;69092;7496;345;7841
84;69;69093;1187;19;1206
84;69;69094;6062;115;6177
84;69;69095;827;17;844
84;69;69096;9706;75;9781
84;69;69097;772;20;792
84;69;69098;508;7;515
84;69;69099;1442;28;1470
84;69;69100;8750;121;8871
84;69;69102;734;12;746
84;69;69103;899;22;921
84;69;69104;432;9;441
84;69;69105;1021;37;1058
84;69;69106;1181;24;1205
84;69;69107;1055;66;1121
84;69;69108;1043;22;1065
84;69;69109;861;27;888
84;69;69110;1862;30;1892
84;69;69111;673;17;690
84;69;69112;6480;155;6635
84;69;69113;901;27;928
84;69;69115;4871;98;4969
84;69;69116;3648;102;3750
84;69;69117;3134;75;3209
84;69;69118;2618;32;2650
84;69;69119;977;8;985
84;69;69120;595;16;611
84;69;69121;2729;45;2774
84;69;69122;1916;53;1969
84;69;69124;459;9;468
84;69;69125;876;15;891
84;69;69126;768;28;796
84;69;69127;3549;64;3613
84;69;69130;233;3;236
84;69;69131;3402;85;3487
84;69;69132;847;15;862
84;69;69133;4318;80;4398
84;69;69134;227;10;237
84;69;69135;1911;53;1964
84;69;69136;3118;55;3173
84;69;69137;516;7;523
84;69;69138;445;9;454
84;69;69139;1378;77;1455
84;69;69140;1995;46;2041
84;69;69141;6144;172;6316
84;69;69142;6524;73;6597
84;69;69143;7562;88;7650
84;69;69145;921;25;946
84;69;69148;2541;71;2612
84;69;69149;26553;278;26831
84;69;69151;1524;32;1556
84;69;69152;10397;60;10457
84;69;69153;1377;28;1405
84;69;69154;2845;53;2898
84;69;69155;1132;31;1163
84;69;69156;2713;82;2795
84;69;69157;5279;88;5367
84;69;69159;3907;93;4000
84;69;69160;1065;18;1083
84;69;69161;487;11;498
84;69;69162;1331;34;1365
84;69;69163;3495;50;3545
84;69;69164;322;10;332
84;69;69165;1126;25;1151
84;69;69166;328;2;330
84;69;69167;589;11;600
84;69;69168;1536;41;1577
84;69;69169;639;23;662
84;69;69170;1157;18;1175
84;69;69171;2363;26;2389
84;69;69172;761;27;788
84;69;69173;1016;25;1041
84;69;69174;614;11;625
84;69;69175;1996;56;2052
84;69;69176;4590;84;4674
84;69;69177;2064;46;2110
84;69;69178;825;20;845
84;69;69179;4055;74;4129
84;69;69180;288;9;297
84;69;69181;223;1;224
84;69;69182;356;2;358
84;69;69183;317;2;319
84;69;69184;991;21;1012
84;69;69186;213;4;217
84;69;69187;654;21;675
84;69;69188;908;9;917
84;69;69189;1884;29;1913
84;69;69190;2028;87;2115
84;69;69191;5747;142;5889
84;69;69192;153;7;160
84;69;69193;1269;32;1301
84;69;69194;7006;158;7164
84;69;69196;617;11;628
84;69;69197;2210;48;2258
84;69;69198;756;11;767
84;69;69199;19617;61;19678
84;69;69200;1472;31;1503
84;69;69201;1286;25;1311
84;69;69202;22175;392;22567
84;69;69203;1018;17;1035
84;69;69204;20914;477;21391
84;69;69205;5158;92;5250
84;69;69206;4409;92;4501
84;69;69207;3001;47;3048
84;69;69208;2262;60;2322
84;69;69209;566;16;582
84;69;69212;479;11;490
84;69;69214;1204;25;1229
84;69;69215;879;20;899
84;69;69216;566;11;577
84;69;69217;748;22;770
84;69;69218;1048;17;1065
84;69;69219;2133;63;2196
84;69;69220;1805;113;1918
84;69;69225;541;14;555
84;69;69227;3853;189;4042
84;69;69228;4224;93;4317
84;69;69229;800;14;814
84;69;69230;320;6;326
84;69;69231;2596;60;2656
84;69;69233;1228;50;1278
84;69;69234;1583;73;1656
84;69;69235;1967;106;2073
84;69;69236;590;7;597
84;69;69238;3710;96;3806
84;69;69239;1212;25;1237
84;69;69240;617;6;623
84;69;69241;2590;61;2651
84;69;69242;927;13;940
84;69;69243;10490;273;10763
84;69;69244;22286;351;22637
84;69;69245;710;25;735
84;69;69246;1295;35;1330
84;69;69248;6020;126;6146
84;69;69249;3053;63;3116
84;69;69250;4117;99;4216
84;69;69252;745;9;754
84;69;69253;637;10;647
84;69;69254;971;10;981
84;69;69255;6080;111;6191
84;69;69256;52795;221;53016
84;69;69257;1086;19;1105
84;69;69258;322;7;329
84;69;69259;67285;266;67551
84;69;69260;4999;56;5055
84;69;69261;104;1;105
84;69;69263;881;19;900
84;69;69264;36291;419;36710
84;69;69265;802;33;835
84;69;69266;152212;1082;153294
84;69;69267;2137;114;2251
84;69;69268;3367;91;3458
84;69;69269;992;24;1016
84;69;69270;4355;67;4422
84;69;69271;10638;152;10790
84;69;69272;4242;85;4327
84;69;69273;11196;73;11269
84;69;69275;28930;139;29069
84;69;69276;9902;52;9954
84;69;69277;13181;221;13402
84;69;69278;5509;105;5614
84;69;69279;6076;76;6152
84;69;69280;1528;13;1541
84;69;69281;1912;23;1935
84;69;69282;34640;301;34941
84;69;69283;13707;146;13853
84;69;69284;3230;116;3346
84;69;69285;4191;38;4229
84;69;69286;30697;366;31063
84;69;69287;6875;108;6983
84;69;69288;5458;67;5525
84;69;69289;4579;82;4661
84;69;69290;46927;284;47211
84;69;69291;5789;56;5845
84;69;69292;6497;63;6560
84;69;69293;2369;48;2417
84;69;69294;2772;37;2809
84;69;69295;1810;9;1819
84;69;69296;2986;33;3019
84;69;69297;5512;74;5586
84;69;69298;3188;28;3216
84;69;69299;2700;42;2742
84;69;69381;29641;782;30423
84;69;69382;31303;386;31689
84;69;69383;102725;1006;103731
84;69;69384;36064;406;36470
84;69;69385;49664;1085;50749
84;69;69386;52862;884;53746
84;69;69387;82573;493;83066
84;69;69388;86154;1022;87176
84;69;69389;51983;537;52520
27;70;70001;357;4;361
27;70;70002;209;7;216
27;70;70003;69;2;71
27;70;70004;307;2;309
27;70;70005;134;2;136
27;70;70006;1490;102;1592
27;70;70007;304;6;310
27;70;70008;148;2;150
27;70;70009;102;1;103
27;70;70010;104;1;105
27;70;70011;317;4;321
27;70;70012;656;11;667
27;70;70013;67;0;67
27;70;70014;399;6;405
27;70;70015;274;6;280
27;70;70016;162;2;164
27;70;70017;240;2;242
27;70;70018;512;4;516
27;70;70019;143;4;147
27;70;70020;244;2;246
27;70;70021;191;5;196
27;70;70022;147;3;150
27;70;70023;143;3;146
27;70;70024;446;14;460
27;70;70025;242;4;246
27;70;70026;2533;26;2559
27;70;70027;71;1;72
27;70;70028;143;3;146
27;70;70029;239;2;241
27;70;70030;45;1;46
27;70;70031;644;17;661
27;70;70032;45;0;45
27;70;70035;177;4;181
27;70;70036;159;2;161
27;70;70037;258;21;279
27;70;70038;315;9;324
27;70;70039;355;4;359
27;70;70040;239;3;242
27;70;70041;377;9;386
27;70;70042;103;1;104
27;70;70043;237;3;240
27;70;70044;408;12;420
27;70;70045;419;7;426
27;70;70046;367;7;374
27;70;70047;107;2;109
27;70;70048;139;3;142
27;70;70049;97;2;99
27;70;70050;98;0;98
27;70;70051;34;0;34
27;70;70052;121;3;124
27;70;70053;77;1;78
27;70;70054;241;4;245
27;70;70055;500;7;507
27;70;70056;310;1;311
27;70;70057;149;2;151
27;70;70058;931;14;945
27;70;70059;470;8;478
27;70;70060;294;3;297
27;70;70061;85;0;85
27;70;70062;142;5;147
27;70;70063;210;3;213
27;70;70064;149;3;152
27;70;70065;77;1;78
27;70;70066;180;1;181
27;70;70067;126;0;126
27;70;70069;46;0;46
27;70;70070;28;2;30
27;70;70071;56;0;56
27;70;70072;83;2;85
27;70;70074;244;3;247
27;70;70075;199;2;201
27;70;70076;376;8;384
27;70;70077;221;4;225
27;70;70078;93;2;95
27;70;70079;524;12;536
27;70;70080;238;4;242
27;70;70081;324;4;328
27;70;70082;130;2;132
27;70;70083;404;10;414
27;70;70084;663;10;673
27;70;70085;680;13;693
27;70;70086;75;0;75
27;70;70087;147;3;150
27;70;70088;117;2;119
27;70;70089;46;0;46
27;70;70090;60;2;62
27;70;70091;47;1;48
27;70;70092;177;3;180
27;70;70093;654;8;662
27;70;70094;301;5;306
27;70;70095;654;11;665
27;70;70096;635;17;652
27;70;70097;238;8;246
27;70;70098;211;4;215
27;70;70099;76;1;77
27;70;70100;133;0;133
27;70;70101;501;5;506
27;70;70102;277;10;287
27;70;70103;221;3;224
27;70;70104;590;13;603
27;70;70105;137;1;138
27;70;70106;113;2;115
27;70;70107;437;4;441
27;70;70109;306;2;308
27;70;70111;275;3;278
27;70;70112;174;5;179
27;70;70113;132;3;135
27;70;70114;205;2;207
27;70;70115;236;5;241
27;70;70116;617;12;629
27;70;70117;1238;33;1271
27;70;70118;194;2;196
27;70;70119;357;12;369
27;70;70120;3745;72;3817
27;70;70121;878;16;894
27;70;70122;1633;32;1665
27;70;70124;92;1;93
27;70;70125;176;2;178
27;70;70126;197;6;203
27;70;70127;110;6;116
27;70;70128;387;3;390
27;70;70129;162;3;165
27;70;70130;318;8;326
27;70;70132;704;67;771
27;70;70133;235;7;242
27;70;70134;204;2;206
27;70;70135;34;1;35
27;70;70136;489;9;498
27;70;70137;215;8;223
27;70;70138;124;3;127
27;70;70140;67;1;68
27;70;70141;118;2;120
27;70;70142;190;2;192
27;70;70143;124;6;130
27;70;70144;33;1;34
27;70;70145;480;10;490
27;70;70146;164;4;168
27;70;70147;228;4;232
27;70;70148;86;1;87
27;70;70149;693;17;710
27;70;70150;320;2;322
27;70;70151;36;0;36
27;70;70152;475;37;512
27;70;70153;96;1;97
27;70;70154;371;6;377
27;70;70155;799;15;814
27;70;70156;111;1;112
27;70;70157;361;10;371
27;70;70158;105;1;106
27;70;70159;89;0;89
27;70;70160;317;19;336
27;70;70162;459;13;472
27;70;70163;443;8;451
27;70;70164;89;2;91
27;70;70165;542;42;584
27;70;70166;154;5;159
27;70;70167;353;13;366
27;70;70168;620;17;637
27;70;70169;220;5;225
27;70;70170;122;2;124
27;70;70171;1263;29;1292
27;70;70172;109;0;109
27;70;70174;143;2;145
27;70;70175;136;3;139
27;70;70176;191;3;194
27;70;70177;603;15;618
27;70;70178;526;10;536
27;70;70179;168;3;171
27;70;70180;441;10;451
27;70;70181;132;0;132
27;70;70182;142;0;142
27;70;70183;60;0;60
27;70;70184;707;21;728
27;70;70185;187;9;196
27;70;70186;73;1;74
27;70;70187;263;3;266
27;70;70188;54;1;55
27;70;70189;250;4;254
27;70;70190;181;3;184
27;70;70192;206;2;208
27;70;70193;232;3;235
27;70;70194;134;8;142
27;70;70195;272;4;276
27;70;70196;250;9;259
27;70;70197;794;15;809
27;70;70198;1240;25;1265
27;70;70199;116;0;116
27;70;70200;39;1;40
27;70;70201;209;1;210
27;70;70202;273;7;280
27;70;70203;149;2;151
27;70;70204;156;4;160
27;70;70205;202;2;204
27;70;70206;555;7;562
27;70;70207;3249;69;3318
27;70;70208;292;5;297
27;70;70210;154;5;159
27;70;70211;65;2;67
27;70;70213;225;5;230
27;70;70214;122;5;127
27;70;70215;244;11;255
27;70;70216;439;24;463
27;70;70217;97;1;98
27;70;70218;134;1;135
27;70;70219;735;15;750
27;70;70220;407;6;413
27;70;70221;288;4;292
27;70;70222;78;1;79
27;70;70224;674;14;688
27;70;70225;104;2;106
27;70;70226;309;3;312
27;70;70227;477;15;492
27;70;70228;980;11;991
27;70;70229;260;6;266
27;70;70230;98;4;102
27;70;70231;35;0;35
27;70;70232;130;5;135
27;70;70233;135;2;137
27;70;70234;226;11;237
27;70;70235;145;4;149
27;70;70236;467;9;476
27;70;70237;97;0;97
27;70;70238;137;4;141
27;70;70239;201;5;206
27;70;70240;1327;24;1351
27;70;70242;133;0;133
27;70;70243;337;12;349
27;70;70244;111;0;111
27;70;70245;3797;123;3920
27;70;70247;212;3;215
27;70;70248;1379;35;1414
27;70;70249;119;3;122
27;70;70250;451;6;457
27;70;70251;100;4;104
27;70;70252;178;3;181
27;70;70253;297;28;325
27;70;70254;253;7;260
27;70;70255;497;4;501
27;70;70256;710;12;722
27;70;70257;742;14;756
27;70;70258;1990;46;2036
27;70;70259;370;6;376
27;70;70260;686;20;706
27;70;70261;1361;33;1394
27;70;70262;161;4;165
27;70;70263;238;2;240
27;70;70264;50;0;50
27;70;70265;151;5;156
27;70;70267;485;7;492
27;70;70268;213;4;217
27;70;70269;35;1;36
27;70;70271;374;11;385
27;70;70272;186;11;197
27;70;70273;67;1;68
27;70;70274;48;0;48
27;70;70275;393;5;398
27;70;70276;184;8;192
27;70;70277;381;9;390
27;70;70278;215;4;219
27;70;70279;5553;424;5977
27;70;70280;937;36;973
27;70;70282;1012;20;1032
27;70;70283;442;7;449
27;70;70284;268;8;276
27;70;70285;10646;272;10918
27;70;70286;128;3;131
27;70;70287;44;0;44
27;70;70288;120;1;121
27;70;70289;210;2;212
27;70;70290;203;6;209
27;70;70291;124;3;127
27;70;70292;1548;34;1582
27;70;70293;77;2;79
27;70;70294;357;4;361
27;70;70295;220;5;225
27;70;70296;271;2;273
27;70;70297;60;0;60
27;70;70298;117;0;117
27;70;70299;311;2;313
27;70;70301;56;0;56
27;70;70302;77;1;78
27;70;70303;153;1;154
27;70;70304;122;1;123
27;70;70305;103;2;105
27;70;70306;460;13;473
27;70;70307;124;7;131
27;70;70308;222;6;228
27;70;70309;453;10;463
27;70;70310;8046;185;8231
27;70;70311;6623;273;6896
27;70;70312;759;21;780
27;70;70313;395;5;400
27;70;70314;168;6;174
27;70;70315;408;11;419
27;70;70316;83;4;87
27;70;70317;141;4;145
27;70;70318;431;15;446
27;70;70319;124;3;127
27;70;70320;98;3;101
27;70;70321;1400;29;1429
27;70;70322;284;6;290
27;70;70323;197;1;198
27;70;70324;645;15;660
27;70;70325;372;3;375
27;70;70326;309;3;312
27;70;70327;134;3;137
27;70;70328;327;6;333
27;70;70329;61;4;65
27;70;70330;287;7;294
27;70;70331;440;20;460
27;70;70332;56;1;57
27;70;70334;1508;24;1532
27;70;70335;62;2;64
27;70;70336;137;3;140
27;70;70337;59;1;60
27;70;70338;228;7;235
27;70;70339;1674;31;1705
27;70;70340;214;27;241
27;70;70341;300;3;303
27;70;70342;136;1;137
27;70;70343;285;5;290
27;70;70344;339;9;348
27;70;70347;356;8;364
27;70;70348;620;12;632
27;70;70349;235;3;238
27;70;70350;65;0;65
27;70;70351;228;3;231
27;70;70352;37;0;37
27;70;70353;503;8;511
27;70;70355;302;4;306
27;70;70356;278;6;284
27;70;70357;543;87;630
27;70;70358;272;4;276
27;70;70359;55;0;55
27;70;70360;78;1;79
27;70;70361;158;5;163
27;70;70362;138;4;142
27;70;70363;645;15;660
27;70;70364;119;1;120
27;70;70366;123;0;123
27;70;70367;184;4;188
27;70;70368;132;3;135
27;70;70369;48;0;48
27;70;70371;203;1;204
27;70;70372;152;4;156
27;70;70373;285;4;289
27;70;70374;95;2;97
27;70;70376;463;10;473
27;70;70378;1623;50;1673
27;70;70380;176;4;180
27;70;70381;341;10;351
27;70;70383;417;4;421
27;70;70384;224;3;227
27;70;70385;333;10;343
27;70;70386;177;2;179
27;70;70387;662;10;672
27;70;70388;1978;75;2053
27;70;70389;58;2;60
27;70;70390;502;11;513
27;70;70392;34;2;36
27;70;70393;430;6;436
27;70;70394;60;4;64
27;70;70395;52;0;52
27;70;70396;39;2;41
27;70;70397;81;0;81
27;70;70398;66;0;66
27;70;70399;208;7;215
27;70;70400;108;2;110
27;70;70401;132;1;133
27;70;70402;371;11;382
27;70;70403;243;3;246
27;70;70404;576;16;592
27;70;70405;194;4;198
27;70;70406;76;1;77
27;70;70407;272;5;277
27;70;70408;1068;29;1097
27;70;70409;115;2;117
27;70;70410;699;3;702
27;70;70411;38;0;38
27;70;70412;71;0;71
27;70;70413;1903;36;1939
27;70;70414;960;15;975
27;70;70415;658;9;667
27;70;70416;204;5;209
27;70;70417;306;3;309
27;70;70418;518;4;522
27;70;70419;107;4;111
27;70;70420;63;0;63
27;70;70421;2954;55;3009
27;70;70422;145;1;146
27;70;70423;113;3;116
27;70;70425;148;6;154
27;70;70426;251;7;258
27;70;70427;335;9;344
27;70;70428;1455;49;1504
27;70;70429;547;14;561
27;70;70430;69;1;70
27;70;70431;249;3;252
27;70;70432;326;7;333
27;70;70433;1396;38;1434
27;70;70435;829;22;851
27;70;70436;116;0;116
27;70;70437;16;0;16
27;70;70438;212;3;215
27;70;70439;355;7;362
27;70;70440;33;2;35
27;70;70441;253;3;256
27;70;70442;109;3;112
27;70;70443;89;1;90
27;70;70444;163;1;164
27;70;70445;115;1;116
27;70;70446;604;9;613
27;70;70447;2297;75;2372
27;70;70448;152;2;154
27;70;70449;62;0;62
27;70;70450;40;0;40
27;70;70451;2735;28;2763
27;70;70452;254;3;257
27;70;70453;81;3;84
27;70;70454;48;2;50
27;70;70455;1493;24;1517
27;70;70456;148;5;153
27;70;70457;107;3;110
27;70;70459;1101;25;1126
27;70;70460;430;9;439
27;70;70461;116;2;118
27;70;70462;80;2;82
27;70;70463;144;1;145
27;70;70464;1353;23;1376
27;70;70466;124;3;127
27;70;70467;3150;66;3216
27;70;70468;90;1;91
27;70;70469;211;4;215
27;70;70470;160;2;162
27;70;70471;25;1;26
27;70;70472;485;4;489
27;70;70473;1929;32;1961
27;70;70474;127;2;129
27;70;70476;65;1;66
27;70;70477;773;13;786
27;70;70478;888;15;903
27;70;70479;98;4;102
27;70;70480;134;6;140
27;70;70481;205;4;209
27;70;70482;1543;25;1568
27;70;70483;137;5;142
27;70;70484;178;3;181
27;70;70485;202;5;207
27;70;70486;111;3;114
27;70;70487;291;3;294
27;70;70488;194;1;195
27;70;70489;788;6;794
27;70;70490;123;1;124
27;70;70491;480;14;494
27;70;70492;579;10;589
27;70;70493;462;8;470
27;70;70494;347;6;353
27;70;70496;25;1;26
27;70;70498;460;14;474
27;70;70499;103;2;105
27;70;70500;167;11;178
27;70;70501;98;3;101
27;70;70502;85;0;85
27;70;70503;162;2;164
27;70;70504;360;13;373
27;70;70505;162;7;169
27;70;70506;388;13;401
27;70;70507;246;6;252
27;70;70509;113;0;113
27;70;70510;130;3;133
27;70;70511;226;3;229
27;70;70512;219;5;224
27;70;70513;2418;55;2473
27;70;70514;670;11;681
27;70;70515;67;1;68
27;70;70516;245;3;248
27;70;70517;395;18;413
27;70;70518;98;2;100
27;70;70519;110;0;110
27;70;70520;115;3;118
27;70;70521;183;4;187
27;70;70522;158;3;161
27;70;70523;197;3;200
27;70;70524;113;3;116
27;70;70525;211;3;214
27;70;70526;625;14;639
27;70;70527;75;1;76
27;70;70528;486;9;495
27;70;70529;385;16;401
27;70;70530;120;0;120
27;70;70531;104;1;105
27;70;70532;519;6;525
27;70;70533;121;0;121
27;70;70534;125;1;126
27;70;70535;153;1;154
27;70;70536;132;2;134
27;70;70537;294;6;300
27;70;70538;82;0;82
27;70;70539;455;12;467
27;70;70540;80;4;84
27;70;70541;204;4;208
27;70;70542;209;5;214
27;70;70544;115;2;117
27;70;70545;127;3;130
27;70;70546;219;22;241
27;70;70547;168;3;171
27;70;70548;141;1;142
27;70;70549;78;1;79
27;70;70550;14914;749;15663
27;70;70552;215;3;218
27;70;70553;116;2;118
27;70;70554;191;1;192
27;70;70555;171;1;172
27;70;70557;133;4;137
27;70;70558;140;2;142
27;70;70559;195;4;199
27;70;70560;165;2;167
27;70;70561;1423;108;1531
27;70;70562;154;3;157
27;70;70563;533;13;546
27;70;70564;310;16;326
27;70;70565;52;2;54
27;70;70566;200;5;205
27;70;70567;134;9;143
27;70;70568;57;4;61
27;70;70569;61;1;62
27;70;70571;39;3;42
27;70;70572;290;5;295
27;70;70573;125;1;126
27;70;70574;57;0;57
27;70;70575;841;16;857
27;70;70576;151;1;152
27;70;70577;379;9;388
27;70;70578;174;2;176
27;70;70579;428;16;444
27;70;70580;152;5;157
27;70;70581;704;16;720
27;70;70582;81;0;81
27;70;70583;130;1;131
27;71;71001;799;15;814
27;71;71002;1243;20;1263
27;71;71003;795;6;801
27;71;71004;1164;25;1189
27;71;71005;251;10;261
27;71;71006;185;5;190
27;71;71007;167;4;171
27;71;71008;151;7;158
27;71;71009;719;14;733
27;71;71010;864;10;874
27;71;71011;444;86;530
27;71;71012;331;15;346
27;71;71013;272;5;277
27;71;71014;12987;1022;14009
27;71;71015;914;29;943
27;71;71016;1082;27;1109
27;71;71017;95;4;99
27;71;71018;547;11;558
27;71;71019;143;7;150
27;71;71020;98;2;100
27;71;71021;291;22;313
27;71;71022;625;9;634
27;71;71023;956;26;982
27;71;71024;509;17;526
27;71;71025;358;8;366
27;71;71026;337;13;350
27;71;71027;721;7;728
27;71;71028;106;3;109
27;71;71029;292;4;296
27;71;71030;203;4;207
27;71;71031;59;1;60
27;71;71032;690;14;704
27;71;71033;861;19;880
27;71;71034;335;7;342
27;71;71035;204;3;207
27;71;71036;69;0;69
27;71;71037;84;6;90
27;71;71038;468;13;481
27;71;71039;181;1;182
27;71;71040;6060;140;6200
27;71;71041;190;2;192
27;71;71042;318;7;325
27;71;71043;83;3;86
27;71;71044;296;6;302
27;71;71045;179;6;185
27;71;71046;94;0;94
27;71;71047;4713;72;4785
27;71;71048;175;2;177
27;71;71050;340;7;347
27;71;71051;130;7;137
27;71;71052;729;11;740
27;71;71054;685;13;698
27;71;71056;2354;37;2391
27;71;71057;124;3;127
27;71;71058;185;11;196
27;71;71059;3538;67;3605
27;71;71060;228;2;230
27;71;71061;460;16;476
27;71;71062;292;8;300
27;71;71063;753;14;767
27;71;71064;985;25;1010
27;71;71065;273;8;281
27;71;71066;119;3;122
27;71;71067;124;3;127
27;71;71068;57;2;59
27;71;71069;579;27;606
27;71;71070;2138;85;2223
27;71;71071;263;8;271
27;71;71072;141;2;143
27;71;71073;5528;80;5608
27;71;71074;564;19;583
27;71;71075;627;11;638
27;71;71076;45056;1521;46577
27;71;71077;513;4;517
27;71;71078;151;3;154
27;71;71079;463;11;474
27;71;71080;97;0;97
27;71;71081;2588;56;2644
27;71;71082;223;3;226
27;71;71084;529;11;540
27;71;71085;222;2;224
27;71;71086;466;9;475
27;71;71087;165;1;166
27;71;71088;226;12;238
27;71;71089;238;2;240
27;71;71090;4171;53;4224
27;71;71091;189;2;191
27;71;71092;504;13;517
27;71;71093;662;18;680
27;71;71094;139;2;141
27;71;71095;437;10;447
27;71;71096;192;2;194
27;71;71097;480;12;492
27;71;71098;250;4;254
27;71;71099;316;14;330
27;71;71100;203;0;203
27;71;71101;452;8;460
27;71;71102;688;24;712
27;71;71103;274;6;280
27;71;71104;190;7;197
27;71;71105;7742;297;8039
27;71;71106;2888;438;3326
27;71;71107;331;10;341
27;71;71108;168;5;173
27;71;71109;352;2;354
27;71;71110;565;10;575
27;71;71111;305;11;316
27;71;71112;228;8;236
27;71;71113;98;0;98
27;71;71115;92;4;96
27;71;71116;169;2;171
27;71;71117;1095;31;1126
27;71;71118;6148;143;6291
27;71;71119;1119;24;1143
27;71;71120;3703;69;3772
27;71;71121;316;3;319
27;71;71122;557;15;572
27;71;71123;373;4;377
27;71;71124;203;7;210
27;71;71125;20;0;20
27;71;71126;584;23;607
27;71;71127;60;5;65
27;71;71128;88;5;93
27;71;71129;271;7;278
27;71;71130;229;6;235
27;71;71131;851;13;864
27;71;71132;2260;30;2290
27;71;71133;1637;58;1695
27;71;71134;661;21;682
27;71;71135;891;20;911
27;71;71136;276;8;284
27;71;71137;4929;247;5176
27;71;71139;144;0;144
27;71;71140;50;0;50
27;71;71141;310;6;316
27;71;71142;240;4;244
27;71;71143;459;8;467
27;71;71144;191;5;196
27;71;71145;564;5;569
27;71;71146;232;7;239
27;71;71147;251;6;257
27;71;71148;843;17;860
27;71;71149;1323;29;1352
27;71;71150;3089;86;3175
27;71;71151;78;4;82
27;71;71152;180;9;189
27;71;71153;21269;298;21567
27;71;71154;2469;62;2531
27;71;71155;519;16;535
27;71;71156;262;65;327
27;71;71157;1829;31;1860
27;71;71158;1571;40;1611
27;71;71159;202;8;210
27;71;71160;310;9;319
27;71;71161;319;6;325
27;71;71162;1153;44;1197
27;71;71163;90;1;91
27;71;71164;129;3;132
27;71;71165;378;8;386
27;71;71166;112;4;116
27;71;71167;552;20;572
27;71;71168;174;1;175
27;71;71169;700;107;807
27;71;71170;1794;40;1834
27;71;71171;305;9;314
27;71;71172;85;1;86
27;71;71173;311;4;315
27;71;71174;173;4;177
27;71;71175;338;4;342
27;71;71176;7741;249;7990
27;71;71177;802;12;814
27;71;71178;889;31;920
27;71;71179;81;1;82
27;71;71181;168;4;172
27;71;71182;1458;52;1510
27;71;71183;153;3;156
27;71;71184;608;9;617
27;71;71185;332;14;346
27;71;71186;262;5;267
27;71;71187;1580;34;1614
27;71;71188;60;1;61
27;71;71189;1616;52;1668
27;71;71190;2164;30;2194
27;71;71191;472;10;482
27;71;71192;1811;148;1959
27;71;71193;473;11;484
27;71;71194;790;15;805
27;71;71195;220;1;221
27;71;71196;634;8;642
27;71;71198;412;7;419
27;71;71199;174;8;182
27;71;71200;704;17;721
27;71;71201;196;7;203
27;71;71202;1877;364;2241
27;71;71203;52;1;53
27;71;71204;1487;43;1530
27;71;71205;651;9;660
27;71;71206;239;4;243
27;71;71207;288;11;299
27;71;71208;210;4;214
27;71;71209;728;14;742
27;71;71210;373;19;392
27;71;71212;1387;33;1420
27;71;71213;569;17;586
27;71;71214;420;11;431
27;71;71215;2581;72;2653
27;71;71216;197;5;202
27;71;71217;125;5;130
27;71;71218;581;21;602
27;71;71219;547;15;562
27;71;71220;473;3;476
27;71;71221;3684;161;3845
27;71;71222;899;26;925
27;71;71223;563;8;571
27;71;71224;82;6;88
27;71;71225;525;13;538
27;71;71226;30;0;30
27;71;71227;513;8;521
27;71;71228;210;0;210
27;71;71229;231;1;232
27;71;71230;6760;194;6954
27;71;71231;630;11;641
27;71;71232;202;14;216
27;71;71233;304;7;311
27;71;71234;341;6;347
27;71;71235;1954;108;2062
27;71;71236;879;21;900
27;71;71237;524;7;531
27;71;71238;986;18;1004
27;71;71239;697;11;708
27;71;71240;384;15;399
27;71;71241;486;18;504
27;71;71242;521;11;532
27;71;71243;371;4;375
27;71;71244;438;2;440
27;71;71245;322;6;328
27;71;71246;250;3;253
27;71;71247;365;10;375
27;71;71248;710;20;730
27;71;71249;991;37;1028
27;71;71250;1087;49;1136
27;71;71251;590;13;603
27;71;71252;370;14;384
27;71;71253;928;26;954
27;71;71254;151;1;152
27;71;71255;179;2;181
27;71;71256;539;12;551
27;71;71257;653;12;665
27;71;71258;509;15;524
27;71;71259;363;7;370
27;71;71261;662;16;678
27;71;71262;161;4;165
27;71;71263;6433;225;6658
27;71;71264;328;9;337
27;71;71266;315;3;318
27;71;71267;859;84;943
27;71;71268;350;10;360
27;71;71269;2067;33;2100
27;71;71270;33908;755;34663
27;71;71271;149;5;154
27;71;71272;199;9;208
27;71;71273;283;6;289
27;71;71274;388;10;398
27;71;71275;1727;31;1758
27;71;71276;128;5;133
27;71;71277;665;19;684
27;71;71278;155;5;160
27;71;71279;628;19;647
27;71;71280;87;2;89
27;71;71281;307;14;321
27;71;71282;1243;34;1277
27;71;71283;537;7;544
27;71;71284;143;7;150
27;71;71285;410;6;416
27;71;71286;263;4;267
27;71;71287;328;6;334
27;71;71289;1145;22;1167
27;71;71290;377;68;445
27;71;71291;968;23;991
27;71;71292;1322;45;1367
27;71;71293;409;10;419
27;71;71294;1212;171;1383
27;71;71295;1505;25;1530
27;71;71296;749;19;768
27;71;71297;754;22;776
27;71;71299;316;7;323
27;71;71300;621;8;629
27;71;71301;170;2;172
27;71;71302;215;9;224
27;71;71303;485;6;491
27;71;71305;828;15;843
27;71;71306;17678;308;17986
27;71;71307;290;7;297
27;71;71308;31;1;32
27;71;71309;1924;60;1984
27;71;71310;4964;89;5053
27;71;71311;256;5;261
27;71;71312;255;1;256
27;71;71313;381;15;396
27;71;71314;206;0;206
27;71;71315;183;2;185
27;71;71316;371;7;378
27;71;71317;183;3;186
27;71;71318;1100;20;1120
27;71;71319;779;16;795
27;71;71320;315;3;318
27;71;71321;192;4;196
27;71;71322;52;1;53
27;71;71323;136;0;136
27;71;71324;579;23;602
27;71;71325;1206;34;1240
27;71;71326;418;7;425
27;71;71327;343;8;351
27;71;71328;631;12;643
27;71;71329;410;9;419
27;71;71330;754;15;769
27;71;71331;117;1;118
27;71;71332;469;5;474
27;71;71333;1222;39;1261
27;71;71334;383;9;392
27;71;71335;66;0;66
27;71;71336;3110;80;3190
27;71;71337;303;8;311
27;71;71338;216;2;218
27;71;71339;391;8;399
27;71;71340;1507;26;1533
27;71;71341;254;2;256
27;71;71342;9214;417;9631
27;71;71343;318;4;322
27;71;71344;66;2;68
27;71;71345;672;11;683
27;71;71346;1568;26;1594
27;71;71347;553;15;568
27;71;71348;131;3;134
27;71;71349;51;1;52
27;71;71350;874;30;904
27;71;71351;1938;31;1969
27;71;71352;88;3;91
27;71;71353;525;7;532
27;71;71354;570;22;592
27;71;71355;280;7;287
27;71;71356;974;17;991
27;71;71357;217;0;217
27;71;71358;102;3;105
27;71;71359;568;10;578
27;71;71360;1910;46;1956
27;71;71361;58;5;63
27;71;71362;344;5;349
27;71;71363;88;5;93
27;71;71364;176;1;177
27;71;71365;591;8;599
27;71;71366;380;8;388
27;71;71367;366;5;371
27;71;71368;303;16;319
27;71;71369;430;7;437
27;71;71370;626;11;637
27;71;71371;1577;41;1618
27;71;71372;2021;33;2054
27;71;71373;1704;21;1725
27;71;71374;162;2;164
27;71;71376;275;8;283
27;71;71377;128;2;130
27;71;71378;1557;35;1592
27;71;71379;1233;21;1254
27;71;71380;789;17;806
27;71;71381;74;0;74
27;71;71382;697;15;712
27;71;71383;534;5;539
27;71;71384;506;8;514
27;71;71385;566;20;586
27;71;71386;94;0;94
27;71;71387;249;9;258
27;71;71388;467;20;487
27;71;71389;281;5;286
27;71;71390;1084;22;1106
27;71;71391;555;17;572
27;71;71392;491;9;500
27;71;71393;491;17;508
27;71;71394;765;22;787
27;71;71395;209;2;211
27;71;71396;488;4;492
27;71;71397;283;8;291
27;71;71398;1044;31;1075
27;71;71399;532;15;547
27;71;71400;129;4;133
27;71;71401;629;13;642
27;71;71402;750;25;775
27;71;71403;260;10;270
27;71;71404;896;22;918
27;71;71405;198;1;199
27;71;71406;126;9;135
27;71;71407;221;4;225
27;71;71408;428;9;437
27;71;71409;310;9;319
27;71;71410;794;15;809
27;71;71411;154;8;162
27;71;71412;1200;24;1224
27;71;71413;833;10;843
27;71;71414;443;17;460
27;71;71415;138;2;140
27;71;71416;592;6;598
27;71;71417;1058;7;1065
27;71;71419;1895;42;1937
27;71;71420;2310;51;2361
27;71;71421;185;7;192
27;71;71422;276;9;285
27;71;71423;433;5;438
27;71;71424;211;3;214
27;71;71425;279;11;290
27;71;71426;540;11;551
27;71;71427;51;1;52
27;71;71428;763;26;789
27;71;71430;395;16;411
27;71;71431;377;13;390
27;71;71433;491;14;505
27;71;71434;345;7;352
27;71;71435;243;9;252
27;71;71436;1004;20;1024
27;71;71437;323;11;334
27;71;71438;529;19;548
27;71;71439;748;19;767
27;71;71440;374;9;383
27;71;71441;279;4;283
27;71;71442;1567;22;1589
27;71;71443;1640;57;1697
27;71;71444;1199;30;1229
27;71;71445;6190;180;6370
27;71;71446;189;6;195
27;71;71447;273;14;287
27;71;71448;1389;33;1422
27;71;71449;120;6;126
27;71;71450;101;6;107
27;71;71451;94;0;94
27;71;71452;96;1;97
27;71;71453;242;11;253
27;71;71454;187;8;195
27;71;71455;159;4;163
27;71;71456;1911;68;1979
27;71;71457;120;2;122
27;71;71458;61;0;61
27;71;71459;340;17;357
27;71;71460;468;23;491
27;71;71461;62;1;63
27;71;71462;528;11;539
27;71;71463;571;12;583
27;71;71464;184;4;188
27;71;71465;274;9;283
27;71;71466;122;4;126
27;71;71468;848;16;864
27;71;71469;364;10;374
27;71;71470;347;14;361
27;71;71471;92;1;93
27;71;71472;209;8;217
27;71;71473;150;1;151
27;71;71474;147;2;149
27;71;71475;6615;157;6772
27;71;71477;484;9;493
27;71;71478;85;2;87
27;71;71479;1758;36;1794
27;71;71480;596;13;609
27;71;71481;1150;20;1170
27;71;71482;836;11;847
27;71;71483;425;12;437
27;71;71484;1282;29;1311
27;71;71485;258;14;272
27;71;71486;8576;172;8748
27;71;71487;162;3;165
27;71;71488;104;3;107
27;71;71489;570;9;579
27;71;71490;1015;17;1032
27;71;71491;1156;24;1180
27;71;71492;126;2;128
27;71;71493;343;7;350
27;71;71494;526;14;540
27;71;71495;874;12;886
27;71;71496;143;10;153
27;71;71497;2150;54;2204
27;71;71498;132;6;138
27;71;71499;4316;81;4397
27;71;71500;93;3;96
27;71;71501;142;3;145
27;71;71502;1577;45;1622
27;71;71503;128;3;131
27;71;71504;80;2;82
27;71;71505;76;1;77
27;71;71506;1137;17;1154
27;71;71507;169;1;170
27;71;71508;406;9;415
27;71;71509;476;6;482
27;71;71510;610;19;629
27;71;71512;3012;68;3080
27;71;71513;1127;36;1163
27;71;71514;419;5;424
27;71;71515;100;3;103
27;71;71516;607;7;614
27;71;71517;232;3;235
27;71;71518;274;9;283
27;71;71519;189;4;193
27;71;71520;1290;25;1315
27;71;71521;106;2;108
27;71;71522;1737;19;1756
27;71;71523;1188;12;1200
27;71;71524;173;7;180
27;71;71525;576;11;587
27;71;71526;361;7;368
27;71;71527;210;4;214
27;71;71528;2001;45;2046
27;71;71529;257;7;264
27;71;71530;488;14;502
27;71;71531;215;1;216
27;71;71532;194;3;197
27;71;71533;532;18;550
27;71;71534;112;5;117
27;71;71535;507;11;518
27;71;71537;131;0;131
27;71;71538;439;11;450
27;71;71539;79;2;81
27;71;71540;2813;39;2852
27;71;71541;374;4;378
27;71;71542;1510;27;1537
27;71;71543;5489;338;5827
27;71;71544;194;5;199
27;71;71545;1056;19;1075
27;71;71546;404;8;412
27;71;71547;259;7;266
27;71;71548;249;2;251
27;71;71549;214;6;220
27;71;71550;825;14;839
27;71;71551;91;5;96
27;71;71552;520;13;533
27;71;71553;275;5;280
27;71;71554;113;3;116
27;71;71555;2317;48;2365
27;71;71556;566;8;574
27;71;71557;728;17;745
27;71;71558;1132;26;1158
27;71;71559;539;14;553
27;71;71561;225;9;234
27;71;71562;212;33;245
27;71;71563;74;1;75
27;71;71564;746;20;766
27;71;71565;569;12;581
27;71;71566;1060;8;1068
27;71;71567;257;7;264
27;71;71568;57;0;57
27;71;71570;516;14;530
27;71;71571;447;26;473
27;71;71572;233;0;233
27;71;71573;192;5;197
27;71;71574;813;27;840
27;71;71576;279;5;284
27;71;71577;219;4;223
27;71;71578;313;11;324
27;71;71579;167;2;169
27;71;71580;418;10;428
27;71;71581;254;5;259
27;71;71582;650;18;668
27;71;71583;718;23;741
27;71;71584;1189;28;1217
27;71;71585;1366;71;1437
27;71;71586;258;4;262
27;71;71588;1099;38;1137
27;71;71589;423;8;431
27;71;71590;632;23;655
27;71;71591;521;8;529
52;72;72001;1698;37;1735
52;72;72002;205;3;208
52;72;72003;11167;109;11276
52;72;72004;585;3;588
52;72;72005;936;22;958
52;72;72006;1899;232;2131
52;72;72007;497;11;508
52;72;72008;5503;123;5626
52;72;72009;362;8;370
52;72;72010;400;11;411
52;72;72011;906;17;923
52;72;72012;490;10;500
52;72;72013;2115;27;2142
52;72;72015;114;0;114
52;72;72016;1478;35;1513
52;72;72017;237;3;240
52;72;72018;87;1;88
52;72;72019;377;9;386
52;72;72020;705;17;722
52;72;72021;585;7;592
52;72;72022;1221;27;1248
52;72;72023;2253;30;2283
52;72;72024;3646;61;3707
52;72;72025;1993;54;2047
52;72;72026;1506;16;1522
52;72;72027;327;8;335
52;72;72028;484;7;491
52;72;72029;1967;28;1995
52;72;72031;529;3;532
52;72;72032;333;10;343
52;72;72034;442;12;454
52;72;72035;2117;45;2162
52;72;72036;309;4;313
52;72;72037;120;1;121
52;72;72038;575;1;576
52;72;72039;3791;57;3848
52;72;72040;142;2;144
52;72;72041;344;5;349
52;72;72042;2102;25;2127
52;72;72043;327;7;334
52;72;72044;436;5;441
52;72;72045;829;13;842
52;72;72046;1544;27;1571
52;72;72047;2128;135;2263
52;72;72048;527;4;531
52;72;72049;247;1;248
52;72;72050;1521;29;1550
52;72;72051;3369;36;3405
52;72;72052;678;9;687
52;72;72053;1227;14;1241
52;72;72054;3756;68;3824
52;72;72056;1336;24;1360
52;72;72057;72;3;75
52;72;72058;6552;197;6749
52;72;72059;841;19;860
52;72;72060;261;3;264
52;72;72061;1701;25;1726
52;72;72062;858;24;882
52;72;72064;528;10;538
52;72;72065;2302;66;2368
52;72;72066;426;7;433
52;72;72067;990;16;1006
52;72;72068;1384;16;1400
52;72;72070;247;7;254
52;72;72071;6038;245;6283
52;72;72072;252;2;254
52;72;72073;1072;22;1094
52;72;72074;210;4;214
52;72;72075;993;26;1019
52;72;72076;241;2;243
52;72;72077;426;7;433
52;72;72078;356;3;359
52;72;72079;312;3;315
52;72;72080;2731;80;2811
52;72;72083;382;11;393
52;72;72084;1259;35;1294
52;72;72085;182;2;184
52;72;72086;138;4;142
52;72;72087;477;14;491
52;72;72088;334;11;345
52;72;72089;1863;38;1901
52;72;72090;2952;59;3011
52;72;72091;133;2;135
52;72;72093;903;14;917
52;72;72094;615;9;624
52;72;72095;7779;116;7895
52;72;72096;1656;82;1738
52;72;72098;505;6;511
52;72;72099;638;7;645
52;72;72100;411;4;415
52;72;72101;676;13;689
52;72;72102;98;1;99
52;72;72103;611;8;619
52;72;72104;573;15;588
52;72;72105;490;5;495
52;72;72106;935;28;963
52;72;72107;347;6;353
52;72;72109;552;6;558
52;72;72110;1044;20;1064
52;72;72111;471;15;486
52;72;72112;476;5;481
52;72;72113;763;12;775
52;72;72114;268;6;274
52;72;72115;922;22;944
52;72;72118;1460;23;1483
52;72;72119;1047;19;1066
52;72;72120;251;3;254
52;72;72121;322;10;332
52;72;72122;1041;21;1062
52;72;72123;72;0;72
52;72;72124;4744;72;4816
52;72;72125;298;9;307
52;72;72126;292;9;301
52;72;72127;1956;37;1993
52;72;72128;524;5;529
52;72;72129;850;16;866
52;72;72130;705;12;717
52;72;72131;593;8;601
52;72;72132;8862;337;9199
52;72;72133;1489;23;1512
52;72;72134;532;14;546
52;72;72135;606;6;612
52;72;72136;318;8;326
52;72;72137;2191;38;2229
52;72;72138;2889;46;2935
52;72;72139;979;41;1020
52;72;72141;923;35;958
52;72;72142;149;5;154
52;72;72143;1926;26;1952
52;72;72144;327;4;331
52;72;72145;395;7;402
52;72;72146;3092;54;3146
52;72;72147;1125;24;1149
52;72;72148;82;1;83
52;72;72149;629;10;639
52;72;72150;1261;23;1284
52;72;72151;1136;31;1167
52;72;72152;444;11;455
52;72;72153;554;12;566
52;72;72154;14858;1071;15929
52;72;72155;2323;30;2353
52;72;72156;932;23;955
52;72;72157;714;13;727
52;72;72158;831;12;843
52;72;72160;586;7;593
52;72;72161;904;13;917
52;72;72163;491;9;500
52;72;72164;70;0;70
52;72;72165;1911;24;1935
52;72;72166;317;10;327
52;72;72167;717;12;729
52;72;72168;2068;41;2109
52;72;72169;1460;25;1485
52;72;72170;172;7;179
52;72;72171;102;1;103
52;72;72172;1441;13;1454
52;72;72173;1231;26;1257
52;72;72174;102;1;103
52;72;72175;1540;14;1554
52;72;72176;4126;71;4197
52;72;72177;354;4;358
52;72;72178;191;1;192
52;72;72179;1884;34;1918
52;72;72180;5157;171;5328
52;72;72181;143847;2856;146703
52;72;72182;1544;29;1573
52;72;72183;1068;16;1084
52;72;72184;384;6;390
52;72;72185;661;9;670
52;72;72186;887;11;898
52;72;72187;1611;17;1628
52;72;72188;151;2;153
52;72;72189;2109;26;2135
52;72;72190;277;4;281
52;72;72191;3120;39;3159
52;72;72192;95;2;97
52;72;72193;430;7;437
52;72;72194;267;2;269
52;72;72195;1874;28;1902
52;72;72196;732;6;738
52;72;72197;689;5;694
52;72;72198;2637;36;2673
52;72;72199;281;1;282
52;72;72200;3703;62;3765
52;72;72201;259;4;263
52;72;72202;198;11;209
52;72;72204;521;6;527
52;72;72205;1804;26;1830
52;72;72208;374;9;383
52;72;72209;304;1;305
52;72;72210;304;5;309
52;72;72211;638;11;649
52;72;72212;699;13;712
52;72;72213;5225;63;5288
52;72;72214;10;2;12
52;72;72215;1034;12;1046
52;72;72216;595;14;609
52;72;72217;2448;48;2496
52;72;72218;291;4;295
52;72;72219;874;58;932
52;72;72220;902;37;939
52;72;72221;372;4;376
52;72;72222;271;0;271
52;72;72223;2624;32;2656
52;72;72224;533;3;536
52;72;72225;667;8;675
52;72;72226;1333;17;1350
52;72;72227;41;0;41
52;72;72228;2084;50;2134
52;72;72229;472;7;479
52;72;72230;1073;27;1100
52;72;72231;5286;82;5368
52;72;72232;657;10;667
52;72;72233;60;0;60
52;72;72234;365;10;375
52;72;72235;376;7;383
52;72;72236;191;8;199
52;72;72237;501;6;507
52;72;72238;73;0;73
52;72;72239;612;21;633
52;72;72241;2931;48;2979
52;72;72243;1645;25;1670
52;72;72244;2957;64;3021
52;72;72245;685;15;700
52;72;72246;208;6;214
52;72;72247;1338;31;1369
52;72;72248;821;24;845
52;72;72249;763;13;776
52;72;72250;151;9;160
52;72;72251;386;5;391
52;72;72252;1142;10;1152
52;72;72253;2615;69;2684
52;72;72254;268;6;274
52;72;72255;800;16;816
52;72;72256;791;7;798
52;72;72257;2316;319;2635
52;72;72259;282;7;289
52;72;72260;3503;69;3572
52;72;72261;302;12;314
52;72;72262;2163;174;2337
52;72;72264;12125;456;12581
52;72;72265;236;2;238
52;72;72266;733;17;750
52;72;72267;912;21;933
52;72;72268;706;11;717
52;72;72269;3244;195;3439
52;72;72270;193;1;194
52;72;72271;927;15;942
52;72;72272;315;6;321
52;72;72273;232;3;235
52;72;72274;207;7;214
52;72;72275;1521;15;1536
52;72;72276;1917;46;1963
52;72;72277;114;1;115
52;72;72278;773;11;784
52;72;72279;153;3;156
52;72;72280;2155;36;2191
52;72;72281;443;5;448
52;72;72282;536;5;541
52;72;72283;334;5;339
52;72;72286;387;7;394
52;72;72287;2021;44;2065
52;72;72289;2035;33;2068
52;72;72290;1811;15;1826
52;72;72291;982;20;1002
52;72;72292;238;5;243
52;72;72293;617;7;624
52;72;72294;471;15;486
52;72;72295;499;7;506
52;72;72296;746;21;767
52;72;72297;547;12;559
52;72;72298;576;10;586
52;72;72299;2439;34;2473
52;72;72300;2698;29;2727
52;72;72302;173;4;177
52;72;72303;731;10;741
52;72;72305;968;25;993
52;72;72306;1322;24;1346
52;72;72307;239;6;245
52;72;72308;2106;248;2354
52;72;72309;285;7;292
52;72;72310;1916;58;1974
52;72;72311;351;6;357
52;72;72312;234;3;237
52;72;72313;224;5;229
52;72;72314;375;8;383
52;72;72315;829;14;843
52;72;72316;686;21;707
52;72;72317;501;18;519
52;72;72319;742;19;761
52;72;72320;2590;81;2671
52;72;72321;516;10;526
52;72;72322;224;2;226
52;72;72323;459;2;461
52;72;72324;506;14;520
52;72;72325;840;17;857
52;72;72326;208;5;213
52;72;72327;300;4;304
52;72;72328;3709;140;3849
52;72;72329;4064;83;4147
52;72;72330;432;13;445
52;72;72331;579;11;590
52;72;72332;605;8;613
52;72;72333;441;11;452
52;72;72334;2231;86;2317
52;72;72335;1075;15;1090
52;72;72336;1214;40;1254
52;72;72337;865;20;885
52;72;72338;743;10;753
52;72;72339;672;10;682
52;72;72340;1239;23;1262
52;72;72341;624;12;636
52;72;72342;165;7;172
52;72;72343;626;11;637
52;72;72344;2881;48;2929
52;72;72345;339;5;344
52;72;72346;4473;56;4529
52;72;72347;300;5;305
52;72;72348;129;1;130
52;72;72349;476;2;478
52;72;72350;3056;61;3117
52;72;72351;1051;20;1071
52;72;72352;139;0;139
52;72;72353;215;5;220
52;72;72354;161;4;165
52;72;72355;106;1;107
52;72;72356;414;5;419
52;72;72357;729;12;741
52;72;72358;1615;37;1652
52;72;72359;1429;9;1438
52;72;72360;1509;34;1543
52;72;72361;484;8;492
52;72;72362;165;1;166
52;72;72363;1663;16;1679
52;72;72364;1432;25;1457
52;72;72366;315;4;319
52;72;72367;793;12;805
52;72;72368;322;6;328
52;72;72369;594;64;658
52;72;72370;328;6;334
52;72;72372;77;1;78
52;72;72373;2510;55;2565
52;72;72374;148;5;153
52;72;72375;539;14;553
52;72;72376;707;21;728
52;72;72377;1033;11;1044
52;72;72378;1445;33;1478
52;72;72379;195;6;201
52;72;72380;947;22;969
52;72;72381;1370;11;1381
52;72;72382;943;18;961
52;72;72383;132;4;136
52;72;72385;1766;24;1790
52;72;72386;4261;133;4394
84;73;73001;232;9;241
84;73;73003;3838;113;3951
84;73;73004;433;16;449
84;73;73005;182;4;186
84;73;73006;4444;109;4553
84;73;73007;1679;22;1701
84;73;73008;30463;577;31040
84;73;73010;6315;141;6456
84;73;73011;19502;564;20066
84;73;73012;147;2;149
84;73;73013;365;10;375
84;73;73014;288;2;290
84;73;73015;1860;43;1903
84;73;73017;987;21;1008
84;73;73018;769;21;790
84;73;73019;955;20;975
84;73;73020;443;11;454
84;73;73021;850;17;867
84;73;73022;563;15;578
84;73;73023;698;23;721
84;73;73024;778;22;800
84;73;73025;526;11;537
84;73;73026;389;14;403
84;73;73027;387;6;393
84;73;73028;337;3;340
84;73;73029;5022;118;5140
84;73;73030;3429;41;3470
84;73;73031;4785;121;4906
84;73;73032;2152;37;2189
84;73;73033;494;5;499
84;73;73034;2034;89;2123
84;73;73036;683;18;701
84;73;73039;536;12;548
84;73;73040;359;8;367
84;73;73041;306;6;312
84;73;73042;263;7;270
84;73;73043;2781;35;2816
84;73;73047;259;9;268
84;73;73048;355;14;369
84;73;73049;148;0;148
84;73;73050;574;21;595
84;73;73051;4966;99;5065
84;73;73052;147;4;151
84;73;73053;690;11;701
84;73;73054;7195;401;7596
84;73;73055;1876;58;1934
84;73;73057;500;12;512
84;73;73058;1272;19;1291
84;73;73059;2262;69;2331
84;73;73061;423;15;438
84;73;73063;718;10;728
84;73;73064;5609;273;5882
84;73;73065;58917;1561;60478
84;73;73067;1151;22;1173
84;73;73068;587;20;607
84;73;73069;952;17;969
84;73;73070;702;8;710
84;73;73071;565;22;587
84;73;73072;33;1;34
84;73;73073;535;7;542
84;73;73074;330;11;341
84;73;73075;572;21;593
84;73;73076;261;4;265
84;73;73077;563;10;573
84;73;73078;144;6;150
84;73;73079;924;15;939
84;73;73081;668;44;712
84;73;73082;747;38;785
84;73;73083;222;3;225
84;73;73084;952;27;979
84;73;73085;1394;21;1415
84;73;73086;393;12;405
84;73;73087;6359;184;6543
84;73;73088;159;8;167
84;73;73089;1269;22;1291
84;73;73090;264;7;271
84;73;73091;207;3;210
84;73;73092;153;4;157
84;73;73094;336;14;350
84;73;73095;382;8;390
84;73;73096;1041;19;1060
84;73;73097;678;21;699
84;73;73098;811;22;833
84;73;73099;433;4;437
84;73;73100;1904;46;1950
84;73;73101;96;3;99
84;73;73103;2934;67;3001
84;73;73104;479;5;484
84;73;73105;1239;17;1256
84;73;73106;303;6;309
84;73;73107;644;8;652
84;73;73109;777;9;786
84;73;73110;782;7;789
84;73;73113;177;3;180
84;73;73114;802;29;831
84;73;73116;481;12;493
84;73;73117;691;9;700
84;73;73119;99;4;103
84;73;73120;609;14;623
84;73;73121;1928;49;1977
84;73;73122;424;19;443
84;73;73123;387;15;402
84;73;73124;3042;78;3120
84;73;73128;4595;101;4696
84;73;73129;1215;39;1254
84;73;73130;2107;38;2145
84;73;73131;303;8;311
84;73;73132;758;23;781
84;73;73133;351;7;358
84;73;73135;1079;26;1105
84;73;73137;4047;78;4125
84;73;73138;491;11;502
84;73;73139;271;12;283
84;73;73140;283;7;290
84;73;73141;687;14;701
84;73;73142;817;20;837
84;73;73145;464;14;478
84;73;73146;781;17;798
84;73;73147;202;0;202
84;73;73149;305;6;311
84;73;73150;3766;128;3894
84;73;73151;3796;88;3884
84;73;73152;213;5;218
84;73;73153;1352;31;1383
84;73;73154;3299;94;3393
84;73;73155;2013;42;2055
84;73;73156;313;6;319
84;73;73157;3075;136;3211
84;73;73159;845;8;853
84;73;73160;978;26;1004
84;73;73161;654;14;668
84;73;73162;678;24;702
84;73;73164;1011;61;1072
84;73;73166;54;2;56
84;73;73168;119;1;120
84;73;73170;526;11;537
84;73;73171;4102;71;4173
84;73;73173;475;11;486
84;73;73175;73;0;73
84;73;73176;709;10;719
84;73;73177;238;7;245
84;73;73178;505;11;516
84;73;73179;12120;611;12731
84;73;73180;435;7;442
84;73;73181;3496;458;3954
84;73;73182;2241;54;2295
84;73;73183;1289;34;1323
84;73;73184;509;11;520
84;73;73186;477;14;491
84;73;73187;2635;56;2691
84;73;73188;1029;25;1054
84;73;73189;227;2;229
84;73;73190;247;6;253
84;73;73191;2147;69;2216
84;73;73192;213;5;218
84;73;73193;106;3;109
84;73;73194;328;9;337
84;73;73196;789;19;808
84;73;73197;641;25;666
84;73;73200;553;7;560
84;73;73201;441;14;455
84;73;73202;454;10;464
84;73;73204;2075;32;2107
84;73;73205;117;4;121
84;73;73206;715;23;738
84;73;73207;432;12;444
84;73;73208;950;40;990
84;73;73210;379;5;384
84;73;73211;782;24;806
84;73;73212;2018;29;2047
84;73;73213;8530;546;9076
84;73;73214;235;10;245
84;73;73215;4160;100;4260
84;73;73216;487;6;493
84;73;73217;368;12;380
84;73;73218;816;16;832
84;73;73219;663;16;679
84;73;73220;366;11;377
84;73;73221;88;3;91
84;73;73222;6285;209;6494
84;73;73223;446;6;452
84;73;73224;889;21;910
84;73;73225;2759;91;2850
84;73;73226;1706;22;1728
84;73;73227;2360;73;2433
84;73;73228;905;24;929
84;73;73229;533;13;546
84;73;73230;132;0;132
84;73;73231;1205;23;1228
84;73;73232;729;24;753
84;73;73233;162;8;170
84;73;73234;149;4;153
84;73;73235;545;6;551
84;73;73236;2905;67;2972
84;73;73237;350;3;353
84;73;73240;793;20;813
84;73;73241;1196;21;1217
84;73;73242;272;10;282
84;73;73243;1726;57;1783
84;73;73245;823;16;839
84;73;73246;299;5;304
84;73;73247;956;71;1027
84;73;73248;7621;345;7966
84;73;73249;1866;46;1912
84;73;73250;1627;44;1671
84;73;73252;239;3;242
84;73;73253;601;8;609
84;73;73254;120;2;122
84;73;73255;818;21;839
84;73;73256;327;8;335
84;73;73257;3494;117;3611
84;73;73258;679;20;699
84;73;73259;544;14;558
84;73;73261;2467;280;2747
84;73;73262;472;35;507
84;73;73263;1145;22;1167
84;73;73265;723;19;742
84;73;73267;297;10;307
84;73;73268;529;59;588
84;73;73269;724;13;737
84;73;73270;4097;103;4200
84;73;73271;307;10;317
84;73;73272;178;4;182
84;73;73273;487;6;493
84;73;73274;451;15;466
84;73;73275;321;8;329
84;73;73276;415;18;433
84;73;73277;172;7;179
84;73;73278;1238;21;1259
84;73;73280;344;8;352
84;73;73281;747;20;767
84;73;73282;1062;19;1081
84;73;73283;709;14;723
84;73;73284;997;19;1016
84;73;73285;2322;70;2392
84;73;73286;1168;21;1189
84;73;73288;2002;46;2048
84;73;73289;427;9;436
84;73;73290;2062;38;2100
84;73;73292;318;7;325
84;73;73293;455;7;462
84;73;73294;338;7;345
84;73;73296;2020;42;2062
84;73;73297;592;22;614
84;73;73298;910;11;921
84;73;73299;325;6;331
84;73;73300;2988;106;3094
84;73;73301;814;16;830
84;73;73302;338;3;341
84;73;73303;7096;289;7385
84;73;73304;1583;46;1629
84;73;73306;1066;25;1091
84;73;73307;566;3;569
84;73;73308;593;18;611
84;73;73309;300;5;305
84;73;73310;479;12;491
84;73;73311;105;1;106
84;73;73312;918;31;949
84;73;73313;230;1;231
84;73;73314;261;5;266
84;73;73315;457;8;465
84;73;73316;290;4;294
84;73;73317;705;27;732
84;73;73318;252;9;261
84;73;73320;853;25;878
84;73;73322;536;14;550
84;73;73323;360;15;375
84;73;73324;193;8;201
84;73;73326;2114;40;2154
84;73;73327;395;6;401
84;73;73328;2269;57;2326
84;73;73329;1911;37;1948
84;73;73330;3002;34;3036
84;74;74001;1447;117;1564
84;74;74002;2576;55;2631
84;74;74003;1102;35;1137
84;74;74004;415;8;423
84;74;74005;4681;125;4806
84;74;74006;2191;30;2221
84;74;74007;2739;54;2793
84;74;74008;6138;67;6205
84;74;74009;953;18;971
84;74;74010;130721;3380;134101
84;74;74012;36582;396;36978
84;74;74013;2198;91;2289
84;74;74014;1847;54;1901
84;74;74015;1140;24;1164
84;74;74016;2609;35;2644
84;74;74018;1866;48;1914
84;74;74019;3370;270;3640
84;74;74020;1359;57;1416
84;74;74021;1623;30;1653
84;74;74024;2219;60;2279
84;74;74025;1492;21;1513
84;74;74026;5078;163;5241
84;74;74027;455;9;464
84;74;74029;419;14;433
84;74;74030;321;6;327
84;74;74031;3027;67;3094
84;74;74032;1273;40;1313
84;74;74033;1384;28;1412
84;74;74034;615;7;622
84;74;74035;592;24;616
84;74;74036;376;12;388
84;74;74037;1861;61;1922
84;74;74038;1133;29;1162
84;74;74040;3181;143;3324
84;74;74041;281;5;286
84;74;74042;12509;406;12915
84;74;74043;5739;109;5848
84;74;74044;1042;12;1054
84;74;74045;249;6;255
84;74;74046;506;12;518
84;74;74048;1096;22;1118
84;74;74049;482;2;484
84;74;74050;673;16;689
84;74;74051;696;11;707
84;74;74052;1055;17;1072
84;74;74053;1233;22;1255
84;74;74054;759;28;787
84;74;74055;544;13;557
84;74;74056;8640;386;9026
84;74;74057;1111;31;1142
84;74;74058;932;17;949
84;74;74059;261;6;267
84;74;74060;115;0;115
84;74;74061;931;35;966
84;74;74062;1428;26;1454
84;74;74063;1246;42;1288
84;74;74064;1194;44;1238
84;74;74065;499;15;514
84;74;74066;253;2;255
84;74;74067;2683;168;2851
84;74;74068;519;8;527
84;74;74069;810;14;824
84;74;74070;2792;35;2827
84;74;74071;221;6;227
84;74;74072;202;6;208
84;74;74073;662;12;674
84;74;74074;626;7;633
84;74;74075;1441;22;1463
84;74;74076;1660;43;1703
84;74;74077;1034;26;1060
84;74;74078;405;6;411
84;74;74079;675;6;681
84;74;74080;1709;53;1762
84;74;74081;16918;405;17323
84;74;74082;3948;117;4065
84;74;74083;2104;115;2219
84;74;74085;1118;47;1165
84;74;74086;722;12;734
84;74;74087;2204;152;2356
84;74;74088;1195;22;1217
84;74;74089;984;26;1010
84;74;74090;1385;20;1405
84;74;74091;362;2;364
84;74;74094;6975;167;7142
84;74;74095;319;10;329
84;74;74096;4502;315;4817
84;74;74097;1836;55;1891
84;74;74098;1541;54;1595
84;74;74099;844;37;881
84;74;74100;785;25;810
84;74;74101;709;17;726
84;74;74102;1441;47;1488
84;74;74103;2195;76;2271
84;74;74104;3542;85;3627
84;74;74105;6483;80;6563
84;74;74106;902;31;933
84;74;74107;154;5;159
84;74;74108;994;21;1015
84;74;74109;927;19;946
84;74;74111;212;3;215
84;74;74112;8196;198;8394
84;74;74114;512;6;518
84;74;74116;2021;70;2091
84;74;74117;838;21;859
84;74;74118;2556;29;2585
84;74;74119;9108;251;9359
84;74;74121;1168;17;1185
84;74;74122;640;21;661
84;74;74123;7609;227;7836
84;74;74124;1757;32;1789
84;74;74126;990;31;1021
84;74;74127;1433;43;1476
84;74;74128;3516;88;3604
84;74;74129;227;4;231
84;74;74130;540;31;571
84;74;74131;2052;39;2091
84;74;74133;10071;108;10179
84;74;74134;1215;27;1242
84;74;74135;525;8;533
84;74;74136;2096;48;2144
84;74;74137;3900;147;4047
84;74;74138;1522;62;1584
84;74;74139;1051;31;1082
84;74;74140;1475;27;1502
84;74;74141;1029;26;1055
84;74;74142;983;31;1014
84;74;74143;3007;80;3087
84;74;74144;827;20;847
84;74;74145;630;12;642
84;74;74146;1506;46;1552
84;74;74147;1008;26;1034
84;74;74148;273;7;280
84;74;74150;1633;29;1662
84;74;74151;572;9;581
84;74;74152;1257;41;1298
84;74;74153;1607;65;1672
84;74;74154;2504;52;2556
84;74;74155;802;28;830
84;74;74156;690;13;703
84;74;74157;1741;63;1804
84;74;74158;1098;17;1115
84;74;74159;3240;68;3308
84;74;74160;996;23;1019
84;74;74161;1953;57;2010
84;74;74162;1052;18;1070
84;74;74163;2197;78;2275
84;74;74164;6372;185;6557
84;74;74165;693;9;702
84;74;74166;1842;52;1894
84;74;74167;1383;24;1407
84;74;74168;1053;11;1064
84;74;74169;5642;116;5758
84;74;74170;874;19;893
84;74;74171;1534;34;1568
84;74;74172;1453;34;1487
84;74;74173;3025;128;3153
84;74;74174;590;25;615
84;74;74175;314;6;320
84;74;74176;1884;70;1954
84;74;74177;1082;20;1102
84;74;74178;729;13;742
84;74;74179;780;27;807
84;74;74180;2150;50;2200
84;74;74183;2421;64;2485
84;74;74184;1045;20;1065
84;74;74185;2318;45;2363
84;74;74186;760;22;782
84;74;74188;939;24;963
84;74;74189;1667;54;1721
84;74;74190;676;13;689
84;74;74191;2717;74;2791
84;74;74192;983;37;1020
84;74;74193;1061;11;1072
84;74;74194;881;24;905
84;74;74195;420;8;428
84;74;74196;465;15;480
84;74;74197;1604;34;1638
84;74;74198;1006;40;1046
84;74;74199;378;7;385
84;74;74200;3122;95;3217
84;74;74201;2152;23;2175
84;74;74202;719;8;727
84;74;74203;49;2;51
84;74;74205;1288;29;1317
84;74;74206;1030;18;1048
84;74;74208;11233;423;11656
84;74;74209;1381;40;1421
84;74;74210;1885;40;1925
84;74;74211;3108;90;3198
84;74;74212;1814;30;1844
84;74;74213;8233;359;8592
84;74;74215;1241;36;1277
84;74;74216;1054;17;1071
84;74;74218;7341;213;7554
84;74;74219;1252;50;1302
84;74;74220;8072;196;8268
84;74;74221;536;21;557
84;74;74222;504;9;513
84;74;74223;470;5;475
84;74;74224;11149;342;11491
84;74;74225;15768;377;16145
84;74;74226;575;12;587
84;74;74228;351;12;363
84;74;74229;3671;74;3745
84;74;74231;594;14;608
84;74;74232;498;21;519
84;74;74233;2418;30;2448
84;74;74234;876;22;898
84;74;74235;587;12;599
84;74;74236;5604;130;5734
84;74;74237;886;4;890
84;74;74238;1558;26;1584
84;74;74239;1461;38;1499
84;74;74240;1007;28;1035
84;74;74241;3370;101;3471
84;74;74242;6008;200;6208
84;74;74243;15873;252;16125
84;74;74244;839;34;873
84;74;74249;2487;83;2570
84;74;74250;7091;139;7230
84;74;74252;585;33;618
84;74;74253;1018;38;1056
84;74;74254;605;16;621
84;74;74255;2060;51;2111
84;74;74256;16831;491;17322
84;74;74257;765;21;786
84;74;74258;2473;63;2536
84;74;74259;434;8;442
84;74;74260;980;21;1001
84;74;74261;484;8;492
84;74;74262;1148;21;1169
84;74;74263;6348;144;6492
84;74;74264;8932;138;9070
84;74;74265;702;72;774
84;74;74266;1057;35;1092
84;74;74267;4139;182;4321
84;74;74269;2351;79;2430
84;74;74271;519;13;532
84;74;74272;5365;130;5495
84;74;74273;759;18;777
84;74;74275;1948;67;2015
84;74;74276;3394;71;3465
84;74;74278;6330;150;6480
84;74;74279;831;25;856
84;74;74280;6598;284;6882
84;74;74281;35826;1147;36973
84;74;74282;9449;236;9685
84;74;74283;1131;19;1150
84;74;74284;1301;25;1326
84;74;74285;415;9;424
84;74;74286;859;17;876
84;74;74287;914;20;934
84;74;74288;4935;60;4995
84;74;74289;2562;59;2621
84;74;74290;406;12;418
84;74;74291;336;4;340
84;74;74292;1022;30;1052
84;74;74293;3919;44;3963
84;74;74294;755;20;775
84;74;74295;343;5;348
84;74;74296;918;18;936
84;74;74297;610;25;635
84;74;74298;9003;264;9267
84;74;74299;2276;82;2358
84;74;74301;905;19;924
84;74;74302;1071;37;1108
84;74;74303;3347;126;3473
84;74;74304;933;10;943
84;74;74305;9050;119;9169
84;74;74306;594;17;611
84;74;74307;989;16;1005
84;74;74308;844;23;867
84;74;74309;5415;82;5497
84;74;74310;1307;33;1340
84;74;74311;4454;78;4532
84;74;74312;1581;28;1609
84;74;74313;555;11;566
84;74;74314;1630;55;1685
84;74;74315;1067;19;1086
11;75;75101;15917;138;16055
11;75;75102;21595;140;21735
11;75;75103;34025;281;34306
11;75;75104;29131;259;29390
11;75;75105;58227;670;58897
11;75;75106;40303;868;41171
11;75;75107;48888;793;49681
11;75;75108;35655;595;36250
11;75;75109;60026;537;60563
11;75;75110;86472;391;86863
11;75;75111;145208;820;146028
11;75;75112;139297;940;140237
11;75;75113;180005;1228;181233
11;75;75114;135592;976;136568
11;75;75115;230981;1687;232668
11;75;75116;165523;2254;167777
11;75;75117;166543;1432;167975
11;75;75118;192468;820;193288
11;75;75119;184573;998;185571
11;75;75120;194994;924;195918
28;76;76001;1158;19;1177
28;76;76002;622;9;631
28;76;76004;468;14;482
28;76;76005;3306;31;3337
28;76;76006;173;4;177
28;76;76007;675;10;685
28;76;76008;630;10;640
28;76;76009;344;4;348
28;76;76010;373;6;379
28;76;76011;152;4;156
28;76;76012;185;3;188
28;76;76013;1078;30;1108
28;76;76014;1405;15;1420
28;76;76015;512;11;523
28;76;76016;121;2;123
28;76;76017;648;6;654
28;76;76018;1491;33;1524
28;76;76019;424;10;434
28;76;76020;1189;23;1212
28;76;76021;467;7;474
28;76;76022;338;13;351
28;76;76023;300;5;305
28;76;76024;157;4;161
28;76;76025;344;8;352
28;76;76026;2573;52;2625
28;76;76028;187;1;188
28;76;76029;199;3;202
28;76;76030;503;3;506
28;76;76032;138;1;139
28;76;76033;458;6;464
28;76;76034;2535;22;2557
28;76;76035;1986;53;2039
28;76;76036;692;19;711
28;76;76038;399;3;402
28;76;76039;1261;26;1287
28;76;76040;308;0;308
28;76;76041;1349;36;1385
28;76;76042;102;0;102
28;76;76043;1130;361;1491
28;76;76045;358;9;367
28;76;76046;702;12;714
28;76;76047;150;1;151
28;76;76048;297;6;303
28;76;76049;280;6;286
28;76;76050;1011;27;1038
28;76;76051;1910;39;1949
28;76;76052;221;1;222
28;76;76053;108;1;109
28;76;76054;522;4;526
28;76;76055;337;17;354
28;76;76056;632;6;638
28;76;76057;12398;229;12627
28;76;76058;218;5;223
28;76;76059;417;11;428
28;76;76060;497;13;510
28;76;76062;261;3;264
28;76;76063;472;10;482
28;76;76064;492;13;505
28;76;76065;411;4;415
28;76;76066;149;4;153
28;76;76067;604;14;618
28;76;76068;643;17;660
28;76;76069;2235;52;2287
28;76;76070;624;10;634
28;76;76071;474;8;482
28;76;76072;738;12;750
28;76;76074;54;0;54
28;76;76075;452;2;454
28;76;76076;267;5;272
28;76;76077;178;5;183
28;76;76079;189;1;190
28;76;76082;637;6;643
28;76;76083;99;1;100
28;76;76084;122;1;123
28;76;76085;339;10;349
28;76;76086;216;5;221
28;76;76087;680;10;690
28;76;76088;545;9;554
28;76;76090;1244;17;1261
28;76;76091;228;2;230
28;76;76092;634;10;644
28;76;76093;357;13;370
28;76;76094;325;3;328
28;76;76095;8264;166;8430
28;76;76096;662;12;674
28;76;76097;106;0;106
28;76;76099;723;9;732
28;76;76100;1222;17;1239
28;76;76101;2907;34;2941
28;76;76103;6479;106;6585
28;76;76104;252;14;266
28;76;76105;659;7;666
28;76;76106;556;7;563
28;76;76107;299;4;303
28;76;76108;14592;404;14996
28;76;76109;182;4;186
28;76;76110;472;5;477
28;76;76111;601;10;611
28;76;76112;353;8;361
28;76;76113;406;6;412
28;76;76114;11610;136;11746
28;76;76115;581;3;584
28;76;76116;3923;46;3969
28;76;76117;651;20;671
28;76;76118;251;8;259
28;76;76119;200;2;202
28;76;76120;452;10;462
28;76;76121;364;3;367
28;76;76122;509;8;517
28;76;76123;1028;28;1056
28;76;76124;434;8;442
28;76;76125;1532;19;1551
28;76;76126;317;6;323
28;76;76128;585;15;600
28;76;76129;206;6;212
28;76;76130;289;3;292
28;76;76131;722;10;732
28;76;76132;465;2;467
28;76;76133;431;9;440
28;76;76134;300;4;304
28;76;76135;987;13;1000
28;76;76136;723;11;734
28;76;76138;329;5;334
28;76;76139;220;3;223
28;76;76140;199;2;201
28;76;76141;1359;13;1372
28;76;76142;454;126;580
28;76;76143;1360;22;1382
28;76;76144;154;2;156
28;76;76146;2840;102;2942
28;76;76147;913;23;936
28;76;76148;326;4;330
28;76;76149;284;5;289
28;76;76151;262;10;272
28;76;76152;763;4;767
28;76;76153;324;3;327
28;76;76154;475;12;487
28;76;76155;377;3;380
28;76;76156;342;9;351
28;76;76157;13846;373;14219
28;76;76158;326;2;328
28;76;76159;3046;56;3102
28;76;76160;417;10;427
28;76;76161;100;3;103
28;76;76162;270;5;275
28;76;76163;672;10;682
28;76;76164;4148;66;4214
28;76;76165;9949;67;10016
28;76;76166;482;4;486
28;76;76167;1594;27;1621
28;76;76168;65;1;66
28;76;76169;1276;114;1390
28;76;76170;118;1;119
28;76;76171;135;1;136
28;76;76172;158;3;161
28;76;76173;542;6;548
28;76;76174;404;5;409
28;76;76175;260;7;267
28;76;76176;343;7;350
28;76;76177;284;6;290
28;76;76178;4924;25;4949
28;76;76179;1377;16;1393
28;76;76180;190;8;198
28;76;76181;154;2;156
28;76;76182;262;2;264
28;76;76183;763;19;782
28;76;76184;109;3;112
28;76;76185;166;4;170
28;76;76186;496;3;499
28;76;76187;162;3;165
28;76;76188;476;4;480
28;76;76189;153;6;159
28;76;76190;208;3;211
28;76;76192;2630;54;2684
28;76;76193;341;5;346
28;76;76194;402;3;405
28;76;76195;177;1;178
28;76;76196;2562;90;2652
28;76;76197;221;2;223
28;76;76198;802;19;821
28;76;76199;691;10;701
28;76;76200;458;12;470
28;76;76201;534;4;538
28;76;76202;318;4;322
28;76;76203;757;7;764
28;76;76204;254;1;255
28;76;76205;248;2;250
28;76;76206;345;5;350
28;76;76207;196;6;202
28;76;76208;665;17;682
28;76;76209;442;8;450
28;76;76210;460;2;462
28;76;76211;231;2;233
28;76;76212;9788;84;9872
28;76;76213;401;9;410
28;76;76214;265;1;266
28;76;76216;10654;75;10729
28;76;76217;28241;468;28709
28;76;76218;98;2;100
28;76;76219;2477;45;2522
28;76;76220;523;12;535
28;76;76221;194;5;199
28;76;76222;4073;53;4126
28;76;76223;514;6;520
28;76;76224;977;19;996
28;76;76225;377;12;389
28;76;76226;163;2;165
28;76;76227;698;11;709
28;76;76228;392;7;399
28;76;76229;406;14;420
28;76;76230;475;6;481
28;76;76231;16224;126;16350
28;76;76232;643;9;652
28;76;76233;151;4;155
28;76;76234;712;11;723
28;76;76235;2022;155;2177
28;76;76236;349;1;350
28;76;76237;509;8;517
28;76;76238;2654;39;2693
28;76;76239;776;14;790
28;76;76240;1013;13;1026
28;76;76241;139;6;145
28;76;76242;195;4;199
28;76;76243;294;2;296
28;76;76244;385;6;391
28;76;76245;1619;16;1635
28;76;76247;495;4;499
28;76;76249;827;11;838
28;76;76250;1205;27;1232
28;76;76251;442;3;445
28;76;76252;1036;28;1064
28;76;76253;826;14;840
28;76;76254;1237;6;1243
28;76;76255;6716;200;6916
28;76;76257;183;2;185
28;76;76258;4193;112;4305
28;76;76259;18041;288;18329
28;76;76260;1675;19;1694
28;76;76261;458;11;469
28;76;76262;134;2;136
28;76;76263;1289;22;1311
28;76;76264;484;11;495
28;76;76265;163;8;171
28;76;76266;705;15;720
28;76;76268;185;5;190
28;76;76269;173;3;176
28;76;76270;2633;53;2686
28;76;76271;1809;18;1827
28;76;76272;899;17;916
28;76;76273;541;15;556
28;76;76274;28;0;28
28;76;76275;1521;24;1545
28;76;76276;3812;198;4010
28;76;76278;797;13;810
28;76;76279;359;10;369
28;76;76280;132;1;133
28;76;76281;2093;45;2138
28;76;76282;953;9;962
28;76;76283;238;4;242
28;76;76284;331;5;336
28;76;76285;574;8;582
28;76;76286;672;7;679
28;76;76287;1017;13;1030
28;76;76288;364;4;368
28;76;76289;1726;24;1750
28;76;76290;398;11;409
28;76;76291;1194;26;1220
28;76;76292;144;3;147
28;76;76293;236;0;236
28;76;76294;384;8;392
28;76;76295;1224;9;1233
28;76;76296;2526;31;2557
28;76;76297;230;7;237
28;76;76298;468;5;473
28;76;76299;391;4;395
28;76;76300;431;4;435
28;76;76302;2864;41;2905
28;76;76303;729;9;738
28;76;76304;369;1;370
28;76;76305;9124;59;9183
28;76;76306;178;2;180
28;76;76307;1371;20;1391
28;76;76308;503;8;511
28;76;76309;123;2;125
28;76;76311;425;5;430
28;76;76312;6041;97;6138
28;76;76313;888;14;902
28;76;76314;615;9;624
28;76;76315;1077;18;1095
28;76;76316;442;4;446
28;76;76317;433;12;445
28;76;76318;737;27;764
28;76;76319;9739;191;9930
28;76;76320;328;4;332
28;76;76321;1783;27;1810
28;76;76322;25963;250;26213
28;76;76323;155;2;157
28;76;76324;848;15;863
28;76;76325;438;5;443
28;76;76327;374;5;379
28;76;76328;375;5;380
28;76;76329;3175;37;3212
28;76;76330;686;20;706
28;76;76331;1008;5;1013
28;76;76332;423;2;425
28;76;76333;464;5;469
28;76;76334;528;19;547
28;76;76335;88;0;88
28;76;76336;377;11;388
28;76;76338;224;1;225
28;76;76339;257;3;260
28;76;76340;523;7;530
28;76;76341;8349;65;8414
28;76;76342;715;17;732
28;76;76343;193;4;197
28;76;76344;407;10;417
28;76;76345;281;2;283
28;76;76346;316;8;324
28;76;76347;356;6;362
28;76;76348;687;8;695
28;76;76349;1891;71;1962
28;76;76350;399;7;406
28;76;76351;168290;1830;170120
28;76;76352;372;3;375
28;76;76353;107;6;113
28;76;76354;1323;14;1337
28;76;76355;950;13;963
28;76;76356;115;2;117
28;76;76357;355;16;371
28;76;76358;247;1;248
28;76;76359;143;2;145
28;76;76360;634;8;642
28;76;76361;715;10;725
28;76;76362;299;7;306
28;76;76363;575;8;583
28;76;76364;272;5;277
28;76;76365;187;0;187
28;76;76366;4107;29;4136
28;76;76367;2907;47;2954
28;76;76368;338;6;344
28;76;76369;534;7;541
28;76;76370;427;3;430
28;76;76371;71;0;71
28;76;76372;410;3;413
28;76;76373;305;6;311
28;76;76374;1234;15;1249
28;76;76375;274;14;288
28;76;76377;3546;72;3618
28;76;76378;1704;34;1738
28;76;76379;192;2;194
28;76;76380;316;8;324
28;76;76381;131;1;132
28;76;76382;1161;13;1174
28;76;76383;96;0;96
28;76;76384;8797;145;8942
28;76;76385;1496;53;1549
28;76;76386;380;6;386
28;76;76387;389;7;396
28;76;76388;472;3;475
28;76;76389;187;7;194
28;76;76390;1106;21;1127
28;76;76391;2338;66;2404
28;76;76392;1264;14;1278
28;76;76393;49;0;49
28;76;76394;630;5;635
28;76;76395;561;11;572
28;76;76396;334;2;336
28;76;76397;992;25;1017
28;76;76398;747;6;753
28;76;76399;196;1;197
28;76;76400;2169;36;2205
28;76;76401;2522;44;2566
28;76;76402;6143;48;6191
28;76;76403;204;3;207
28;76;76404;1228;22;1250
28;76;76405;224;1;225
28;76;76406;421;6;427
28;76;76407;304;8;312
28;76;76408;1035;14;1049
28;76;76409;892;13;905
28;76;76410;10663;135;10798
28;76;76411;233;1;234
28;76;76412;714;11;725
28;76;76413;426;6;432
28;76;76414;1603;51;1654
28;76;76415;334;5;339
28;76;76416;327;5;332
28;76;76417;415;3;418
28;76;76418;1000;20;1020
28;76;76419;164;6;170
28;76;76420;358;6;364
28;76;76421;922;14;936
28;76;76422;266;8;274
28;76;76423;168;2;170
28;76;76424;228;1;229
28;76;76425;293;5;298
28;76;76426;161;1;162
28;76;76427;937;249;1186
28;76;76428;17;3;20
28;76;76429;7886;341;8227
28;76;76430;120;3;123
28;76;76431;97;3;100
28;76;76432;245;4;249
28;76;76433;729;7;736
28;76;76434;1090;7;1097
28;76;76435;793;16;809
28;76;76436;619;4;623
28;76;76437;553;5;558
28;76;76438;244;5;249
28;76;76439;342;9;351
28;76;76440;197;4;201
28;76;76441;633;11;644
28;76;76442;591;9;600
28;76;76443;840;16;856
28;76;76445;600;7;607
28;76;76446;1271;17;1288
28;76;76447;15470;235;15705
28;76;76448;1346;29;1375
28;76;76449;500;8;508
28;76;76450;271;26;297
28;76;76451;19357;375;19732
28;76;76452;4563;51;4614
28;76;76453;1076;20;1096
28;76;76454;83;0;83
28;76;76455;316;5;321
28;76;76456;765;11;776
28;76;76457;928;17;945
28;76;76458;127;3;130
28;76;76459;349;5;354
28;76;76460;513;8;521
28;76;76461;400;5;405
28;76;76462;4678;209;4887
28;76;76463;667;22;689
28;76;76464;2378;37;2415
28;76;76465;571;6;577
28;76;76467;1329;19;1348
28;76;76468;1360;33;1393
28;76;76469;432;5;437
28;76;76470;659;24;683
28;76;76471;1001;27;1028
28;76;76472;774;2;776
28;76;76473;790;10;800
28;76;76474;6978;83;7061
28;76;76475;6105;194;6299
28;76;76476;10248;185;10433
28;76;76477;453;7;460
28;76;76478;186;1;187
28;76;76479;132;1;133
28;76;76480;451;11;462
28;76;76481;6018;122;6140
28;76;76482;3143;228;3371
28;76;76483;227;2;229
28;76;76484;12241;58;12299
28;76;76485;270;46;316
28;76;76486;897;4;901
28;76;76487;314;6;320
28;76;76488;507;16;523
28;76;76489;417;10;427
28;76;76490;1130;13;1143
28;76;76491;662;6;668
28;76;76492;465;16;481
28;76;76493;407;12;419
28;76;76494;585;7;592
28;76;76495;6212;51;6263
28;76;76497;8693;175;8868
28;76;76498;22000;275;22275
28;76;76499;1126;29;1155
28;76;76500;478;4;482
28;76;76501;135;7;142
28;76;76502;551;9;560
28;76;76503;1276;20;1296
28;76;76504;128;2;130
28;76;76505;95;1;96
28;76;76506;488;4;492
28;76;76507;816;15;831
28;76;76508;453;15;468
28;76;76509;1836;31;1867
28;76;76510;237;3;240
28;76;76511;154;1;155
28;76;76512;24;0;24
28;76;76513;589;15;604
28;76;76514;1025;13;1038
28;76;76515;541;14;555
28;76;76516;423;19;442
28;76;76517;3097;88;3185
28;76;76518;504;9;513
28;76;76519;73;4;77
28;76;76520;606;13;619
28;76;76521;147;1;148
28;76;76522;1277;24;1301
28;76;76523;184;3;187
28;76;76524;134;2;136
28;76;76526;180;7;187
28;76;76527;441;3;444
28;76;76528;609;11;620
28;76;76529;294;12;306
28;76;76530;222;5;227
28;76;76531;319;8;327
28;76;76532;793;18;811
28;76;76533;1574;17;1591
28;76;76534;1186;18;1204
28;76;76535;461;8;469
28;76;76536;1209;22;1231
28;76;76537;184;6;190
28;76;76538;266;5;271
28;76;76540;112321;1613;113934
28;76;76541;1524;27;1551
28;76;76542;278;4;282
28;76;76543;605;11;616
28;76;76544;225;8;233
28;76;76545;1809;42;1851
28;76;76546;298;7;305
28;76;76547;780;9;789
28;76;76548;744;15;759
28;76;76549;146;6;152
28;76;76550;1205;24;1229
28;76;76551;850;11;861
28;76;76552;7317;259;7576
28;76;76553;302;5;307
28;76;76554;355;2;357
28;76;76555;833;20;853
28;76;76556;1091;21;1112
28;76;76557;1444;21;1465
28;76;76558;1176;6;1182
28;76;76559;512;8;520
28;76;76560;1024;16;1040
28;76;76561;8429;76;8505
28;76;76562;841;18;859
28;76;76563;1917;14;1931
28;76;76564;165;3;168
28;76;76565;1160;99;1259
28;76;76566;624;5;629
28;76;76567;178;5;183
28;76;76568;606;12;618
28;76;76569;222;4;226
28;76;76570;308;4;312
28;76;76571;692;4;696
28;76;76572;126;5;131
28;76;76573;502;14;516
28;76;76574;693;4;697
28;76;76575;28352;221;28573
28;76;76576;1208;17;1225
28;76;76577;620;13;633
28;76;76578;269;4;273
28;76;76580;904;19;923
28;76;76581;391;9;400
28;76;76582;247;5;252
28;76;76583;342;5;347
28;76;76584;218;5;223
28;76;76585;411;15;426
28;76;76586;652;5;657
28;76;76587;720;9;729
28;76;76588;489;12;501
28;76;76589;199;5;204
28;76;76590;344;2;346
28;76;76591;3045;44;3089
28;76;76592;816;27;843
28;76;76593;610;11;621
28;76;76594;1351;26;1377
28;76;76595;1844;38;1882
28;76;76596;1491;38;1529
28;76;76597;763;9;772
28;76;76598;489;9;498
28;76;76599;3599;49;3648
28;76;76600;1709;34;1743
28;76;76601;233;3;236
28;76;76602;620;12;632
28;76;76603;462;6;468
28;76;76604;179;6;185
28;76;76605;468;13;481
28;76;76606;188;25;213
28;76;76608;2027;33;2060
28;76;76609;364;11;375
28;76;76610;1580;13;1593
28;76;76611;317;9;326
28;76;76612;261;5;266
28;76;76613;651;12;663
28;76;76614;1535;31;1566
28;76;76615;629;24;653
28;76;76616;1469;34;1503
28;76;76617;1660;62;1722
28;76;76618;9628;203;9831
28;76;76619;289;5;294
28;76;76620;273;7;280
28;76;76621;1186;22;1208
28;76;76622;301;10;311
28;76;76623;118;4;122
28;76;76624;3719;60;3779
28;76;76626;417;6;423
28;76;76627;1645;19;1664
28;76;76628;783;13;796
28;76;76629;278;6;284
28;76;76630;225;7;232
28;76;76631;1311;15;1326
28;76;76632;391;3;394
28;76;76634;897;15;912
28;76;76635;72;0;72
28;76;76636;2306;33;2339
28;76;76637;823;12;835
28;76;76638;1091;16;1107
28;76;76640;8283;71;8354
28;76;76641;195;5;200
28;76;76642;265;3;268
28;76;76644;799;16;815
28;76;76645;145;5;150
28;76;76646;604;14;618
28;76;76647;4259;40;4299
28;76;76648;2351;23;2374
28;76;76649;585;11;596
28;76;76650;1229;26;1255
28;76;76651;153;3;156
28;76;76652;763;5;768
28;76;76653;372;3;375
28;76;76654;468;10;478
28;76;76655;3928;163;4091
28;76;76656;767;7;774
28;76;76657;1137;23;1160
28;76;76658;691;21;712
28;76;76660;797;11;808
28;76;76662;111;1;112
28;76;76663;1035;18;1053
28;76;76664;281;5;286
28;76;76665;431;5;436
28;76;76666;411;16;427
28;76;76667;349;6;355
28;76;76668;365;7;372
28;76;76669;430;7;437
28;76;76670;884;11;895
28;76;76671;178;1;179
28;76;76672;979;20;999
28;76;76673;1132;16;1148
28;76;76675;1094;11;1105
28;76;76676;496;11;507
28;76;76677;383;8;391
28;76;76678;828;13;841
28;76;76679;111;1;112
28;76;76680;185;4;189
28;76;76681;29068;445;29513
28;76;76682;758;4;762
28;76;76683;397;10;407
28;76;76684;1250;22;1272
28;76;76685;669;3;672
28;76;76686;541;8;549
28;76;76688;400;14;414
28;76;76689;367;38;405
28;76;76690;639;19;658
28;76;76691;230;1;231
28;76;76692;293;5;298
28;76;76693;687;7;694
28;76;76694;138;3;141
28;76;76695;279;5;284
28;76;76697;796;25;821
28;76;76698;491;7;498
28;76;76699;451;4;455
28;76;76700;1576;31;1607
28;76;76702;838;15;853
28;76;76703;212;8;220
28;76;76705;2493;21;2514
28;76;76706;691;7;698
28;76;76707;1211;39;1250
28;76;76708;702;12;714
28;76;76709;4876;46;4922
28;76;76710;103;2;105
28;76;76711;4582;98;4680
28;76;76712;832;26;858
28;76;76714;769;14;783
28;76;76715;624;8;632
28;76;76716;1462;25;1487
28;76;76717;718;3;721
28;76;76718;1421;37;1458
28;76;76719;858;15;873
28;76;76720;945;33;978
28;76;76721;328;9;337
28;76;76723;438;7;445
28;76;76724;132;2;134
28;76;76725;576;5;581
28;76;76726;322;6;328
28;76;76727;1141;26;1167
28;76;76728;1124;20;1144
28;76;76730;133;2;135
28;76;76731;209;2;211
28;76;76732;242;4;246
28;76;76733;228;4;232
28;76;76734;447;12;459
28;76;76735;550;14;564
28;76;76736;271;6;277
28;76;76737;600;19;619
28;76;76738;757;11;768
28;76;76739;553;6;559
28;76;76740;574;10;584
28;76;76741;286;12;298
28;76;76743;1765;19;1784
28;76;76744;188;2;190
28;76;76745;201;2;203
28;76;76746;222;2;224
28;76;76747;351;3;354
28;76;76748;653;7;660
28;76;76749;342;8;350
28;76;76750;1041;13;1054
28;76;76751;1269;18;1287
28;76;76752;2514;21;2535
28;76;76753;1151;22;1173
28;76;76754;726;15;741
28;76;76755;576;9;585
28;76;76756;240;8;248
28;76;76757;640;7;647
28;76;76758;11448;222;11670
28;76;76759;444;6;450
11;77;77001;1142;29;1171
11;77;77002;826;5;831
11;77;77003;337;17;354
11;77;77004;286;5;291
11;77;77005;3281;45;3326
11;77;77006;979;20;999
11;77;77007;355;7;362
11;77;77008;1225;24;1249
11;77;77009;124;0;124
11;77;77010;935;10;945
11;77;77011;499;6;505
11;77;77012;294;7;301
11;77;77013;359;9;368
11;77;77014;13419;224;13643
11;77;77015;94;2;96
11;77;77016;1623;15;1638
11;77;77018;7416;61;7477
11;77;77019;333;3;336
11;77;77020;645;12;657
11;77;77021;152;2;154
11;77;77022;1207;39;1246
11;77;77023;310;7;317
11;77;77024;382;2;384
11;77;77025;862;8;870
11;77;77026;358;15;373
11;77;77027;1194;15;1209
11;77;77029;192;3;195
11;77;77030;773;5;778
11;77;77031;905;11;916
11;77;77032;921;17;938
11;77;77033;233;8;241
11;77;77034;749;7;756
11;77;77035;548;7;555
11;77;77036;133;3;136
11;77;77037;5913;148;6061
11;77;77038;409;7;416
11;77;77039;1146;11;1157
11;77;77040;3739;41;3780
11;77;77041;280;5;285
11;77;77042;3216;43;3259
11;77;77043;348;7;355
11;77;77044;960;8;968
11;77;77045;722;11;733
11;77;77046;335;10;345
11;77;77047;1680;14;1694
11;77;77048;2763;85;2848
11;77;77049;844;14;858
11;77;77050;541;10;551
11;77;77051;2307;18;2325
11;77;77052;345;5;350
11;77;77053;18812;317;19129
11;77;77054;730;14;744
11;77;77055;4809;10;4819
11;77;77056;148;6;154
11;77;77057;519;3;522
11;77;77058;26597;347;26944
11;77;77059;647;14;661
11;77;77060;732;16;748
11;77;77061;2482;35;2517
11;77;77062;455;10;465
11;77;77063;1267;15;1282
11;77;77065;1238;24;1262
11;77;77066;327;8;335
11;77;77067;10833;145;10978
11;77;77068;214;4;218
11;77;77069;2074;32;2106
11;77;77070;1479;118;1597
11;77;77071;864;12;876
11;77;77072;685;10;695
11;77;77073;560;17;577
11;77;77075;1288;15;1303
11;77;77076;755;54;809
11;77;77077;993;12;1005
11;77;77078;1335;51;1386
11;77;77079;6353;149;6502
11;77;77080;196;1;197
11;77;77081;727;8;735
11;77;77082;815;13;828
11;77;77083;25654;154;25808
11;77;77084;1349;11;1360
11;77;77085;3991;51;4042
11;77;77086;1441;5;1446
11;77;77087;170;0;170
11;77;77088;2384;30;2414
11;77;77089;916;6;922
11;77;77090;241;4;245
11;77;77091;486;3;489
11;77;77093;449;3;452
11;77;77094;299;1;300
11;77;77095;1354;16;1370
11;77;77096;2543;56;2599
11;77;77097;299;2;301
11;77;77098;358;2;360
11;77;77099;2947;56;3003
11;77;77100;4339;67;4406
11;77;77101;1063;11;1074
11;77;77102;163;1;164
11;77;77103;217;2;219
11;77;77104;693;7;700
11;77;77106;1023;17;1040
11;77;77107;3339;26;3365
11;77;77108;55154;294;55448
11;77;77109;1640;26;1666
11;77;77110;312;8;320
11;77;77111;6304;54;6358
11;77;77112;251;4;255
11;77;77113;1088;14;1102
11;77;77114;3927;40;3967
11;77;77115;515;17;532
11;77;77116;1308;18;1326
11;77;77117;953;9;962
11;77;77118;12172;133;12305
11;77;77119;248;3;251
11;77;77120;626;4;630
11;77;77121;3359;43;3402
11;77;77122;21627;150;21777
11;77;77123;815;2;817
11;77;77124;1754;28;1782
11;77;77125;1426;17;1443
11;77;77126;1762;193;1955
11;77;77127;1885;13;1898
11;77;77128;2097;29;2126
11;77;77129;559;9;568
11;77;77130;488;4;492
11;77;77131;14779;239;15018
11;77;77132;2871;28;2899
11;77;77133;199;3;202
11;77;77134;148;3;151
11;77;77135;1294;14;1308
11;77;77136;189;7;196
11;77;77137;239;10;249
11;77;77138;548;5;553
11;77;77139;6698;52;6750
11;77;77140;281;3;284
11;77;77141;1167;11;1178
11;77;77142;4713;67;4780
11;77;77143;5223;51;5274
11;77;77144;429;1;430
11;77;77145;620;12;632
11;77;77146;2026;21;2047
11;77;77147;666;8;674
11;77;77148;1825;24;1849
11;77;77150;455;2;457
11;77;77151;278;4;282
11;77;77152;22128;146;22274
11;77;77153;10355;88;10443
11;77;77154;1135;16;1151
11;77;77155;3417;36;3453
11;77;77156;896;14;910
11;77;77157;311;6;317
11;77;77158;199;2;201
11;77;77159;2775;48;2823
11;77;77161;802;18;820
11;77;77162;1070;8;1078
11;77;77163;367;5;372
11;77;77164;557;6;563
11;77;77165;599;5;604
11;77;77167;323;6;329
11;77;77168;2152;38;2190
11;77;77169;7659;32;7691
11;77;77171;6404;47;6451
11;77;77172;887;9;896
11;77;77173;844;7;851
11;77;77174;582;11;593
11;77;77175;3025;30;3055
11;77;77176;2944;28;2972
11;77;77177;1132;13;1145
11;77;77178;495;11;506
11;77;77179;594;15;609
11;77;77180;1257;27;1284
11;77;77181;3768;35;3803
11;77;77182;4933;48;4981
11;77;77183;9637;85;9722
11;77;77184;622;10;632
11;77;77185;647;17;664
11;77;77186;15696;463;16159
11;77;77187;588;3;591
11;77;77188;998;18;1016
11;77;77190;258;5;263
11;77;77191;1052;13;1065
11;77;77192;5710;57;5767
11;77;77193;233;1;234
11;77;77194;415;17;432
11;77;77195;575;10;585
11;77;77196;971;3;974
11;77;77197;166;3;169
11;77;77198;247;4;251
11;77;77199;1389;11;1400
11;77;77200;117;2;119
11;77;77201;678;4;682
11;77;77202;802;6;808
11;77;77203;1326;21;1347
11;77;77204;211;3;214
11;77;77205;148;1;149
11;77;77206;181;4;185
11;77;77207;153;5;158
11;77;77208;1400;29;1429
11;77;77209;1186;22;1208
11;77;77210;2833;35;2868
11;77;77211;1025;9;1034
11;77;77212;164;3;167
11;77;77214;814;13;827
11;77;77215;8476;69;8545
11;77;77216;1413;35;1448
11;77;77217;2532;30;2562
11;77;77218;108;1;109
11;77;77219;2621;33;2654
11;77;77220;266;5;271
11;77;77221;1144;24;1168
11;77;77222;4296;29;4325
11;77;77223;565;6;571
11;77;77224;253;2;255
11;77;77225;318;7;325
11;77;77226;2545;101;2646
11;77;77227;624;17;641
11;77;77228;256;4;260
11;77;77229;1650;18;1668
11;77;77230;161;2;163
11;77;77231;815;2;817
11;77;77232;1149;17;1166
11;77;77233;589;3;592
11;77;77234;691;7;698
11;77;77235;316;5;321
11;77;77236;345;4;349
11;77;77237;656;9;665
11;77;77238;4349;41;4390
11;77;77239;1509;20;1529
11;77;77240;2171;28;2199
11;77;77241;2003;15;2018
11;77;77242;537;7;544
11;77;77243;21539;225;21764
11;77;77244;681;42;723
11;77;77245;410;4;414
11;77;77246;587;15;602
11;77;77247;447;11;458
11;77;77248;763;8;771
11;77;77249;7151;118;7269
11;77;77250;162;7;169
11;77;77251;13853;94;13947
11;77;77252;561;6;567
11;77;77253;288;1;289
11;77;77254;1285;22;1307
11;77;77255;2181;34;2215
11;77;77256;186;1;187
11;77;77257;3533;21;3554
11;77;77258;14353;65;14418
11;77;77259;2331;11;2342
11;77;77260;1781;25;1806
11;77;77261;1189;20;1209
11;77;77262;490;18;508
11;77;77263;236;7;243
11;77;77264;1526;17;1543
11;77;77265;1112;48;1160
11;77;77266;779;12;791
11;77;77267;360;3;363
11;77;77268;9107;150;9257
11;77;77269;1808;54;1862
11;77;77270;926;11;937
11;77;77271;134;1;135
11;77;77272;862;8;870
11;77;77273;583;4;587
11;77;77274;442;2;444
11;77;77275;148;4;152
11;77;77276;3231;41;3272
11;77;77277;1763;22;1785
11;77;77278;410;6;416
11;77;77279;1814;33;1847
11;77;77280;1114;11;1125
11;77;77281;476;4;480
11;77;77282;361;4;365
11;77;77283;943;4;947
11;77;77284;55750;479;56229
11;77;77285;20917;142;21059
11;77;77286;228;6;234
11;77;77287;496;11;507
11;77;77288;40844;295;41139
11;77;77289;351;3;354
11;77;77290;673;58;731
11;77;77291;1068;5;1073
11;77;77292;1199;11;1210
11;77;77293;926;17;943
11;77;77294;20648;83;20731
11;77;77295;1387;13;1400
11;77;77296;17849;135;17984
11;77;77297;329;4;333
11;77;77298;445;10;455
11;77;77300;604;12;616
11;77;77301;323;1;324
11;77;77302;1958;34;1992
11;77;77303;239;3;242
11;77;77304;25;0;25
11;77;77305;21229;193;21422
11;77;77306;503;6;509
11;77;77307;13517;111;13628
11;77;77308;743;7;750
11;77;77309;1753;10;1763
11;77;77310;305;6;311
11;77;77311;1427;15;1442
11;77;77312;2660;75;2735
11;77;77313;257;2;259
11;77;77314;236;2;238
11;77;77315;3705;31;3736
11;77;77316;12223;333;12556
11;77;77317;5014;36;5050
11;77;77318;1431;22;1453
11;77;77319;145;3;148
11;77;77320;5654;58;5712
11;77;77321;672;4;676
11;77;77322;3160;27;3187
11;77;77323;1477;5;1482
11;77;77325;359;4;363
11;77;77326;6235;71;6306
11;77;77327;8867;86;8953
11;77;77328;429;8;437
11;77;77329;686;3;689
11;77;77330;6225;74;6299
11;77;77331;429;6;435
11;77;77332;286;1;287
11;77;77333;13088;123;13211
11;77;77335;3554;28;3582
11;77;77336;1185;11;1196
11;77;77337;15960;107;16067
11;77;77338;597;8;605
11;77;77339;1827;58;1885
11;77;77340;602;11;613
11;77;77341;381;10;391
11;77;77342;111;1;112
11;77;77343;392;19;411
11;77;77344;2431;23;2454
11;77;77345;666;9;675
11;77;77347;856;10;866
11;77;77348;234;6;240
11;77;77349;6725;76;6801
11;77;77350;20532;194;20726
11;77;77352;1921;22;1943
11;77;77353;425;7;432
11;77;77354;940;8;948
11;77;77355;159;1;160
11;77;77356;45;1;46
11;77;77357;851;10;861
11;77;77358;1315;12;1327
11;77;77359;1980;25;2005
11;77;77360;386;4;390
11;77;77361;463;7;470
11;77;77363;1568;11;1579
11;77;77364;260;2;262
11;77;77365;614;5;619
11;77;77366;292;1;293
11;77;77367;279;4;283
11;77;77368;515;13;528
11;77;77369;724;12;736
11;77;77370;787;12;799
11;77;77371;2966;21;2987
11;77;77372;4183;38;4221
11;77;77373;37617;208;37825
11;77;77374;2186;18;2204
11;77;77376;809;3;812
11;77;77377;2312;29;2341
11;77;77378;2954;20;2974
11;77;77379;12132;285;12417
11;77;77380;320;6;326
11;77;77381;666;5;671
11;77;77382;5439;54;5493
11;77;77383;826;7;833
11;77;77384;1919;3;1922
11;77;77385;2292;24;2316
11;77;77386;614;22;636
11;77;77387;466;8;474
11;77;77388;826;7;833
11;77;77389;3778;105;3883
11;77;77390;22851;82;22933
11;77;77391;489;6;495
11;77;77392;910;12;922
11;77;77393;2808;36;2844
11;77;77394;2831;23;2854
11;77;77395;121;4;125
11;77;77396;98;0;98
11;77;77397;1844;25;1869
11;77;77398;717;8;725
11;77;77400;1729;28;1757
11;77;77401;673;7;680
11;77;77402;338;5;343
11;77;77403;807;17;824
11;77;77404;1826;32;1858
11;77;77405;1969;44;2013
11;77;77406;997;19;1016
11;77;77407;14121;125;14246
11;77;77408;417;2;419
11;77;77409;2707;101;2808
11;77;77410;738;33;771
11;77;77411;553;11;564
11;77;77412;380;5;385
11;77;77413;3770;48;3818
11;77;77414;483;7;490
11;77;77415;1277;18;1295
11;77;77416;238;5;243
11;77;77417;260;1;261
11;77;77418;874;11;885
11;77;77419;3391;117;3508
11;77;77420;3875;26;3901
11;77;77421;265;6;271
11;77;77423;655;9;664
11;77;77424;278;4;282
11;77;77425;737;21;758
11;77;77426;337;9;346
11;77;77427;612;5;617
11;77;77428;834;12;846
11;77;77429;537;5;542
11;77;77430;6110;53;6163
11;77;77431;5394;89;5483
11;77;77432;992;9;1001
11;77;77433;1992;34;2026
11;77;77434;364;5;369
11;77;77435;1107;31;1138
11;77;77436;896;5;901
11;77;77437;3224;29;3253
11;77;77438;6354;73;6427
11;77;77439;1169;23;1192
11;77;77440;1132;13;1145
11;77;77441;2040;47;2087
11;77;77442;2396;60;2456
11;77;77443;389;8;397
11;77;77444;318;2;320
11;77;77445;29987;225;30212
11;77;77446;603;9;612
11;77;77447;1853;48;1901
11;77;77448;522;7;529
11;77;77449;9494;90;9584
11;77;77450;3288;52;3340
11;77;77451;582;6;588
11;77;77452;65;0;65
11;77;77453;1155;14;1169
11;77;77454;376;6;382
11;77;77455;2009;32;2041
11;77;77456;814;19;833
11;77;77457;1179;22;1201
11;77;77458;5383;102;5485
11;77;77459;1504;393;1897
11;77;77460;349;4;353
11;77;77461;295;6;301
11;77;77462;872;2;874
11;77;77463;3420;114;3534
11;77;77464;10454;116;10570
11;77;77465;655;9;664
11;77;77466;381;3;384
11;77;77467;207;0;207
11;77;77468;22030;104;22134
11;77;77469;1221;11;1232
11;77;77470;8521;110;8631
11;77;77471;363;8;371
11;77;77472;504;10;514
11;77;77473;411;7;418
11;77;77474;657;5;662
11;77;77475;5045;32;5077
11;77;77476;233;2;235
11;77;77477;850;30;880
11;77;77478;1097;10;1107
11;77;77479;13368;132;13500
11;77;77480;1048;9;1057
11;77;77481;188;1;189
11;77;77482;3601;70;3671
11;77;77483;2032;22;2054
11;77;77484;276;6;282
11;77;77485;729;14;743
11;77;77486;898;8;906
11;77;77487;11101;159;11260
11;77;77489;232;3;235
11;77;77490;696;9;705
11;77;77492;657;4;661
11;77;77493;3204;21;3225
11;77;77494;2643;37;2680
11;77;77495;8238;82;8320
11;77;77496;189;4;193
11;77;77498;307;0;307
11;77;77500;468;9;477
11;77;77501;719;17;736
11;77;77504;1111;17;1128
11;77;77505;385;5;390
11;77;77506;782;10;792
11;77;77507;410;6;416
11;77;77508;1816;36;1852
11;77;77509;610;7;617
11;77;77510;982;4;986
11;77;77511;645;0;645
11;77;77512;1129;12;1141
11;77;77513;4975;34;5009
11;77;77514;26580;98;26678
11;77;77515;705;5;710
11;77;77516;862;26;888
11;77;77517;2137;13;2150
11;77;77518;208;3;211
11;77;77519;1189;25;1214
11;77;77520;646;20;666
11;77;77521;1935;46;1981
11;77;77522;298;6;304
11;77;77523;261;3;264
11;77;77524;522;6;528
11;77;77525;383;2;385
11;77;77526;277;5;282
11;77;77527;576;17;593
11;77;77528;1154;16;1170
11;77;77529;1494;30;1524
11;77;77530;316;12;328
11;77;77531;1664;23;1687
11;77;77532;66;0;66
11;77;77533;2748;62;2810
11;77;77534;953;1;954
11;78;78003;3490;48;3538
11;78;78005;21529;159;21688
11;78;78006;662;16;678
11;78;78007;1086;49;1135
11;78;78009;293;6;299
11;78;78010;1213;37;1250
11;78;78013;483;4;487
11;78;78015;13302;147;13449
11;78;78020;939;12;951
11;78;78029;12152;64;12216
11;78;78030;1958;47;2005
11;78;78031;649;10;659
11;78;78033;1142;24;1166
11;78;78034;967;19;986
11;78;78036;584;7;591
11;78;78043;3733;140;3873
11;78;78048;1457;41;1498
11;78;78049;1649;46;1695
11;78;78050;641;9;650
11;78;78053;479;12;491
11;78;78057;1883;21;1904
11;78;78062;7618;111;7729
11;78;78068;894;20;914
11;78;78070;288;2;290
11;78;78071;609;9;618
11;78;78072;264;2;266
11;78;78073;15325;143;15468
11;78;78076;275;4;279
11;78;78077;752;57;809
11;78;78082;623;11;634
11;78;78084;653;12;665
11;78;78087;2079;50;2129
11;78;78089;4791;38;4829
11;78;78090;2194;28;2222
11;78;78092;8790;142;8932
11;78;78096;499;9;508
11;78;78104;743;12;755
11;78;78107;1803;26;1829
11;78;78108;1305;29;1334
11;78;78113;696;12;708
11;78;78117;6027;165;6192
11;78;78118;3306;23;3329
11;78;78120;1908;62;1970
11;78;78123;16641;116;16757
11;78;78124;15178;198;15376
11;78;78125;836;31;867
11;78;78126;20692;404;21096
11;78;78128;1559;38;1597
11;78;78133;5587;141;5728
11;78;78138;10426;73;10499
11;78;78140;1335;25;1360
11;78;78143;1423;39;1462
11;78;78146;30153;501;30654
11;78;78147;476;7;483
11;78;78152;1767;76;1843
11;78;78158;31233;638;31871
11;78;78160;5610;136;5746
11;78;78162;545;26;571
11;78;78163;332;4;336
11;78;78164;818;64;882
11;78;78165;17487;235;17722
11;78;78168;4355;31;4386
11;78;78171;1238;27;1265
11;78;78172;35536;410;35946
11;78;78185;366;11;377
11;78;78188;407;6;413
11;78;78189;1671;63;1734
11;78;78190;10031;336;10367
11;78;78192;1375;16;1391
11;78;78193;1022;15;1037
11;78;78194;209;3;212
11;78;78196;293;14;307
11;78;78202;561;8;569
11;78;78206;4150;44;4194
11;78;78208;25624;244;25868
11;78;78209;881;13;894
11;78;78217;6561;94;6655
11;78;78220;6668;136;6804
11;78;78224;4453;185;4638
11;78;78227;793;14;807
11;78;78230;592;8;600
11;78;78231;155;6;161
11;78;78233;2983;141;3124
11;78;78234;183;0;183
11;78;78236;583;14;597
11;78;78237;154;2;156
11;78;78238;2428;30;2458
11;78;78239;2146;30;2176
11;78;78242;13466;141;13607
11;78;78245;377;14;391
11;78;78246;954;19;973
11;78;78255;4266;58;4324
11;78;78261;665;13;678
11;78;78262;1243;18;1261
11;78;78263;2476;64;2540
11;78;78264;57;1;58
11;78;78265;2375;53;2428
11;78;78267;7893;68;7961
11;78;78269;1290;30;1320
11;78;78276;674;5;679
11;78;78278;511;10;521
11;78;78281;625;10;635
11;78;78283;304;10;314
11;78;78285;544;14;558
11;78;78289;900;39;939
11;78;78290;1074;15;1089
11;78;78291;2166;38;2204
11;78;78296;622;11;633
11;78;78297;29471;461;29932
11;78;78299;2495;21;2516
11;78;78300;454;5;459
11;78;78302;166;5;171
11;78;78305;247;6;253
11;78;78307;949;25;974
11;78;78310;3671;41;3712
11;78;78311;32801;346;33147
11;78;78314;3893;46;3939
11;78;78317;796;13;809
11;78;78320;687;15;702
11;78;78321;5772;117;5889
11;78;78322;8049;167;8216
11;78;78324;558;3;561
11;78;78325;605;7;612
11;78;78327;3843;46;3889
11;78;78329;776;12;788
11;78;78334;1600;34;1634
11;78;78335;17136;105;17241
11;78;78337;1937;32;1969
11;78;78343;1629;65;1694
11;78;78344;658;9;667
11;78;78346;1502;24;1526
11;78;78349;504;12;516
11;78;78350;7236;165;7401
11;78;78354;6177;131;6308
11;78;78356;9418;170;9588
11;78;78358;23361;501;23862
11;78;78361;43921;195;44116
11;78;78362;20818;157;20975
11;78;78364;765;9;774
11;78;78366;391;11;402
11;78;78367;3677;168;3845
11;78;78368;1696;36;1732
11;78;78372;16385;499;16884
11;78;78380;5881;221;6102
11;78;78381;1013;15;1028
11;78;78382;4414;53;4467
11;78;78383;17683;248;17931
11;78;78384;1346;45;1391
11;78;78385;212;1;213
11;78;78389;1665;50;1715
11;78;78391;394;7;401
11;78;78396;6285;151;6436
11;78;78397;6777;117;6894
11;78;78398;865;22;887
11;78;78401;9005;76;9081
11;78;78402;3683;40;3723
11;78;78403;2296;35;2331
11;78;78404;269;4;273
11;78;78406;283;12;295
11;78;78407;626;15;641
11;78;78410;979;7;986
11;78;78413;407;3;410
11;78;78415;510;21;531
11;78;78416;316;5;321
11;78;78417;297;7;304
11;78;78418;14991;278;15269
11;78;78420;2935;78;3013
11;78;78423;32282;459;32741
11;78;78431;3023;82;3105
11;78;78437;679;9;688
11;78;78439;109;1;110
11;78;78440;33203;159;33362
11;78;78442;3385;54;3439
11;78;78443;916;19;935
11;78;78444;823;15;838
11;78;78451;1040;15;1055
11;78;78455;7635;285;7920
11;78;78460;1070;20;1090
11;78;78464;1020;23;1043
11;78;78465;2433;68;2501
11;78;78466;6664;199;6863
11;78;78470;883;26;909
11;78;78472;330;6;336
11;78;78474;927;9;936
11;78;78475;379;9;388
11;78;78478;243;7;250
11;78;78481;15716;330;16046
11;78;78484;637;16;653
11;78;78486;6597;113;6710
11;78;78490;30950;353;31303
11;78;78497;916;41;957
11;78;78498;39187;288;39475
11;78;78499;664;19;683
11;78;78501;3174;70;3244
11;78;78502;5481;56;5537
11;78;78505;416;17;433
11;78;78506;882;9;891
11;78;78513;2199;31;2230
11;78;78516;979;16;995
11;78;78517;27141;495;27636
11;78;78518;110;4;114
11;78;78520;1593;25;1618
11;78;78522;907;38;945
11;78;78528;375;3;378
11;78;78530;374;6;380
11;78;78531;6883;46;6929
11;78;78536;357;11;368
11;78;78537;5818;135;5953
11;78;78545;19792;640;20432
11;78;78548;473;13;486
11;78;78550;1850;37;1887
11;78;78551;44806;1843;46649
11;78;78557;948;18;966
11;78;78558;390;8;398
11;78;78559;426;5;431
11;78;78561;447;35;482
11;78;78562;1394;32;1426
11;78;78564;667;9;676
11;78;78565;303;9;312
11;78;78567;928;11;939
11;78;78569;921;19;940
11;78;78571;4920;210;5130
11;78;78575;7806;159;7965
11;78;78576;1621;29;1650
11;78;78586;52774;449;53223
11;78;78588;957;27;984
11;78;78590;499;11;510
11;78;78591;2349;24;2373
11;78;78597;685;8;693
11;78;78601;1600;62;1662
11;78;78605;1042;17;1059
11;78;78606;36;1;37
11;78;78608;123;1;124
11;78;78609;1051;6;1057
11;78;78615;1189;22;1211
11;78;78616;1424;28;1452
11;78;78618;516;14;530
11;78;78620;1166;38;1204
11;78;78621;32645;114;32759
11;78;78623;951;150;1101
11;78;78624;12250;213;12463
11;78;78638;5010;67;5077
11;78;78640;23092;184;23276
11;78;78642;15980;372;16352
11;78;78643;10104;187;10291
11;78;78644;6386;79;6465
11;78;78646;84808;2038;86846
11;78;78647;835;12;847
11;78;78650;15943;553;16496
11;78;78653;377;9;386
11;78;78655;635;26;661
11;78;78668;656;10;666
11;78;78672;5292;167;5459
11;78;78674;11003;205;11208
11;78;78677;509;17;526
11;78;78681;828;17;845
11;78;78683;2906;161;3067
11;78;78686;16752;348;17100
11;78;78688;10835;374;11209
75;79;79001;1052;15;1067
75;79;79002;309;5;314
75;79;79003;5396;170;5566
75;79;79005;3270;47;3317
75;79;79007;666;19;685
75;79;79008;822;7;829
75;79;79009;432;9;441
75;79;79010;612;6;618
75;79;79012;1244;32;1276
75;79;79013;3183;89;3272
75;79;79014;2620;36;2656
75;79;79015;196;5;201
75;79;79016;769;12;781
75;79;79018;184;5;189
75;79;79019;164;1;165
75;79;79020;890;21;911
75;79;79022;193;1;194
75;79;79023;63;1;64
75;79;79024;1982;95;2077
75;79;79025;1125;29;1154
75;79;79029;664;14;678
75;79;79030;973;55;1028
75;79;79031;1768;37;1805
75;79;79032;774;14;788
75;79;79034;1721;65;1786
75;79;79038;1192;28;1220
75;79;79040;236;2;238
75;79;79042;176;6;182
75;79;79046;567;6;573
75;79;79047;453;10;463
75;79;79048;5820;133;5953
75;79;79049;19850;997;20847
75;79;79050;589;16;605
75;79;79055;123;3;126
75;79;79056;740;11;751
75;79;79057;1445;51;1496
75;79;79058;767;17;784
75;79;79059;733;8;741
75;79;79060;178;3;181
75;79;79061;3907;57;3964
75;79;79062;4764;73;4837
75;79;79063;2044;110;2154
75;79;79064;848;24;872
75;79;79066;1734;39;1773
75;79;79069;1012;23;1035
75;79;79070;402;10;412
75;79;79071;469;14;483
75;79;79074;179;5;184
75;79;79076;2034;26;2060
75;79;79077;731;10;741
75;79;79078;965;15;980
75;79;79079;8578;226;8804
75;79;79080;2678;54;2732
75;79;79081;7083;206;7289
75;79;79083;2457;113;2570
75;79;79084;451;3;454
75;79;79085;135;5;140
75;79;79086;1960;42;2002
75;79;79087;559;9;568
75;79;79088;1695;44;1739
75;79;79089;160;1;161
75;79;79090;846;22;868
75;79;79091;947;24;971
75;79;79092;361;4;365
75;79;79094;952;9;961
75;79;79095;586;12;598
75;79;79096;1144;34;1178
75;79;79100;2260;55;2315
75;79;79101;2355;49;2404
75;79;79102;433;3;436
75;79;79103;2421;49;2470
75;79;79104;560;13;573
75;79;79105;473;9;482
75;79;79106;401;2;403
75;79;79108;230;1;231
75;79;79109;3441;99;3540
75;79;79111;289;4;293
75;79;79112;860;24;884
75;79;79114;1578;31;1609
75;79;79115;567;10;577
75;79;79116;1114;17;1131
75;79;79117;648;8;656
75;79;79118;281;6;287
75;79;79119;628;11;639
75;79;79120;762;13;775
75;79;79121;405;10;415
75;79;79122;533;5;538
75;79;79123;2311;49;2360
75;79;79124;112;5;117
75;79;79125;1811;55;1866
75;79;79126;439;10;449
75;79;79127;850;7;857
75;79;79128;953;26;979
75;79;79129;1719;31;1750
75;79;79130;2899;99;2998
75;79;79131;314;7;321
75;79;79132;317;6;323
75;79;79133;1182;23;1205
75;79;79134;571;14;585
75;79;79135;960;23;983
75;79;79136;894;17;911
75;79;79137;903;18;921
75;79;79139;55;2;57
75;79;79140;828;10;838
75;79;79141;208;4;212
75;79;79142;100;2;102
75;79;79144;372;7;379
75;79;79145;368;5;373
75;79;79147;732;9;741
75;79;79148;1982;27;2009
75;79;79149;139;2;141
75;79;79150;819;16;835
75;79;79152;302;6;308
75;79;79153;158;3;161
75;79;79154;400;6;406
75;79;79156;687;25;712
75;79;79157;1320;41;1361
75;79;79158;132;3;135
75;79;79159;526;4;530
75;79;79160;164;3;167
75;79;79161;644;12;656
75;79;79162;2693;65;2758
75;79;79163;519;10;529
75;79;79164;262;4;266
75;79;79165;141;5;146
75;79;79166;877;14;891
75;79;79167;236;11;247
75;79;79170;2891;55;2946
75;79;79172;1026;23;1049
75;79;79174;6173;329;6502
75;79;79175;488;12;500
75;79;79176;861;23;884
75;79;79177;193;4;197
75;79;79179;5057;184;5241
75;79;79180;309;3;312
75;79;79183;373;10;383
75;79;79184;1674;24;1698
75;79;79185;4677;144;4821
75;79;79189;1704;31;1735
75;79;79190;492;3;495
75;79;79191;59193;1834;61027
75;79;79195;5536;119;5655
75;79;79196;2384;53;2437
75;79;79197;91;2;93
75;79;79198;260;3;263
75;79;79200;265;3;268
75;79;79201;1704;20;1724
75;79;79202;10089;400;10489
75;79;79203;367;8;375
75;79;79204;1004;38;1042
75;79;79205;74;3;77
75;79;79207;630;17;647
75;79;79208;1137;38;1175
75;79;79209;330;8;338
75;79;79210;1047;23;1070
75;79;79212;206;3;209
75;79;79213;1992;54;2046
75;79;79215;368;7;375
75;79;79216;2217;40;2257
75;79;79217;950;22;972
75;79;79218;193;6;199
75;79;79220;600;15;615
75;79;79223;62;1;63
75;79;79225;376;6;382
75;79;79226;276;5;281
75;79;79229;553;14;567
75;79;79230;867;11;878
75;79;79231;708;15;723
75;79;79235;1408;42;1450
75;79;79236;652;12;664
75;79;79238;540;21;561
75;79;79239;1714;127;1841
75;79;79241;569;11;580
75;79;79242;1119;20;1139
75;79;79243;279;0;279
75;79;79244;366;4;370
75;79;79246;605;13;618
75;79;79249;2136;63;2199
75;79;79250;400;4;404
75;79;79251;745;29;774
75;79;79252;348;13;361
75;79;79253;694;14;708
75;79;79254;451;13;464
75;79;79255;401;3;404
75;79;79256;233;6;239
75;79;79257;1524;23;1547
75;79;79258;432;13;445
75;79;79259;1372;36;1408
75;79;79263;596;11;607
75;79;79265;1261;24;1285
75;79;79267;326;4;330
75;79;79268;995;40;1035
75;79;79269;414;5;419
75;79;79270;7242;140;7382
75;79;79271;370;2;372
75;79;79273;795;20;815
75;79;79274;292;6;298
75;79;79276;1083;31;1114
75;79;79277;1090;18;1108
75;79;79278;238;6;244
75;79;79280;883;14;897
75;79;79281;1306;36;1342
75;79;79283;1327;31;1358
75;79;79284;782;12;794
75;79;79285;1862;42;1904
75;79;79286;441;7;448
75;79;79289;1444;26;1470
75;79;79290;944;15;959
75;79;79293;1128;25;1153
75;79;79294;167;5;172
75;79;79295;711;18;729
75;79;79297;353;7;360
75;79;79298;1950;56;2006
75;79;79299;2401;49;2450
75;79;79300;1377;30;1407
75;79;79301;627;20;647
75;79;79302;1391;34;1425
75;79;79303;328;12;340
75;79;79304;760;51;811
75;79;79306;188;2;190
75;79;79307;1514;28;1542
75;79;79308;637;10;647
75;79;79309;350;7;357
75;79;79310;501;15;516
75;79;79311;1802;85;1887
75;79;79312;116;3;119
75;79;79313;625;15;640
75;79;79316;431;14;445
75;79;79319;873;28;901
75;79;79320;655;12;667
75;79;79322;2000;56;2056
75;79;79326;1409;27;1436
75;79;79329;13886;344;14230
75;79;79331;124;6;130
75;79;79332;121;4;125
75;79;79334;1076;22;1098
75;79;79335;793;21;814
75;79;79336;226;2;228
75;79;79337;868;26;894
75;79;79338;252;0;252
75;79;79339;1671;29;1700
75;79;79340;324;6;330
75;79;79341;113;1;114
75;79;79342;573;13;586
75;79;79343;211;2;213
75;79;79345;896;32;928
75;79;79346;129;3;132
75;79;79347;1105;21;1126
75;79;79348;222;5;227
75;79;79349;148;2;150
75;79;79350;121;3;124
75;79;79351;1793;31;1824
75;79;79352;157;6;163
75;79;79354;362;10;372
75;79;79355;3345;101;3446
75;79;79357;232;3;235
32;80;80001;22980;410;23390
32;80;80002;266;5;271
32;80;80003;581;11;592
32;80;80004;511;4;515
32;80;80005;84;2;86
32;80;80006;253;4;257
32;80;80008;896;18;914
32;80;80009;997;24;1021
32;80;80010;2833;31;2864
32;80;80011;2952;26;2978
32;80;80013;2383;32;2415
32;80;80014;56;0;56
32;80;80015;64;3;67
32;80;80016;9779;166;9945
32;80;80017;442;6;448
32;80;80018;248;5;253
32;80;80019;787;14;801
32;80;80020;762;18;780
32;80;80021;134706;2674;137380
32;80;80022;264;3;267
32;80;80023;279;4;283
32;80;80024;544;6;550
32;80;80025;327;3;330
32;80;80026;28;0;28
32;80;80027;31;0;31
32;80;80028;157;1;158
32;80;80029;842;25;867
32;80;80030;216;8;224
32;80;80031;775;9;784
32;80;80032;104;0;104
32;80;80033;303;3;306
32;80;80034;588;6;594
32;80;80035;78;1;79
32;80;80036;538;4;542
32;80;80037;153;1;154
32;80;80038;144;3;147
32;80;80039;1397;17;1414
32;80;80040;175;4;179
32;80;80041;147;4;151
32;80;80042;122;2;124
32;80;80043;264;11;275
32;80;80044;408;6;414
32;80;80045;161;2;163
32;80;80046;55;0;55
32;80;80047;521;5;526
32;80;80048;63;3;66
32;80;80049;167;10;177
32;80;80050;485;10;495
32;80;80051;257;3;260
32;80;80052;212;5;217
32;80;80053;70;1;71
32;80;80054;236;5;241
32;80;80055;168;1;169
32;80;80056;96;1;97
32;80;80057;77;3;80
32;80;80058;334;4;338
32;80;80059;77;1;78
32;80;80060;105;0;105
32;80;80061;187;3;190
32;80;80062;1422;17;1439
32;80;80063;988;22;1010
32;80;80064;170;3;173
32;80;80065;89;3;92
32;80;80066;281;6;287
32;80;80067;194;2;196
32;80;80068;220;1;221
32;80;80069;208;0;208
32;80;80070;1325;52;1377
32;80;80071;2036;23;2059
32;80;80073;156;2;158
32;80;80074;130;1;131
32;80;80076;516;4;520
32;80;80077;324;3;327
32;80;80078;511;9;520
32;80;80079;326;4;330
32;80;80080;148;5;153
32;80;80081;90;2;92
32;80;80082;740;8;748
32;80;80083;140;4;144
32;80;80084;213;1;214
32;80;80085;37;2;39
32;80;80086;1058;17;1075
32;80;80087;238;6;244
32;80;80088;353;2;355
32;80;80089;264;1;265
32;80;80090;152;3;155
32;80;80092;686;6;692
32;80;80093;1103;12;1115
32;80;80094;439;11;450
32;80;80095;212;3;215
32;80;80096;942;9;951
32;80;80097;129;3;132
32;80;80098;106;3;109
32;80;80099;226;4;230
32;80;80100;619;4;623
32;80;80101;861;5;866
32;80;80102;383;7;390
32;80;80103;66;0;66
32;80;80104;135;2;137
32;80;80105;168;2;170
32;80;80106;175;3;178
32;80;80107;622;11;633
32;80;80108;73;1;74
32;80;80109;343;3;346
32;80;80110;474;16;490
32;80;80112;240;1;241
32;80;80113;337;7;344
32;80;80114;336;6;342
32;80;80115;282;4;286
32;80;80116;273;3;276
32;80;80117;158;5;163
32;80;80118;116;1;117
32;80;80119;422;8;430
32;80;80120;536;11;547
32;80;80121;156;0;156
32;80;80122;488;15;503
32;80;80123;372;8;380
32;80;80124;704;14;718
32;80;80125;87;0;87
32;80;80126;922;17;939
32;80;80127;832;11;843
32;80;80128;147;3;150
32;80;80129;541;13;554
32;80;80130;427;6;433
32;80;80131;3281;56;3337
32;80;80132;232;3;235
32;80;80133;238;1;239
32;80;80134;79;2;81
32;80;80135;244;4;248
32;80;80136;1275;7;1282
32;80;80137;746;4;750
32;80;80138;125;1;126
32;80;80139;43;0;43
32;80;80140;107;3;110
32;80;80141;329;1;330
32;80;80142;318;4;322
32;80;80143;101;1;102
32;80;80144;497;9;506
32;80;80145;138;0;138
32;80;80146;205;5;210
32;80;80147;326;7;333
32;80;80148;400;5;405
32;80;80149;524;11;535
32;80;80150;222;7;229
32;80;80151;308;4;312
32;80;80152;148;1;149
32;80;80153;131;0;131
32;80;80154;213;7;220
32;80;80155;293;8;301
32;80;80156;398;3;401
32;80;80157;96;5;101
32;80;80158;51;0;51
32;80;80159;280;6;286
32;80;80160;1203;21;1224
32;80;80161;205;7;212
32;80;80162;699;11;710
32;80;80163;761;11;772
32;80;80164;4436;54;4490
32;80;80165;190;1;191
32;80;80166;702;7;709
32;80;80167;330;11;341
32;80;80168;1105;9;1114
32;80;80169;66;0;66
32;80;80170;111;1;112
32;80;80171;599;19;618
32;80;80172;546;7;553
32;80;80173;538;7;545
32;80;80174;79;3;82
32;80;80176;268;4;272
32;80;80177;715;23;738
32;80;80179;219;4;223
32;80;80180;104;1;105
32;80;80181;123;0;123
32;80;80182;2445;31;2476
32;80;80183;264;5;269
32;80;80184;534;5;539
32;80;80185;284;10;294
32;80;80186;2026;22;2048
32;80;80187;650;11;661
32;80;80188;590;7;597
32;80;80189;72;1;73
32;80;80190;1231;17;1248
32;80;80191;174;5;179
32;80;80192;167;2;169
32;80;80193;136;3;139
32;80;80194;139;1;140
32;80;80195;150;1;151
32;80;80196;243;8;251
32;80;80197;31;0;31
32;80;80198;378;4;382
32;80;80199;522;11;533
32;80;80200;223;2;225
32;80;80201;49;2;51
32;80;80202;361;3;364
32;80;80203;87;2;89
32;80;80204;738;12;750
32;80;80205;912;10;922
32;80;80206;117;0;117
32;80;80207;364;2;366
32;80;80208;219;4;223
32;80;80210;146;7;153
32;80;80211;1796;49;1845
32;80;80212;6292;79;6371
32;80;80213;571;170;741
32;80;80214;320;1;321
32;80;80215;220;8;228
32;80;80216;155;1;156
32;80;80217;75;0;75
32;80;80218;144;3;147
32;80;80219;68;1;69
32;80;80220;100;2;102
32;80;80221;305;5;310
32;80;80222;1370;28;1398
32;80;80223;133;0;133
32;80;80224;123;1;124
32;80;80225;193;4;197
32;80;80226;272;5;277
32;80;80227;447;9;456
32;80;80228;1989;33;2022
32;80;80229;340;2;342
32;80;80230;303;8;311
32;80;80231;171;2;173
32;80;80232;229;5;234
32;80;80233;156;1;157
32;80;80234;776;16;792
32;80;80235;1197;18;1215
32;80;80236;575;4;579
32;80;80237;524;11;535
32;80;80238;564;9;573
32;80;80239;53;2;55
32;80;80240;1402;44;1446
32;80;80241;1065;11;1076
32;80;80242;409;9;418
32;80;80243;43;0;43
32;80;80244;174;3;177
32;80;80245;302;3;305
32;80;80246;347;5;352
32;80;80247;715;8;723
32;80;80248;418;6;424
32;80;80249;312;7;319
32;80;80250;351;4;355
32;80;80251;351;8;359
32;80;80252;251;1;252
32;80;80253;5890;172;6062
32;80;80256;1639;10;1649
32;80;80258;87;3;90
32;80;80259;87;1;88
32;80;80260;924;23;947
32;80;80261;1464;61;1525
32;80;80262;392;14;406
32;80;80263;50;1;51
32;80;80264;84;39;123
32;80;80265;569;7;576
32;80;80266;305;0;305
32;80;80267;281;2;283
32;80;80268;530;14;544
32;80;80269;119;2;121
32;80;80270;5;0;5
32;80;80271;1129;14;1143
32;80;80272;124;2;126
32;80;80273;351;5;356
32;80;80274;1789;18;1807
32;80;80275;298;2;300
32;80;80276;286;7;293
32;80;80278;188;3;191
32;80;80279;769;11;780
32;80;80280;123;2;125
32;80;80281;176;1;177
32;80;80282;511;5;516
32;80;80283;166;0;166
32;80;80284;748;36;784
32;80;80285;260;3;263
32;80;80287;239;4;243
32;80;80288;328;10;338
32;80;80290;391;5;396
32;80;80291;272;3;275
32;80;80292;135;1;136
32;80;80293;362;3;365
32;80;80294;159;3;162
32;80;80295;592;7;599
32;80;80296;1182;8;1190
32;80;80297;40;1;41
32;80;80298;529;3;532
32;80;80299;236;1;237
32;80;80300;156;1;157
32;80;80301;274;2;276
32;80;80302;170;3;173
32;80;80303;462;7;469
32;80;80304;100;2;102
32;80;80305;474;12;486
32;80;80306;133;5;138
32;80;80307;153;2;155
32;80;80308;2499;42;2541
32;80;80310;684;12;696
32;80;80311;153;2;155
32;80;80312;279;1;280
32;80;80313;292;5;297
32;80;80314;199;3;202
32;80;80315;508;10;518
32;80;80316;2016;24;2040
32;80;80317;212;3;215
32;80;80318;3237;73;3310
32;80;80319;340;0;340
32;80;80320;156;1;157
32;80;80321;142;2;144
32;80;80322;170;0;170
32;80;80324;145;5;150
32;80;80325;51;1;52
32;80;80326;108;2;110
32;80;80327;158;5;163
32;80;80328;525;5;530
32;80;80329;178;1;179
32;80;80330;237;6;243
32;80;80331;308;12;320
32;80;80332;397;9;406
32;80;80333;1298;13;1311
32;80;80334;96;3;99
32;80;80335;244;3;247
32;80;80336;81;1;82
32;80;80337;204;3;207
32;80;80338;1829;17;1846
32;80;80339;154;4;158
32;80;80340;199;2;201
32;80;80341;401;9;410
32;80;80342;459;3;462
32;80;80343;171;2;173
32;80;80344;182;8;190
32;80;80345;530;5;535
32;80;80346;167;1;168
32;80;80347;156;2;158
32;80;80348;181;4;185
32;80;80349;134;1;135
32;80;80350;506;7;513
32;80;80351;258;2;260
32;80;80352;157;1;158
32;80;80353;151;1;152
32;80;80354;204;3;207
32;80;80355;102;2;104
32;80;80356;90;9;99
32;80;80357;234;6;240
32;80;80358;137;2;139
32;80;80359;287;9;296
32;80;80360;2181;43;2224
32;80;80361;75;0;75
32;80;80362;308;7;315
32;80;80364;703;11;714
32;80;80365;185;0;185
32;80;80366;490;4;494
32;80;80367;180;5;185
32;80;80368;4491;98;4589
32;80;80369;235;5;240
32;80;80371;97;4;101
32;80;80372;124;4;128
32;80;80373;2480;84;2564
32;80;80374;280;3;283
32;80;80375;341;7;348
32;80;80376;652;4;656
32;80;80377;409;5;414
32;80;80378;66;1;67
32;80;80379;826;1;827
32;80;80380;243;5;248
32;80;80381;38;1;39
32;80;80383;92;0;92
32;80;80384;177;1;178
32;80;80385;459;28;487
32;80;80386;179;3;182
32;80;80387;324;1;325
32;80;80388;213;2;215
32;80;80390;411;6;417
32;80;80391;88;0;88
32;80;80392;576;13;589
32;80;80393;312;6;318
32;80;80395;278;5;283
32;80;80396;361;4;365
32;80;80397;93;4;97
32;80;80399;395;4;399
32;80;80400;413;5;418
32;80;80401;130;1;131
32;80;80402;136;1;137
32;80;80403;184;3;187
32;80;80404;142;3;145
32;80;80405;429;2;431
32;80;80406;1302;17;1319
32;80;80407;141;6;147
32;80;80408;334;1;335
32;80;80409;153;5;158
32;80;80410;4559;98;4657
32;80;80411;493;6;499
32;80;80412;638;6;644
32;80;80413;90;1;91
32;80;80414;123;2;125
32;80;80415;1012;8;1020
32;80;80416;770;9;779
32;80;80417;1640;11;1651
32;80;80418;84;0;84
32;80;80420;175;1;176
32;80;80421;294;4;298
32;80;80422;578;10;588
32;80;80423;381;5;386
32;80;80424;540;18;558
32;80;80425;116;1;117
32;80;80426;435;8;443
32;80;80427;376;8;384
32;80;80428;134;2;136
32;80;80429;193;1;194
32;80;80430;201;7;208
32;80;80431;683;11;694
32;80;80432;190;1;191
32;80;80433;44;0;44
32;80;80434;190;4;194
32;80;80435;57;0;57
32;80;80436;522;13;535
32;80;80437;110;4;114
32;80;80438;511;6;517
32;80;80439;167;1;168
32;80;80440;153;3;156
32;80;80442;1178;10;1188
32;80;80443;1681;28;1709
32;80;80444;661;13;674
32;80;80445;272;2;274
32;80;80446;755;20;775
32;80;80449;69;2;71
32;80;80450;112;1;113
32;80;80451;123;0;123
32;80;80452;521;3;524
32;80;80453;142;0;142
32;80;80455;91;2;93
32;80;80456;554;6;560
32;80;80458;451;11;462
32;80;80459;108;0;108
32;80;80460;65;1;66
32;80;80461;216;4;220
32;80;80462;357;11;368
32;80;80463;702;10;712
32;80;80464;918;14;932
32;80;80465;196;5;201
32;80;80466;133;1;134
32;80;80467;194;1;195
32;80;80468;170;3;173
32;80;80469;162;1;163
32;80;80470;164;2;166
32;80;80472;173;7;180
32;80;80473;295;2;297
32;80;80474;396;3;399
32;80;80475;215;7;222
32;80;80476;372;4;376
32;80;80477;222;4;226
32;80;80478;145;2;147
32;80;80479;354;6;360
32;80;80480;113;2;115
32;80;80481;458;5;463
32;80;80482;140;2;142
32;80;80484;388;6;394
32;80;80485;1179;9;1188
32;80;80486;618;8;626
32;80;80487;79;2;81
32;80;80488;1587;29;1616
32;80;80489;5765;45;5810
32;80;80490;273;9;282
32;80;80491;75;1;76
32;80;80493;294;5;299
32;80;80494;201;3;204
32;80;80495;521;4;525
32;80;80496;154;1;155
32;80;80497;118;5;123
32;80;80498;632;5;637
32;80;80499;300;6;306
32;80;80500;531;7;538
32;80;80501;283;3;286
32;80;80502;101;3;104
32;80;80503;186;2;188
32;80;80504;76;0;76
32;80;80505;292;4;296
32;80;80507;1263;19;1282
32;80;80508;51;0;51
32;80;80509;598;6;604
32;80;80511;111;1;112
32;80;80512;836;11;847
32;80;80513;180;3;183
32;80;80514;129;1;130
32;80;80515;144;2;146
32;80;80516;194;1;195
32;80;80517;197;3;200
32;80;80518;425;3;428
32;80;80519;502;7;509
32;80;80520;182;3;185
32;80;80521;211;0;211
32;80;80522;107;0;107
32;80;80523;1259;22;1281
32;80;80524;588;6;594
32;80;80525;179;3;182
32;80;80526;155;3;158
32;80;80527;303;7;310
32;80;80528;9;0;9
32;80;80529;193;4;197
32;80;80530;607;4;611
32;80;80531;102;0;102
32;80;80533;2655;56;2711
32;80;80535;161;5;166
32;80;80536;287;3;290
32;80;80537;89;0;89
32;80;80538;122;0;122
32;80;80540;235;4;239
32;80;80541;198;3;201
32;80;80542;561;6;567
32;80;80543;117;3;120
32;80;80544;184;3;187
32;80;80545;559;7;566
32;80;80546;584;12;596
32;80;80547;205;4;209
32;80;80548;354;2;356
32;80;80549;655;12;667
32;80;80550;130;4;134
32;80;80552;1153;22;1175
32;80;80553;327;10;337
32;80;80554;980;9;989
32;80;80555;601;19;620
32;80;80556;552;6;558
32;80;80557;594;11;605
32;80;80558;223;3;226
32;80;80559;143;3;146
32;80;80560;214;1;215
32;80;80561;6113;105;6218
32;80;80562;206;2;208
32;80;80563;96;1;97
32;80;80565;82;2;84
32;80;80566;341;8;349
32;80;80568;347;4;351
32;80;80569;327;3;330
32;80;80570;3986;28;4014
32;80;80571;497;9;506
32;80;80572;367;2;369
32;80;80573;398;5;403
32;80;80574;95;1;96
32;80;80575;80;8;88
32;80;80576;321;0;321
32;80;80577;183;1;184
32;80;80578;719;11;730
32;80;80579;851;12;863
32;80;80580;250;3;253
32;80;80582;1002;15;1017
32;80;80583;290;8;298
32;80;80584;1078;10;1088
32;80;80585;2314;30;2344
32;80;80586;156;1;157
32;80;80587;82;2;84
32;80;80588;359;7;366
32;80;80589;100;0;100
32;80;80590;321;12;333
32;80;80591;151;1;152
32;80;80592;507;7;514
32;80;80593;254;2;256
32;80;80595;301;1;302
32;80;80596;221;6;227
32;80;80597;852;15;867
32;80;80598;1259;37;1296
32;80;80599;241;3;244
32;80;80600;685;10;695
32;80;80601;373;4;377
32;80;80602;129;3;132
32;80;80603;334;1;335
32;80;80604;80;3;83
32;80;80605;207;2;209
32;80;80606;1148;45;1193
32;80;80607;212;3;215
32;80;80609;408;6;414
32;80;80611;924;11;935
32;80;80613;621;12;633
32;80;80614;317;6;323
32;80;80615;437;3;440
32;80;80616;199;1;200
32;80;80617;231;3;234
32;80;80618;1051;14;1065
32;80;80619;728;8;736
32;80;80620;7577;207;7784
32;80;80621;723;11;734
32;80;80622;1311;16;1327
32;80;80623;371;6;377
32;80;80624;282;5;287
32;80;80625;1516;12;1528
32;80;80626;292;2;294
32;80;80627;829;20;849
32;80;80628;776;4;780
32;80;80629;108;2;110
32;80;80630;2358;39;2397
32;80;80631;98;3;101
32;80;80632;2411;37;2448
32;80;80633;608;10;618
32;80;80634;821;17;838
32;80;80635;1459;22;1481
32;80;80637;288;1;289
32;80;80638;108;6;114
32;80;80639;1236;23;1259
32;80;80640;266;3;269
32;80;80642;321;2;323
32;80;80643;558;8;566
32;80;80644;728;11;739
32;80;80645;556;3;559
32;80;80646;92;4;96
32;80;80647;293;3;296
32;80;80648;121;1;122
32;80;80649;1313;29;1342
32;80;80650;632;17;649
32;80;80651;265;2;267
32;80;80652;780;9;789
32;80;80654;543;18;561
32;80;80655;428;5;433
32;80;80656;1085;10;1095
32;80;80657;322;2;324
32;80;80658;144;3;147
32;80;80659;271;6;277
32;80;80661;1010;7;1017
32;80;80662;284;2;286
32;80;80663;340;7;347
32;80;80664;192;3;195
32;80;80665;123;3;126
32;80;80666;32;0;32
32;80;80667;132;0;132
32;80;80668;168;3;171
32;80;80669;351;6;357
32;80;80670;497;8;505
32;80;80671;234;7;241
32;80;80672;648;12;660
32;80;80673;175;7;182
32;80;80674;3599;34;3633
32;80;80675;127;2;129
32;80;80676;154;7;161
32;80;80677;1593;19;1612
32;80;80678;770;19;789
32;80;80679;591;5;596
32;80;80680;3017;25;3042
32;80;80681;309;8;317
32;80;80682;213;6;219
32;80;80683;103;3;106
32;80;80684;109;4;113
32;80;80685;5693;61;5754
32;80;80686;728;9;737
32;80;80687;133;2;135
32;80;80688;3111;91;3202
32;80;80690;628;9;637
32;80;80691;353;13;366
32;80;80692;1023;18;1041
32;80;80693;327;1;328
32;80;80694;350;6;356
32;80;80695;483;6;489
32;80;80696;1220;32;1252
32;80;80697;32;0;32
32;80;80698;221;4;225
32;80;80699;111;0;111
32;80;80700;878;16;894
32;80;80701;432;10;442
32;80;80702;1309;27;1336
32;80;80703;203;3;206
32;80;80704;382;5;387
32;80;80705;82;1;83
32;80;80706;1854;16;1870
32;80;80707;75;4;79
32;80;80708;155;3;158
32;80;80709;268;8;276
32;80;80710;395;5;400
32;80;80711;1828;15;1843
32;80;80713;281;5;286
32;80;80714;1280;21;1301
32;80;80716;1265;29;1294
32;80;80717;992;7;999
32;80;80718;1341;16;1357
32;80;80719;52;5;57
32;80;80721;2469;41;2510
32;80;80722;488;7;495
32;80;80723;240;1;241
32;80;80724;2805;30;2835
32;80;80725;3918;54;3972
32;80;80726;265;6;271
32;80;80728;75;0;75
32;80;80729;177;0;177
32;80;80730;952;8;960
32;80;80732;628;14;642
32;80;80733;307;3;310
32;80;80734;212;3;215
32;80;80735;167;2;169
32;80;80736;208;5;213
32;80;80737;161;1;162
32;80;80738;126;3;129
32;80;80740;344;2;346
32;80;80741;190;4;194
32;80;80742;65;2;67
32;80;80743;192;4;196
32;80;80744;57;2;59
32;80;80746;1069;12;1081
32;80;80747;136;3;139
32;80;80748;185;3;188
32;80;80749;317;4;321
32;80;80750;146;1;147
32;80;80751;580;6;586
32;80;80752;678;8;686
32;80;80753;124;2;126
32;80;80754;399;4;403
32;80;80755;147;4;151
32;80;80756;63;0;63
32;80;80757;146;2;148
32;80;80758;207;0;207
32;80;80759;349;9;358
32;80;80760;378;10;388
32;80;80762;346;10;356
32;80;80763;344;8;352
32;80;80764;296;7;303
32;80;80765;809;10;819
32;80;80766;439;5;444
32;80;80767;258;6;264
32;80;80769;232;0;232
32;80;80770;538;9;547
32;80;80771;33;0;33
32;80;80773;104;0;104
32;80;80774;291;3;294
32;80;80775;632;6;638
32;80;80776;218;1;219
32;80;80777;139;1;140
32;80;80778;127;0;127
32;80;80779;848;19;867
32;80;80780;406;5;411
32;80;80781;225;5;230
32;80;80782;418;7;425
32;80;80783;84;1;85
32;80;80784;306;6;312
32;80;80785;544;9;553
32;80;80786;149;0;149
32;80;80787;95;1;96
32;80;80788;173;2;175
32;80;80789;152;0;152
32;80;80790;169;3;172
32;80;80791;732;6;738
32;80;80792;246;1;247
32;80;80793;2338;34;2372
32;80;80794;57;1;58
32;80;80795;469;42;511
32;80;80796;182;6;188
32;80;80797;138;3;141
32;80;80798;1435;53;1488
32;80;80799;4592;56;4648
32;80;80800;143;7;150
32;80;80801;330;4;334
32;80;80802;557;9;566
32;80;80803;275;0;275
32;80;80804;179;5;184
32;80;80805;159;6;165
32;80;80806;471;8;479
32;80;80807;266;3;269
32;80;80808;498;9;507
32;80;80809;477;12;489
32;80;80810;135;1;136
32;80;80811;591;7;598
32;80;80812;139;3;142
32;80;80813;97;3;100
32;80;80814;449;9;458
32;80;80815;836;26;862
32;80;80819;84;3;87
32;80;80820;753;10;763
32;80;80821;220;5;225
32;80;80822;143;2;145
32;80;80823;134;10;144
32;80;80824;270;2;272
32;80;80825;115;1;116
32;80;80826;791;17;808
32;80;80827;1239;14;1253
32;80;80828;67;0;67
32;80;80829;91;2;93
32;80;80830;245;5;250
32;80;80832;305;4;309
32;80;80833;123;2;125
32;80;80834;514;42;556
32;80;80835;269;0;269
32;80;80836;220;7;227
76;81;81001;226;9;235
76;81;81002;2512;57;2569
76;81;81003;928;36;964
76;81;81004;48902;1723;50625
76;81;81005;518;5;523
76;81;81006;198;3;201
76;81;81007;95;2;97
76;81;81008;294;4;298
76;81;81009;68;0;68
76;81;81010;467;6;473
76;81;81011;1010;40;1050
76;81;81012;121;1;122
76;81;81013;406;8;414
76;81;81014;502;8;510
76;81;81015;73;1;74
76;81;81016;165;7;172
76;81;81017;160;1;161
76;81;81018;2512;50;2562
76;81;81019;143;1;144
76;81;81020;271;12;283
76;81;81021;5827;135;5962
76;81;81022;203;7;210
76;81;81023;208;2;210
76;81;81024;363;9;372
76;81;81025;244;9;253
76;81;81026;703;7;710
76;81;81027;158;2;160
76;81;81028;103;1;104
76;81;81029;186;5;191
76;81;81030;111;1;112
76;81;81031;821;18;839
76;81;81032;1135;19;1154
76;81;81033;2946;186;3132
76;81;81034;387;7;394
76;81;81035;218;7;225
76;81;81036;1267;22;1289
76;81;81037;1305;33;1338
76;81;81038;2341;64;2405
76;81;81039;2040;30;2070
76;81;81040;427;11;438
76;81;81041;121;1;122
76;81;81042;2053;41;2094
76;81;81043;736;13;749
76;81;81044;303;4;307
76;81;81045;369;9;378
76;81;81046;1529;45;1574
76;81;81047;225;7;232
76;81;81048;2578;32;2610
76;81;81049;350;3;353
76;81;81050;342;10;352
76;81;81051;1158;20;1178
76;81;81052;2128;56;2184
76;81;81053;334;10;344
76;81;81054;939;28;967
76;81;81055;349;1;350
76;81;81056;157;2;159
76;81;81058;230;7;237
76;81;81059;669;15;684
76;81;81060;9782;156;9938
76;81;81061;191;2;193
76;81;81062;935;18;953
76;81;81063;1621;38;1659
76;81;81064;1041;25;1066
76;81;81065;42079;1470;43549
76;81;81066;280;6;286
76;81;81067;469;16;485
76;81;81068;153;6;159
76;81;81069;822;39;861
76;81;81070;2939;54;2993
76;81;81071;79;3;82
76;81;81072;134;3;137
76;81;81073;177;1;178
76;81;81074;1607;62;1669
76;81;81075;502;11;513
76;81;81076;698;20;718
76;81;81077;399;10;409
76;81;81078;1028;18;1046
76;81;81079;803;33;836
76;81;81080;71;2;73
76;81;81081;1311;36;1347
76;81;81082;111;1;112
76;81;81083;246;1;247
76;81;81084;614;21;635
76;81;81085;45;1;46
76;81;81086;173;3;176
76;81;81087;357;10;367
76;81;81088;554;14;568
76;81;81089;136;5;141
76;81;81090;253;6;259
76;81;81092;926;15;941
76;81;81093;682;46;728
76;81;81094;93;3;96
76;81;81095;83;1;84
76;81;81096;410;5;415
76;81;81097;1328;35;1363
76;81;81098;701;20;721
76;81;81099;15265;323;15588
76;81;81100;402;10;412
76;81;81101;1270;18;1288
76;81;81102;271;14;285
76;81;81103;134;7;141
76;81;81104;1506;36;1542
76;81;81105;12844;245;13089
76;81;81106;618;11;629
76;81;81108;168;1;169
76;81;81109;438;7;445
76;81;81110;96;3;99
76;81;81111;77;0;77
76;81;81112;937;24;961
76;81;81114;513;12;525
76;81;81115;1414;25;1439
76;81;81116;1937;46;1983
76;81;81117;753;22;775
76;81;81118;152;4;156
76;81;81119;489;6;495
76;81;81120;6506;114;6620
76;81;81121;298;1;299
76;81;81122;81;2;83
76;81;81123;95;3;98
76;81;81124;2464;77;2541
76;81;81125;310;8;318
76;81;81126;179;8;187
76;81;81127;109;7;116
76;81;81128;1590;35;1625
76;81;81129;232;5;237
76;81;81130;1818;35;1853
76;81;81131;2213;41;2254
76;81;81132;825;12;837
76;81;81133;504;13;517
76;81;81134;58;0;58
76;81;81135;96;0;96
76;81;81136;153;3;156
76;81;81137;87;1;88
76;81;81138;550;9;559
76;81;81139;1731;51;1782
76;81;81140;10879;426;11305
76;81;81141;149;5;154
76;81;81142;889;14;903
76;81;81143;731;13;744
76;81;81144;4574;91;4665
76;81;81145;4676;84;4760
76;81;81146;230;5;235
76;81;81147;1139;14;1153
76;81;81148;75;6;81
76;81;81149;421;15;436
76;81;81150;424;13;437
76;81;81151;128;6;134
76;81;81152;319;3;322
76;81;81154;76;1;77
76;81;81156;3395;79;3474
76;81;81157;312;11;323
76;81;81158;265;6;271
76;81;81159;405;18;423
76;81;81160;372;8;380
76;81;81161;108;1;109
76;81;81162;162;2;164
76;81;81163;9996;422;10418
76;81;81164;509;12;521
76;81;81165;247;3;250
76;81;81166;91;3;94
76;81;81167;105;1;106
76;81;81168;1046;22;1068
76;81;81169;98;1;99
76;81;81170;1358;13;1371
76;81;81171;1513;32;1545
76;81;81172;59;0;59
76;81;81173;319;7;326
76;81;81174;623;6;629
76;81;81175;441;5;446
76;81;81176;104;5;109
76;81;81177;493;6;499
76;81;81178;367;13;380
76;81;81179;280;8;288
76;81;81180;249;9;258
76;81;81181;190;4;194
76;81;81182;1987;42;2029
76;81;81183;188;6;194
76;81;81184;35;0;35
76;81;81185;237;3;240
76;81;81186;262;5;267
76;81;81187;211;3;214
76;81;81188;316;3;319
76;81;81189;126;2;128
76;81;81190;534;9;543
76;81;81191;236;1;237
76;81;81192;862;12;874
76;81;81193;338;4;342
76;81;81195;691;23;714
76;81;81196;850;21;871
76;81;81197;213;4;217
76;81;81198;329;4;333
76;81;81199;189;3;192
76;81;81200;433;52;485
76;81;81201;840;20;860
76;81;81202;960;18;978
76;81;81203;559;8;567
76;81;81204;2170;37;2207
76;81;81205;193;9;202
76;81;81206;586;19;605
76;81;81207;78;29;107
76;81;81208;594;11;605
76;81;81209;2775;79;2854
76;81;81210;261;7;268
76;81;81211;495;10;505
76;81;81212;125;4;129
76;81;81213;89;2;91
76;81;81214;101;1;102
76;81;81215;638;9;647
76;81;81216;213;3;216
76;81;81217;452;11;463
76;81;81218;3510;80;3590
76;81;81219;3160;72;3232
76;81;81220;5713;146;5859
76;81;81221;236;1;237
76;81;81222;3480;58;3538
76;81;81223;54;0;54
76;81;81224;101;0;101
76;81;81225;1064;30;1094
76;81;81227;2187;46;2233
76;81;81228;458;10;468
76;81;81229;131;4;135
76;81;81230;731;14;745
76;81;81231;378;7;385
76;81;81232;626;13;639
76;81;81233;1717;27;1744
76;81;81234;86;3;89
76;81;81235;723;28;751
76;81;81236;254;8;262
76;81;81237;186;3;189
76;81;81238;1527;123;1650
76;81;81239;877;12;889
76;81;81240;101;4;105
76;81;81242;260;3;263
76;81;81243;133;2;135
76;81;81244;2094;34;2128
76;81;81245;124;6;130
76;81;81246;111;2;113
76;81;81247;208;3;211
76;81;81248;889;20;909
76;81;81249;925;13;938
76;81;81250;281;9;290
76;81;81251;932;18;950
76;81;81252;145;1;146
76;81;81253;456;7;463
76;81;81254;376;5;381
76;81;81255;532;12;544
76;81;81256;76;1;77
76;81;81257;6694;103;6797
76;81;81258;439;16;455
76;81;81259;223;1;224
76;81;81261;1121;18;1139
76;81;81262;213;2;215
76;81;81263;390;11;401
76;81;81264;90;2;92
76;81;81265;77;1;78
76;81;81266;1084;28;1112
76;81;81267;618;12;630
76;81;81268;75;4;79
76;81;81269;510;8;518
76;81;81270;167;3;170
76;81;81271;9336;268;9604
76;81;81272;217;1;218
76;81;81273;3602;72;3674
76;81;81274;836;18;854
76;81;81275;195;2;197
76;81;81276;1223;19;1242
76;81;81277;596;9;605
76;81;81278;161;2;163
76;81;81279;261;8;269
76;81;81280;262;7;269
76;81;81281;2008;55;2063
76;81;81282;34;0;34
76;81;81283;1115;33;1148
76;81;81284;1917;29;1946
76;81;81285;487;2;489
76;81;81286;612;20;632
76;81;81287;264;2;266
76;81;81288;2903;64;2967
76;81;81289;2622;41;2663
76;81;81290;165;2;167
76;81;81291;504;6;510
76;81;81292;531;18;549
76;81;81293;356;3;359
76;81;81294;1002;18;1020
76;81;81295;441;6;447
76;81;81297;1229;29;1258
76;81;81298;483;13;496
76;81;81299;382;16;398
76;81;81300;98;2;100
76;81;81302;52;1;53
76;81;81303;410;4;414
76;81;81304;184;4;188
76;81;81305;738;19;757
76;81;81306;840;23;863
76;81;81307;857;18;875
76;81;81308;1299;27;1326
76;81;81309;303;15;318
76;81;81310;163;4;167
76;81;81311;759;20;779
76;81;81312;1009;173;1182
76;81;81313;229;6;235
76;81;81314;531;39;570
76;81;81315;1421;48;1469
76;81;81316;226;3;229
76;81;81317;1248;30;1278
76;81;81318;141;2;143
76;81;81319;493;14;507
76;81;81320;149;5;154
76;81;81321;89;1;90
76;81;81322;245;6;251
76;81;81323;360;6;366
76;81;81324;226;5;231
76;81;81325;1968;39;2007
76;81;81326;386;13;399
76;82;82001;627;18;645
76;82;82002;3294;58;3352
76;82;82003;249;5;254
76;82;82004;135;0;135
76;82;82005;1504;20;1524
76;82;82006;84;2;86
76;82;82007;144;1;145
76;82;82008;914;42;956
76;82;82009;40;2;42
76;82;82010;260;5;265
76;82;82011;941;14;955
76;82;82012;564;8;572
76;82;82013;3773;174;3947
76;82;82014;257;6;263
76;82;82015;149;4;153
76;82;82016;215;2;217
76;82;82017;1487;25;1512
76;82;82018;1148;30;1178
76;82;82019;751;17;768
76;82;82020;594;14;608
76;82;82021;193;3;196
76;82;82022;382;10;392
76;82;82023;959;11;970
76;82;82024;248;3;251
76;82;82025;3697;104;3801
76;82;82026;600;9;609
76;82;82027;1405;23;1428
76;82;82028;793;11;804
76;82;82029;281;3;284
76;82;82030;491;4;495
76;82;82031;1222;17;1239
76;82;82032;542;13;555
76;82;82033;14114;323;14437
76;82;82034;108;3;111
76;82;82035;335;9;344
76;82;82036;135;2;137
76;82;82037;6808;202;7010
76;82;82038;1473;28;1501
76;82;82039;555;22;577
76;82;82040;280;9;289
76;82;82041;233;3;236
76;82;82042;1192;21;1213
76;82;82043;269;10;279
76;82;82044;1647;50;1697
76;82;82045;354;6;360
76;82;82046;114;0;114
76;82;82047;51;0;51
76;82;82048;1650;14;1664
76;82;82049;1034;13;1047
76;82;82050;1208;24;1232
76;82;82051;841;90;931
76;82;82052;1114;106;1220
76;82;82053;288;3;291
76;82;82054;382;7;389
76;82;82055;255;8;263
76;82;82056;173;4;177
76;82;82057;658;15;673
76;82;82058;100;2;102
76;82;82059;290;10;300
76;82;82060;194;4;198
76;82;82061;142;2;144
76;82;82062;1546;19;1565
76;82;82063;679;13;692
76;82;82064;121;0;121
76;82;82065;409;10;419
76;82;82066;609;13;622
76;82;82067;107;1;108
76;82;82068;240;6;246
76;82;82069;202;6;208
76;82;82070;73;2;75
76;82;82071;37;2;39
76;82;82072;1014;27;1041
76;82;82073;937;31;968
76;82;82074;133;5;138
76;82;82075;4177;56;4233
76;82;82076;1587;35;1622
76;82;82077;400;5;405
76;82;82078;128;0;128
76;82;82079;3783;80;3863
76;82;82080;1143;27;1170
76;82;82081;194;2;196
76;82;82082;196;5;201
76;82;82083;118;1;119
76;82;82084;168;5;173
76;82;82085;1239;11;1250
76;82;82086;221;3;224
76;82;82087;2835;65;2900
76;82;82088;604;13;617
76;82;82089;1167;18;1185
76;82;82090;1052;28;1080
76;82;82091;126;3;129
76;82;82092;284;4;288
76;82;82093;693;8;701
76;82;82094;1454;17;1471
76;82;82095;217;13;230
76;82;82096;3148;44;3192
76;82;82097;1619;18;1637
76;82;82098;1269;28;1297
76;82;82099;529;7;536
76;82;82100;132;7;139
76;82;82101;1199;17;1216
76;82;82102;294;4;298
76;82;82103;107;6;113
76;82;82104;186;5;191
76;82;82105;1342;18;1360
76;82;82106;137;1;138
76;82;82107;46;1;47
76;82;82108;1360;29;1389
76;82;82109;201;13;214
76;82;82110;1037;18;1055
76;82;82111;316;9;325
76;82;82112;13378;319;13697
76;82;82113;1182;25;1207
76;82;82114;645;7;652
76;82;82115;2004;18;2022
76;82;82116;194;4;198
76;82;82117;1302;25;1327
76;82;82118;100;1;101
76;82;82119;654;18;672
76;82;82120;295;5;300
76;82;82121;61372;1460;62832
76;82;82122;183;3;186
76;82;82123;1474;22;1496
76;82;82124;4241;87;4328
76;82;82125;6589;127;6716
76;82;82126;1359;102;1461
76;82;82127;758;19;777
76;82;82128;106;3;109
76;82;82129;145;4;149
76;82;82130;166;1;167
76;82;82131;1590;41;1631
76;82;82132;1186;27;1213
76;82;82133;93;1;94
76;82;82134;5685;81;5766
76;82;82135;1340;18;1358
76;82;82136;1754;34;1788
76;82;82137;570;11;581
76;82;82138;162;2;164
76;82;82139;121;3;124
76;82;82140;444;3;447
76;82;82141;546;4;550
76;82;82142;1544;20;1564
76;82;82143;85;0;85
76;82;82144;746;11;757
76;82;82145;379;8;387
76;82;82146;60;2;62
76;82;82147;331;8;339
76;82;82148;694;25;719
76;82;82149;1879;32;1911
76;82;82150;862;24;886
76;82;82151;401;9;410
76;82;82152;398;11;409
76;82;82153;226;1;227
76;82;82154;212;5;217
76;82;82155;1851;46;1897
76;82;82156;148;3;151
76;82;82157;96;2;98
76;82;82158;147;6;153
76;82;82159;557;17;574
76;82;82160;264;8;272
76;82;82161;3901;78;3979
76;82;82162;261;7;268
76;82;82163;49;0;49
76;82;82164;126;3;129
76;82;82165;531;4;535
76;82;82166;276;3;279
76;82;82167;1875;41;1916
76;82;82168;323;3;326
76;82;82169;2296;30;2326
76;82;82170;566;18;584
76;82;82171;1414;24;1438
76;82;82172;278;8;286
76;82;82173;1155;14;1169
76;82;82174;285;2;287
76;82;82175;277;4;281
76;82;82176;856;13;869
76;82;82177;160;3;163
76;82;82178;811;17;828
76;82;82179;2238;50;2288
76;82;82180;526;8;534
76;82;82181;207;4;211
76;82;82182;339;3;342
76;82;82183;238;10;248
76;82;82184;896;10;906
76;82;82185;248;6;254
76;82;82186;5205;153;5358
76;82;82187;654;13;667
76;82;82188;632;14;646
76;82;82189;743;14;757
76;82;82190;4808;67;4875
76;82;82191;416;3;419
76;82;82192;522;14;536
76;82;82193;137;3;140
76;82;82194;1368;35;1403
76;82;82195;779;13;792
93;83;83001;2784;74;2858
93;83;83002;270;5;275
93;83;83003;913;24;937
93;83;83004;7066;174;7240
93;83;83005;288;6;294
93;83;83006;283;8;291
93;83;83007;2284;37;2321
93;83;83008;2862;59;2921
93;83;83009;8403;145;8548
93;83;83010;225;1;226
93;83;83011;1334;21;1355
93;83;83012;2990;39;3029
93;83;83013;208;1;209
93;83;83014;235;9;244
93;83;83015;321;4;325
93;83;83016;9845;175;10020
93;83;83017;2423;30;2453
93;83;83018;3038;44;3082
93;83;83019;8162;117;8279
93;83;83020;41;1;42
93;83;83021;2629;52;2681
93;83;83022;25;0;25
93;83;83023;17361;345;17706
93;83;83025;1419;22;1441
93;83;83026;1951;36;1987
93;83;83027;5574;98;5672
93;83;83028;1948;39;1987
93;83;83029;3341;61;3402
93;83;83030;1897;47;1944
93;83;83031;4279;59;4338
93;83;83032;3380;81;3461
93;83;83033;3525;36;3561
93;83;83034;9518;163;9681
93;83;83035;3873;42;3915
93;83;83036;7586;86;7672
93;83;83037;1483;55;1538
93;83;83038;477;15;492
93;83;83039;147;14;161
93;83;83040;79;1;80
93;83;83041;720;12;732
93;83;83042;11311;238;11549
93;83;83043;1874;89;1963
93;83;83044;328;5;333
93;83;83045;906;8;914
93;83;83046;2111;39;2150
93;83;83047;18774;428;19202
93;83;83048;3779;96;3875
93;83;83049;11962;139;12101
93;83;83050;39433;911;40344
93;83;83051;1118;23;1141
93;83;83052;371;5;376
93;83;83053;2416;51;2467
93;83;83054;9614;118;9732
93;83;83055;5735;85;5820
93;83;83056;2623;53;2676
93;83;83057;3564;67;3631
93;83;83058;4247;104;4351
93;83;83059;3101;47;3148
93;83;83060;458;4;462
93;83;83061;54458;843;55301
93;83;83062;25505;313;25818
93;83;83063;1847;42;1889
93;83;83064;5303;99;5402
93;83;83065;2614;55;2669
93;83;83066;1874;35;1909
93;83;83067;4329;60;4389
93;83;83068;4562;60;4622
93;83;83069;54821;977;55798
93;83;83070;5985;60;6045
93;83;83071;10641;135;10776
93;83;83072;9054;292;9346
93;83;83073;11094;112;11206
93;83;83074;204;5;209
93;83;83075;631;8;639
93;83;83076;868;13;881
93;83;83077;2226;20;2246
93;83;83078;290;7;297
93;83;83079;1461;25;1486
93;83;83080;806;15;821
93;83;83081;6548;132;6680
93;83;83082;1527;22;1549
93;83;83083;1420;26;1446
93;83;83084;533;3;536
93;83;83085;2804;52;2856
93;83;83086;9288;249;9537
93;83;83087;4835;85;4920
93;83;83088;2828;68;2896
93;83;83089;650;23;673
93;83;83090;13866;253;14119
93;83;83091;6068;105;6173
93;83;83092;4588;47;4635
93;83;83093;2187;27;2214
93;83;83094;3048;52;3100
93;83;83095;737;18;755
93;83;83096;1574;22;1596
93;83;83097;5181;91;5272
93;83;83098;10277;149;10426
93;83;83099;8062;108;8170
93;83;83100;4357;51;4408
93;83;83101;2115;48;2163
93;83;83102;2642;16;2658
93;83;83103;3962;59;4021
93;83;83104;4278;85;4363
93;83;83105;49;0;49
93;83;83106;5250;68;5318
93;83;83107;14937;191;15128
93;83;83108;2203;41;2244
93;83;83109;256;0;256
93;83;83110;1662;30;1692
93;83;83111;2048;25;2073
93;83;83112;11484;241;11725
93;83;83113;2402;41;2443
93;83;83114;247;4;251
93;83;83115;14448;224;14672
93;83;83116;17095;497;17592
93;83;83117;1757;42;1799
93;83;83118;36027;601;36628
93;83;83119;3851;71;3922
93;83;83120;6051;83;6134
93;83;83121;3761;77;3838
93;83;83122;226;4;230
93;83;83123;16889;271;17160
93;83;83124;2669;33;2702
93;83;83125;2492;38;2530
93;83;83126;62987;762;63749
93;83;83127;2927;44;2971
93;83;83128;745;55;800
93;83;83129;34592;562;35154
93;83;83130;11762;184;11946
93;83;83131;5753;108;5861
93;83;83132;2526;46;2572
93;83;83133;1671;33;1704
93;83;83134;1784;33;1817
93;83;83135;1405;16;1421
93;83;83136;2552;47;2599
93;83;83137;178745;1896;180641
93;83;83138;2877;51;2928
93;83;83139;585;15;600
93;83;83140;5042;71;5113
93;83;83141;5947;134;6081
93;83;83142;203;5;208
93;83;83143;4292;95;4387
93;83;83144;24087;259;24346
93;83;83145;1176;15;1191
93;83;83146;1603;13;1616
93;83;83147;9;0;9
93;83;83148;12616;144;12760
93;83;83149;1466;28;1494
93;83;83150;4248;88;4336
93;83;83151;963;15;978
93;83;83152;667;13;680
93;83;83153;6095;68;6163
93;83;83154;722;14;736
93;84;84001;2851;46;2897
93;84;84002;1046;25;1071
93;84;84003;11037;221;11258
93;84;84004;5778;94;5872
93;84;84005;193;2;195
93;84;84006;70;4;74
93;84;84007;91143;1678;92821
93;84;84008;639;50;689
93;84;84009;1614;95;1709
93;84;84010;873;22;895
93;84;84011;355;9;364
93;84;84012;2389;48;2437
93;84;84013;280;4;284
93;84;84014;1134;16;1150
93;84;84015;296;5;301
93;84;84016;5316;76;5392
93;84;84017;3093;68;3161
93;84;84018;518;8;526
93;84;84019;13439;232;13671
93;84;84020;1206;23;1229
93;84;84021;90;3;93
93;84;84022;277;12;289
93;84;84023;87;3;90
93;84;84024;957;14;971
93;84;84025;1835;37;1872
93;84;84026;4201;77;4278
93;84;84027;2651;47;2698
93;84;84028;1084;20;1104
93;84;84029;4542;111;4653
93;84;84030;3399;58;3457
93;84;84031;29236;713;29949
93;84;84032;493;8;501
93;84;84033;120;0;120
93;84;84034;4914;99;5013
93;84;84035;26236;412;26648
93;84;84036;3321;75;3396
93;84;84037;2055;30;2085
93;84;84038;4290;75;4365
93;84;84039;6026;76;6102
93;84;84040;416;16;432
93;84;84041;475;20;495
93;84;84042;1771;32;1803
93;84;84043;8595;123;8718
93;84;84044;1134;33;1167
93;84;84045;450;8;458
93;84;84046;478;14;492
93;84;84047;3078;49;3127
93;84;84048;71;1;72
93;84;84049;434;10;444
93;84;84050;1670;34;1704
93;84;84051;1100;27;1127
93;84;84052;1226;29;1255
93;84;84053;1749;31;1780
93;84;84054;20042;493;20535
93;84;84055;1550;37;1587
93;84;84056;5469;63;5532
93;84;84057;347;5;352
93;84;84058;423;7;430
93;84;84059;121;1;122
93;84;84060;32;1;33
93;84;84061;327;13;340
93;84;84062;1641;33;1674
93;84;84063;395;1;396
93;84;84064;3830;79;3909
93;84;84065;3879;69;3948
93;84;84066;291;4;295
93;84;84067;2520;55;2575
93;84;84068;1040;22;1062
93;84;84069;2785;60;2845
93;84;84070;1887;24;1911
93;84;84071;1920;48;1968
93;84;84072;6201;158;6359
93;84;84073;1002;17;1019
93;84;84074;2189;37;2226
93;84;84075;442;8;450
93;84;84076;1344;39;1383
93;84;84077;465;7;472
93;84;84078;3736;63;3799
93;84;84079;282;5;287
93;84;84080;12935;226;13161
93;84;84081;8786;130;8916
93;84;84082;1864;49;1913
93;84;84083;2438;47;2485
93;84;84084;1371;41;1412
93;84;84085;418;6;424
93;84;84086;1295;27;1322
93;84;84087;28772;665;29437
93;84;84088;10170;287;10457
93;84;84089;20557;309;20866
93;84;84090;673;15;688
93;84;84091;5394;95;5489
93;84;84092;17041;136;17177
93;84;84093;819;21;840
93;84;84094;580;12;592
93;84;84095;830;14;844
93;84;84096;803;20;823
93;84;84097;537;81;618
93;84;84098;634;9;643
93;84;84099;4631;75;4706
93;84;84100;52;0;52
93;84;84101;416;13;429
93;84;84102;1289;31;1320
93;84;84103;661;20;681
93;84;84104;1349;32;1381
93;84;84105;929;22;951
93;84;84106;2591;53;2644
93;84;84107;1401;20;1421
93;84;84108;1996;41;2037
93;84;84109;167;9;176
93;84;84110;33;0;33
93;84;84111;327;11;338
93;84;84112;728;6;734
93;84;84113;815;17;832
93;84;84114;189;3;192
93;84;84115;509;12;521
93;84;84116;783;21;804
93;84;84117;330;7;337
93;84;84118;2877;71;2948
93;84;84119;4935;113;5048
93;84;84120;118;1;119
93;84;84121;265;0;265
93;84;84122;6128;78;6206
93;84;84123;1361;23;1384
93;84;84124;946;16;962
93;84;84125;61;0;61
93;84;84126;856;23;879
93;84;84127;2853;81;2934
93;84;84128;46;1;47
93;84;84129;18893;234;19127
93;84;84130;113;3;116
93;84;84131;1921;40;1961
93;84;84132;8940;177;9117
93;84;84133;4334;138;4472
93;84;84134;711;13;724
93;84;84135;1666;51;1717
93;84;84136;1240;31;1271
93;84;84137;5908;129;6037
93;84;84138;9403;230;9633
93;84;84139;579;16;595
93;84;84140;558;19;577
93;84;84141;11383;368;11751
93;84;84142;2976;54;3030
93;84;84143;1013;18;1031
93;84;84144;641;18;659
93;84;84145;781;14;795
93;84;84146;489;14;503
93;84;84147;3356;86;3442
93;84;84148;1284;34;1318
93;84;84149;1710;33;1743
93;84;84150;1956;57;2013
93;84;84151;164;5;169
52;85;85001;2061;35;2096
52;85;85002;2024;24;2048
52;85;85003;9881;198;10079
52;85;85004;2878;34;2912
52;85;85005;1054;21;1075
52;85;85006;1854;13;1867
52;85;85008;6880;104;6984
52;85;85009;1165;24;1189
52;85;85010;1423;20;1443
52;85;85011;1723;52;1775
52;85;85012;2179;48;2227
52;85;85013;1460;28;1488
52;85;85014;1149;27;1176
52;85;85015;1514;21;1535
52;85;85016;2252;30;2282
52;85;85017;2442;49;2491
52;85;85018;3880;60;3940
52;85;85019;6095;123;6218
52;85;85020;4014;75;4089
52;85;85021;1868;35;1903
52;85;85022;1239;18;1257
52;85;85023;439;9;448
52;85;85024;2048;34;2082
52;85;85025;2272;52;2324
52;85;85026;1417;18;1435
52;85;85028;595;8;603
52;85;85029;2156;36;2192
52;85;85031;3227;43;3270
52;85;85033;731;19;750
52;85;85034;3403;101;3504
52;85;85035;5066;89;5155
52;85;85036;573;11;584
52;85;85037;590;16;606
52;85;85038;2816;44;2860
52;85;85039;4028;61;4089
52;85;85040;1128;24;1152
52;85;85041;296;12;308
52;85;85042;1883;24;1907
52;85;85045;1083;14;1097
52;85;85046;3799;58;3857
52;85;85047;21322;773;22095
52;85;85049;1783;16;1799
52;85;85050;1857;22;1879
52;85;85051;8394;471;8865
52;85;85053;260;3;263
52;85;85054;900;7;907
52;85;85055;935;18;953
52;85;85056;391;9;400
52;85;85058;735;20;755
52;85;85059;2586;36;2622
52;85;85061;1506;33;1539
52;85;85062;1114;20;1134
52;85;85064;2469;33;2502
52;85;85065;3552;101;3653
52;85;85066;834;17;851
52;85;85067;994;21;1015
52;85;85070;3285;37;3322
52;85;85071;3605;57;3662
52;85;85072;1018;11;1029
52;85;85073;1014;16;1030
52;85;85074;224;3;227
52;85;85076;3563;90;3653
52;85;85077;538;8;546
52;85;85078;741;17;758
52;85;85080;1731;33;1764
52;85;85081;4344;114;4458
52;85;85082;2914;57;2971
52;85;85083;1633;40;1673
52;85;85084;9174;166;9340
52;85;85086;1637;15;1652
52;85;85087;198;4;202
52;85;85088;4854;136;4990
52;85;85089;5315;157;5472
52;85;85090;6423;255;6678
52;85;85092;13235;724;13959
52;85;85093;1224;22;1246
52;85;85094;1157;30;1187
52;85;85095;1942;21;1963
52;85;85096;5114;100;5214
52;85;85097;3111;67;3178
52;85;85098;1982;37;2019
52;85;85099;1097;23;1120
52;85;85100;2230;52;2282
52;85;85101;489;5;494
52;85;85102;692;9;701
52;85;85103;2229;31;2260
52;85;85104;895;11;906
52;85;85105;529;13;542
52;85;85106;1320;35;1355
52;85;85108;3297;110;3407
52;85;85109;16250;485;16735
52;85;85110;924;14;938
52;85;85111;1501;23;1524
52;85;85112;2783;59;2842
52;85;85113;4850;138;4988
52;85;85114;2665;31;2696
52;85;85115;600;11;611
52;85;85116;461;6;467
52;85;85117;621;19;640
52;85;85118;2363;50;2413
52;85;85119;2403;42;2445
52;85;85120;1449;36;1485
52;85;85121;993;31;1024
52;85;85123;280;4;284
52;85;85125;400;4;404
52;85;85126;1341;50;1391
52;85;85127;2405;26;2431
52;85;85128;9554;386;9940
52;85;85129;3522;72;3594
52;85;85130;1589;20;1609
52;85;85131;1486;40;1526
52;85;85132;749;13;762
52;85;85133;921;23;944
52;85;85134;243;10;253
52;85;85135;2792;122;2914
52;85;85136;123;1;124
52;85;85137;480;14;494
52;85;85138;1171;12;1183
52;85;85139;445;14;459
52;85;85140;1502;43;1545
52;85;85141;675;13;688
52;85;85142;1014;23;1037
52;85;85143;1047;20;1067
52;85;85144;1504;27;1531
52;85;85145;957;17;974
52;85;85146;20424;634;21058
52;85;85147;1641;50;1691
52;85;85148;814;23;837
52;85;85149;413;5;418
52;85;85151;6059;168;6227
52;85;85152;5271;108;5379
52;85;85153;2922;46;2968
52;85;85154;1806;92;1898
52;85;85155;4971;123;5094
52;85;85156;2212;34;2246
52;85;85157;761;12;773
52;85;85158;1194;27;1221
52;85;85159;2310;47;2357
52;85;85160;2912;45;2957
52;85;85161;2549;26;2575
52;85;85162;2094;51;2145
52;85;85163;4550;106;4656
52;85;85164;2149;47;2196
52;85;85167;787;17;804
52;85;85169;1106;17;1123
52;85;85171;608;23;631
52;85;85172;2056;34;2090
52;85;85174;687;18;705
52;85;85175;660;3;663
52;85;85176;1160;36;1196
52;85;85177;1383;22;1405
52;85;85178;8596;220;8816
52;85;85179;1158;11;1169
52;85;85181;644;17;661
52;85;85182;5557;204;5761
52;85;85184;321;7;328
52;85;85185;657;6;663
52;85;85186;999;15;1014
52;85;85187;862;15;877
52;85;85188;1097;22;1119
52;85;85189;2156;44;2200
52;85;85190;3400;47;3447
52;85;85191;55147;2956;58103
52;85;85192;988;9;997
52;85;85193;645;17;662
52;85;85194;45030;1433;46463
52;85;85196;1892;16;1908
52;85;85197;3761;58;3819
52;85;85198;1344;18;1362
52;85;85199;542;6;548
52;85;85200;1082;21;1103
52;85;85201;493;6;499
52;85;85202;1597;114;1711
52;85;85204;2586;43;2629
52;85;85205;528;8;536
52;85;85206;394;13;407
52;85;85207;389;8;397
52;85;85208;2376;37;2413
52;85;85209;642;9;651
52;85;85210;2135;25;2160
52;85;85211;2439;25;2464
52;85;85213;4217;171;4388
52;85;85214;2378;47;2425
52;85;85215;3814;139;3953
52;85;85216;2058;213;2271
52;85;85218;1696;15;1711
52;85;85220;1598;27;1625
52;85;85221;2697;36;2733
52;85;85222;7862;250;8112
52;85;85223;2940;62;3002
52;85;85226;11297;204;11501
52;85;85227;1921;52;1973
52;85;85229;585;12;597
52;85;85231;790;15;805
52;85;85232;1079;23;1102
52;85;85233;604;9;613
52;85;85234;8696;226;8922
52;85;85235;421;13;434
52;85;85236;1872;21;1893
52;85;85237;378;12;390
52;85;85238;3689;441;4130
52;85;85239;1124;5;1129
52;85;85240;1615;50;1665
52;85;85242;999;20;1019
52;85;85243;2817;49;2866
52;85;85244;821;58;879
52;85;85245;171;2;173
52;85;85246;2483;39;2522
52;85;85247;1082;18;1100
52;85;85248;416;12;428
52;85;85250;2323;35;2358
52;85;85251;632;18;650
52;85;85252;593;24;617
52;85;85254;1755;44;1799
52;85;85255;2341;80;2421
52;85;85256;1287;32;1319
52;85;85259;1328;35;1363
52;85;85260;826;11;837
52;85;85261;278;12;290
52;85;85262;3535;39;3574
52;85;85264;1331;20;1351
52;85;85265;940;21;961
52;85;85266;1662;29;1691
52;85;85267;934;18;952
52;85;85268;1459;31;1490
52;85;85269;419;7;426
52;85;85271;436;13;449
52;85;85273;1879;35;1914
52;85;85274;532;12;544
52;85;85276;759;13;772
52;85;85277;1535;25;1560
52;85;85278;1312;22;1334
52;85;85280;3171;71;3242
52;85;85281;987;30;1017
52;85;85282;912;16;928
52;85;85284;4259;95;4354
52;85;85285;740;13;753
52;85;85286;561;5;566
52;85;85287;458;8;466
52;85;85288;7831;185;8016
52;85;85289;1327;26;1353
52;85;85290;553;13;566
52;85;85291;1231;20;1251
52;85;85292;778;10;788
52;85;85293;1576;38;1614
52;85;85294;2904;65;2969
52;85;85295;3280;82;3362
52;85;85296;1246;24;1270
52;85;85297;986;15;1001
52;85;85298;1744;31;1775
52;85;85300;4628;178;4806
52;85;85301;1772;22;1794
52;85;85302;5453;130;5583
52;85;85303;1809;30;1839
52;85;85304;753;10;763
52;85;85305;880;49;929
52;85;85306;732;9;741
52;85;85307;665;8;673
75;86;86001;714;8;722
75;86;86002;580;20;600
75;86;86003;338;7;345
75;86;86004;347;14;361
75;86;86005;617;23;640
75;86;86006;546;19;565
75;86;86007;1163;32;1195
75;86;86008;343;6;349
75;86;86009;1070;17;1087
75;86;86010;1119;19;1138
75;86;86011;180;4;184
75;86;86012;164;8;172
75;86;86013;97;3;100
75;86;86014;1740;42;1782
75;86;86015;1244;26;1270
75;86;86016;2200;40;2240
75;86;86017;1104;17;1121
75;86;86018;321;2;323
75;86;86019;2958;43;3001
75;86;86020;253;4;257
75;86;86022;259;4;263
75;86;86023;280;6;286
75;86;86024;1553;24;1577
75;86;86025;474;5;479
75;86;86026;546;5;551
75;86;86027;1832;62;1894
75;86;86028;1067;18;1085
75;86;86029;780;24;804
75;86;86031;1729;20;1749
75;86;86032;2079;99;2178
75;86;86034;601;13;614
75;86;86035;185;6;191
75;86;86036;885;20;905
75;86;86037;507;6;513
75;86;86038;219;8;227
75;86;86039;733;9;742
75;86;86040;314;11;325
75;86;86041;10060;139;10199
75;86;86042;919;12;931
75;86;86044;548;11;559
75;86;86045;1351;17;1368
75;86;86046;1737;29;1766
75;86;86047;485;13;498
75;86;86048;1153;12;1165
75;86;86049;501;16;517
75;86;86050;843;13;856
75;86;86051;197;4;201
75;86;86052;995;20;1015
75;86;86053;1961;36;1997
75;86;86054;352;5;357
75;86;86055;356;12;368
75;86;86058;726;20;746
75;86;86059;581;4;585
75;86;86061;1128;25;1153
75;86;86062;4692;51;4743
75;86;86063;249;1;250
75;86;86064;613;10;623
75;86;86065;1045;16;1061
75;86;86066;31487;799;32286
75;86;86068;1211;17;1228
75;86;86069;180;4;184
75;86;86070;7062;114;7176
75;86;86072;454;9;463
75;86;86073;528;11;539
75;86;86074;915;15;930
75;86;86075;750;19;769
75;86;86076;2835;48;2883
75;86;86077;1209;17;1226
75;86;86078;2596;137;2733
75;86;86079;560;36;596
75;86;86080;493;5;498
75;86;86081;1438;30;1468
75;86;86082;4455;116;4571
75;86;86083;1132;13;1145
75;86;86084;235;5;240
75;86;86085;249;6;255
75;86;86086;954;17;971
75;86;86087;185;4;189
75;86;86088;865;24;889
75;86;86089;391;6;397
75;86;86090;216;1;217
75;86;86091;387;7;394
75;86;86092;2969;58;3027
75;86;86093;156;3;159
75;86;86094;573;12;585
75;86;86095;3255;50;3305
75;86;86096;659;9;668
75;86;86097;328;5;333
75;86;86098;141;2;143
75;86;86099;1054;9;1063
75;86;86100;3934;74;4008
75;86;86102;583;8;591
75;86;86103;1746;65;1811
75;86;86104;497;5;502
75;86;86105;369;1;370
75;86;86106;98;2;100
75;86;86107;467;8;475
75;86;86108;402;12;414
75;86;86109;220;8;228
75;86;86110;227;4;231
75;86;86111;1744;35;1779
75;86;86112;1165;12;1177
75;86;86113;2966;49;3015
75;86;86114;1279;23;1302
75;86;86115;7600;255;7855
75;86;86116;783;17;800
75;86;86117;525;7;532
75;86;86118;373;9;382
75;86;86119;302;1;303
75;86;86120;1217;16;1233
75;86;86121;1458;27;1485
75;86;86122;67;3;70
75;86;86123;3073;52;3125
75;86;86124;1185;19;1204
75;86;86125;596;13;609
75;86;86126;644;13;657
75;86;86127;465;3;468
75;86;86128;2457;31;2488
75;86;86129;527;8;535
75;86;86130;382;4;386
75;86;86131;883;24;907
75;86;86132;310;3;313
75;86;86133;3374;59;3433
75;86;86134;221;1;222
75;86;86135;573;11;584
75;86;86136;391;8;399
75;86;86137;6712;351;7063
75;86;86138;250;3;253
75;86;86139;2659;38;2697
75;86;86140;2294;50;2344
75;86;86141;674;14;688
75;86;86142;642;12;654
75;86;86143;169;5;174
75;86;86144;328;8;336
75;86;86145;1228;15;1243
75;86;86147;605;12;617
75;86;86148;712;12;724
75;86;86149;376;9;385
75;86;86150;274;7;281
75;86;86151;174;8;182
75;86;86152;583;15;598
75;86;86153;862;13;875
75;86;86154;263;4;267
75;86;86156;239;4;243
75;86;86157;5026;176;5202
75;86;86158;6154;117;6271
75;86;86159;552;14;566
75;86;86160;2171;34;2205
75;86;86161;998;19;1017
75;86;86162;110;1;111
75;86;86163;3677;61;3738
75;86;86164;665;5;670
75;86;86165;5940;459;6399
75;86;86167;909;7;916
75;86;86169;348;5;353
75;86;86170;367;12;379
75;86;86171;441;14;455
75;86;86172;162;4;166
75;86;86173;661;12;673
75;86;86174;5941;119;6060
75;86;86175;312;12;324
75;86;86176;123;5;128
75;86;86177;5359;84;5443
75;86;86178;2757;38;2795
75;86;86180;2847;52;2899
75;86;86181;208;5;213
75;86;86182;378;9;387
75;86;86183;1606;21;1627
75;86;86184;939;11;950
75;86;86186;952;23;975
75;86;86187;458;14;472
75;86;86189;475;6;481
75;86;86190;737;14;751
75;86;86191;248;7;255
75;86;86192;174;4;178
75;86;86193;1217;13;1230
75;86;86194;89212;2275;91487
75;86;86195;571;11;582
75;86;86196;234;5;239
75;86;86197;416;11;427
75;86;86198;692;9;701
75;86;86200;572;12;584
75;86;86201;212;2;214
75;86;86202;599;10;609
75;86;86203;547;11;558
75;86;86204;2160;56;2216
75;86;86205;200;3;203
75;86;86206;138;5;143
75;86;86207;1560;31;1591
75;86;86209;2034;32;2066
75;86;86210;753;20;773
75;86;86211;905;92;997
75;86;86213;2496;185;2681
75;86;86214;7267;247;7514
75;86;86217;290;12;302
75;86;86218;198;8;206
75;86;86220;313;8;321
75;86;86221;1205;22;1227
75;86;86222;4233;56;4289
75;86;86223;915;25;940
75;86;86224;1327;32;1359
75;86;86225;1408;29;1437
75;86;86226;2779;49;2828
75;86;86227;133;4;137
75;86;86228;198;3;201
75;86;86229;338;5;343
75;86;86230;174;4;178
75;86;86231;485;17;502
75;86;86233;2749;43;2792
75;86;86234;385;5;390
75;86;86235;1299;36;1335
75;86;86236;885;16;901
75;86;86237;769;20;789
75;86;86239;172;0;172
75;86;86241;391;6;397
75;86;86242;394;7;401
75;86;86244;1255;24;1279
75;86;86245;1795;43;1838
75;86;86246;826;16;842
75;86;86247;534;13;547
75;86;86248;536;16;552
75;86;86249;125;6;131
75;86;86250;290;5;295
75;86;86252;651;14;665
75;86;86253;550;11;561
75;86;86254;1005;11;1016
75;86;86255;1337;27;1364
75;86;86256;1187;25;1212
75;86;86257;373;5;378
75;86;86258;2242;31;2273
75;86;86260;311;1;312
75;86;86261;2236;77;2313
75;86;86262;593;15;608
75;86;86263;2892;44;2936
75;86;86264;753;17;770
75;86;86265;428;7;435
75;86;86266;142;2;144
75;86;86268;1118;17;1135
75;86;86269;191;3;194
75;86;86270;151;3;154
75;86;86271;814;14;828
75;86;86272;2858;151;3009
75;86;86273;859;23;882
75;86;86274;1097;24;1121
75;86;86275;601;9;610
75;86;86276;1251;22;1273
75;86;86279;532;6;538
75;86;86280;358;5;363
75;86;86281;5578;88;5666
75;86;86284;714;21;735
75;86;86285;969;25;994
75;86;86286;389;4;393
75;86;86287;357;6;363
75;86;86288;607;7;614
75;86;86289;676;30;706
75;86;86290;1555;35;1590
75;86;86291;102;7;109
75;86;86292;920;18;938
75;86;86293;4409;75;4484
75;86;86294;3683;73;3756
75;86;86295;391;5;396
75;86;86296;471;7;478
75;86;86297;6060;142;6202
75;86;86298;2264;31;2295
75;86;86299;575;9;584
75;86;86300;602;5;607
75;87;87001;5804;78;5882
75;87;87002;5593;74;5667
75;87;87003;936;26;962
75;87;87004;109;2;111
75;87;87005;1008;20;1028
75;87;87006;246;1;247
75;87;87007;196;3;199
75;87;87008;147;0;147
75;87;87009;142;5;147
75;87;87011;3639;127;3766
75;87;87012;437;5;442
75;87;87013;651;16;667
75;87;87014;2803;57;2860
75;87;87015;702;73;775
75;87;87016;282;6;288
75;87;87017;499;11;510
75;87;87018;696;24;720
75;87;87019;2926;63;2989
75;87;87020;1651;27;1678
75;87;87021;2616;34;2650
75;87;87022;120;1;121
75;87;87023;188;4;192
75;87;87024;814;9;823
75;87;87025;848;12;860
75;87;87027;1282;16;1298
75;87;87028;1646;22;1668
75;87;87029;629;11;640
75;87;87030;1257;23;1280
75;87;87031;310;4;314
75;87;87032;1640;29;1669
75;87;87033;791;9;800
75;87;87034;566;8;574
75;87;87035;530;9;539
75;87;87036;669;11;680
75;87;87037;262;2;264
75;87;87038;2102;18;2120
75;87;87039;800;13;813
75;87;87040;1523;20;1543
75;87;87041;2042;21;2063
75;87;87042;388;6;394
75;87;87043;204;2;206
75;87;87044;323;6;329
75;87;87045;1002;13;1015
75;87;87046;1188;9;1197
75;87;87047;1854;16;1870
75;87;87048;5128;73;5201
75;87;87049;1317;34;1351
75;87;87050;9518;161;9679
75;87;87051;624;12;636
75;87;87052;180;1;181
75;87;87053;244;2;246
75;87;87054;1192;18;1210
75;87;87056;275;3;278
75;87;87057;369;5;374
75;87;87058;107;3;110
75;87;87059;1586;64;1650
75;87;87060;671;9;680
75;87;87061;346;5;351
75;87;87062;457;8;465
75;87;87063;1316;22;1338
75;87;87064;2077;24;2101
75;87;87065;6118;78;6196
75;87;87066;1075;11;1086
75;87;87067;466;9;475
75;87;87068;517;16;533
75;87;87069;140;1;141
75;87;87070;975;17;992
75;87;87071;780;18;798
75;87;87072;507;10;517
75;87;87073;388;9;397
75;87;87074;246;2;248
75;87;87075;7847;151;7998
75;87;87076;235;3;238
75;87;87077;527;9;536
75;87;87078;695;5;700
75;87;87079;839;12;851
75;87;87080;179;3;182
75;87;87081;1106;14;1120
75;87;87082;1165;12;1177
75;87;87083;543;7;550
75;87;87084;165;4;169
75;87;87085;130876;2260;133136
75;87;87086;1030;16;1046
75;87;87087;488;3;491
75;87;87088;1106;20;1126
75;87;87089;1711;168;1879
75;87;87090;265;5;270
75;87;87091;384;7;391
75;87;87092;500;6;506
75;87;87093;281;3;284
75;87;87094;527;5;532
75;87;87095;733;13;746
75;87;87096;847;20;867
75;87;87097;1025;12;1037
75;87;87099;337;16;353
75;87;87100;268;2;270
75;87;87101;119;1;120
75;87;87103;1614;25;1639
75;87;87104;456;4;460
75;87;87105;923;17;940
75;87;87106;2509;45;2554
75;87;87107;1635;18;1653
75;87;87108;461;5;466
75;87;87109;329;34;363
75;87;87110;2477;22;2499
75;87;87111;1490;20;1510
75;87;87112;576;13;589
75;87;87113;6023;64;6087
75;87;87114;10900;212;11112
75;87;87115;173;2;175
75;87;87116;1044;24;1068
75;87;87117;1027;16;1043
75;87;87118;1278;13;1291
75;87;87119;1161;11;1172
75;87;87120;504;11;515
75;87;87121;488;11;499
75;87;87122;1173;13;1186
75;87;87123;149;4;153
75;87;87124;373;2;375
75;87;87125;4608;65;4673
75;87;87126;3767;51;3818
75;87;87127;604;13;617
75;87;87128;1327;13;1340
75;87;87129;955;7;962
75;87;87130;172;0;172
75;87;87131;812;12;824
75;87;87132;110;4;114
75;87;87133;496;4;500
75;87;87134;155;3;158
75;87;87135;960;18;978
75;87;87137;129;2;131
75;87;87138;571;14;585
75;87;87139;460;8;468
75;87;87140;1682;17;1699
75;87;87141;683;10;693
75;87;87142;541;7;548
75;87;87143;2170;27;2197
75;87;87144;518;5;523
75;87;87145;237;1;238
75;87;87146;1159;13;1172
75;87;87147;47;2;49
75;87;87148;990;12;1002
75;87;87149;374;8;382
75;87;87150;849;14;863
75;87;87151;500;9;509
75;87;87152;1658;23;1681
75;87;87153;291;0;291
75;87;87154;11254;277;11531
75;87;87155;179;7;186
75;87;87156;2670;46;2716
75;87;87157;843;34;877
75;87;87158;1439;14;1453
75;87;87159;350;3;353
75;87;87160;495;4;499
75;87;87161;4385;115;4500
75;87;87162;204;2;206
75;87;87163;140;4;144
75;87;87164;568;10;578
75;87;87165;137;1;138
75;87;87166;930;16;946
75;87;87167;553;5;558
75;87;87168;1079;14;1093
75;87;87169;1052;25;1077
75;87;87170;351;7;358
75;87;87172;216;5;221
75;87;87174;1227;23;1250
75;87;87176;667;12;679
75;87;87177;1790;19;1809
75;87;87178;2888;32;2920
75;87;87179;241;0;241
75;87;87180;577;4;581
75;87;87181;825;17;842
75;87;87182;1203;17;1220
75;87;87183;919;10;929
75;87;87185;1774;29;1803
75;87;87186;320;4;324
75;87;87187;6718;432;7150
75;87;87188;432;3;435
75;87;87189;139;1;140
75;87;87190;870;7;877
75;87;87191;1989;23;2012
75;87;87192;1583;24;1607
75;87;87193;44;3;47
75;87;87194;347;3;350
75;87;87195;135;1;136
75;87;87197;565;9;574
75;87;87198;413;5;418
75;87;87199;734;13;747
75;87;87200;129;0;129
75;87;87201;4881;217;5098
75;87;87202;2112;35;2147
75;87;87203;1327;27;1354
75;87;87204;204;4;208
75;87;87205;2236;40;2276
75;87;87206;159;1;160
44;88;88001;58;0;58
44;88;88002;75;0;75
44;88;88003;62;1;63
44;88;88004;133;6;139
44;88;88005;203;4;207
44;88;88006;290;8;298
44;88;88007;48;1;49
44;88;88008;168;3;171
44;88;88009;3368;68;3436
44;88;88010;198;1;199
44;88;88011;1634;53;1687
44;88;88012;1105;13;1118
44;88;88013;86;0;86
44;88;88014;183;5;188
44;88;88015;206;3;209
44;88;88016;212;9;221
44;88;88017;166;6;172
44;88;88019;149;3;152
44;88;88020;188;5;193
44;88;88021;283;12;295
44;88;88022;234;6;240
44;88;88023;81;2;83
44;88;88024;114;0;114
44;88;88025;69;3;72
44;88;88026;1009;48;1057
44;88;88027;144;6;150
44;88;88028;618;95;713
44;88;88029;1609;126;1735
44;88;88030;147;0;147
44;88;88031;99;4;103
44;88;88032;1199;33;1232
44;88;88033;350;7;357
44;88;88035;145;6;151
44;88;88036;96;2;98
44;88;88037;871;27;898
44;88;88038;36;0;36
44;88;88039;331;7;338
44;88;88040;250;5;255
44;88;88041;109;8;117
44;88;88042;80;1;81
44;88;88043;110;3;113
44;88;88044;603;16;619
44;88;88045;87;0;87
44;88;88046;130;4;134
44;88;88047;148;7;155
44;88;88048;981;26;1007
44;88;88049;113;2;115
44;88;88050;303;5;308
44;88;88051;133;1;134
44;88;88052;97;2;99
44;88;88053;161;2;163
44;88;88054;306;10;316
44;88;88055;164;0;164
44;88;88056;96;2;98
44;88;88057;92;6;98
44;88;88058;97;5;102
44;88;88059;398;12;410
44;88;88060;32;1;33
44;88;88061;298;13;311
44;88;88062;98;2;100
44;88;88063;136;4;140
44;88;88064;108;1;109
44;88;88065;288;5;293
44;88;88066;68;4;72
44;88;88068;899;20;919
44;88;88069;136;6;142
44;88;88070;174;1;175
44;88;88071;52;1;53
44;88;88073;213;4;217
44;88;88074;60;0;60
44;88;88075;4143;150;4293
44;88;88076;433;10;443
44;88;88077;566;14;580
44;88;88078;3073;54;3127
44;88;88079;1539;103;1642
44;88;88080;306;2;308
44;88;88081;1349;23;1372
44;88;88082;784;17;801
44;88;88083;211;10;221
44;88;88084;466;9;475
44;88;88085;187;2;189
44;88;88086;518;24;542
44;88;88087;3197;95;3292
44;88;88088;672;8;680
44;88;88089;562;14;576
44;88;88090;4690;55;4745
44;88;88091;387;9;396
44;88;88092;587;8;595
44;88;88093;43;2;45
44;88;88094;1708;50;1758
44;88;88095;1702;44;1746
44;88;88096;112;8;120
44;88;88097;43;1;44
44;88;88098;901;25;926
44;88;88099;1367;22;1389
44;88;88100;46;2;48
44;88;88101;1236;24;1260
44;88;88102;95;1;96
44;88;88103;87;2;89
44;88;88104;185;10;195
44;88;88105;213;4;217
44;88;88106;946;29;975
44;88;88107;34;0;34
44;88;88108;508;19;527
44;88;88109;646;13;659
44;88;88110;219;5;224
44;88;88111;355;4;359
44;88;88113;134;1;135
44;88;88114;3190;224;3414
44;88;88115;1500;14;1514
44;88;88116;3111;71;3182
44;88;88117;78;1;79
44;88;88118;713;20;733
44;88;88119;174;2;176
44;88;88120;486;9;495
44;88;88121;271;6;277
44;88;88122;364;7;371
44;88;88123;252;5;257
44;88;88124;1076;53;1129
44;88;88125;66;1;67
44;88;88126;1380;31;1411
44;88;88127;59;2;61
44;88;88128;249;5;254
44;88;88129;114;3;117
44;88;88130;248;4;252
44;88;88131;307;14;321
44;88;88132;1361;38;1399
44;88;88133;199;9;208
44;88;88134;624;14;638
44;88;88135;864;17;881
44;88;88136;1484;27;1511
44;88;88137;100;0;100
44;88;88138;79;2;81
44;88;88139;120;1;121
44;88;88140;368;14;382
44;88;88141;239;3;242
44;88;88142;406;8;414
44;88;88143;265;14;279
44;88;88144;56;0;56
44;88;88145;216;2;218
44;88;88146;175;2;177
44;88;88147;382;5;387
44;88;88148;1882;51;1933
44;88;88149;54;0;54
44;88;88150;294;6;300
44;88;88151;1108;28;1136
44;88;88152;249;14;263
44;88;88153;346;8;354
44;88;88154;91;2;93
44;88;88155;101;8;109
44;88;88156;132;2;134
44;88;88157;856;18;874
44;88;88158;3122;60;3182
44;88;88159;497;8;505
44;88;88160;32256;1450;33706
44;88;88161;434;12;446
44;88;88162;193;5;198
44;88;88163;745;9;754
44;88;88164;94;1;95
44;88;88165;2610;53;2663
44;88;88166;356;3;359
44;88;88167;233;5;238
44;88;88168;136;2;138
44;88;88169;215;6;221
44;88;88170;725;17;742
44;88;88171;47;1;48
44;88;88172;227;4;231
44;88;88173;462;12;474
44;88;88174;151;4;155
44;88;88175;458;20;478
44;88;88176;508;35;543
44;88;88177;520;11;531
44;88;88178;1833;69;1902
44;88;88179;44;3;47
44;88;88180;126;2;128
44;88;88181;2841;46;2887
44;88;88182;195;9;204
44;88;88183;335;7;342
44;88;88184;440;11;451
44;88;88185;109;4;113
44;88;88186;46;0;46
44;88;88187;54;1;55
44;88;88188;1726;48;1774
44;88;88189;135;4;139
44;88;88190;521;6;527
44;88;88192;105;1;106
44;88;88193;145;1;146
44;88;88194;140;12;152
44;88;88195;105;3;108
44;88;88196;7807;624;8431
44;88;88197;352;11;363
44;88;88198;601;12;613
44;88;88199;78;3;81
44;88;88200;53;1;54
44;88;88201;900;14;914
44;88;88202;191;3;194
44;88;88203;351;11;362
44;88;88205;254;17;271
44;88;88206;889;17;906
44;88;88208;115;4;119
44;88;88209;8798;123;8921
44;88;88210;173;6;179
44;88;88212;351;10;361
44;88;88213;135;0;135
44;88;88214;76;4;80
44;88;88215;77;2;79
44;88;88216;744;11;755
44;88;88218;2613;56;2669
44;88;88219;149;6;155
44;88;88220;46;1;47
44;88;88221;237;11;248
44;88;88222;253;19;272
44;88;88223;164;7;171
44;88;88224;388;12;400
44;88;88225;2359;105;2464
44;88;88226;126;3;129
44;88;88227;86;1;87
44;88;88228;174;4;178
44;88;88229;73;4;77
44;88;88230;40;0;40
44;88;88231;477;18;495
44;88;88232;219;4;223
44;88;88233;628;52;680
44;88;88236;125;0;125
44;88;88237;370;7;377
44;88;88238;393;12;405
44;88;88239;135;3;138
44;88;88240;279;2;281
44;88;88241;441;12;453
44;88;88242;45;1;46
44;88;88243;485;7;492
44;88;88244;547;18;565
44;88;88245;319;13;332
44;88;88246;484;12;496
44;88;88247;1160;14;1174
44;88;88248;174;4;178
44;88;88249;76;3;79
44;88;88250;478;5;483
44;88;88251;1119;35;1154
44;88;88252;132;7;139
44;88;88253;683;16;699
44;88;88254;82;1;83
44;88;88255;91;3;94
44;88;88256;270;5;275
44;88;88257;179;3;182
44;88;88258;858;16;874
44;88;88259;298;9;307
44;88;88260;154;2;156
44;88;88261;626;11;637
44;88;88262;582;12;594
44;88;88263;206;6;212
44;88;88264;61;3;64
44;88;88265;30;0;30
44;88;88266;834;18;852
44;88;88267;451;16;467
44;88;88268;142;8;150
44;88;88269;297;7;304
44;88;88270;2124;61;2185
44;88;88271;307;7;314
44;88;88272;71;0;71
44;88;88273;456;11;467
44;88;88274;78;1;79
44;88;88275;239;2;241
44;88;88276;395;16;411
44;88;88277;115;3;118
44;88;88278;72;1;73
44;88;88279;50;1;51
44;88;88280;137;0;137
44;88;88281;405;12;417
44;88;88283;81;2;83
44;88;88284;581;12;593
44;88;88285;440;129;569
44;88;88286;98;0;98
44;88;88287;63;1;64
44;88;88288;7;0;7
44;88;88289;816;66;882
44;88;88290;105;2;107
44;88;88291;131;3;134
44;88;88292;806;25;831
44;88;88293;216;4;220
44;88;88294;263;3;266
44;88;88295;228;7;235
44;88;88296;74;0;74
44;88;88297;157;5;162
44;88;88298;67;0;67
44;88;88299;147;1;148
44;88;88300;131;6;137
44;88;88301;294;11;305
44;88;88302;1026;22;1048
44;88;88303;199;1;200
44;88;88304;4949;487;5436
44;88;88305;196;5;201
44;88;88306;51;0;51
44;88;88307;95;2;97
44;88;88308;302;5;307
44;88;88309;159;9;168
44;88;88310;909;18;927
44;88;88311;37;1;38
44;88;88312;197;5;202
44;88;88313;420;8;428
44;88;88314;101;4;105
44;88;88315;171;2;173
44;88;88316;48;2;50
44;88;88317;566;5;571
44;88;88318;227;5;232
44;88;88319;3089;64;3153
44;88;88320;780;39;819
44;88;88321;6636;284;6920
44;88;88322;506;12;518
44;88;88324;379;10;389
44;88;88325;183;7;190
44;88;88326;349;10;359
44;88;88327;2005;22;2027
44;88;88328;542;23;565
44;88;88330;195;2;197
44;88;88331;53;2;55
44;88;88332;215;6;221
44;88;88333;123;1;124
44;88;88334;312;5;317
44;88;88335;154;3;157
44;88;88336;73;1;74
44;88;88338;84;0;84
44;88;88340;499;11;510
44;88;88341;508;10;518
44;88;88342;164;3;167
44;88;88343;159;4;163
44;88;88344;182;5;187
44;88;88345;72;3;75
44;88;88346;742;12;754
44;88;88347;118;1;119
44;88;88348;131;2;133
44;88;88349;1641;26;1667
44;88;88350;78;3;81
44;88;88351;1604;34;1638
44;88;88352;195;5;200
44;88;88353;108;3;111
44;88;88354;185;0;185
44;88;88355;1239;21;1260
44;88;88356;272;5;277
44;88;88357;685;21;706
44;88;88358;1980;35;2015
44;88;88359;91;2;93
44;88;88360;153;5;158
44;88;88361;1343;115;1458
44;88;88362;113;1;114
44;88;88363;156;5;161
44;88;88364;146;3;149
44;88;88365;158;9;167
44;88;88366;279;12;291
44;88;88367;5096;135;5231
44;88;88368;191;4;195
44;88;88369;1889;135;2024
44;88;88370;61;1;62
44;88;88371;1228;18;1246
44;88;88372;6205;141;6346
44;88;88373;147;2;149
44;88;88374;23;0;23
44;88;88375;471;7;478
44;88;88376;278;7;285
44;88;88377;122;2;124
44;88;88378;96;2;98
44;88;88379;356;6;362
44;88;88380;209;2;211
44;88;88381;199;11;210
44;88;88382;67;1;68
44;88;88383;7691;301;7992
44;88;88385;573;10;583
44;88;88386;457;4;461
44;88;88387;217;4;221
44;88;88388;121;3;124
44;88;88389;81;0;81
44;88;88390;106;8;114
44;88;88391;686;17;703
44;88;88393;315;9;324
44;88;88394;51;0;51
44;88;88395;375;8;383
44;88;88398;85;4;89
44;88;88399;202;4;206
44;88;88400;274;12;286
44;88;88401;447;9;456
44;88;88402;370;139;509
44;88;88403;190;2;192
44;88;88404;67;1;68
44;88;88406;134;1;135
44;88;88407;141;3;144
44;88;88408;3529;68;3597
44;88;88409;2146;38;2184
44;88;88410;272;4;276
44;88;88411;78;1;79
44;88;88412;438;9;447
44;88;88413;19576;484;20060
44;88;88415;3847;80;3927
44;88;88416;135;2;137
44;88;88417;386;9;395
44;88;88418;456;4;460
44;88;88419;119;0;119
44;88;88421;109;2;111
44;88;88423;1351;22;1373
44;88;88424;2308;69;2377
44;88;88425;181;5;186
44;88;88426;1367;36;1403
44;88;88427;129;1;130
44;88;88428;1836;56;1892
44;88;88429;3994;257;4251
44;88;88430;503;13;516
44;88;88431;165;3;168
44;88;88432;153;3;156
44;88;88433;76;1;77
44;88;88434;222;4;226
44;88;88435;518;12;530
44;88;88436;72;1;73
44;88;88437;99;3;102
44;88;88438;392;7;399
44;88;88439;943;36;979
44;88;88440;168;4;172
44;88;88441;128;2;130
44;88;88442;635;9;644
44;88;88443;95;2;97
44;88;88444;326;11;337
44;88;88445;2328;56;2384
44;88;88446;250;2;252
44;88;88447;2517;80;2597
44;88;88448;178;7;185
44;88;88449;187;0;187
44;88;88450;183;1;184
44;88;88451;2423;35;2458
44;88;88452;132;0;132
44;88;88453;34;0;34
44;88;88454;231;10;241
44;88;88455;98;6;104
44;88;88456;84;3;87
44;88;88457;144;1;145
44;88;88458;277;3;280
44;88;88459;43;1;44
44;88;88460;655;13;668
44;88;88461;215;0;215
44;88;88462;1884;40;1924
44;88;88463;1529;42;1571
44;88;88464;510;7;517
44;88;88465;8634;214;8848
44;88;88466;129;5;134
44;88;88467;577;15;592
44;88;88468;3376;56;3432
44;88;88469;99;4;103
44;88;88470;1555;43;1598
44;88;88471;102;1;103
44;88;88472;117;4;121
44;88;88473;106;4;110
44;88;88474;64;0;64
44;88;88475;121;5;126
44;88;88476;119;1;120
44;88;88477;97;1;98
44;88;88478;104;1;105
44;88;88479;259;4;263
44;88;88480;167;0;167
44;88;88481;1340;22;1362
44;88;88482;56;2;58
44;88;88483;2296;67;2363
44;88;88484;1035;30;1065
44;88;88485;120;0;120
44;88;88486;3911;108;4019
44;88;88487;3864;99;3963
44;88;88488;235;5;240
44;88;88489;253;8;261
44;88;88490;178;4;182
44;88;88491;119;5;124
44;88;88492;73;2;75
44;88;88493;24;1;25
44;88;88494;121;2;123
44;88;88495;177;6;183
44;88;88496;161;3;164
44;88;88497;443;8;451
44;88;88498;858;21;879
44;88;88499;160;3;163
44;88;88500;832;14;846
44;88;88501;71;0;71
44;88;88502;133;4;137
44;88;88503;148;3;151
44;88;88504;207;4;211
44;88;88505;124;2;126
44;88;88506;314;6;320
44;88;88507;200;6;206
44;88;88508;541;11;552
44;88;88509;109;1;110
44;88;88510;154;0;154
44;88;88511;86;2;88
44;88;88512;254;3;257
44;88;88513;2190;26;2216
44;88;88514;160;7;167
44;88;88515;151;2;153
44;88;88516;4832;138;4970
44;88;88517;202;3;205
44;88;88518;37;0;37
44;88;88519;676;22;698
44;88;88520;298;9;307
44;88;88521;259;3;262
44;88;88522;71;3;74
44;88;88523;153;5;158
44;88;88524;351;4;355
44;88;88525;129;2;131
44;88;88526;419;10;429
44;88;88527;144;2;146
44;88;88528;156;3;159
44;88;88529;111;4;115
44;88;88530;2586;49;2635
44;88;88531;1515;50;1565
44;88;88532;77;4;81
27;89;89002;77;3;80
27;89;89003;2856;60;2916
27;89;89004;238;11;249
27;89;89005;853;22;875
27;89;89006;160;6;166
27;89;89007;425;12;437
27;89;89008;157;7;164
27;89;89009;349;17;366
27;89;89010;207;5;212
27;89;89011;122;10;132
27;89;89012;84;2;86
27;89;89013;3245;50;3295
27;89;89014;607;8;615
27;89;89015;472;12;484
27;89;89016;78;3;81
27;89;89017;220;2;222
27;89;89018;769;6;775
27;89;89019;151;1;152
27;89;89020;113;2;115
27;89;89021;291;13;304
27;89;89022;132;3;135
27;89;89023;1008;23;1031
27;89;89024;34451;1103;35554
27;89;89025;6462;220;6682
27;89;89027;205;5;210
27;89;89028;61;5;66
27;89;89029;877;20;897
27;89;89030;413;9;422
27;89;89031;632;12;644
27;89;89032;67;3;70
27;89;89033;394;11;405
27;89;89034;470;13;483
27;89;89035;443;14;457
27;89;89036;246;6;252
27;89;89037;519;18;537
27;89;89038;112;0;112
27;89;89039;76;4;80
27;89;89040;188;3;191
27;89;89041;301;15;316
27;89;89042;166;5;171
27;89;89043;100;1;101
27;89;89044;106;1;107
27;89;89045;283;7;290
27;89;89046;1176;17;1193
27;89;89048;341;7;348
27;89;89049;21;3;24
27;89;89050;859;10;869
27;89;89051;542;12;554
27;89;89053;439;10;449
27;89;89054;787;9;796
27;89;89055;3192;71;3263
27;89;89056;628;14;642
27;89;89057;303;4;307
27;89;89058;122;2;124
27;89;89059;716;11;727
27;89;89060;457;11;468
27;89;89061;251;3;254
27;89;89062;360;4;364
27;89;89063;805;19;824
27;89;89064;56;1;57
27;89;89065;39;1;40
27;89;89066;972;24;996
27;89;89067;1106;16;1122
27;89;89068;2205;39;2244
27;89;89069;531;11;542
27;89;89071;103;0;103
27;89;89072;306;3;309
27;89;89073;920;40;960
27;89;89074;2117;40;2157
27;89;89075;723;11;734
27;89;89076;787;11;798
27;89;89077;1571;92;1663
27;89;89079;659;23;682
27;89;89080;642;4;646
27;89;89081;89;0;89
27;89;89083;1854;47;1901
27;89;89084;281;5;286
27;89;89085;1130;23;1153
27;89;89086;4815;71;4886
27;89;89087;300;9;309
27;89;89088;464;12;476
27;89;89089;137;5;142
27;89;89091;597;15;612
27;89;89092;207;11;218
27;89;89093;645;11;656
27;89;89094;708;15;723
27;89;89095;140;8;148
27;89;89096;906;26;932
27;89;89098;225;6;231
27;89;89099;2356;38;2394
27;89;89100;1676;16;1692
27;89;89101;551;11;562
27;89;89102;2169;64;2233
27;89;89104;303;13;316
27;89;89105;484;17;501
27;89;89108;345;9;354
27;89;89111;301;5;306
27;89;89112;163;8;171
27;89;89113;676;17;693
27;89;89115;206;6;212
27;89;89116;359;7;366
27;89;89117;217;1;218
27;89;89118;806;19;825
27;89;89119;512;10;522
27;89;89120;129;3;132
27;89;89122;569;8;577
27;89;89123;260;8;268
27;89;89124;1190;20;1210
27;89;89125;939;20;959
27;89;89126;33;1;34
27;89;89127;784;24;808
27;89;89128;137;4;141
27;89;89129;410;9;419
27;89;89130;1265;29;1294
27;89;89131;234;4;238
27;89;89132;165;6;171
27;89;89133;351;4;355
27;89;89134;327;8;335
27;89;89136;861;29;890
27;89;89137;472;10;482
27;89;89139;1102;35;1137
27;89;89141;116;7;123
27;89;89142;918;26;944
27;89;89143;316;3;319
27;89;89144;812;14;826
27;89;89145;379;12;391
27;89;89146;86;3;89
27;89;89147;233;2;235
27;89;89148;266;4;270
27;89;89149;214;6;220
27;89;89150;449;9;458
27;89;89151;1346;21;1367
27;89;89152;742;15;757
27;89;89153;554;17;571
27;89;89154;886;24;910
27;89;89155;699;11;710
27;89;89156;394;7;401
27;89;89158;626;15;641
27;89;89159;390;10;400
27;89;89160;761;25;786
27;89;89161;195;5;200
27;89;89162;390;3;393
27;89;89163;526;9;535
27;89;89164;91;0;91
27;89;89165;107;2;109
27;89;89167;1112;35;1147
27;89;89168;175;3;178
27;89;89169;974;21;995
27;89;89170;124;2;126
27;89;89171;297;3;300
27;89;89172;503;25;528
27;89;89173;469;5;474
27;89;89175;149;6;155
27;89;89176;137;2;139
27;89;89177;72;0;72
27;89;89179;300;8;308
27;89;89180;480;10;490
27;89;89181;119;2;121
27;89;89182;171;4;175
27;89;89183;68;0;68
27;89;89184;130;2;132
27;89;89186;530;13;543
27;89;89187;88;2;90
27;89;89188;167;6;173
27;89;89189;575;19;594
27;89;89190;180;8;188
27;89;89191;46;2;48
27;89;89194;116;6;122
27;89;89195;1251;73;1324
27;89;89196;1755;52;1807
27;89;89197;748;8;756
27;89;89198;1699;38;1737
27;89;89199;454;10;464
27;89;89200;389;16;405
27;89;89201;1786;40;1826
27;89;89202;260;7;267
27;89;89203;186;6;192
27;89;89204;661;14;675
27;89;89205;579;4;583
27;89;89206;9557;322;9879
27;89;89207;25;0;25
27;89;89208;1153;18;1171
27;89;89209;512;11;523
27;89;89210;131;7;138
27;89;89211;68;0;68
27;89;89212;368;15;383
27;89;89214;194;2;196
27;89;89215;186;4;190
27;89;89216;319;10;329
27;89;89217;137;2;139
27;89;89218;1260;22;1282
27;89;89219;144;0;144
27;89;89220;459;8;467
27;89;89221;327;5;332
27;89;89222;219;6;225
27;89;89223;661;20;681
27;89;89224;156;3;159
27;89;89225;44;0;44
27;89;89226;190;5;195
27;89;89227;1228;27;1255
27;89;89228;1393;43;1436
27;89;89229;472;12;484
27;89;89230;437;18;455
27;89;89232;289;16;305
27;89;89233;200;5;205
27;89;89234;120;2;122
27;89;89235;873;22;895
27;89;89236;1178;31;1209
27;89;89237;497;9;506
27;89;89238;545;6;551
27;89;89239;1547;45;1592
27;89;89240;327;9;336
27;89;89242;805;19;824
27;89;89244;86;4;90
27;89;89245;843;19;862
27;89;89246;355;5;360
27;89;89247;237;2;239
27;89;89248;41;2;43
27;89;89249;78;1;79
27;89;89250;201;3;204
27;89;89251;371;9;380
27;89;89252;177;4;181
27;89;89253;192;1;193
27;89;89254;523;8;531
27;89;89255;1067;22;1089
27;89;89256;415;3;418
27;89;89257;7258;112;7370
27;89;89259;90;2;92
27;89;89261;275;6;281
27;89;89262;171;8;179
27;89;89263;4125;79;4204
27;89;89264;732;27;759
27;89;89265;583;20;603
27;89;89266;262;7;269
27;89;89267;177;6;183
27;89;89268;793;16;809
27;89;89270;127;2;129
27;89;89271;104;1;105
27;89;89272;293;2;295
27;89;89273;280;4;284
27;89;89274;1336;36;1372
27;89;89276;885;40;925
27;89;89277;367;10;377
27;89;89278;552;5;557
27;89;89279;589;18;607
27;89;89280;393;9;402
27;89;89281;362;2;364
27;89;89282;678;12;690
27;89;89283;599;16;615
27;89;89284;183;4;187
27;89;89285;314;3;317
27;89;89286;830;15;845
27;89;89287;4828;118;4946
27;89;89288;179;3;182
27;89;89289;283;12;295
27;89;89290;44;1;45
27;89;89291;340;10;350
27;89;89292;250;5;255
27;89;89295;1258;32;1290
27;89;89296;130;1;131
27;89;89297;112;1;113
27;89;89298;612;9;621
27;89;89299;63;2;65
27;89;89300;80;1;81
27;89;89302;205;5;210
27;89;89303;251;6;257
27;89;89304;677;17;694
27;89;89306;366;11;377
27;89;89307;749;9;758
27;89;89308;188;7;195
27;89;89309;3316;60;3376
27;89;89310;140;3;143
27;89;89311;1392;34;1426
27;89;89312;248;5;253
27;89;89313;425;16;441
27;89;89314;181;1;182
27;89;89315;153;1;154
27;89;89316;254;8;262
27;89;89318;633;20;653
27;89;89319;483;14;497
27;89;89320;63;2;65
27;89;89321;718;17;735
27;89;89323;141;4;145
27;89;89324;657;17;674
27;89;89325;91;1;92
27;89;89326;1090;32;1122
27;89;89327;395;10;405
27;89;89328;371;9;380
27;89;89329;75;1;76
27;89;89331;312;12;324
27;89;89332;953;27;980
27;89;89333;152;4;156
27;89;89334;557;7;564
27;89;89335;418;13;431
27;89;89336;283;7;290
27;89;89337;1021;26;1047
27;89;89338;2740;77;2817
27;89;89339;190;7;197
27;89;89341;448;5;453
27;89;89342;650;18;668
27;89;89344;1495;15;1510
27;89;89345;4240;62;4302
27;89;89346;3225;143;3368
27;89;89347;349;10;359
27;89;89348;2236;48;2284
27;89;89349;354;6;360
27;89;89350;261;4;265
27;89;89351;482;8;490
27;89;89352;268;7;275
27;89;89353;418;4;422
27;89;89354;1525;42;1567
27;89;89355;145;6;151
27;89;89359;417;5;422
27;89;89360;372;6;378
27;89;89361;255;2;257
27;89;89362;178;5;183
27;89;89363;107;2;109
27;89;89364;295;5;300
27;89;89365;526;15;541
27;89;89367;548;11;559
27;89;89368;892;20;912
27;89;89369;572;12;584
27;89;89370;1727;21;1748
27;89;89371;84;0;84
27;89;89373;675;10;685
27;89;89374;73;3;76
27;89;89375;84;3;87
27;89;89376;144;7;151
27;89;89377;70;0;70
27;89;89378;722;15;737
27;89;89379;151;3;154
27;89;89380;454;7;461
27;89;89382;1476;37;1513
27;89;89383;104;2;106
27;89;89384;683;24;707
27;89;89385;77;3;80
27;89;89386;115;1;116
27;89;89387;26688;515;27203
27;89;89388;519;14;533
27;89;89390;663;10;673
27;89;89391;1269;26;1295
27;89;89392;248;3;251
27;89;89393;110;2;112
27;89;89394;80;1;81
27;89;89395;409;8;417
27;89;89397;364;5;369
27;89;89398;360;4;364
27;89;89399;1592;45;1637
27;89;89400;316;5;321
27;89;89402;221;4;225
27;89;89403;88;8;96
27;89;89404;523;9;532
27;89;89405;499;6;505
27;89;89406;72;2;74
27;89;89407;935;31;966
27;89;89408;277;7;284
27;89;89409;61;1;62
27;89;89410;100;1;101
27;89;89411;1038;18;1056
27;89;89412;185;8;193
27;89;89413;36;1;37
27;89;89414;1417;30;1447
27;89;89415;200;3;203
27;89;89416;439;7;446
27;89;89417;109;2;111
27;89;89418;4381;165;4546
27;89;89419;2615;141;2756
27;89;89420;969;20;989
27;89;89422;41;2;43
27;89;89423;127;3;130
27;89;89424;134;6;140
27;89;89425;674;20;694
27;89;89426;387;12;399
27;89;89427;681;19;700
27;89;89428;564;6;570
27;89;89430;322;9;331
27;89;89431;71;1;72
27;89;89432;461;8;469
27;89;89433;274;5;279
27;89;89434;349;8;357
27;89;89436;877;15;892
27;89;89437;301;7;308
27;89;89438;1759;200;1959
27;89;89439;1528;24;1552
27;89;89440;413;5;418
27;89;89441;1255;25;1280
27;89;89442;241;7;248
27;89;89443;1887;62;1949
27;89;89445;52;2;54
27;89;89446;418;4;422
27;89;89447;156;5;161
27;89;89449;1815;35;1850
27;89;89450;627;22;649
27;89;89451;250;4;254
27;89;89452;380;13;393
27;89;89453;1126;30;1156
27;89;89456;668;8;676
27;89;89458;166;9;175
27;89;89459;318;0;318
27;89;89460;3515;46;3561
27;89;89461;1112;19;1131
27;89;89462;296;3;299
27;89;89463;254;4;258
27;89;89464;5165;85;5250
27;89;89465;321;1;322
27;89;89466;388;9;397
27;89;89467;819;14;833
27;89;89468;419;59;478
27;89;89469;949;21;970
27;89;89470;121;7;128
27;89;89471;467;15;482
27;89;89472;448;9;457
27;89;89474;275;6;281
27;89;89475;109;2;111
27;89;89477;112;2;114
27;89;89478;914;15;929
27;89;89479;292;6;298
27;89;89480;1594;24;1618
27;89;89481;107;6;113
27;89;89482;111;1;112
27;89;89483;509;18;527
27;89;89485;204;6;210
27;89;89486;154;3;157
27;90;90001;1171;21;1192
27;90;90002;356;8;364
27;90;90003;589;22;611
27;90;90004;512;15;527
27;90;90005;453;13;466
27;90;90006;286;7;293
27;90;90007;288;12;300
27;90;90008;4659;108;4767
27;90;90009;5010;64;5074
27;90;90010;46443;799;47242
27;90;90011;378;9;387
27;90;90012;1283;46;1329
27;90;90013;239;11;250
27;90;90014;488;8;496
27;90;90015;238;9;247
27;90;90016;123;2;125
27;90;90017;1903;26;1929
27;90;90018;396;7;403
27;90;90019;270;6;276
27;90;90020;275;9;284
27;90;90021;363;4;367
27;90;90022;2667;51;2718
27;90;90023;1164;32;1196
27;90;90024;141;3;144
27;90;90025;344;4;348
27;90;90026;1570;38;1608
27;90;90027;116;0;116
27;90;90028;388;7;395
27;90;90029;1951;53;2004
27;90;90030;168;3;171
27;90;90031;344;9;353
27;90;90032;3620;68;3688
27;90;90033;5667;86;5753
27;90;90034;757;26;783
27;90;90035;797;10;807
27;90;90036;270;9;279
27;90;90037;941;26;967
27;90;90039;3321;103;3424
27;90;90041;1430;51;1481
27;90;90042;2032;69;2101
27;90;90043;582;2;584
27;90;90044;239;5;244
27;90;90045;762;13;775
27;90;90046;447;6;453
27;90;90047;596;15;611
27;90;90048;122;3;125
27;90;90049;919;18;937
27;90;90050;240;7;247
27;90;90051;467;8;475
27;90;90052;2929;80;3009
27;90;90053;3003;61;3064
27;90;90054;521;10;531
27;90;90055;336;2;338
27;90;90056;1410;29;1439
27;90;90057;746;26;772
27;90;90058;580;6;586
27;90;90059;227;10;237
27;90;90060;139;3;142
27;90;90061;43;2;45
27;90;90062;284;10;294
27;90;90063;415;9;424
27;90;90064;303;4;307
27;90;90065;1156;21;1177
27;90;90066;242;1;243
27;90;90067;397;18;415
27;90;90068;1368;31;1399
27;90;90069;1308;24;1332
27;90;90070;404;9;413
27;90;90071;1175;21;1196
27;90;90072;1076;22;1098
27;90;90074;302;4;306
27;90;90075;4219;99;4318
27;90;90076;1176;41;1217
27;90;90077;299;7;306
27;90;90078;189;5;194
27;90;90079;314;6;320
27;90;90080;439;13;452
27;90;90081;776;13;789
27;90;90082;277;9;286
27;90;90083;124;0;124
27;90;90084;343;10;353
27;90;90085;95;2;97
27;90;90086;221;6;227
27;90;90087;1040;31;1071
27;90;90088;966;25;991
27;90;90089;1497;65;1562
27;90;90090;435;12;447
27;90;90091;643;23;666
27;90;90093;916;20;936
27;90;90094;702;24;726
27;90;90095;434;3;437
27;90;90096;282;8;290
27;90;90097;1283;32;1315
27;90;90098;242;11;253
27;90;90099;5269;239;5508
27;90;90100;201;12;213
27;90;90101;243;6;249
27;90;90102;719;23;742
27;90;90103;660;22;682
27;90;90104;986;23;1009
27;90;90105;179;5;184
11;91;91001;324;8;332
11;91;91016;4353;70;4423
11;91;91017;1723;26;1749
11;91;91021;11355;92;11447
11;91;91022;135;5;140
11;91;91027;35670;331;36001
11;91;91035;374;6;380
11;91;91037;324;1;325
11;91;91038;1273;22;1295
11;91;91041;995;7;1002
11;91;91044;4600;42;4642
11;91;91045;7593;100;7693
11;91;91047;1311;13;1324
11;91;91064;4823;112;4935
11;91;91067;117;4;121
11;91;91069;387;10;397
11;91;91075;80;1;81
11;91;91079;510;7;517
11;91;91080;1341;14;1355
11;91;91081;689;17;706
11;91;91085;3828;47;3875
11;91;91086;10046;98;10144
11;91;91093;648;21;669
11;91;91095;2113;26;2139
11;91;91097;7983;75;8058
11;91;91098;426;5;431
11;91;91099;2963;41;3004
11;91;91100;646;16;662
11;91;91103;27412;321;27733
11;91;91105;8566;120;8686
11;91;91106;1290;12;1302
11;91;91109;1260;9;1269
11;91;91111;3342;39;3381
11;91;91112;128;4;132
11;91;91114;25330;427;25757
11;91;91115;3497;43;3540
11;91;91121;434;7;441
11;91;91122;9408;220;9628
11;91;91129;3337;165;3502
11;91;91130;1026;28;1054
11;91;91131;404;8;412
11;91;91132;1133;12;1145
11;91;91135;2867;56;2923
11;91;91136;2778;18;2796
11;91;91137;370;6;376
11;91;91145;69;0;69
11;91;91148;137;0;137
11;91;91156;2226;30;2256
11;91;91159;1590;28;1618
11;91;91161;19822;128;19950
11;91;91174;51234;294;51528
11;91;91175;1718;31;1749
11;91;91179;4844;45;4889
11;91;91180;337;10;347
11;91;91184;276;7;283
11;91;91186;577;8;585
11;91;91191;9369;58;9427
11;91;91195;822;6;828
11;91;91198;1495;24;1519
11;91;91200;10452;187;10639
11;91;91201;28602;265;28867
11;91;91204;791;17;808
11;91;91207;6322;53;6375
11;91;91215;12266;83;12349
11;91;91216;11184;145;11329
11;91;91223;25629;184;25813
11;91;91225;3144;150;3294
11;91;91226;6729;92;6821
11;91;91228;66851;466;67317
11;91;91232;3659;55;3714
11;91;91235;13641;18;13659
11;91;91240;182;4;186
11;91;91243;2232;32;2264
11;91;91244;1591;26;1617
11;91;91247;519;7;526
11;91;91248;161;1;162
11;91;91249;3923;75;3998
11;91;91272;21007;595;21602
11;91;91273;766;18;784
11;91;91274;1502;24;1526
11;91;91275;2664;50;2714
11;91;91284;1177;23;1200
11;91;91286;28201;98;28299
11;91;91292;842;15;857
11;91;91293;903;17;920
11;91;91294;814;11;825
11;91;91312;9917;303;10220
11;91;91315;6522;61;6583
11;91;91318;1970;49;2019
11;91;91319;635;10;645
11;91;91326;17454;127;17581
11;91;91330;5483;102;5585
11;91;91332;1477;24;1501
11;91;91333;4378;43;4421
11;91;91338;6492;121;6613
11;91;91339;6842;51;6893
11;91;91340;7333;63;7396
11;91;91345;21269;143;21412
11;91;91347;6375;53;6428
11;91;91359;2780;40;2820
11;91;91363;8138;157;8295
11;91;91374;237;3;240
11;91;91376;5610;54;5664
11;91;91377;50644;352;50996
11;91;91378;289;3;292
11;91;91386;15292;291;15583
11;91;91390;3305;43;3348
11;91;91393;625;8;633
11;91;91399;227;5;232
11;91;91405;4635;92;4727
11;91;91408;1252;30;1282
11;91;91411;1874;49;1923
11;91;91412;738;15;753
11;91;91414;382;5;387
11;91;91421;23760;293;24053
11;91;91425;7681;223;7904
11;91;91432;13424;78;13502
11;91;91433;4346;106;4452
11;91;91434;20124;165;20289
11;91;91435;550;27;577
11;91;91441;503;11;514
11;91;91457;4331;46;4377
11;91;91458;4511;73;4584
11;91;91461;4759;58;4817
11;91;91463;1044;21;1065
11;91;91468;2158;21;2179
11;91;91469;911;49;960
11;91;91471;15503;329;15832
11;91;91473;168;2;170
11;91;91477;35236;332;35568
11;91;91479;7814;58;7872
11;91;91482;548;11;559
11;91;91494;4140;58;4198
11;91;91495;337;3;340
11;91;91507;289;5;294
11;91;91508;258;4;262
11;91;91511;2106;29;2135
11;91;91514;9426;47;9473
11;91;91519;393;11;404
11;91;91521;29745;182;29927
11;91;91525;1340;25;1365
11;91;91526;107;1;108
11;91;91533;1859;24;1883
11;91;91534;4256;57;4313
11;91;91538;696;20;716
11;91;91540;5238;79;5317
11;91;91544;524;9;533
11;91;91546;937;22;959
11;91;91547;506;17;523
11;91;91549;35830;310;36140
11;91;91552;10983;77;11060
11;91;91553;7488;97;7585
11;91;91556;410;9;419
11;91;91560;487;7;494
11;91;91568;1544;37;1581
11;91;91570;20484;147;20631
11;91;91573;11220;111;11331
11;91;91577;5797;65;5862
11;91;91578;278;5;283
11;91;91579;3059;52;3111
11;91;91581;902;10;912
11;91;91587;6416;56;6472
11;91;91589;36577;246;36823
11;91;91593;1610;38;1648
11;91;91599;1282;22;1304
11;91;91600;7213;138;7351
11;91;91602;441;9;450
11;91;91613;216;8;224
11;91;91617;4294;76;4370
11;91;91619;274;10;284
11;91;91629;620;12;632
11;91;91630;1486;32;1518
11;91;91631;2300;31;2331
11;91;91634;1355;31;1386
11;91;91635;2064;32;2096
11;91;91639;959;68;1027
11;91;91645;14888;360;15248
11;91;91648;2262;27;2289
11;91;91649;2818;38;2856
11;91;91654;595;17;612
11;91;91657;31394;181;31575
11;91;91659;5487;43;5530
11;91;91661;10466;165;10631
11;91;91662;726;22;748
11;91;91665;8010;65;8075
11;91;91666;2425;18;2443
11;91;91667;7058;90;7148
11;91;91671;604;7;611
11;91;91679;1212;17;1229
11;91;91685;4600;39;4639
11;91;91687;30865;214;31079
11;91;91689;7133;69;7202
11;91;91691;29318;209;29527
11;91;91692;25024;150;25174
11;92;92002;62760;775;63535
11;92;92004;87143;666;87809
11;92;92007;40936;134;41070
11;92;92009;28841;241;29082
11;92;92012;121583;1242;122825
11;92;92014;21050;360;21410
11;92;92019;34021;357;34378
11;92;92020;36639;295;36934
11;92;92022;20771;310;21081
11;92;92023;52925;499;53424
11;92;92024;63089;257;63346
11;92;92025;86534;586;87120
11;92;92026;81558;655;82213
11;92;92032;25531;231;25762
11;92;92033;17795;438;18233
11;92;92035;29642;247;29889
11;92;92036;48530;216;48746
11;92;92040;67981;704;68685
11;92;92044;66082;571;66653
11;92;92046;30950;201;31151
11;92;92047;1774;61;1835
11;92;92048;45818;684;46502
11;92;92049;48352;235;48587
11;92;92050;96277;640;96917
11;92;92051;59599;985;60584
11;92;92060;30061;154;30215
11;92;92062;45157;289;45446
11;92;92063;78317;1471;79788
11;92;92064;30012;598;30610
11;92;92071;20004;370;20374
11;92;92072;23463;389;23852
11;92;92073;49311;505;49816
11;92;92075;27846;285;28131
11;92;92076;8683;325;9008
11;92;92077;11225;302;11527
11;92;92078;24097;86;24183
11;93;93001;88948;191;89139
11;93;93005;86969;410;87379
11;93;93006;36060;106;36166
11;93;93007;57498;166;57664
11;93;93008;54363;165;54528
11;93;93010;54587;159;54746
11;93;93013;15905;43;15948
11;93;93014;28782;92;28874
11;93;93015;4921;42;4963
11;93;93027;45053;128;45181
11;93;93029;72376;282;72658
11;93;93030;11073;40;11113
11;93;93031;54611;157;54768
11;93;93032;39661;199;39860
11;93;93033;6844;61;6905
11;93;93039;8288;41;8329
11;93;93045;23447;128;23575
11;93;93046;45692;216;45908
11;93;93047;27928;130;28058
11;93;93048;111240;570;111810
11;93;93049;20878;129;21007
11;93;93050;35907;121;36028
11;93;93051;67871;385;68256
11;93;93053;44463;128;44591
11;93;93055;59846;181;60027
11;93;93057;23898;97;23995
11;93;93059;30861;47;30908
11;93;93061;17351;72;17423
11;93;93062;14569;198;14767
11;93;93063;30087;84;30171
11;93;93064;46024;174;46198
11;93;93066;112852;914;113766
11;93;93070;50697;129;50826
11;93;93071;51734;173;51907
11;93;93072;38285;76;38361
11;93;93073;36461;163;36624
11;93;93074;7181;89;7270
11;93;93077;30405;185;30590
11;93;93078;37713;83;37796
11;93;93079;13574;82;13656
11;94;94001;5852;27;5879
11;94;94002;44805;161;44966
11;94;94003;21788;122;21910
11;94;94004;16977;55;17032
11;94;94011;18062;72;18134
11;94;94015;17525;198;17723
11;94;94016;30440;274;30714
11;94;94017;76990;344;77334
11;94;94018;29882;204;30086
11;94;94019;18039;114;18153
11;94;94021;19988;69;20057
11;94;94022;46150;209;46359
11;94;94028;93246;476;93722
11;94;94033;52008;419;52427
11;94;94034;28710;112;28822
11;94;94037;18815;106;18921
11;94;94038;32071;173;32244
11;94;94041;63748;250;63998
11;94;94042;19652;155;19807
11;94;94043;24971;114;25085
11;94;94044;27833;112;27945
11;94;94046;56483;291;56774
11;94;94047;4777;48;4825
11;94;94048;4783;105;4888
11;94;94052;34042;236;34278
11;94;94053;4607;42;4649
11;94;94054;24627;178;24805
11;94;94055;10419;91;10510
11;94;94056;2688;24;2712
11;94;94058;33588;303;33891
11;94;94059;19829;78;19907
11;94;94060;12051;133;12184
11;94;94065;5657;67;5724
11;94;94067;22377;199;22576
11;94;94068;74976;912;75888
11;94;94069;14189;118;14307
11;94;94070;4014;61;4075
11;94;94071;27157;258;27415
11;94;94073;30676;234;30910
11;94;94074;14883;51;14934
11;94;94075;11779;65;11844
11;94;94076;55208;243;55451
11;94;94077;21679;96;21775
11;94;94078;34890;102;34992
11;94;94079;28895;119;29014
11;94;94080;49788;442;50230
11;94;94081;95510;459;95969
11;95;95002;1124;14;1138
11;95;95008;887;12;899
11;95;95011;387;3;390
11;95;95012;205;6;211
11;95;95014;2574;54;2628
11;95;95018;111038;557;111595
11;95;95019;14255;80;14335
11;95;95023;637;3;640
11;95;95024;271;5;276
11;95;95026;2939;39;2978
11;95;95028;1691;8;1699
11;95;95039;6813;102;6915
11;95;95040;857;14;871
11;95;95042;1899;15;1914
11;95;95046;148;2;150
11;95;95051;8687;94;8781
11;95;95052;9504;103;9607
11;95;95054;212;5;217
11;95;95055;477;3;480
11;95;95056;2203;9;2212
11;95;95058;2733;24;2757
11;95;95059;350;3;353
11;95;95060;7878;61;7939
11;95;95061;410;2;412
11;95;95063;31671;124;31795
11;95;95074;818;15;833
11;95;95078;1844;31;1875
11;95;95088;1129;2;1131
11;95;95091;6578;58;6636
11;95;95094;302;3;305
11;95;95101;962;12;974
11;95;95102;404;9;413
11;95;95110;212;3;215
11;95;95116;4347;34;4381
11;95;95119;322;3;325
11;95;95120;2276;24;2300
11;95;95127;65911;518;66429
11;95;95134;5018;42;5060
11;95;95139;316;5;321
11;95;95141;36;0;36
11;95;95142;2046;17;2063
11;95;95144;76;1;77
11;95;95149;3241;54;3295
11;95;95150;582;15;597
11;95;95151;299;5;304
11;95;95154;305;3;308
11;95;95157;124;4;128
11;95;95166;465;7;472
11;95;95169;498;3;501
11;95;95170;548;1;549
11;95;95176;25406;214;25620
11;95;95177;1333;14;1347
11;95;95181;288;3;291
11;95;95183;6709;111;6820
11;95;95197;22149;187;22336
11;95;95199;15504;194;15698
11;95;95203;25335;318;25653
11;95;95205;7125;44;7169
11;95;95210;11470;158;11628
11;95;95211;2418;24;2442
11;95;95212;109;0;109
11;95;95213;616;15;631
11;95;95214;70;0;70
11;95;95218;18296;120;18416
11;95;95219;28939;244;29183
11;95;95229;9656;56;9712
11;95;95241;2007;16;2023
11;95;95250;9791;61;9852
11;95;95252;37394;170;37564
11;95;95253;520;11;531
11;95;95254;558;7;565
11;95;95256;3342;44;3386
11;95;95257;4701;41;4742
11;95;95258;349;8;357
11;95;95268;43239;94;43333
11;95;95270;541;19;560
11;95;95271;519;9;528
11;95;95277;26106;122;26228
11;95;95280;31068;143;31211
11;95;95282;160;1;161
11;95;95287;694;12;706
11;95;95288;8509;52;8561
11;95;95295;142;3;145
11;95;95298;561;7;568
11;95;95301;286;6;292
11;95;95303;206;1;207
11;95;95304;281;2;283
11;95;95306;31314;231;31545
11;95;95308;576;12;588
11;95;95309;207;3;210
11;95;95313;12063;216;12279
11;95;95316;271;2;273
11;95;95323;16741;132;16873
11;95;95328;643;7;650
11;95;95331;190;3;193
11;95;95341;383;9;392
11;95;95348;550;6;556
11;95;95351;11037;83;11120
11;95;95352;4733;79;4812
11;95;95353;1834;17;1851
11;95;95355;5846;58;5904
11;95;95365;707;8;715
11;95;95369;2846;50;2896
11;95;95370;3446;52;3498
11;95;95371;5663;43;5706
11;95;95379;188;2;190
11;95;95387;62;0;62
11;95;95388;5902;53;5955
11;95;95392;5168;53;5221
11;95;95394;9865;97;9962
11;95;95395;898;9;907
11;95;95409;1287;3;1290
11;95;95422;347;3;350
11;95;95424;21528;110;21638
11;95;95426;2937;75;3012
11;95;95427;14523;65;14588
11;95;95428;21723;252;21975
11;95;95429;406;10;416
11;95;95430;3633;35;3668
11;95;95436;1629;9;1638
11;95;95438;121;2;123
11;95;95445;747;4;751
11;95;95446;1803;31;1834
11;95;95447;220;4;224
11;95;95450;2043;28;2071
11;95;95452;863;7;870
11;95;95456;653;4;657
11;95;95459;699;15;714
11;95;95462;323;8;331
11;95;95476;17446;239;17685
11;95;95480;5589;112;5701
11;95;95483;533;4;537
11;95;95487;13734;54;13788
11;95;95488;9423;39;9462
11;95;95489;671;69;740
11;95;95491;8514;75;8589
11;95;95492;74;0;74
11;95;95493;128;1;129
11;95;95500;32405;486;32891
11;95;95504;3923;51;3974
11;95;95509;3563;32;3595
11;95;95510;583;11;594
11;95;95523;479;37;516
11;95;95527;2833;26;2859
11;95;95529;866;8;874
11;95;95535;1104;26;1130
11;95;95539;15043;78;15121
11;95;95541;1001;13;1014
11;95;95543;240;1;241
11;95;95554;896;19;915
11;95;95555;20895;166;21061
11;95;95563;16130;174;16304
11;95;95566;2697;24;2721
11;95;95572;24674;115;24789
11;95;95574;7036;107;7143
11;95;95580;2379;104;2483
11;95;95582;26565;336;26901
11;95;95584;663;7;670
11;95;95585;59196;252;59448
11;95;95592;1290;14;1304
11;95;95594;1025;14;1039
11;95;95598;18033;161;18194
11;95;95604;4213;25;4238
11;95;95607;26872;190;27062
11;95;95610;300;7;307
11;95;95611;50;0;50
11;95;95612;4567;21;4588
11;95;95625;1339;12;1351
11;95;95627;598;13;611
11;95;95628;1213;25;1238
11;95;95633;98;0;98
11;95;95637;16456;219;16675
11;95;95641;2699;22;2721
11;95;95651;884;19;903
11;95;95652;5194;73;5267
11;95;95656;379;6;385
11;95;95658;1083;22;1105
11;95;95660;775;8;783
11;95;95675;1506;14;1520
11;95;95676;490;10;500
11;95;95678;861;11;872
11;95;95680;28423;117;28540
11;95;95682;189;3;192
11;95;95690;330;7;337
01;971;97101;53514;513;54027
01;971;97102;4001;64;4065
01;971;97103;30837;498;31335
01;971;97104;5203;92;5295
01;971;97105;9861;244;10105
01;971;97106;6847;111;6958
01;971;97107;17741;173;17914
01;971;97108;3298;43;3341
01;971;97109;7760;185;7945
01;971;97110;1419;34;1453
01;971;97111;3998;65;4063
01;971;97112;4870;132;5002
01;971;97113;26489;344;26833
01;971;97114;7621;138;7759
01;971;97115;16354;297;16651
01;971;97116;16495;197;16692
01;971;97117;22149;274;22423
01;971;97118;24753;421;25174
01;971;97119;8203;123;8326
01;971;97120;15181;108;15289
01;971;97121;6031;144;6175
01;971;97122;5618;70;5688
01;971;97124;10466;265;10731
01;971;97125;11689;160;11849
01;971;97126;2397;54;2451
01;971;97128;24151;269;24420
01;971;97129;17985;294;18279
01;971;97130;975;24;999
01;971;97131;1519;51;1570
01;971;97132;7862;148;8010
01;971;97133;1842;31;1873
01;971;97134;7110;190;7300
02;972;97201;1756;31;1787
02;972;97202;3494;53;3547
02;972;97203;2823;42;2865
02;972;97204;3461;47;3508
02;972;97205;4455;68;4523
02;972;97206;5511;74;5585
02;972;97207;17655;287;17942
02;972;97208;680;12;692
02;972;97209;76512;898;77410
02;972;97210;15980;210;16190
02;972;97211;610;11;621
02;972;97212;9689;88;9777
02;972;97213;40095;590;40685
02;972;97214;6768;76;6844
02;972;97215;1050;8;1058
02;972;97216;3117;49;3166
02;972;97217;8751;145;8896
02;972;97218;4795;53;4848
02;972;97219;1203;23;1226
02;972;97220;11877;143;12020
02;972;97221;11874;237;12111
02;972;97222;21913;183;22096
02;972;97223;9890;97;9987
02;972;97224;15883;249;16132
02;972;97225;4121;55;4176
02;972;97226;4444;59;4503
02;972;97227;9487;204;9691
02;972;97228;15487;165;15652
02;972;97229;19612;218;19830
02;972;97230;12025;152;12177
02;972;97231;7242;123;7365
02;972;97232;8619;96;8715
02;972;97233;1816;26;1842
02;972;97234;1813;126;1939
03;973;97301;854;26;880
03;973;97302;65493;385;65878
03;973;97303;1748;20;1768
03;973;97304;24903;245;25148
03;973;97305;16219;186;16405
03;973;97306;11675;170;11845
03;973;97307;33458;238;33696
03;973;97308;4245;90;4335
03;973;97309;26358;381;26739
03;973;97310;3458;54;3512
03;973;97311;47621;342;47963
03;973;97312;2875;44;2919
03;973;97313;2957;19;2976
03;973;97314;242;1;243
03;973;97352;152;7;159
03;973;97353;11842;125;11967
03;973;97356;1864;24;1888
03;973;97357;8779;5;8784
03;973;97358;247;1;248
03;973;97360;9482;15;9497
03;973;97361;1449;12;1461
03;973;97362;5757;17;5774
04;974;97401;11440;210;11650
04;974;97402;13057;203;13260
04;974;97403;6927;65;6992
04;974;97404;14059;199;14258
04;974;97405;12395;123;12518
04;974;97406;6626;99;6725
04;974;97407;32977;258;33235
04;974;97408;32985;420;33405
04;974;97409;56902;464;57366
04;974;97410;37036;249;37285
04;974;97411;153810;1492;155302
04;974;97412;37918;507;38425
04;974;97413;34586;476;35062
04;974;97414;53120;573;53693
04;974;97415;103208;1348;104556
04;974;97416;84982;896;85878
04;974;97417;5198;66;5264
04;974;97418;34061;450;34511
04;974;97419;6345;77;6422
04;974;97420;24065;227;24292
04;974;97421;7136;73;7209
04;974;97422;79824;1009;80833
04;974;97423;7015;91;7106
04;974;97424;5538;85;5623
